date,縣市,鄉鎮,戶數,人口總,人口男,人口女
2007/3/1,總計,臺灣地區,7380217,22792780,11539693,11253087
2007/3/1,總計,臺灣省,5888276,18651530,9505179,9146351
2007/3/1,總計,新北市,1285668,3771528,1888465,1883063
2007/3/1,總計,宜蘭縣,145031,460211,236195,224016
2007/3/1,總計,桃園市,607502,1915521,973309,942212
2007/3/1,總計,新竹縣,143929,489334,253504,235830
2007/3/1,總計,苗栗縣,160956,559709,292586,267123
2007/3/1,總計,臺中市,437103,1544771,786970,757801
2007/3/1,總計,彰化縣,344856,1314822,678370,636452
2007/3/1,總計,南投縣,162641,534724,277245,257479
2007/3/1,總計,雲林縣,216366,727446,382312,345134
2007/3/1,總計,嘉義縣,167137,552819,290181,262638
2007/3/1,總計,臺南市,349995,1106114,568160,537954
2007/3/1,總計,高雄市,411275,1244560,641661,602899
2007/3/1,總計,屏東縣,264920,891915,461789,430126
2007/3/1,總計,臺東縣,77396,235226,124290,110936
2007/3/1,總計,花蓮縣,115543,344550,179387,165163
2007/3/1,總計,澎湖縣,30085,91950,47563,44387
2007/3/1,總計,基隆市,141042,390412,198113,192299
2007/3/1,總計,新竹市,128604,396261,198690,197571
2007/3/1,總計,臺中市,354930,1046372,512444,533928
2007/3/1,總計,嘉義市,89647,272221,134931,137290
2007/3/1,總計,臺南市,253650,761064,379014,382050
2007/3/1,總計,臺北市,939801,2626273,1278977,1347296
2007/3/1,總計,高雄市,552140,1514977,755537,759440
2007/3/1,總計,福建省,30613,87674,47049,40625
2007/3/1,總計,金門縣,28716,77873,41311,36562
2007/3/1,總計,連江縣,1897,9801,5738,4063
2007/3/1,新北市,板橋區,179223,544649,271929,272720
2007/3/1,新北市,三重區,129159,383506,192624,190882
2007/3/1,新北市,永和區,86712,235458,113846,121612
2007/3/1,新北市,中和區,144913,410116,204269,205847
2007/3/1,新北市,新莊區,126920,393330,195688,197642
2007/3/1,新北市,新店區,109172,289695,143478,146217
2007/3/1,新北市,土城區,77351,236970,119069,117901
2007/3/1,新北市,蘆洲區,60095,190296,94774,95522
2007/3/1,新北市,汐止區,72806,179174,89752,89422
2007/3/1,新北市,樹林區,50931,162792,82548,80244
2007/3/1,新北市,鶯歌區,25164,85157,43463,41694
2007/3/1,新北市,三峽區,29010,92302,47732,44570
2007/3/1,新北市,淡水區,48373,130334,64219,66115
2007/3/1,新北市,瑞芳區,15385,43630,22443,21187
2007/3/1,新北市,五股區,25088,76463,38968,37495
2007/3/1,新北市,泰山區,23980,73216,37121,36095
2007/3/1,新北市,林口區,20301,63015,31612,31403
2007/3/1,新北市,深坑區,7959,21777,11141,10636
2007/3/1,新北市,石碇區,3132,7927,4420,3507
2007/3/1,新北市,坪林區,2317,6612,3724,2888
2007/3/1,新北市,三芝區,8397,23494,12269,11225
2007/3/1,新北市,石門區,3594,11726,6232,5494
2007/3/1,新北市,八里區,10887,32394,16655,15739
2007/3/1,新北市,平溪區,2334,5769,3213,2556
2007/3/1,新北市,雙溪區,3768,9952,5383,4569
2007/3/1,新北市,貢寮區,4265,13943,7275,6668
2007/3/1,新北市,金山區,6348,22198,11351,10847
2007/3/1,新北市,萬里區,6420,20283,10518,9765
2007/3/1,新北市,烏來區,1664,5350,2749,2601
2007/3/1,宜蘭縣,宜蘭市,31473,95579,47428,48151
2007/3/1,宜蘭縣,羅東鎮,23903,74201,35726,38475
2007/3/1,宜蘭縣,蘇澳鎮,12979,43121,22450,20671
2007/3/1,宜蘭縣,頭城鎮,9106,31842,16544,15298
2007/3/1,宜蘭縣,礁溪鄉,11568,35986,18939,17047
2007/3/1,宜蘭縣,壯圍鄉,7689,25338,13405,11933
2007/3/1,宜蘭縣,員山鄉,10095,32444,17496,14948
2007/3/1,宜蘭縣,冬山鄉,16039,51174,26590,24584
2007/3/1,宜蘭縣,五結鄉,11916,37600,19711,17889
2007/3/1,宜蘭縣,三星鄉,6827,21237,11560,9677
2007/3/1,宜蘭縣,大同鄉,1752,5801,3224,2577
2007/3/1,宜蘭縣,南澳鄉,1684,5888,3122,2766
2007/3/1,桃園市,桃園區,130403,386556,190351,196205
2007/3/1,桃園市,中壢區,114694,355780,179117,176663
2007/3/1,桃園市,平鎮區,60510,201060,101973,99087
2007/3/1,桃園市,八德區,52418,171396,88284,83112
2007/3/1,桃園市,大溪區,26999,89512,46454,43058
2007/3/1,桃園市,楊梅區,42965,141088,72311,68777
2007/3/1,桃園市,蘆竹區,41581,128772,65073,63699
2007/3/1,桃園市,大園區,23423,79312,41473,37839
2007/3/1,桃園市,龜山區,45034,130138,66743,63395
2007/3/1,桃園市,龍潭區,34049,112077,57391,54686
2007/3/1,桃園市,新屋區,14215,49896,26679,23217
2007/3/1,桃園市,觀音區,17608,59175,31421,27754
2007/3/1,桃園市,復興區,3603,10759,6039,4720
2007/3/1,新竹縣,竹北市,37694,121183,61122,60061
2007/3/1,新竹縣,關西鎮,8740,32730,17499,15231
2007/3/1,新竹縣,新埔鎮,9770,36171,19217,16954
2007/3/1,新竹縣,竹東鎮,28305,95910,48516,47394
2007/3/1,新竹縣,湖口鄉,21621,73573,37898,35675
2007/3/1,新竹縣,橫山鄉,4150,14744,8063,6681
2007/3/1,新竹縣,新豐鄉,14316,51208,26605,24603
2007/3/1,新竹縣,芎林鄉,5862,20756,10935,9821
2007/3/1,新竹縣,寶山鄉,4388,13758,7457,6301
2007/3/1,新竹縣,北埔鄉,2937,10430,5658,4772
2007/3/1,新竹縣,峨眉鄉,1962,6162,3433,2729
2007/3/1,新竹縣,尖石鄉,2517,8193,4538,3655
2007/3/1,新竹縣,五峰鄉,1667,4516,2563,1953
2007/3/1,苗栗縣,苗栗市,27560,90782,46106,44676
2007/3/1,苗栗縣,苑裡鎮,13086,48961,25672,23289
2007/3/1,苗栗縣,通霄鎮,10836,39479,21115,18364
2007/3/1,苗栗縣,竹南鎮,21215,74401,38041,36360
2007/3/1,苗栗縣,頭份市,26644,93907,48162,45745
2007/3/1,苗栗縣,後龍鎮,11324,40664,21615,19049
2007/3/1,苗栗縣,卓蘭鎮,5684,18596,9910,8686
2007/3/1,苗栗縣,大湖鄉,5043,16375,8841,7534
2007/3/1,苗栗縣,公館鄉,9431,34623,18199,16424
2007/3/1,苗栗縣,銅鑼鄉,5814,20033,10694,9339
2007/3/1,苗栗縣,南庄鄉,3797,11589,6459,5130
2007/3/1,苗栗縣,頭屋鄉,3430,11973,6298,5675
2007/3/1,苗栗縣,三義鄉,5043,17836,9447,8389
2007/3/1,苗栗縣,西湖鄉,2549,8076,4487,3589
2007/3/1,苗栗縣,造橋鄉,3850,13959,7379,6580
2007/3/1,苗栗縣,三灣鄉,2274,7561,4111,3450
2007/3/1,苗栗縣,獅潭鄉,1596,5199,2906,2293
2007/3/1,苗栗縣,泰安鄉,1780,5695,3144,2551
2007/3/1,臺中市,豐原區,46432,164071,82007,82064
2007/3/1,臺中市,大里區,57011,190537,95107,95430
2007/3/1,臺中市,太平區,51670,171138,86275,84863
2007/3/1,臺中市,東勢區,16431,55129,28777,26352
2007/3/1,臺中市,大甲區,20627,79542,40419,39123
2007/3/1,臺中市,清水區,23597,85746,44450,41296
2007/3/1,臺中市,沙鹿區,20819,77616,39707,37909
2007/3/1,臺中市,梧棲區,15075,53890,27463,26427
2007/3/1,臺中市,后里區,14088,54630,28367,26263
2007/3/1,臺中市,神岡區,16745,64212,33152,31060
2007/3/1,臺中市,潭子區,29658,96619,48517,48102
2007/3/1,臺中市,大雅區,24548,87186,44276,42910
2007/3/1,臺中市,新社區,7069,25814,13658,12156
2007/3/1,臺中市,石岡區,4609,16183,8425,7758
2007/3/1,臺中市,外埔區,8177,31681,16395,15286
2007/3/1,臺中市,大安區,5085,20775,10987,9788
2007/3/1,臺中市,烏日區,18794,67199,34323,32876
2007/3/1,臺中市,大肚區,15063,55870,28780,27090
2007/3/1,臺中市,龍井區,19211,71425,36582,34843
2007/3/1,臺中市,霧峰區,17895,64554,33272,31282
2007/3/1,臺中市,和平區,4499,10954,6031,4923
2007/3/1,彰化縣,彰化市,67831,235575,118157,117418
2007/3/1,彰化縣,鹿港鎮,20959,85063,43695,41368
2007/3/1,彰化縣,和美鎮,22531,88897,45755,43142
2007/3/1,彰化縣,北斗鎮,9366,33487,17038,16449
2007/3/1,彰化縣,員林市,34825,126248,63875,62373
2007/3/1,彰化縣,溪湖鎮,14304,56568,29090,27478
2007/3/1,彰化縣,田中鎮,12016,45226,23816,21410
2007/3/1,彰化縣,二林鎮,13725,55419,28677,26742
2007/3/1,彰化縣,線西鄉,3894,17011,8787,8224
2007/3/1,彰化縣,伸港鄉,8347,35551,18362,17189
2007/3/1,彰化縣,福興鄉,11338,48818,25657,23161
2007/3/1,彰化縣,秀水鄉,9064,38689,20098,18591
2007/3/1,彰化縣,花壇鄉,12119,46340,23982,22358
2007/3/1,彰化縣,芬園鄉,6706,25402,13489,11913
2007/3/1,彰化縣,大村鄉,9673,36488,19125,17363
2007/3/1,彰化縣,埔鹽鄉,8455,34851,18371,16480
2007/3/1,彰化縣,埔心鄉,9383,35460,18423,17037
2007/3/1,彰化縣,永靖鄉,9922,39913,20782,19131
2007/3/1,彰化縣,社頭鄉,11788,45570,23529,22041
2007/3/1,彰化縣,二水鄉,5151,17226,9131,8095
2007/3/1,彰化縣,田尾鄉,7421,29217,15238,13979
2007/3/1,彰化縣,埤頭鄉,8134,32091,16875,15216
2007/3/1,彰化縣,芳苑鄉,9782,37227,19803,17424
2007/3/1,彰化縣,大城鄉,5272,19409,10623,8786
2007/3/1,彰化縣,竹塘鄉,4448,16800,8895,7905
2007/3/1,彰化縣,溪州鄉,8402,32276,17097,15179
2007/3/1,南投縣,南投市,31777,105617,53426,52191
2007/3/1,南投縣,埔里鎮,27220,86551,43991,42560
2007/3/1,南投縣,草屯鎮,29085,99766,50757,49009
2007/3/1,南投縣,竹山鎮,17799,59362,30831,28531
2007/3/1,南投縣,集集鎮,4066,12195,6429,5766
2007/3/1,南投縣,名間鄉,11609,41756,22103,19653
2007/3/1,南投縣,鹿谷鄉,6201,19712,10528,9184
2007/3/1,南投縣,中寮鄉,5370,16714,9157,7557
2007/3/1,南投縣,魚池鄉,5566,17421,9319,8102
2007/3/1,南投縣,國姓鄉,6984,21711,11921,9790
2007/3/1,南投縣,水里鄉,7139,21176,11160,10016
2007/3/1,南投縣,信義鄉,5003,17257,9410,7847
2007/3/1,南投縣,仁愛鄉,4822,15486,8213,7273
2007/3/1,雲林縣,斗六市,31973,105111,53239,51872
2007/3/1,雲林縣,斗南鎮,14527,47911,24508,23403
2007/3/1,雲林縣,虎尾鎮,20666,69003,35323,33680
2007/3/1,雲林縣,西螺鎮,13444,49193,25176,24017
2007/3/1,雲林縣,土庫鎮,8297,31303,16471,14832
2007/3/1,雲林縣,北港鎮,14713,44559,23267,21292
2007/3/1,雲林縣,古坑鄉,10198,35008,18552,16456
2007/3/1,雲林縣,大埤鄉,6355,22012,11746,10266
2007/3/1,雲林縣,莿桐鄉,8617,31075,16320,14755
2007/3/1,雲林縣,林內鄉,5492,20514,10755,9759
2007/3/1,雲林縣,二崙鄉,8499,30839,16571,14268
2007/3/1,雲林縣,崙背鄉,7929,28292,15046,13246
2007/3/1,雲林縣,麥寮鄉,11058,33077,17707,15370
2007/3/1,雲林縣,東勢鄉,5571,17847,9680,8167
2007/3/1,雲林縣,褒忠鄉,4112,14932,7985,6947
2007/3/1,雲林縣,臺西鄉,8367,27549,14871,12678
2007/3/1,雲林縣,元長鄉,9022,30004,16385,13619
2007/3/1,雲林縣,四湖鄉,8661,27822,15391,12431
2007/3/1,雲林縣,口湖鄉,9268,31382,16848,14534
2007/3/1,雲林縣,水林鄉,9597,30013,16471,13542
2007/3/1,嘉義縣,太保市,10117,35227,18341,16886
2007/3/1,嘉義縣,朴子市,13411,44330,22793,21537
2007/3/1,嘉義縣,布袋鎮,9818,31515,16360,15155
2007/3/1,嘉義縣,大林鎮,10814,34585,17904,16681
2007/3/1,嘉義縣,民雄鄉,21328,72726,37580,35146
2007/3/1,嘉義縣,溪口鄉,5145,16938,9061,7877
2007/3/1,嘉義縣,新港鄉,9992,35510,18784,16726
2007/3/1,嘉義縣,六腳鄉,8860,27522,14629,12893
2007/3/1,嘉義縣,東石鄉,9045,28906,15437,13469
2007/3/1,嘉義縣,義竹鄉,7191,21968,11449,10519
2007/3/1,嘉義縣,鹿草鄉,5497,17527,9415,8112
2007/3/1,嘉義縣,水上鄉,16988,53875,28126,25749
2007/3/1,嘉義縣,中埔鄉,14308,48213,25281,22932
2007/3/1,嘉義縣,竹崎鄉,10987,39601,21150,18451
2007/3/1,嘉義縣,梅山鄉,6259,22435,11932,10503
2007/3/1,嘉義縣,番路鄉,3709,11852,6485,5367
2007/3/1,嘉義縣,大埔鄉,1741,3928,2139,1789
2007/3/1,嘉義縣,阿里山鄉,1927,6161,3315,2846
2007/3/1,臺南市,新營區,25897,78954,39719,39235
2007/3/1,臺南市,永康區,69239,209150,104736,104414
2007/3/1,臺南市,鹽水區,9556,28010,14631,13379
2007/3/1,臺南市,白河區,10683,32622,17310,15312
2007/3/1,臺南市,麻豆區,14126,46387,23859,22528
2007/3/1,臺南市,佳里區,18104,59203,29608,29595
2007/3/1,臺南市,新化區,12990,44694,23004,21690
2007/3/1,臺南市,善化區,13315,42261,21617,20644
2007/3/1,臺南市,學甲區,9120,28767,14819,13948
2007/3/1,臺南市,柳營區,7504,23343,12246,11097
2007/3/1,臺南市,後壁區,8320,26666,13889,12777
2007/3/1,臺南市,東山區,7982,23924,12838,11086
2007/3/1,臺南市,下營區,8798,26903,13961,12942
2007/3/1,臺南市,六甲區,7328,24532,12798,11734
2007/3/1,臺南市,官田區,7449,22746,11779,10967
2007/3/1,臺南市,大內區,3999,11449,6132,5317
2007/3/1,臺南市,西港區,7483,25705,13183,12522
2007/3/1,臺南市,七股區,7690,25193,13243,11950
2007/3/1,臺南市,將軍區,7228,22294,11446,10848
2007/3/1,臺南市,北門區,4161,12752,6581,6171
2007/3/1,臺南市,新市區,10321,35772,18036,17736
2007/3/1,臺南市,安定區,8542,29885,15570,14315
2007/3/1,臺南市,山上區,2671,8104,4296,3808
2007/3/1,臺南市,玉井區,4978,15977,8348,7629
2007/3/1,臺南市,楠西區,3583,11110,5938,5172
2007/3/1,臺南市,南化區,2805,9013,4956,4057
2007/3/1,臺南市,左鎮區,1922,5682,3146,2536
2007/3/1,臺南市,仁德區,23059,68161,35302,32859
2007/3/1,臺南市,歸仁區,19170,65225,33368,31857
2007/3/1,臺南市,關廟區,10438,37237,19403,17834
2007/3/1,臺南市,龍崎區,1534,4393,2398,1995
2007/3/1,高雄市,鳳山區,120240,338873,170183,168690
2007/3/1,高雄市,岡山區,31572,95616,48454,47162
2007/3/1,高雄市,旗山區,13487,41314,21699,19615
2007/3/1,高雄市,美濃區,13454,44371,23341,21030
2007/3/1,高雄市,林園區,23244,71521,36980,34541
2007/3/1,高雄市,大寮區,36128,109298,57209,52089
2007/3/1,高雄市,大樹區,12790,45021,23448,21573
2007/3/1,高雄市,仁武區,22633,66658,34519,32139
2007/3/1,高雄市,大社區,11080,32599,16804,15795
2007/3/1,高雄市,鳥松區,15413,41096,21023,20073
2007/3/1,高雄市,橋頭區,12202,36774,18965,17809
2007/3/1,高雄市,燕巢區,9516,31312,16824,14488
2007/3/1,高雄市,田寮區,3605,8678,4864,3814
2007/3/1,高雄市,阿蓮區,8809,30947,15677,15270
2007/3/1,高雄市,路竹區,15252,54610,28012,26598
2007/3/1,高雄市,湖內區,8931,28694,14889,13805
2007/3/1,高雄市,茄萣區,9844,32135,16882,15253
2007/3/1,高雄市,永安區,5541,14281,7341,6940
2007/3/1,高雄市,彌陀區,6366,20915,10990,9925
2007/3/1,高雄市,梓官區,11433,37462,19636,17826
2007/3/1,高雄市,六龜區,5621,15744,8605,7139
2007/3/1,高雄市,甲仙區,2582,8338,4499,3839
2007/3/1,高雄市,杉林區,3972,11521,6349,5172
2007/3/1,高雄市,內門區,4968,16700,9126,7574
2007/3/1,高雄市,茂林區,519,1768,904,864
2007/3/1,高雄市,桃源區,1205,4821,2595,2226
2007/3/1,屏東縣,屏東市,70181,216285,108631,107654
2007/3/1,屏東縣,潮州鎮,17398,56977,28837,28140
2007/3/1,屏東縣,東港鎮,14426,50345,25762,24583
2007/3/1,屏東縣,恆春鎮,10157,31305,16310,14995
2007/3/1,屏東縣,萬丹鄉,13582,54408,28292,26116
2007/3/1,屏東縣,長治鄉,9359,30946,16316,14630
2007/3/1,屏東縣,麟洛鄉,3426,11760,6095,5665
2007/3/1,屏東縣,九如鄉,6358,23237,12091,11146
2007/3/1,屏東縣,里港鄉,7726,26547,13692,12855
2007/3/1,屏東縣,鹽埔鄉,7416,27878,14599,13279
2007/3/1,屏東縣,高樹鄉,9492,27733,14893,12840
2007/3/1,屏東縣,萬巒鄉,6263,22857,12103,10754
2007/3/1,屏東縣,內埔鄉,17061,59559,31197,28362
2007/3/1,屏東縣,竹田鄉,5363,18635,9963,8672
2007/3/1,屏東縣,新埤鄉,3266,11103,5915,5188
2007/3/1,屏東縣,枋寮鄉,8251,27551,14645,12906
2007/3/1,屏東縣,新園鄉,10757,39876,20725,19151
2007/3/1,屏東縣,崁頂鄉,3894,16847,8729,8118
2007/3/1,屏東縣,林邊鄉,6143,21396,11128,10268
2007/3/1,屏東縣,南州鄉,3564,12236,6305,5931
2007/3/1,屏東縣,佳冬鄉,6564,21934,11498,10436
2007/3/1,屏東縣,琉球鄉,3695,12754,7072,5682
2007/3/1,屏東縣,車城鄉,3382,10234,5534,4700
2007/3/1,屏東縣,滿州鄉,2955,8759,4803,3956
2007/3/1,屏東縣,枋山鄉,2099,6303,3399,2904
2007/3/1,屏東縣,三地門鄉,1998,7269,3734,3535
2007/3/1,屏東縣,霧臺鄉,808,2815,1508,1307
2007/3/1,屏東縣,瑪家鄉,1801,6573,3458,3115
2007/3/1,屏東縣,泰武鄉,1065,4954,2639,2315
2007/3/1,屏東縣,來義鄉,2060,7861,4043,3818
2007/3/1,屏東縣,春日鄉,1248,5037,2648,2389
2007/3/1,屏東縣,獅子鄉,1409,5010,2667,2343
2007/3/1,屏東縣,牡丹鄉,1753,4931,2558,2373
2007/3/1,臺東縣,臺東市,36609,110437,56524,53913
2007/3/1,臺東縣,成功鎮,5287,16616,8913,7703
2007/3/1,臺東縣,關山鎮,3158,10064,5321,4743
2007/3/1,臺東縣,卑南鄉,6382,18624,10284,8340
2007/3/1,臺東縣,大武鄉,2471,7270,3827,3443
2007/3/1,臺東縣,太麻里鄉,4465,12371,6663,5708
2007/3/1,臺東縣,東河鄉,3417,9848,5477,4371
2007/3/1,臺東縣,長濱鄉,2799,8960,5087,3873
2007/3/1,臺東縣,鹿野鄉,3097,9083,4937,4146
2007/3/1,臺東縣,池上鄉,3181,9599,5146,4453
2007/3/1,臺東縣,綠島鄉,865,3048,1607,1441
2007/3/1,臺東縣,延平鄉,1052,3665,2055,1610
2007/3/1,臺東縣,海端鄉,1076,4612,2520,2092
2007/3/1,臺東縣,達仁鄉,1395,3784,2098,1686
2007/3/1,臺東縣,金峰鄉,973,3338,1769,1569
2007/3/1,臺東縣,蘭嶼鄉,1169,3907,2062,1845
2007/3/1,花蓮縣,花蓮市,38468,109543,54313,55230
2007/3/1,花蓮縣,鳳林鎮,4369,12614,6688,5926
2007/3/1,花蓮縣,玉里鎮,8730,28505,15628,12877
2007/3/1,花蓮縣,新城鄉,7113,20639,10778,9861
2007/3/1,花蓮縣,吉安鄉,26983,78795,40705,38090
2007/3/1,花蓮縣,壽豐鄉,6634,19547,10701,8846
2007/3/1,花蓮縣,光復鄉,4964,14903,8000,6903
2007/3/1,花蓮縣,豐濱鄉,1802,5427,3030,2397
2007/3/1,花蓮縣,瑞穗鄉,4477,13564,7360,6204
2007/3/1,花蓮縣,富里鄉,3865,12200,6756,5444
2007/3/1,花蓮縣,秀林鄉,4409,15014,7897,7117
2007/3/1,花蓮縣,萬榮鄉,2135,7179,3851,3328
2007/3/1,花蓮縣,卓溪鄉,1594,6620,3680,2940
2007/3/1,澎湖縣,馬公市,17556,54112,27637,26475
2007/3/1,澎湖縣,湖西鄉,4237,12889,6746,6143
2007/3/1,澎湖縣,白沙鄉,2912,9173,4863,4310
2007/3/1,澎湖縣,西嶼鄉,2633,8169,4251,3918
2007/3/1,澎湖縣,望安鄉,1674,4449,2380,2069
2007/3/1,澎湖縣,七美鄉,1073,3158,1686,1472
2007/3/1,基隆市,中正區,21491,57896,29862,28034
2007/3/1,基隆市,七堵區,18901,55122,28128,26994
2007/3/1,基隆市,暖暖區,13938,38493,19721,18772
2007/3/1,基隆市,仁愛區,18504,50112,25072,25040
2007/3/1,基隆市,中山區,18647,52872,27183,25689
2007/3/1,基隆市,安樂區,30440,85023,42529,42494
2007/3/1,基隆市,信義區,19121,50894,25618,25276
2007/3/1,新竹市,東區,62510,189057,93994,95063
2007/3/1,新竹市,北區,45572,137759,69033,68726
2007/3/1,新竹市,香山區,20522,69445,35663,33782
2007/3/1,臺中市,中區,8300,23645,11747,11898
2007/3/1,臺中市,東區,24508,73268,37346,35922
2007/3/1,臺中市,西區,40745,116191,56277,59914
2007/3/1,臺中市,南區,38488,109337,53528,55809
2007/3/1,臺中市,北區,52790,146775,71676,75099
2007/3/1,臺中市,西屯區,65557,195960,95993,99967
2007/3/1,臺中市,南屯區,47654,144029,69821,74208
2007/3/1,臺中市,北屯區,76888,237167,116056,121111
2007/3/1,嘉義市,東區,42878,128434,63146,65288
2007/3/1,嘉義市,西區,46769,143787,71785,72002
2007/3/1,臺南市,東區,67374,192959,94061,98898
2007/3/1,臺南市,南區,41555,128076,64666,63410
2007/3/1,臺南市,北區,44567,127832,63718,64114
2007/3/1,臺南市,安南區,50046,172629,88347,84282
2007/3/1,臺南市,安平區,20600,57921,27887,30034
2007/3/1,臺南市,中西區,29508,81647,40335,41312
2007/3/1,臺北市,松山區,75539,209651,99830,109821
2007/3/1,臺北市,信義區,84533,230342,112460,117882
2007/3/1,臺北市,大安區,113107,313038,148808,164230
2007/3/1,臺北市,中山區,86629,218459,104283,114176
2007/3/1,臺北市,中正區,59387,158665,77231,81434
2007/3/1,臺北市,大同區,45201,126467,62973,63494
2007/3/1,臺北市,萬華區,72073,193781,97894,95887
2007/3/1,臺北市,文山區,92789,260813,127471,133342
2007/3/1,臺北市,南港區,39057,113190,56405,56785
2007/3/1,臺北市,內湖區,89952,264682,128678,136004
2007/3/1,臺北市,士林區,96495,287606,140835,146771
2007/3/1,臺北市,北投區,85039,249579,122109,127470
2007/3/1,高雄市,鹽埕區,11188,28916,14761,14155
2007/3/1,高雄市,鼓山區,44597,119508,59672,59836
2007/3/1,高雄市,左營區,68808,184347,91943,92404
2007/3/1,高雄市,楠梓區,57388,166583,83397,83186
2007/3/1,高雄市,三民區,126663,360945,178205,182740
2007/3/1,高雄市,新興區,22652,57738,28346,29392
2007/3/1,高雄市,前金區,12203,30085,14834,15251
2007/3/1,高雄市,苓雅區,69532,189374,93050,96324
2007/3/1,高雄市,前鎮區,71912,200521,100877,99644
2007/3/1,高雄市,旗津區,10637,30101,15821,14280
2007/3/1,高雄市,小港區,57428,150352,76474,73878
2007/3/1,金門縣,金城鎮,9760,26580,14023,12557
2007/3/1,金門縣,金湖鎮,6337,17411,9255,8156
2007/3/1,金門縣,金沙鎮,4859,12577,6639,5938
2007/3/1,金門縣,金寧鄉,5362,14050,7559,6491
2007/3/1,金門縣,烈嶼鄉,2264,6801,3601,3200
2007/3/1,金門縣,烏坵鄉,134,454,234,220
2007/3/1,連江縣,南竿鄉,1050,5846,3393,2453
2007/3/1,連江縣,北竿鄉,367,1819,1080,739
2007/3/1,連江縣,莒光鄉,235,1159,683,476
2007/3/1,連江縣,東引鄉,245,977,582,395
2007/4/1,總計,臺灣地區,7389326,22798704,11540664,11258040
2007/4/1,總計,臺灣省,5896137,18656251,9506161,9150090
2007/4/1,總計,新北市,1287506,3773177,1889032,1884145
2007/4/1,總計,宜蘭縣,145171,460265,236173,224092
2007/4/1,總計,桃園市,608596,1917187,973966,943221
2007/4/1,總計,新竹縣,144281,490019,253833,236186
2007/4/1,總計,苗栗縣,161216,559740,292577,267163
2007/4/1,總計,臺中市,437734,1545017,787084,757933
2007/4/1,總計,彰化縣,345192,1314711,678281,636430
2007/4/1,總計,南投縣,162843,534530,277126,257404
2007/4/1,總計,雲林縣,216619,727162,382093,345069
2007/4/1,總計,嘉義縣,167300,552446,290018,262428
2007/4/1,總計,臺南市,350295,1106009,568023,537986
2007/4/1,總計,高雄市,411592,1244316,641454,602862
2007/4/1,總計,屏東縣,265107,891587,461563,430024
2007/4/1,總計,臺東縣,77440,235137,124214,110923
2007/4/1,總計,花蓮縣,115688,344453,179284,165169
2007/4/1,總計,澎湖縣,30128,92023,47599,44424
2007/4/1,總計,基隆市,141163,390455,198122,192333
2007/4/1,總計,新竹市,128741,396402,198739,197663
2007/4/1,總計,臺中市,355653,1047692,512913,534779
2007/4/1,總計,嘉義市,89821,272434,134976,137458
2007/4/1,總計,臺南市,254051,761489,379091,382398
2007/4/1,總計,臺北市,940299,2627146,1279016,1348130
2007/4/1,總計,高雄市,552890,1515307,755487,759820
2007/4/1,總計,福建省,30715,88198,47346,40852
2007/4/1,總計,金門縣,28814,78407,41628,36779
2007/4/1,總計,連江縣,1901,9791,5718,4073
2007/4/1,新北市,板橋區,179461,544990,272045,272945
2007/4/1,新北市,三重區,129187,383235,192510,190725
2007/4/1,新北市,永和區,86874,235596,113864,121732
2007/4/1,新北市,中和區,145031,410011,204204,205807
2007/4/1,新北市,新莊區,127235,393723,195862,197861
2007/4/1,新北市,新店區,109230,289576,143368,146208
2007/4/1,新北市,土城區,77420,236943,119053,117890
2007/4/1,新北市,蘆洲區,60247,190483,94845,95638
2007/4/1,新北市,汐止區,72869,179233,89744,89489
2007/4/1,新北市,樹林區,51045,162931,82621,80310
2007/4/1,新北市,鶯歌區,25206,85173,43455,41718
2007/4/1,新北市,三峽區,29145,92572,47844,44728
2007/4/1,新北市,淡水區,48477,130533,64329,66204
2007/4/1,新北市,瑞芳區,15373,43583,22428,21155
2007/4/1,新北市,五股區,25102,76546,39022,37524
2007/4/1,新北市,泰山區,24031,73341,37180,36161
2007/4/1,新北市,林口區,20437,63288,31747,31541
2007/4/1,新北市,深坑區,7966,21817,11152,10665
2007/4/1,新北市,石碇區,3133,7932,4420,3512
2007/4/1,新北市,坪林區,2316,6608,3720,2888
2007/4/1,新北市,三芝區,8408,23505,12268,11237
2007/4/1,新北市,石門區,3597,11715,6229,5486
2007/4/1,新北市,八里區,10896,32378,16645,15733
2007/4/1,新北市,平溪區,2333,5755,3208,2547
2007/4/1,新北市,雙溪區,3766,9944,5386,4558
2007/4/1,新北市,貢寮區,4273,13935,7269,6666
2007/4/1,新北市,金山區,6354,22197,11347,10850
2007/4/1,新北市,萬里區,6429,20302,10527,9775
2007/4/1,新北市,烏來區,1665,5332,2740,2592
2007/4/1,宜蘭縣,宜蘭市,31518,95672,47460,48212
2007/4/1,宜蘭縣,羅東鎮,23922,74233,35738,38495
2007/4/1,宜蘭縣,蘇澳鎮,12989,43136,22443,20693
2007/4/1,宜蘭縣,頭城鎮,9109,31808,16529,15279
2007/4/1,宜蘭縣,礁溪鄉,11570,35960,18924,17036
2007/4/1,宜蘭縣,壯圍鄉,7689,25321,13401,11920
2007/4/1,宜蘭縣,員山鄉,10099,32445,17498,14947
2007/4/1,宜蘭縣,冬山鄉,16059,51191,26589,24602
2007/4/1,宜蘭縣,五結鄉,11925,37600,19703,17897
2007/4/1,宜蘭縣,三星鄉,6843,21231,11546,9685
2007/4/1,宜蘭縣,大同鄉,1755,5803,3228,2575
2007/4/1,宜蘭縣,南澳鄉,1693,5865,3114,2751
2007/4/1,桃園市,桃園區,130642,386988,190512,196476
2007/4/1,桃園市,中壢區,114920,356087,179240,176847
2007/4/1,桃園市,平鎮區,60619,201280,102070,99210
2007/4/1,桃園市,八德區,52455,171416,88262,83154
2007/4/1,桃園市,大溪區,27057,89584,46506,43078
2007/4/1,桃園市,楊梅區,43065,141275,72430,68845
2007/4/1,桃園市,蘆竹區,41732,129260,65323,63937
2007/4/1,桃園市,大園區,23438,79211,41396,37815
2007/4/1,桃園市,龜山區,45112,130111,66699,63412
2007/4/1,桃園市,龍潭區,34090,112084,57367,54717
2007/4/1,桃園市,新屋區,14229,49917,26682,23235
2007/4/1,桃園市,觀音區,17634,59223,31443,27780
2007/4/1,桃園市,復興區,3603,10751,6036,4715
2007/4/1,新竹縣,竹北市,37900,121737,61411,60326
2007/4/1,新竹縣,關西鎮,8753,32719,17499,15220
2007/4/1,新竹縣,新埔鎮,9769,36140,19180,16960
2007/4/1,新竹縣,竹東鎮,28351,95992,48569,47423
2007/4/1,新竹縣,湖口鄉,21672,73676,37948,35728
2007/4/1,新竹縣,橫山鄉,4155,14741,8054,6687
2007/4/1,新竹縣,新豐鄉,14337,51263,26624,24639
2007/4/1,新竹縣,芎林鄉,5867,20742,10927,9815
2007/4/1,新竹縣,寶山鄉,4390,13761,7458,6303
2007/4/1,新竹縣,北埔鄉,2934,10423,5651,4772
2007/4/1,新竹縣,峨眉鄉,1965,6148,3426,2722
2007/4/1,新竹縣,尖石鄉,2522,8177,4529,3648
2007/4/1,新竹縣,五峰鄉,1666,4500,2557,1943
2007/4/1,苗栗縣,苗栗市,27616,90863,46119,44744
2007/4/1,苗栗縣,苑裡鎮,13126,48977,25689,23288
2007/4/1,苗栗縣,通霄鎮,10839,39440,21095,18345
2007/4/1,苗栗縣,竹南鎮,21265,74481,38077,36404
2007/4/1,苗栗縣,頭份市,26699,93964,48190,45774
2007/4/1,苗栗縣,後龍鎮,11331,40661,21614,19047
2007/4/1,苗栗縣,卓蘭鎮,5684,18579,9896,8683
2007/4/1,苗栗縣,大湖鄉,5038,16335,8817,7518
2007/4/1,苗栗縣,公館鄉,9449,34646,18210,16436
2007/4/1,苗栗縣,銅鑼鄉,5815,19992,10678,9314
2007/4/1,苗栗縣,南庄鄉,3809,11573,6451,5122
2007/4/1,苗栗縣,頭屋鄉,3428,11949,6287,5662
2007/4/1,苗栗縣,三義鄉,5051,17821,9439,8382
2007/4/1,苗栗縣,西湖鄉,2556,8070,4487,3583
2007/4/1,苗栗縣,造橋鄉,3853,13955,7384,6571
2007/4/1,苗栗縣,三灣鄉,2274,7558,4110,3448
2007/4/1,苗栗縣,獅潭鄉,1596,5196,2904,2292
2007/4/1,苗栗縣,泰安鄉,1787,5680,3130,2550
2007/4/1,臺中市,豐原區,46521,164196,82049,82147
2007/4/1,臺中市,大里區,57125,190744,95197,95547
2007/4/1,臺中市,太平區,51707,171160,86303,84857
2007/4/1,臺中市,東勢區,16443,55122,28763,26359
2007/4/1,臺中市,大甲區,20638,79532,40416,39116
2007/4/1,臺中市,清水區,23633,85707,44431,41276
2007/4/1,臺中市,沙鹿區,20917,77756,39744,38012
2007/4/1,臺中市,梧棲區,15109,53941,27484,26457
2007/4/1,臺中市,后里區,14115,54625,28365,26260
2007/4/1,臺中市,神岡區,16751,64176,33145,31031
2007/4/1,臺中市,潭子區,29704,96599,48529,48070
2007/4/1,臺中市,大雅區,24593,87214,44302,42912
2007/4/1,臺中市,新社區,7072,25804,13661,12143
2007/4/1,臺中市,石岡區,4609,16155,8406,7749
2007/4/1,臺中市,外埔區,8195,31721,16413,15308
2007/4/1,臺中市,大安區,5084,20731,10972,9759
2007/4/1,臺中市,烏日區,18812,67190,34314,32876
2007/4/1,臺中市,大肚區,15077,55869,28783,27086
2007/4/1,臺中市,龍井區,19218,71378,36566,34812
2007/4/1,臺中市,霧峰區,17924,64481,33232,31249
2007/4/1,臺中市,和平區,4487,10916,6009,4907
2007/4/1,彰化縣,彰化市,67916,235646,118198,117448
2007/4/1,彰化縣,鹿港鎮,20977,85017,43664,41353
2007/4/1,彰化縣,和美鎮,22562,88888,45747,43141
2007/4/1,彰化縣,北斗鎮,9388,33515,17050,16465
2007/4/1,彰化縣,員林市,34843,126279,63900,62379
2007/4/1,彰化縣,溪湖鎮,14316,56648,29121,27527
2007/4/1,彰化縣,田中鎮,12038,45220,23821,21399
2007/4/1,彰化縣,二林鎮,13727,55382,28660,26722
2007/4/1,彰化縣,線西鄉,3901,17046,8809,8237
2007/4/1,彰化縣,伸港鄉,8362,35561,18359,17202
2007/4/1,彰化縣,福興鄉,11356,48835,25657,23178
2007/4/1,彰化縣,秀水鄉,9078,38701,20101,18600
2007/4/1,彰化縣,花壇鄉,12135,46334,23971,22363
2007/4/1,彰化縣,芬園鄉,6718,25360,13468,11892
2007/4/1,彰化縣,大村鄉,9676,36453,19101,17352
2007/4/1,彰化縣,埔鹽鄉,8451,34794,18341,16453
2007/4/1,彰化縣,埔心鄉,9400,35421,18408,17013
2007/4/1,彰化縣,永靖鄉,9926,39902,20785,19117
2007/4/1,彰化縣,社頭鄉,11793,45535,23511,22024
2007/4/1,彰化縣,二水鄉,5150,17203,9114,8089
2007/4/1,彰化縣,田尾鄉,7418,29231,15241,13990
2007/4/1,彰化縣,埤頭鄉,8133,32103,16888,15215
2007/4/1,彰化縣,芳苑鄉,9783,37162,19768,17394
2007/4/1,彰化縣,大城鄉,5278,19402,10616,8786
2007/4/1,彰化縣,竹塘鄉,4453,16799,8893,7906
2007/4/1,彰化縣,溪州鄉,8414,32274,17089,15185
2007/4/1,南投縣,南投市,31821,105662,53452,52210
2007/4/1,南投縣,埔里鎮,27262,86512,43977,42535
2007/4/1,南投縣,草屯鎮,29129,99785,50743,49042
2007/4/1,南投縣,竹山鎮,17822,59319,30822,28497
2007/4/1,南投縣,集集鎮,4066,12181,6418,5763
2007/4/1,南投縣,名間鄉,11614,41708,22084,19624
2007/4/1,南投縣,鹿谷鄉,6209,19693,10514,9179
2007/4/1,南投縣,中寮鄉,5378,16677,9137,7540
2007/4/1,南投縣,魚池鄉,5575,17385,9296,8089
2007/4/1,南投縣,國姓鄉,6989,21682,11905,9777
2007/4/1,南投縣,水里鄉,7142,21164,11148,10016
2007/4/1,南投縣,信義鄉,5003,17254,9412,7842
2007/4/1,南投縣,仁愛鄉,4833,15508,8218,7290
2007/4/1,雲林縣,斗六市,32036,105181,53262,51919
2007/4/1,雲林縣,斗南鎮,14544,47874,24495,23379
2007/4/1,雲林縣,虎尾鎮,20711,69020,35336,33684
2007/4/1,雲林縣,西螺鎮,13476,49252,25173,24079
2007/4/1,雲林縣,土庫鎮,8301,31274,16442,14832
2007/4/1,雲林縣,北港鎮,14722,44545,23251,21294
2007/4/1,雲林縣,古坑鄉,10199,34951,18530,16421
2007/4/1,雲林縣,大埤鄉,6359,22006,11731,10275
2007/4/1,雲林縣,莿桐鄉,8609,31020,16281,14739
2007/4/1,雲林縣,林內鄉,5506,20502,10756,9746
2007/4/1,雲林縣,二崙鄉,8514,30839,16574,14265
2007/4/1,雲林縣,崙背鄉,7934,28254,15016,13238
2007/4/1,雲林縣,麥寮鄉,11069,33095,17716,15379
2007/4/1,雲林縣,東勢鄉,5574,17808,9659,8149
2007/4/1,雲林縣,褒忠鄉,4113,14926,7988,6938
2007/4/1,雲林縣,臺西鄉,8377,27499,14841,12658
2007/4/1,雲林縣,元長鄉,9028,29998,16374,13624
2007/4/1,雲林縣,四湖鄉,8674,27802,15377,12425
2007/4/1,雲林縣,口湖鄉,9263,31311,16824,14487
2007/4/1,雲林縣,水林鄉,9610,30005,16467,13538
2007/4/1,嘉義縣,太保市,10160,35292,18380,16912
2007/4/1,嘉義縣,朴子市,13422,44338,22804,21534
2007/4/1,嘉義縣,布袋鎮,9830,31499,16345,15154
2007/4/1,嘉義縣,大林鎮,10822,34517,17865,16652
2007/4/1,嘉義縣,民雄鄉,21354,72753,37618,35135
2007/4/1,嘉義縣,溪口鄉,5148,16915,9052,7863
2007/4/1,嘉義縣,新港鄉,10004,35515,18785,16730
2007/4/1,嘉義縣,六腳鄉,8867,27471,14612,12859
2007/4/1,嘉義縣,東石鄉,9055,28853,15405,13448
2007/4/1,嘉義縣,義竹鄉,7200,21929,11426,10503
2007/4/1,嘉義縣,鹿草鄉,5496,17525,9414,8111
2007/4/1,嘉義縣,水上鄉,16987,53780,28080,25700
2007/4/1,嘉義縣,中埔鄉,14315,48114,25242,22872
2007/4/1,嘉義縣,竹崎鄉,10989,39581,21138,18443
2007/4/1,嘉義縣,梅山鄉,6260,22406,11909,10497
2007/4/1,嘉義縣,番路鄉,3719,11835,6477,5358
2007/4/1,嘉義縣,大埔鄉,1745,3955,2150,1805
2007/4/1,嘉義縣,阿里山鄉,1927,6168,3316,2852
2007/4/1,臺南市,新營區,25915,79000,39742,39258
2007/4/1,臺南市,永康區,69367,209343,104827,104516
2007/4/1,臺南市,鹽水區,9559,28006,14625,13381
2007/4/1,臺南市,白河區,10667,32569,17271,15298
2007/4/1,臺南市,麻豆區,14124,46418,23874,22544
2007/4/1,臺南市,佳里區,18121,59204,29596,29608
2007/4/1,臺南市,新化區,12998,44654,22980,21674
2007/4/1,臺南市,善化區,13348,42296,21632,20664
2007/4/1,臺南市,學甲區,9116,28745,14799,13946
2007/4/1,臺南市,柳營區,7498,23322,12230,11092
2007/4/1,臺南市,後壁區,8332,26633,13880,12753
2007/4/1,臺南市,東山區,7981,23873,12815,11058
2007/4/1,臺南市,下營區,8797,26881,13948,12933
2007/4/1,臺南市,六甲區,7329,24510,12781,11729
2007/4/1,臺南市,官田區,7448,22732,11765,10967
2007/4/1,臺南市,大內區,3995,11437,6127,5310
2007/4/1,臺南市,西港區,7492,25725,13186,12539
2007/4/1,臺南市,七股區,7701,25211,13255,11956
2007/4/1,臺南市,將軍區,7228,22247,11418,10829
2007/4/1,臺南市,北門區,4159,12718,6562,6156
2007/4/1,臺南市,新市區,10328,35747,18018,17729
2007/4/1,臺南市,安定區,8567,29898,15572,14326
2007/4/1,臺南市,山上區,2668,8097,4294,3803
2007/4/1,臺南市,玉井區,4980,15960,8332,7628
2007/4/1,臺南市,楠西區,3583,11098,5935,5163
2007/4/1,臺南市,南化區,2804,9009,4954,4055
2007/4/1,臺南市,左鎮區,1923,5675,3141,2534
2007/4/1,臺南市,仁德區,23076,68154,35295,32859
2007/4/1,臺南市,歸仁區,19209,65254,33385,31869
2007/4/1,臺南市,關廟區,10444,37184,19377,17807
2007/4/1,臺南市,龍崎區,1538,4409,2407,2002
2007/4/1,高雄市,鳳山區,120339,338889,170167,168722
2007/4/1,高雄市,岡山區,31585,95615,48441,47174
2007/4/1,高雄市,旗山區,13484,41285,21672,19613
2007/4/1,高雄市,美濃區,13460,44358,23314,21044
2007/4/1,高雄市,林園區,23259,71490,36969,34521
2007/4/1,高雄市,大寮區,36132,109261,57174,52087
2007/4/1,高雄市,大樹區,12795,44971,23431,21540
2007/4/1,高雄市,仁武區,22691,66775,34588,32187
2007/4/1,高雄市,大社區,11096,32623,16822,15801
2007/4/1,高雄市,鳥松區,15424,41127,21033,20094
2007/4/1,高雄市,橋頭區,12205,36760,18969,17791
2007/4/1,高雄市,燕巢區,9522,31329,16820,14509
2007/4/1,高雄市,田寮區,3603,8659,4860,3799
2007/4/1,高雄市,阿蓮區,8819,30951,15674,15277
2007/4/1,高雄市,路竹區,15257,54658,28018,26640
2007/4/1,高雄市,湖內區,8939,28676,14882,13794
2007/4/1,高雄市,茄萣區,9842,32105,16872,15233
2007/4/1,高雄市,永安區,5592,14243,7322,6921
2007/4/1,高雄市,彌陀區,6363,20878,10972,9906
2007/4/1,高雄市,梓官區,11443,37406,19612,17794
2007/4/1,高雄市,六龜區,5629,15728,8594,7134
2007/4/1,高雄市,甲仙區,2580,8309,4484,3825
2007/4/1,高雄市,杉林區,3974,11478,6327,5151
2007/4/1,高雄市,內門區,4965,16651,9100,7551
2007/4/1,高雄市,茂林區,519,1770,903,867
2007/4/1,高雄市,桃源區,1205,4824,2594,2230
2007/4/1,屏東縣,屏東市,70231,216310,108589,107721
2007/4/1,屏東縣,潮州鎮,17416,57034,28867,28167
2007/4/1,屏東縣,東港鎮,14446,50371,25766,24605
2007/4/1,屏東縣,恆春鎮,10181,31285,16298,14987
2007/4/1,屏東縣,萬丹鄉,13597,54393,28279,26114
2007/4/1,屏東縣,長治鄉,9368,30971,16325,14646
2007/4/1,屏東縣,麟洛鄉,3430,11749,6100,5649
2007/4/1,屏東縣,九如鄉,6365,23261,12104,11157
2007/4/1,屏東縣,里港鄉,7727,26532,13683,12849
2007/4/1,屏東縣,鹽埔鄉,7421,27865,14585,13280
2007/4/1,屏東縣,高樹鄉,9493,27707,14880,12827
2007/4/1,屏東縣,萬巒鄉,6263,22829,12095,10734
2007/4/1,屏東縣,內埔鄉,17064,59568,31204,28364
2007/4/1,屏東縣,竹田鄉,5358,18576,9923,8653
2007/4/1,屏東縣,新埤鄉,3268,11086,5905,5181
2007/4/1,屏東縣,枋寮鄉,8245,27525,14633,12892
2007/4/1,屏東縣,新園鄉,10761,39784,20670,19114
2007/4/1,屏東縣,崁頂鄉,3897,16856,8736,8120
2007/4/1,屏東縣,林邊鄉,6148,21392,11128,10264
2007/4/1,屏東縣,南州鄉,3566,12193,6282,5911
2007/4/1,屏東縣,佳冬鄉,6563,21908,11481,10427
2007/4/1,屏東縣,琉球鄉,3696,12734,7062,5672
2007/4/1,屏東縣,車城鄉,3387,10187,5512,4675
2007/4/1,屏東縣,滿州鄉,2959,8735,4794,3941
2007/4/1,屏東縣,枋山鄉,2098,6305,3408,2897
2007/4/1,屏東縣,三地門鄉,2005,7267,3740,3527
2007/4/1,屏東縣,霧臺鄉,811,2799,1497,1302
2007/4/1,屏東縣,瑪家鄉,1799,6551,3439,3112
2007/4/1,屏東縣,泰武鄉,1069,4946,2636,2310
2007/4/1,屏東縣,來義鄉,2061,7863,4052,3811
2007/4/1,屏東縣,春日鄉,1251,5043,2654,2389
2007/4/1,屏東縣,獅子鄉,1408,5021,2674,2347
2007/4/1,屏東縣,牡丹鄉,1755,4941,2562,2379
2007/4/1,臺東縣,臺東市,36632,110439,56493,53946
2007/4/1,臺東縣,成功鎮,5287,16588,8908,7680
2007/4/1,臺東縣,關山鎮,3156,10048,5317,4731
2007/4/1,臺東縣,卑南鄉,6389,18591,10269,8322
2007/4/1,臺東縣,大武鄉,2464,7256,3819,3437
2007/4/1,臺東縣,太麻里鄉,4464,12339,6638,5701
2007/4/1,臺東縣,東河鄉,3428,9881,5495,4386
2007/4/1,臺東縣,長濱鄉,2807,8956,5072,3884
2007/4/1,臺東縣,鹿野鄉,3094,9076,4930,4146
2007/4/1,臺東縣,池上鄉,3184,9593,5147,4446
2007/4/1,臺東縣,綠島鄉,872,3067,1624,1443
2007/4/1,臺東縣,延平鄉,1051,3661,2053,1608
2007/4/1,臺東縣,海端鄉,1075,4606,2515,2091
2007/4/1,臺東縣,達仁鄉,1394,3790,2095,1695
2007/4/1,臺東縣,金峰鄉,974,3338,1773,1565
2007/4/1,臺東縣,蘭嶼鄉,1169,3908,2066,1842
2007/4/1,花蓮縣,花蓮市,38529,109548,54317,55231
2007/4/1,花蓮縣,鳳林鎮,4366,12608,6688,5920
2007/4/1,花蓮縣,玉里鎮,8744,28471,15599,12872
2007/4/1,花蓮縣,新城鄉,7124,20654,10784,9870
2007/4/1,花蓮縣,吉安鄉,27039,78817,40692,38125
2007/4/1,花蓮縣,壽豐鄉,6628,19485,10660,8825
2007/4/1,花蓮縣,光復鄉,4966,14883,7985,6898
2007/4/1,花蓮縣,豐濱鄉,1795,5426,3031,2395
2007/4/1,花蓮縣,瑞穗鄉,4479,13547,7344,6203
2007/4/1,花蓮縣,富里鄉,3869,12199,6754,5445
2007/4/1,花蓮縣,秀林鄉,4424,15027,7900,7127
2007/4/1,花蓮縣,萬榮鄉,2128,7168,3848,3320
2007/4/1,花蓮縣,卓溪鄉,1597,6620,3682,2938
2007/4/1,澎湖縣,馬公市,17581,54212,27689,26523
2007/4/1,澎湖縣,湖西鄉,4230,12852,6721,6131
2007/4/1,澎湖縣,白沙鄉,2914,9152,4852,4300
2007/4/1,澎湖縣,西嶼鄉,2641,8169,4249,3920
2007/4/1,澎湖縣,望安鄉,1687,4472,2393,2079
2007/4/1,澎湖縣,七美鄉,1075,3166,1695,1471
2007/4/1,基隆市,中正區,21499,57861,29825,28036
2007/4/1,基隆市,七堵區,18914,55112,28147,26965
2007/4/1,基隆市,暖暖區,13963,38542,19740,18802
2007/4/1,基隆市,仁愛區,18538,50166,25098,25068
2007/4/1,基隆市,中山區,18642,52801,27135,25666
2007/4/1,基隆市,安樂區,30458,85052,42540,42512
2007/4/1,基隆市,信義區,19149,50921,25637,25284
2007/4/1,新竹市,東區,62523,189043,93973,95070
2007/4/1,新竹市,北區,45657,137838,69072,68766
2007/4/1,新竹市,香山區,20561,69521,35694,33827
2007/4/1,臺中市,中區,8325,23713,11780,11933
2007/4/1,臺中市,東區,24545,73333,37382,35951
2007/4/1,臺中市,西區,40793,116276,56269,60007
2007/4/1,臺中市,南區,38527,109399,53528,55871
2007/4/1,臺中市,北區,52885,146954,71729,75225
2007/4/1,臺中市,西屯區,65706,196174,96071,100103
2007/4/1,臺中市,南屯區,47815,144347,69975,74372
2007/4/1,臺中市,北屯區,77057,237496,116179,121317
2007/4/1,嘉義市,東區,42958,128640,63196,65444
2007/4/1,嘉義市,西區,46863,143794,71780,72014
2007/4/1,臺南市,東區,67492,193054,94048,99006
2007/4/1,臺南市,南區,41586,128046,64639,63407
2007/4/1,臺南市,北區,44654,127936,63747,64189
2007/4/1,臺南市,安南區,50134,172751,88400,84351
2007/4/1,臺南市,安平區,20673,58035,27935,30100
2007/4/1,臺南市,中西區,29512,81667,40322,41345
2007/4/1,臺北市,松山區,75624,209882,99940,109942
2007/4/1,臺北市,信義區,84537,230254,112396,117858
2007/4/1,臺北市,大安區,113216,313455,148932,164523
2007/4/1,臺北市,中山區,86632,218439,104233,114206
2007/4/1,臺北市,中正區,59447,158935,77306,81629
2007/4/1,臺北市,大同區,45256,126516,62973,63543
2007/4/1,臺北市,萬華區,72047,193598,97757,95841
2007/4/1,臺北市,文山區,92824,260979,127523,133456
2007/4/1,臺北市,南港區,39071,113129,56363,56766
2007/4/1,臺北市,內湖區,90053,264925,128763,136162
2007/4/1,臺北市,士林區,96517,287473,140744,146729
2007/4/1,臺北市,北投區,85075,249561,122086,127475
2007/4/1,高雄市,鹽埕區,11198,28906,14742,14164
2007/4/1,高雄市,鼓山區,44781,119739,59747,59992
2007/4/1,高雄市,左營區,68814,184342,91882,92460
2007/4/1,高雄市,楠梓區,57540,166794,83460,83334
2007/4/1,高雄市,三民區,126767,360912,178192,182720
2007/4/1,高雄市,新興區,22684,57759,28353,29406
2007/4/1,高雄市,前金區,12209,30053,14819,15234
2007/4/1,高雄市,苓雅區,69564,189278,92960,96318
2007/4/1,高雄市,前鎮區,72038,200551,100855,99696
2007/4/1,高雄市,旗津區,10631,30081,15809,14272
2007/4/1,高雄市,小港區,57534,150389,76508,73881
2007/4/1,金門縣,金城鎮,9797,26817,14162,12655
2007/4/1,金門縣,金湖鎮,6363,17523,9326,8197
2007/4/1,金門縣,金沙鎮,4871,12633,6669,5964
2007/4/1,金門縣,金寧鄉,5380,14126,7609,6517
2007/4/1,金門縣,烈嶼鄉,2270,6857,3629,3228
2007/4/1,金門縣,烏坵鄉,133,451,233,218
2007/4/1,連江縣,南竿鄉,1055,5834,3376,2458
2007/4/1,連江縣,北竿鄉,366,1820,1076,744
2007/4/1,連江縣,莒光鄉,235,1159,685,474
2007/4/1,連江縣,東引鄉,245,978,581,397
2007/5/1,總計,臺灣地區,7402435,22805786,11542151,11263635
2007/5/1,總計,臺灣省,5907458,18662872,9508089,9154783
2007/5/1,總計,新北市,1290643,3776501,1890433,1886068
2007/5/1,總計,宜蘭縣,145410,460161,236067,224094
2007/5/1,總計,桃園市,610276,1919487,974894,944593
2007/5/1,總計,新竹縣,144787,490714,254152,236562
2007/5/1,總計,苗栗縣,161476,559818,292552,267266
2007/5/1,總計,臺中市,438500,1545524,787279,758245
2007/5/1,總計,彰化縣,345629,1314225,677948,636277
2007/5/1,總計,南投縣,162972,534186,276914,257272
2007/5/1,總計,雲林縣,216935,726986,382037,344949
2007/5/1,總計,嘉義縣,167527,552273,289866,262407
2007/5/1,總計,臺南市,350718,1105779,567731,538048
2007/5/1,總計,高雄市,412156,1244090,641340,602750
2007/5/1,總計,屏東縣,265265,891058,461191,429867
2007/5/1,總計,臺東縣,77502,234939,124095,110844
2007/5/1,總計,花蓮縣,115903,344336,179237,165099
2007/5/1,總計,澎湖縣,30167,92059,47622,44437
2007/5/1,總計,基隆市,141341,390380,198048,192332
2007/5/1,總計,新竹市,128993,396739,198848,197891
2007/5/1,總計,臺中市,356677,1049056,513464,535592
2007/5/1,總計,嘉義市,90035,272471,134961,137510
2007/5/1,總計,臺南市,254546,762090,379410,382680
2007/5/1,總計,臺北市,941000,2627232,1278685,1348547
2007/5/1,總計,高雄市,553977,1515682,755377,760305
2007/5/1,總計,福建省,30761,88497,47516,40981
2007/5/1,總計,金門縣,28856,78707,41803,36904
2007/5/1,總計,連江縣,1905,9790,5713,4077
2007/5/1,新北市,板橋區,179923,545442,272267,273175
2007/5/1,新北市,三重區,129368,383230,192458,190772
2007/5/1,新北市,永和區,87068,235999,114059,121940
2007/5/1,新北市,中和區,145213,409777,204058,205719
2007/5/1,新北市,新莊區,127674,394307,196157,198150
2007/5/1,新北市,新店區,109364,289507,143273,146234
2007/5/1,新北市,土城區,77543,236917,118994,117923
2007/5/1,新北市,蘆洲區,60387,190692,94934,95758
2007/5/1,新北市,汐止區,72974,179445,89843,89602
2007/5/1,新北市,樹林區,51200,163106,82728,80378
2007/5/1,新北市,鶯歌區,25267,85311,43514,41797
2007/5/1,新北市,三峽區,29357,93027,48061,44966
2007/5/1,新北市,淡水區,48674,130777,64461,66316
2007/5/1,新北市,瑞芳區,15393,43581,22411,21170
2007/5/1,新北市,五股區,25163,76652,39073,37579
2007/5/1,新北市,泰山區,24151,73587,37294,36293
2007/5/1,新北市,林口區,20668,63736,31949,31787
2007/5/1,新北市,深坑區,7988,21858,11187,10671
2007/5/1,新北市,石碇區,3135,7938,4413,3525
2007/5/1,新北市,坪林區,2319,6594,3712,2882
2007/5/1,新北市,三芝區,8418,23539,12279,11260
2007/5/1,新北市,石門區,3599,11690,6222,5468
2007/5/1,新北市,八里區,10940,32416,16660,15756
2007/5/1,新北市,平溪區,2335,5717,3194,2523
2007/5/1,新北市,雙溪區,3767,9932,5378,4554
2007/5/1,新北市,貢寮區,4277,13918,7262,6656
2007/5/1,新北市,金山區,6368,22199,11336,10863
2007/5/1,新北市,萬里區,6448,20297,10520,9777
2007/5/1,新北市,烏來區,1662,5310,2736,2574
2007/5/1,宜蘭縣,宜蘭市,31583,95771,47498,48273
2007/5/1,宜蘭縣,羅東鎮,23934,74190,35722,38468
2007/5/1,宜蘭縣,蘇澳鎮,13004,43123,22428,20695
2007/5/1,宜蘭縣,頭城鎮,9114,31756,16493,15263
2007/5/1,宜蘭縣,礁溪鄉,11585,35946,18912,17034
2007/5/1,宜蘭縣,壯圍鄉,7709,25293,13378,11915
2007/5/1,宜蘭縣,員山鄉,10118,32406,17479,14927
2007/5/1,宜蘭縣,冬山鄉,16093,51182,26564,24618
2007/5/1,宜蘭縣,五結鄉,11953,37601,19713,17888
2007/5/1,宜蘭縣,三星鄉,6866,21235,11549,9686
2007/5/1,宜蘭縣,大同鄉,1755,5807,3227,2580
2007/5/1,宜蘭縣,南澳鄉,1696,5851,3104,2747
2007/5/1,桃園市,桃園區,131060,387720,190824,196896
2007/5/1,桃園市,中壢區,115183,356376,179344,177032
2007/5/1,桃園市,平鎮區,60757,201400,102119,99281
2007/5/1,桃園市,八德區,52551,171512,88284,83228
2007/5/1,桃園市,大溪區,27118,89755,46565,43190
2007/5/1,桃園市,楊梅區,43211,141485,72526,68959
2007/5/1,桃園市,蘆竹區,41959,129569,65470,64099
2007/5/1,桃園市,大園區,23454,79224,41389,37835
2007/5/1,桃園市,龜山區,45259,130379,66830,63549
2007/5/1,桃園市,龍潭區,34191,112144,57378,54766
2007/5/1,桃園市,新屋區,14246,49923,26682,23241
2007/5/1,桃園市,觀音區,17694,59304,31480,27824
2007/5/1,桃園市,復興區,3593,10696,6003,4693
2007/5/1,新竹縣,竹北市,38189,122321,61688,60633
2007/5/1,新竹縣,關西鎮,8771,32681,17471,15210
2007/5/1,新竹縣,新埔鎮,9779,36121,19172,16949
2007/5/1,新竹縣,竹東鎮,28398,96043,48582,47461
2007/5/1,新竹縣,湖口鄉,21733,73797,37989,35808
2007/5/1,新竹縣,橫山鄉,4163,14720,8046,6674
2007/5/1,新竹縣,新豐鄉,14378,51321,26646,24675
2007/5/1,新竹縣,芎林鄉,5884,20747,10942,9805
2007/5/1,新竹縣,寶山鄉,4388,13752,7472,6280
2007/5/1,新竹縣,北埔鄉,2945,10437,5667,4770
2007/5/1,新竹縣,峨眉鄉,1966,6139,3421,2718
2007/5/1,新竹縣,尖石鄉,2529,8159,4510,3649
2007/5/1,新竹縣,五峰鄉,1664,4476,2546,1930
2007/5/1,苗栗縣,苗栗市,27626,91005,46197,44808
2007/5/1,苗栗縣,苑裡鎮,13147,48988,25686,23302
2007/5/1,苗栗縣,通霄鎮,10866,39420,21091,18329
2007/5/1,苗栗縣,竹南鎮,21352,74651,38161,36490
2007/5/1,苗栗縣,頭份市,26759,94012,48199,45813
2007/5/1,苗栗縣,後龍鎮,11327,40576,21560,19016
2007/5/1,苗栗縣,卓蘭鎮,5694,18579,9892,8687
2007/5/1,苗栗縣,大湖鄉,5049,16318,8812,7506
2007/5/1,苗栗縣,公館鄉,9466,34651,18208,16443
2007/5/1,苗栗縣,銅鑼鄉,5810,19956,10655,9301
2007/5/1,苗栗縣,南庄鄉,3809,11574,6453,5121
2007/5/1,苗栗縣,頭屋鄉,3426,11916,6272,5644
2007/5/1,苗栗縣,三義鄉,5056,17767,9404,8363
2007/5/1,苗栗縣,西湖鄉,2561,8045,4463,3582
2007/5/1,苗栗縣,造橋鄉,3864,13965,7385,6580
2007/5/1,苗栗縣,三灣鄉,2275,7537,4099,3438
2007/5/1,苗栗縣,獅潭鄉,1597,5183,2897,2286
2007/5/1,苗栗縣,泰安鄉,1792,5675,3118,2557
2007/5/1,臺中市,豐原區,46620,164246,82094,82152
2007/5/1,臺中市,大里區,57270,190971,95324,95647
2007/5/1,臺中市,太平區,51776,171132,86283,84849
2007/5/1,臺中市,東勢區,16450,55061,28731,26330
2007/5/1,臺中市,大甲區,20644,79419,40356,39063
2007/5/1,臺中市,清水區,23652,85735,44441,41294
2007/5/1,臺中市,沙鹿區,20986,77890,39812,38078
2007/5/1,臺中市,梧棲區,15123,53976,27488,26488
2007/5/1,臺中市,后里區,14130,54595,28355,26240
2007/5/1,臺中市,神岡區,16754,64142,33112,31030
2007/5/1,臺中市,潭子區,29812,96671,48552,48119
2007/5/1,臺中市,大雅區,24649,87361,44376,42985
2007/5/1,臺中市,新社區,7079,25810,13663,12147
2007/5/1,臺中市,石岡區,4616,16161,8401,7760
2007/5/1,臺中市,外埔區,8223,31764,16424,15340
2007/5/1,臺中市,大安區,5088,20722,10971,9751
2007/5/1,臺中市,烏日區,18849,67194,34294,32900
2007/5/1,臺中市,大肚區,15092,55849,28765,27084
2007/5/1,臺中市,龍井區,19247,71400,36584,34816
2007/5/1,臺中市,霧峰區,17952,64506,33238,31268
2007/5/1,臺中市,和平區,4488,10919,6015,4904
2007/5/1,彰化縣,彰化市,68019,235619,118180,117439
2007/5/1,彰化縣,鹿港鎮,21055,85120,43724,41396
2007/5/1,彰化縣,和美鎮,22616,88901,45745,43156
2007/5/1,彰化縣,北斗鎮,9399,33523,17039,16484
2007/5/1,彰化縣,員林市,34891,126244,63839,62405
2007/5/1,彰化縣,溪湖鎮,14334,56627,29101,27526
2007/5/1,彰化縣,田中鎮,12047,45160,23764,21396
2007/5/1,彰化縣,二林鎮,13737,55278,28605,26673
2007/5/1,彰化縣,線西鄉,3903,17030,8800,8230
2007/5/1,彰化縣,伸港鄉,8375,35583,18371,17212
2007/5/1,彰化縣,福興鄉,11365,48779,25631,23148
2007/5/1,彰化縣,秀水鄉,9088,38727,20097,18630
2007/5/1,彰化縣,花壇鄉,12125,46266,23941,22325
2007/5/1,彰化縣,芬園鄉,6722,25350,13459,11891
2007/5/1,彰化縣,大村鄉,9693,36460,19107,17353
2007/5/1,彰化縣,埔鹽鄉,8455,34792,18329,16463
2007/5/1,彰化縣,埔心鄉,9411,35410,18416,16994
2007/5/1,彰化縣,永靖鄉,9924,39844,20762,19082
2007/5/1,彰化縣,社頭鄉,11808,45524,23517,22007
2007/5/1,彰化縣,二水鄉,5155,17168,9104,8064
2007/5/1,彰化縣,田尾鄉,7425,29207,15235,13972
2007/5/1,彰化縣,埤頭鄉,8139,32094,16875,15219
2007/5/1,彰化縣,芳苑鄉,9787,37110,19736,17374
2007/5/1,彰化縣,大城鄉,5277,19378,10609,8769
2007/5/1,彰化縣,竹塘鄉,4459,16772,8882,7890
2007/5/1,彰化縣,溪州鄉,8420,32259,17080,15179
2007/5/1,南投縣,南投市,31873,105770,53504,52266
2007/5/1,南投縣,埔里鎮,27263,86429,43935,42494
2007/5/1,南投縣,草屯鎮,29151,99717,50691,49026
2007/5/1,南投縣,竹山鎮,17838,59309,30805,28504
2007/5/1,南投縣,集集鎮,4068,12169,6401,5768
2007/5/1,南投縣,名間鄉,11632,41623,22041,19582
2007/5/1,南投縣,鹿谷鄉,6213,19617,10489,9128
2007/5/1,南投縣,中寮鄉,5392,16664,9125,7539
2007/5/1,南投縣,魚池鄉,5571,17367,9290,8077
2007/5/1,南投縣,國姓鄉,6987,21657,11894,9763
2007/5/1,南投縣,水里鄉,7143,21101,11117,9984
2007/5/1,南投縣,信義鄉,5000,17243,9402,7841
2007/5/1,南投縣,仁愛鄉,4841,15520,8220,7300
2007/5/1,雲林縣,斗六市,32128,105245,53314,51931
2007/5/1,雲林縣,斗南鎮,14557,47891,24507,23384
2007/5/1,雲林縣,虎尾鎮,20763,69110,35392,33718
2007/5/1,雲林縣,西螺鎮,13502,49336,25165,24171
2007/5/1,雲林縣,土庫鎮,8311,31250,16426,14824
2007/5/1,雲林縣,北港鎮,14726,44512,23240,21272
2007/5/1,雲林縣,古坑鄉,10215,34925,18518,16407
2007/5/1,雲林縣,大埤鄉,6355,21964,11707,10257
2007/5/1,雲林縣,莿桐鄉,8615,30948,16253,14695
2007/5/1,雲林縣,林內鄉,5530,20700,10885,9815
2007/5/1,雲林縣,二崙鄉,8528,30792,16569,14223
2007/5/1,雲林縣,崙背鄉,7948,28202,14973,13229
2007/5/1,雲林縣,麥寮鄉,11099,33135,17757,15378
2007/5/1,雲林縣,東勢鄉,5561,17746,9619,8127
2007/5/1,雲林縣,褒忠鄉,4120,14904,7981,6923
2007/5/1,雲林縣,臺西鄉,8388,27450,14805,12645
2007/5/1,雲林縣,元長鄉,9032,29930,16340,13590
2007/5/1,雲林縣,四湖鄉,8675,27709,15326,12383
2007/5/1,雲林縣,口湖鄉,9267,31239,16791,14448
2007/5/1,雲林縣,水林鄉,9615,29998,16469,13529
2007/5/1,嘉義縣,太保市,10207,35361,18418,16943
2007/5/1,嘉義縣,朴子市,13453,44411,22830,21581
2007/5/1,嘉義縣,布袋鎮,9845,31445,16324,15121
2007/5/1,嘉義縣,大林鎮,10830,34489,17850,16639
2007/5/1,嘉義縣,民雄鄉,21385,72736,37590,35146
2007/5/1,嘉義縣,溪口鄉,5150,16881,9033,7848
2007/5/1,嘉義縣,新港鄉,9996,35479,18759,16720
2007/5/1,嘉義縣,六腳鄉,8867,27385,14574,12811
2007/5/1,嘉義縣,東石鄉,9071,28823,15379,13444
2007/5/1,嘉義縣,義竹鄉,7207,21943,11426,10517
2007/5/1,嘉義縣,鹿草鄉,5499,17518,9406,8112
2007/5/1,嘉義縣,水上鄉,16987,53758,28059,25699
2007/5/1,嘉義縣,中埔鄉,14346,48142,25243,22899
2007/5/1,嘉義縣,竹崎鄉,10996,39554,21121,18433
2007/5/1,嘉義縣,梅山鄉,6272,22374,11899,10475
2007/5/1,嘉義縣,番路鄉,3735,11842,6484,5358
2007/5/1,嘉義縣,大埔鄉,1753,3966,2157,1809
2007/5/1,嘉義縣,阿里山鄉,1928,6166,3314,2852
2007/5/1,臺南市,新營區,25942,79014,39726,39288
2007/5/1,臺南市,永康區,69496,209448,104858,104590
2007/5/1,臺南市,鹽水區,9550,27975,14608,13367
2007/5/1,臺南市,白河區,10667,32494,17232,15262
2007/5/1,臺南市,麻豆區,14149,46397,23852,22545
2007/5/1,臺南市,佳里區,18156,59213,29590,29623
2007/5/1,臺南市,新化區,13014,44626,22951,21675
2007/5/1,臺南市,善化區,13374,42376,21657,20719
2007/5/1,臺南市,學甲區,9123,28699,14774,13925
2007/5/1,臺南市,柳營區,7503,23280,12209,11071
2007/5/1,臺南市,後壁區,8339,26607,13880,12727
2007/5/1,臺南市,東山區,7992,23853,12800,11053
2007/5/1,臺南市,下營區,8809,26865,13940,12925
2007/5/1,臺南市,六甲區,7344,24499,12781,11718
2007/5/1,臺南市,官田區,7444,22717,11754,10963
2007/5/1,臺南市,大內區,3996,11418,6108,5310
2007/5/1,臺南市,西港區,7504,25707,13176,12531
2007/5/1,臺南市,七股區,7712,25230,13262,11968
2007/5/1,臺南市,將軍區,7225,22194,11388,10806
2007/5/1,臺南市,北門區,4155,12709,6559,6150
2007/5/1,臺南市,新市區,10333,35691,17979,17712
2007/5/1,臺南市,安定區,8610,29960,15603,14357
2007/5/1,臺南市,山上區,2669,8091,4290,3801
2007/5/1,臺南市,玉井區,4978,15935,8313,7622
2007/5/1,臺南市,楠西區,3578,11091,5922,5169
2007/5/1,臺南市,南化區,2804,8996,4949,4047
2007/5/1,臺南市,左鎮區,1923,5648,3126,2522
2007/5/1,臺南市,仁德區,23083,68101,35240,32861
2007/5/1,臺南市,歸仁區,19256,65359,33424,31935
2007/5/1,臺南市,關廟區,10445,37182,19378,17804
2007/5/1,臺南市,龍崎區,1545,4404,2402,2002
2007/5/1,高雄市,鳳山區,120511,338779,170103,168676
2007/5/1,高雄市,岡山區,31634,95663,48484,47179
2007/5/1,高雄市,旗山區,13493,41261,21651,19610
2007/5/1,高雄市,美濃區,13461,44305,23286,21019
2007/5/1,高雄市,林園區,23284,71505,36972,34533
2007/5/1,高雄市,大寮區,36158,109186,57154,52032
2007/5/1,高雄市,大樹區,12799,44924,23411,21513
2007/5/1,高雄市,仁武區,22785,66967,34683,32284
2007/5/1,高雄市,大社區,11090,32628,16822,15806
2007/5/1,高雄市,鳥松區,15465,41143,21059,20084
2007/5/1,高雄市,橋頭區,12212,36772,18968,17804
2007/5/1,高雄市,燕巢區,9549,31320,16817,14503
2007/5/1,高雄市,田寮區,3600,8632,4843,3789
2007/5/1,高雄市,阿蓮區,8824,30946,15672,15274
2007/5/1,高雄市,路竹區,15299,54716,28006,26710
2007/5/1,高雄市,湖內區,8959,28660,14888,13772
2007/5/1,高雄市,茄萣區,9842,32046,16840,15206
2007/5/1,高雄市,永安區,5604,14244,7327,6917
2007/5/1,高雄市,彌陀區,6368,20849,10961,9888
2007/5/1,高雄市,梓官區,11453,37388,19606,17782
2007/5/1,高雄市,六龜區,5644,15742,8593,7149
2007/5/1,高雄市,甲仙區,2582,8287,4473,3814
2007/5/1,高雄市,杉林區,3976,11458,6314,5144
2007/5/1,高雄市,內門區,4969,16613,9086,7527
2007/5/1,高雄市,茂林區,517,1762,899,863
2007/5/1,高雄市,桃源區,1206,4799,2582,2217
2007/5/1,屏東縣,屏東市,70294,216238,108510,107728
2007/5/1,屏東縣,潮州鎮,17447,57042,28870,28172
2007/5/1,屏東縣,東港鎮,14448,50460,25797,24663
2007/5/1,屏東縣,恆春鎮,10193,31266,16274,14992
2007/5/1,屏東縣,萬丹鄉,13595,54425,28288,26137
2007/5/1,屏東縣,長治鄉,9374,30963,16334,14629
2007/5/1,屏東縣,麟洛鄉,3434,11750,6091,5659
2007/5/1,屏東縣,九如鄉,6369,23272,12116,11156
2007/5/1,屏東縣,里港鄉,7744,26549,13682,12867
2007/5/1,屏東縣,鹽埔鄉,7412,27812,14556,13256
2007/5/1,屏東縣,高樹鄉,9483,27654,14847,12807
2007/5/1,屏東縣,萬巒鄉,6261,22794,12080,10714
2007/5/1,屏東縣,內埔鄉,17077,59564,31199,28365
2007/5/1,屏東縣,竹田鄉,5361,18537,9912,8625
2007/5/1,屏東縣,新埤鄉,3272,11076,5889,5187
2007/5/1,屏東縣,枋寮鄉,8238,27478,14612,12866
2007/5/1,屏東縣,新園鄉,10763,39696,20630,19066
2007/5/1,屏東縣,崁頂鄉,3907,16842,8712,8130
2007/5/1,屏東縣,林邊鄉,6146,21341,11108,10233
2007/5/1,屏東縣,南州鄉,3568,12190,6279,5911
2007/5/1,屏東縣,佳冬鄉,6568,21911,11478,10433
2007/5/1,屏東縣,琉球鄉,3695,12706,7044,5662
2007/5/1,屏東縣,車城鄉,3390,10171,5511,4660
2007/5/1,屏東縣,滿州鄉,2964,8721,4785,3936
2007/5/1,屏東縣,枋山鄉,2097,6292,3404,2888
2007/5/1,屏東縣,三地門鄉,2008,7263,3741,3522
2007/5/1,屏東縣,霧臺鄉,808,2770,1485,1285
2007/5/1,屏東縣,瑪家鄉,1798,6543,3424,3119
2007/5/1,屏東縣,泰武鄉,1071,4930,2629,2301
2007/5/1,屏東縣,來義鄉,2060,7827,4035,3792
2007/5/1,屏東縣,春日鄉,1258,5037,2646,2391
2007/5/1,屏東縣,獅子鄉,1410,5017,2673,2344
2007/5/1,屏東縣,牡丹鄉,1752,4921,2550,2371
2007/5/1,臺東縣,臺東市,36689,110444,56465,53979
2007/5/1,臺東縣,成功鎮,5284,16550,8895,7655
2007/5/1,臺東縣,關山鎮,3156,10032,5308,4724
2007/5/1,臺東縣,卑南鄉,6395,18603,10266,8337
2007/5/1,臺東縣,大武鄉,2463,7218,3801,3417
2007/5/1,臺東縣,太麻里鄉,4455,12312,6638,5674
2007/5/1,臺東縣,東河鄉,3433,9866,5490,4376
2007/5/1,臺東縣,長濱鄉,2816,8935,5064,3871
2007/5/1,臺東縣,鹿野鄉,3091,9047,4916,4131
2007/5/1,臺東縣,池上鄉,3178,9574,5139,4435
2007/5/1,臺東縣,綠島鄉,869,3071,1624,1447
2007/5/1,臺東縣,延平鄉,1052,3658,2056,1602
2007/5/1,臺東縣,海端鄉,1073,4600,2507,2093
2007/5/1,臺東縣,達仁鄉,1395,3777,2086,1691
2007/5/1,臺東縣,金峰鄉,978,3338,1773,1565
2007/5/1,臺東縣,蘭嶼鄉,1175,3914,2067,1847
2007/5/1,花蓮縣,花蓮市,38636,109654,54371,55283
2007/5/1,花蓮縣,鳳林鎮,4361,12591,6693,5898
2007/5/1,花蓮縣,玉里鎮,8745,28421,15563,12858
2007/5/1,花蓮縣,新城鄉,7137,20678,10792,9886
2007/5/1,花蓮縣,吉安鄉,27106,78789,40702,38087
2007/5/1,花蓮縣,壽豐鄉,6629,19457,10631,8826
2007/5/1,花蓮縣,光復鄉,4969,14830,7960,6870
2007/5/1,花蓮縣,豐濱鄉,1812,5430,3028,2402
2007/5/1,花蓮縣,瑞穗鄉,4483,13515,7338,6177
2007/5/1,花蓮縣,富里鄉,3872,12203,6750,5453
2007/5/1,花蓮縣,秀林鄉,4423,15011,7887,7124
2007/5/1,花蓮縣,萬榮鄉,2133,7156,3844,3312
2007/5/1,花蓮縣,卓溪鄉,1597,6601,3678,2923
2007/5/1,澎湖縣,馬公市,17611,54276,27711,26565
2007/5/1,澎湖縣,湖西鄉,4232,12839,6728,6111
2007/5/1,澎湖縣,白沙鄉,2918,9143,4850,4293
2007/5/1,澎湖縣,西嶼鄉,2643,8158,4243,3915
2007/5/1,澎湖縣,望安鄉,1688,4483,2398,2085
2007/5/1,澎湖縣,七美鄉,1075,3160,1692,1468
2007/5/1,基隆市,中正區,21514,57788,29781,28007
2007/5/1,基隆市,七堵區,18947,55105,28136,26969
2007/5/1,基隆市,暖暖區,13984,38528,19734,18794
2007/5/1,基隆市,仁愛區,18608,50268,25144,25124
2007/5/1,基隆市,中山區,18624,52698,27065,25633
2007/5/1,基隆市,安樂區,30504,85090,42543,42547
2007/5/1,基隆市,信義區,19160,50903,25645,25258
2007/5/1,新竹市,東區,62618,189277,94049,95228
2007/5/1,新竹市,北區,45759,137919,69065,68854
2007/5/1,新竹市,香山區,20616,69543,35734,33809
2007/5/1,臺中市,中區,8353,23803,11816,11987
2007/5/1,臺中市,東區,24611,73414,37403,36011
2007/5/1,臺中市,西區,40850,116340,56310,60030
2007/5/1,臺中市,南區,38641,109447,53567,55880
2007/5/1,臺中市,北區,52974,147061,71796,75265
2007/5/1,臺中市,西屯區,65956,196524,96177,100347
2007/5/1,臺中市,南屯區,47983,144610,70045,74565
2007/5/1,臺中市,北屯區,77309,237857,116350,121507
2007/5/1,嘉義市,東區,43031,128641,63182,65459
2007/5/1,嘉義市,西區,47004,143830,71779,72051
2007/5/1,臺南市,東區,67655,193296,94160,99136
2007/5/1,臺南市,南區,41624,127893,64563,63330
2007/5/1,臺南市,北區,44726,128025,63805,64220
2007/5/1,臺南市,安南區,50249,172974,88523,84451
2007/5/1,臺南市,安平區,20766,58298,28088,30210
2007/5/1,臺南市,中西區,29526,81604,40271,41333
2007/5/1,臺北市,松山區,75695,210195,100119,110076
2007/5/1,臺北市,信義區,84517,230079,112260,117819
2007/5/1,臺北市,大安區,113295,313752,149050,164702
2007/5/1,臺北市,中山區,86635,218273,104089,114184
2007/5/1,臺北市,中正區,59521,159155,77390,81765
2007/5/1,臺北市,大同區,45341,126487,62933,63554
2007/5/1,臺北市,萬華區,72037,193216,97519,95697
2007/5/1,臺北市,文山區,92953,261253,127608,133645
2007/5/1,臺北市,南港區,39113,113049,56294,56755
2007/5/1,臺北市,內湖區,90113,264968,128763,136205
2007/5/1,臺北市,士林區,96562,287350,140625,146725
2007/5/1,臺北市,北投區,85218,249455,122035,127420
2007/5/1,高雄市,鹽埕區,11223,28899,14728,14171
2007/5/1,高雄市,鼓山區,45048,120050,59846,60204
2007/5/1,高雄市,左營區,68954,184553,91941,92612
2007/5/1,高雄市,楠梓區,57695,167025,83526,83499
2007/5/1,高雄市,三民區,126974,360806,178068,182738
2007/5/1,高雄市,新興區,22692,57730,28336,29394
2007/5/1,高雄市,前金區,12233,30073,14841,15232
2007/5/1,高雄市,苓雅區,69657,189138,92854,96284
2007/5/1,高雄市,前鎮區,72163,200553,100841,99712
2007/5/1,高雄市,旗津區,10628,30054,15790,14264
2007/5/1,高雄市,小港區,57582,150296,76446,73850
2007/5/1,金門縣,金城鎮,9804,26980,14247,12733
2007/5/1,金門縣,金湖鎮,6380,17601,9378,8223
2007/5/1,金門縣,金沙鎮,4880,12671,6685,5986
2007/5/1,金門縣,金寧鄉,5385,14145,7640,6505
2007/5/1,金門縣,烈嶼鄉,2275,6864,3626,3238
2007/5/1,金門縣,烏坵鄉,132,446,227,219
2007/5/1,連江縣,南竿鄉,1056,5825,3368,2457
2007/5/1,連江縣,北竿鄉,368,1815,1072,743
2007/5/1,連江縣,莒光鄉,235,1169,693,476
2007/5/1,連江縣,東引鄉,246,981,580,401
2007/6/1,總計,臺灣地區,7414236,22813060,11544100,11268960
2007/6/1,總計,臺灣省,5917244,18668955,9510013,9158942
2007/6/1,總計,新北市,1293130,3779219,1891510,1887709
2007/6/1,總計,宜蘭縣,145647,460133,236061,224072
2007/6/1,總計,桃園市,611651,1921526,975832,945694
2007/6/1,總計,新竹縣,145234,491405,254477,236928
2007/6/1,總計,苗栗縣,161658,559776,292516,267260
2007/6/1,總計,臺中市,439087,1546114,787585,758529
2007/6/1,總計,彰化縣,346002,1313986,677783,636203
2007/6/1,總計,南投縣,163185,533903,276724,257179
2007/6/1,總計,雲林縣,217200,726868,381891,344977
2007/6/1,總計,嘉義縣,167730,551993,289751,262242
2007/6/1,總計,臺南市,350932,1105515,567475,538040
2007/6/1,總計,高雄市,412778,1244282,641441,602841
2007/6/1,總計,屏東縣,265539,890753,460998,429755
2007/6/1,總計,臺東縣,77595,234672,123961,110711
2007/6/1,總計,花蓮縣,116072,344087,179080,165007
2007/6/1,總計,澎湖縣,30231,92077,47628,44449
2007/6/1,總計,基隆市,141571,390299,197993,192306
2007/6/1,總計,新竹市,129193,396983,198909,198074
2007/6/1,總計,臺中市,357584,1050160,513808,536352
2007/6/1,總計,嘉義市,90228,272718,135061,137657
2007/6/1,總計,臺南市,254997,762486,379529,382957
2007/6/1,總計,臺北市,941991,2627990,1278705,1349285
2007/6/1,總計,高雄市,555001,1516115,755382,760733
2007/6/1,總計,福建省,30820,88837,47723,41114
2007/6/1,總計,金門縣,28913,79023,41997,37026
2007/6/1,總計,連江縣,1907,9814,5726,4088
2007/6/1,新北市,板橋區,180286,545710,272382,273328
2007/6/1,新北市,三重區,129577,383293,192464,190829
2007/6/1,新北市,永和區,87205,236177,114095,122082
2007/6/1,新北市,中和區,145313,409698,204004,205694
2007/6/1,新北市,新莊區,127985,394714,196341,198373
2007/6/1,新北市,新店區,109583,289605,143240,146365
2007/6/1,新北市,土城區,77669,237033,119024,118009
2007/6/1,新北市,蘆洲區,60484,190800,95003,95797
2007/6/1,新北市,汐止區,73029,179589,89925,89664
2007/6/1,新北市,樹林區,51299,163217,82794,80423
2007/6/1,新北市,鶯歌區,25309,85321,43517,41804
2007/6/1,新北市,三峽區,29553,93426,48256,45170
2007/6/1,新北市,淡水區,48777,130906,64511,66395
2007/6/1,新北市,瑞芳區,15406,43524,22374,21150
2007/6/1,新北市,五股區,25189,76691,39077,37614
2007/6/1,新北市,泰山區,24244,73830,37416,36414
2007/6/1,新北市,林口區,20903,64277,32191,32086
2007/6/1,新北市,深坑區,7989,21888,11197,10691
2007/6/1,新北市,石碇區,3133,7920,4408,3512
2007/6/1,新北市,坪林區,2327,6606,3715,2891
2007/6/1,新北市,三芝區,8424,23548,12290,11258
2007/6/1,新北市,石門區,3608,11690,6215,5475
2007/6/1,新北市,八里區,10955,32437,16666,15771
2007/6/1,新北市,平溪區,2331,5690,3181,2509
2007/6/1,新北市,雙溪區,3770,9966,5394,4572
2007/6/1,新北市,貢寮區,4282,13866,7237,6629
2007/6/1,新北市,金山區,6364,22168,11313,10855
2007/6/1,新北市,萬里區,6474,20345,10546,9799
2007/6/1,新北市,烏來區,1662,5284,2734,2550
2007/6/1,宜蘭縣,宜蘭市,31651,95838,47539,48299
2007/6/1,宜蘭縣,羅東鎮,23971,74253,35745,38508
2007/6/1,宜蘭縣,蘇澳鎮,13002,43035,22383,20652
2007/6/1,宜蘭縣,頭城鎮,9124,31718,16477,15241
2007/6/1,宜蘭縣,礁溪鄉,11613,35957,18911,17046
2007/6/1,宜蘭縣,壯圍鄉,7719,25278,13368,11910
2007/6/1,宜蘭縣,員山鄉,10131,32370,17471,14899
2007/6/1,宜蘭縣,冬山鄉,16121,51214,26588,24626
2007/6/1,宜蘭縣,五結鄉,11977,37622,19731,17891
2007/6/1,宜蘭縣,三星鄉,6886,21209,11529,9680
2007/6/1,宜蘭縣,大同鄉,1754,5795,3217,2578
2007/6/1,宜蘭縣,南澳鄉,1698,5844,3102,2742
2007/6/1,桃園市,桃園區,131404,388266,191093,197173
2007/6/1,桃園市,中壢區,115362,356662,179495,177167
2007/6/1,桃園市,平鎮區,60890,201632,102188,99444
2007/6/1,桃園市,八德區,52617,171611,88300,83311
2007/6/1,桃園市,大溪區,27178,89879,46625,43254
2007/6/1,桃園市,楊梅區,43363,141689,72606,69083
2007/6/1,桃園市,蘆竹區,42143,129921,65638,64283
2007/6/1,桃園市,大園區,23483,79254,41398,37856
2007/6/1,桃園市,龜山區,45363,130492,66893,63599
2007/6/1,桃園市,龍潭區,34274,112257,57433,54824
2007/6/1,桃園市,新屋區,14259,49898,26691,23207
2007/6/1,桃園市,觀音區,17726,59304,31490,27814
2007/6/1,桃園市,復興區,3589,10661,5982,4679
2007/6/1,新竹縣,竹北市,38404,122875,61936,60939
2007/6/1,新竹縣,關西鎮,8797,32680,17480,15200
2007/6/1,新竹縣,新埔鎮,9806,36097,19163,16934
2007/6/1,新竹縣,竹東鎮,28465,96180,48659,47521
2007/6/1,新竹縣,湖口鄉,21781,73825,37995,35830
2007/6/1,新竹縣,橫山鄉,4163,14700,8041,6659
2007/6/1,新竹縣,新豐鄉,14408,51367,26667,24700
2007/6/1,新竹縣,芎林鄉,5897,20761,10946,9815
2007/6/1,新竹縣,寶山鄉,4395,13762,7473,6289
2007/6/1,新竹縣,北埔鄉,2947,10416,5658,4758
2007/6/1,新竹縣,峨眉鄉,1972,6144,3427,2717
2007/6/1,新竹縣,尖石鄉,2535,8141,4496,3645
2007/6/1,新竹縣,五峰鄉,1664,4457,2536,1921
2007/6/1,苗栗縣,苗栗市,27649,91052,46214,44838
2007/6/1,苗栗縣,苑裡鎮,13155,48978,25672,23306
2007/6/1,苗栗縣,通霄鎮,10877,39387,21079,18308
2007/6/1,苗栗縣,竹南鎮,21428,74751,38210,36541
2007/6/1,苗栗縣,頭份市,26807,94061,48217,45844
2007/6/1,苗栗縣,後龍鎮,11331,40565,21543,19022
2007/6/1,苗栗縣,卓蘭鎮,5698,18580,9892,8688
2007/6/1,苗栗縣,大湖鄉,5050,16297,8800,7497
2007/6/1,苗栗縣,公館鄉,9479,34668,18229,16439
2007/6/1,苗栗縣,銅鑼鄉,5800,19885,10609,9276
2007/6/1,苗栗縣,南庄鄉,3806,11555,6446,5109
2007/6/1,苗栗縣,頭屋鄉,3427,11914,6274,5640
2007/6/1,苗栗縣,三義鄉,5057,17740,9391,8349
2007/6/1,苗栗縣,西湖鄉,2558,8033,4463,3570
2007/6/1,苗栗縣,造橋鄉,3862,13925,7361,6564
2007/6/1,苗栗縣,三灣鄉,2276,7533,4097,3436
2007/6/1,苗栗縣,獅潭鄉,1602,5182,2901,2281
2007/6/1,苗栗縣,泰安鄉,1796,5670,3118,2552
2007/6/1,臺中市,豐原區,46691,164357,82154,82203
2007/6/1,臺中市,大里區,57373,191310,95453,95857
2007/6/1,臺中市,太平區,51850,171204,86326,84878
2007/6/1,臺中市,東勢區,16456,55076,28741,26335
2007/6/1,臺中市,大甲區,20666,79403,40335,39068
2007/6/1,臺中市,清水區,23682,85726,44431,41295
2007/6/1,臺中市,沙鹿區,21051,77979,39877,38102
2007/6/1,臺中市,梧棲區,15141,54032,27517,26515
2007/6/1,臺中市,后里區,14145,54560,28328,26232
2007/6/1,臺中市,神岡區,16786,64103,33103,31000
2007/6/1,臺中市,潭子區,29845,96716,48590,48126
2007/6/1,臺中市,大雅區,24689,87409,44385,43024
2007/6/1,臺中市,新社區,7086,25812,13658,12154
2007/6/1,臺中市,石岡區,4618,16156,8393,7763
2007/6/1,臺中市,外埔區,8225,31723,16401,15322
2007/6/1,臺中市,大安區,5094,20719,10969,9750
2007/6/1,臺中市,烏日區,18868,67200,34309,32891
2007/6/1,臺中市,大肚區,15104,55810,28756,27054
2007/6/1,臺中市,龍井區,19250,71405,36607,34798
2007/6/1,臺中市,霧峰區,17986,64513,33242,31271
2007/6/1,臺中市,和平區,4481,10901,6010,4891
2007/6/1,彰化縣,彰化市,68107,235611,118169,117442
2007/6/1,彰化縣,鹿港鎮,21084,85171,43769,41402
2007/6/1,彰化縣,和美鎮,22646,88924,45745,43179
2007/6/1,彰化縣,北斗鎮,9401,33524,17035,16489
2007/6/1,彰化縣,員林市,34928,126196,63798,62398
2007/6/1,彰化縣,溪湖鎮,14343,56595,29082,27513
2007/6/1,彰化縣,田中鎮,12058,45143,23759,21384
2007/6/1,彰化縣,二林鎮,13753,55204,28571,26633
2007/6/1,彰化縣,線西鄉,3908,17006,8785,8221
2007/6/1,彰化縣,伸港鄉,8384,35580,18364,17216
2007/6/1,彰化縣,福興鄉,11389,48783,25638,23145
2007/6/1,彰化縣,秀水鄉,9117,38792,20116,18676
2007/6/1,彰化縣,花壇鄉,12144,46204,23910,22294
2007/6/1,彰化縣,芬園鄉,6721,25328,13459,11869
2007/6/1,彰化縣,大村鄉,9694,36425,19082,17343
2007/6/1,彰化縣,埔鹽鄉,8452,34757,18312,16445
2007/6/1,彰化縣,埔心鄉,9430,35468,18440,17028
2007/6/1,彰化縣,永靖鄉,9934,39835,20760,19075
2007/6/1,彰化縣,社頭鄉,11825,45512,23507,22005
2007/6/1,彰化縣,二水鄉,5164,17173,9102,8071
2007/6/1,彰化縣,田尾鄉,7421,29240,15246,13994
2007/6/1,彰化縣,埤頭鄉,8153,32078,16860,15218
2007/6/1,彰化縣,芳苑鄉,9787,37119,19737,17382
2007/6/1,彰化縣,大城鄉,5278,19349,10599,8750
2007/6/1,彰化縣,竹塘鄉,4454,16751,8875,7876
2007/6/1,彰化縣,溪州鄉,8427,32218,17063,15155
2007/6/1,南投縣,南投市,31919,105829,53530,52299
2007/6/1,南投縣,埔里鎮,27305,86466,43927,42539
2007/6/1,南投縣,草屯鎮,29220,99683,50669,49014
2007/6/1,南投縣,竹山鎮,17862,59286,30800,28486
2007/6/1,南投縣,集集鎮,4076,12161,6393,5768
2007/6/1,南投縣,名間鄉,11631,41615,22030,19585
2007/6/1,南投縣,鹿谷鄉,6225,19592,10474,9118
2007/6/1,南投縣,中寮鄉,5399,16647,9104,7543
2007/6/1,南投縣,魚池鄉,5579,17318,9260,8058
2007/6/1,南投縣,國姓鄉,6990,21597,11859,9738
2007/6/1,南投縣,水里鄉,7136,21044,11097,9947
2007/6/1,南投縣,信義鄉,5003,17223,9395,7828
2007/6/1,南投縣,仁愛鄉,4840,15442,8186,7256
2007/6/1,雲林縣,斗六市,32187,105251,53287,51964
2007/6/1,雲林縣,斗南鎮,14564,47792,24446,23346
2007/6/1,雲林縣,虎尾鎮,20822,69149,35421,33728
2007/6/1,雲林縣,西螺鎮,13524,49460,25171,24289
2007/6/1,雲林縣,土庫鎮,8332,31271,16432,14839
2007/6/1,雲林縣,北港鎮,14716,44495,23235,21260
2007/6/1,雲林縣,古坑鄉,10231,35032,18595,16437
2007/6/1,雲林縣,大埤鄉,6363,21958,11699,10259
2007/6/1,雲林縣,莿桐鄉,8613,30929,16246,14683
2007/6/1,雲林縣,林內鄉,5531,20704,10887,9817
2007/6/1,雲林縣,二崙鄉,8529,30700,16527,14173
2007/6/1,雲林縣,崙背鄉,7962,28188,14966,13222
2007/6/1,雲林縣,麥寮鄉,11114,33172,17763,15409
2007/6/1,雲林縣,東勢鄉,5564,17732,9612,8120
2007/6/1,雲林縣,褒忠鄉,4123,14893,7978,6915
2007/6/1,雲林縣,臺西鄉,8406,27458,14804,12654
2007/6/1,雲林縣,元長鄉,9040,29880,16330,13550
2007/6/1,雲林縣,四湖鄉,8681,27697,15305,12392
2007/6/1,雲林縣,口湖鄉,9279,31172,16749,14423
2007/6/1,雲林縣,水林鄉,9619,29935,16438,13497
2007/6/1,嘉義縣,太保市,10236,35406,18450,16956
2007/6/1,嘉義縣,朴子市,13472,44420,22840,21580
2007/6/1,嘉義縣,布袋鎮,9853,31408,16299,15109
2007/6/1,嘉義縣,大林鎮,10840,34478,17851,16627
2007/6/1,嘉義縣,民雄鄉,21419,72746,37595,35151
2007/6/1,嘉義縣,溪口鄉,5151,16865,9021,7844
2007/6/1,嘉義縣,新港鄉,10002,35451,18743,16708
2007/6/1,嘉義縣,六腳鄉,8869,27350,14571,12779
2007/6/1,嘉義縣,東石鄉,9082,28782,15355,13427
2007/6/1,嘉義縣,義竹鄉,7213,21902,11413,10489
2007/6/1,嘉義縣,鹿草鄉,5504,17542,9421,8121
2007/6/1,嘉義縣,水上鄉,17000,53726,28044,25682
2007/6/1,嘉義縣,中埔鄉,14384,48084,25219,22865
2007/6/1,嘉義縣,竹崎鄉,11005,39547,21122,18425
2007/6/1,嘉義縣,梅山鄉,6275,22335,11864,10471
2007/6/1,嘉義縣,番路鄉,3742,11828,6475,5353
2007/6/1,嘉義縣,大埔鄉,1754,3964,2151,1813
2007/6/1,嘉義縣,阿里山鄉,1929,6159,3317,2842
2007/6/1,臺南市,新營區,25971,78987,39706,39281
2007/6/1,臺南市,永康區,69589,209577,104899,104678
2007/6/1,臺南市,鹽水區,9549,27945,14575,13370
2007/6/1,臺南市,白河區,10668,32467,17220,15247
2007/6/1,臺南市,麻豆區,14161,46418,23859,22559
2007/6/1,臺南市,佳里區,18183,59230,29587,29643
2007/6/1,臺南市,新化區,13021,44616,22945,21671
2007/6/1,臺南市,善化區,13398,42411,21658,20753
2007/6/1,臺南市,學甲區,9134,28684,14774,13910
2007/6/1,臺南市,柳營區,7501,23265,12200,11065
2007/6/1,臺南市,後壁區,8351,26635,13902,12733
2007/6/1,臺南市,東山區,7991,23855,12793,11062
2007/6/1,臺南市,下營區,8820,26862,13934,12928
2007/6/1,臺南市,六甲區,7365,24495,12776,11719
2007/6/1,臺南市,官田區,7439,22709,11751,10958
2007/6/1,臺南市,大內區,3996,11402,6102,5300
2007/6/1,臺南市,西港區,7504,25684,13150,12534
2007/6/1,臺南市,七股區,7721,25247,13273,11974
2007/6/1,臺南市,將軍區,7229,22192,11378,10814
2007/6/1,臺南市,北門區,4160,12704,6552,6152
2007/6/1,臺南市,新市區,10341,35637,17953,17684
2007/6/1,臺南市,安定區,8631,29951,15595,14356
2007/6/1,臺南市,山上區,2672,8080,4285,3795
2007/6/1,臺南市,玉井區,4975,15900,8297,7603
2007/6/1,臺南市,楠西區,3578,11078,5911,5167
2007/6/1,臺南市,南化區,2808,8990,4940,4050
2007/6/1,臺南市,左鎮區,1921,5641,3120,2521
2007/6/1,臺南市,仁德區,22982,67915,35154,32761
2007/6/1,臺南市,歸仁區,19284,65359,33414,31945
2007/6/1,臺南市,關廟區,10446,37176,19368,17808
2007/6/1,臺南市,龍崎區,1543,4403,2404,1999
2007/6/1,高雄市,鳳山區,120739,338905,170143,168762
2007/6/1,高雄市,岡山區,31697,95875,48578,47297
2007/6/1,高雄市,旗山區,13502,41272,21646,19626
2007/6/1,高雄市,美濃區,13482,44276,23263,21013
2007/6/1,高雄市,林園區,23326,71592,37010,34582
2007/6/1,高雄市,大寮區,36222,109202,57171,52031
2007/6/1,高雄市,大樹區,12819,44898,23402,21496
2007/6/1,高雄市,仁武區,22847,67024,34748,32276
2007/6/1,高雄市,大社區,11110,32643,16828,15815
2007/6/1,高雄市,鳥松區,15495,41158,21075,20083
2007/6/1,高雄市,橋頭區,12223,36773,18989,17784
2007/6/1,高雄市,燕巢區,9560,31305,16794,14511
2007/6/1,高雄市,田寮區,3595,8612,4830,3782
2007/6/1,高雄市,阿蓮區,8825,30936,15661,15275
2007/6/1,高雄市,路竹區,15314,54508,27927,26581
2007/6/1,高雄市,湖內區,8977,28670,14881,13789
2007/6/1,高雄市,茄萣區,9854,32078,16849,15229
2007/6/1,高雄市,永安區,5607,14245,7322,6923
2007/6/1,高雄市,彌陀區,6367,20840,10968,9872
2007/6/1,高雄市,梓官區,11449,37348,19595,17753
2007/6/1,高雄市,六龜區,5644,15725,8581,7144
2007/6/1,高雄市,甲仙區,2576,8283,4471,3812
2007/6/1,高雄市,杉林區,3983,11454,6308,5146
2007/6/1,高雄市,內門區,4971,16620,9082,7538
2007/6/1,高雄市,茂林區,517,1760,898,862
2007/6/1,高雄市,桃源區,1206,4783,2577,2206
2007/6/1,屏東縣,屏東市,70408,216247,108484,107763
2007/6/1,屏東縣,潮州鎮,17461,57021,28859,28162
2007/6/1,屏東縣,東港鎮,14471,50486,25820,24666
2007/6/1,屏東縣,恆春鎮,10209,31261,16268,14993
2007/6/1,屏東縣,萬丹鄉,13627,54440,28290,26150
2007/6/1,屏東縣,長治鄉,9377,30942,16317,14625
2007/6/1,屏東縣,麟洛鄉,3440,11718,6079,5639
2007/6/1,屏東縣,九如鄉,6375,23290,12123,11167
2007/6/1,屏東縣,里港鄉,7749,26538,13674,12864
2007/6/1,屏東縣,鹽埔鄉,7414,27781,14534,13247
2007/6/1,屏東縣,高樹鄉,9480,27621,14837,12784
2007/6/1,屏東縣,萬巒鄉,6264,22779,12068,10711
2007/6/1,屏東縣,內埔鄉,17089,59574,31210,28364
2007/6/1,屏東縣,竹田鄉,5372,18584,9953,8631
2007/6/1,屏東縣,新埤鄉,3280,11091,5897,5194
2007/6/1,屏東縣,枋寮鄉,8233,27447,14594,12853
2007/6/1,屏東縣,新園鄉,10785,39677,20615,19062
2007/6/1,屏東縣,崁頂鄉,3912,16859,8705,8154
2007/6/1,屏東縣,林邊鄉,6144,21348,11105,10243
2007/6/1,屏東縣,南州鄉,3566,12173,6267,5906
2007/6/1,屏東縣,佳冬鄉,6575,21864,11459,10405
2007/6/1,屏東縣,琉球鄉,3695,12683,7033,5650
2007/6/1,屏東縣,車城鄉,3388,10186,5521,4665
2007/6/1,屏東縣,滿州鄉,2955,8682,4764,3918
2007/6/1,屏東縣,枋山鄉,2091,6266,3390,2876
2007/6/1,屏東縣,三地門鄉,2013,7259,3735,3524
2007/6/1,屏東縣,霧臺鄉,808,2755,1481,1274
2007/6/1,屏東縣,瑪家鄉,1796,6529,3419,3110
2007/6/1,屏東縣,泰武鄉,1075,4915,2626,2289
2007/6/1,屏東縣,來義鄉,2060,7801,4030,3771
2007/6/1,屏東縣,春日鄉,1261,5035,2646,2389
2007/6/1,屏東縣,獅子鄉,1409,4988,2654,2334
2007/6/1,屏東縣,牡丹鄉,1757,4913,2541,2372
2007/6/1,臺東縣,臺東市,36748,110421,56467,53954
2007/6/1,臺東縣,成功鎮,5295,16522,8879,7643
2007/6/1,臺東縣,關山鎮,3163,10029,5309,4720
2007/6/1,臺東縣,卑南鄉,6414,18603,10257,8346
2007/6/1,臺東縣,大武鄉,2461,7213,3799,3414
2007/6/1,臺東縣,太麻里鄉,4456,12277,6618,5659
2007/6/1,臺東縣,東河鄉,3425,9832,5464,4368
2007/6/1,臺東縣,長濱鄉,2821,8911,5053,3858
2007/6/1,臺東縣,鹿野鄉,3088,9019,4902,4117
2007/6/1,臺東縣,池上鄉,3186,9543,5125,4418
2007/6/1,臺東縣,綠島鄉,872,3071,1625,1446
2007/6/1,臺東縣,延平鄉,1052,3632,2044,1588
2007/6/1,臺東縣,海端鄉,1073,4594,2507,2087
2007/6/1,臺東縣,達仁鄉,1390,3766,2077,1689
2007/6/1,臺東縣,金峰鄉,978,3322,1767,1555
2007/6/1,臺東縣,蘭嶼鄉,1173,3917,2068,1849
2007/6/1,花蓮縣,花蓮市,38732,109641,54348,55293
2007/6/1,花蓮縣,鳳林鎮,4367,12558,6676,5882
2007/6/1,花蓮縣,玉里鎮,8746,28398,15542,12856
2007/6/1,花蓮縣,新城鄉,7138,20657,10783,9874
2007/6/1,花蓮縣,吉安鄉,27159,78868,40754,38114
2007/6/1,花蓮縣,壽豐鄉,6631,19412,10600,8812
2007/6/1,花蓮縣,光復鄉,4966,14812,7950,6862
2007/6/1,花蓮縣,豐濱鄉,1819,5417,3022,2395
2007/6/1,花蓮縣,瑞穗鄉,4492,13464,7308,6156
2007/6/1,花蓮縣,富里鄉,3870,12166,6731,5435
2007/6/1,花蓮縣,秀林鄉,4420,14972,7866,7106
2007/6/1,花蓮縣,萬榮鄉,2134,7144,3840,3304
2007/6/1,花蓮縣,卓溪鄉,1598,6578,3660,2918
2007/6/1,澎湖縣,馬公市,17653,54349,27738,26611
2007/6/1,澎湖縣,湖西鄉,4240,12823,6725,6098
2007/6/1,澎湖縣,白沙鄉,2920,9141,4854,4287
2007/6/1,澎湖縣,西嶼鄉,2647,8167,4246,3921
2007/6/1,澎湖縣,望安鄉,1694,4446,2378,2068
2007/6/1,澎湖縣,七美鄉,1077,3151,1687,1464
2007/6/1,基隆市,中正區,21574,57776,29769,28007
2007/6/1,基隆市,七堵區,18952,55090,28122,26968
2007/6/1,基隆市,暖暖區,13986,38496,19722,18774
2007/6/1,基隆市,仁愛區,18683,50349,25186,25163
2007/6/1,基隆市,中山區,18623,52613,27042,25571
2007/6/1,基隆市,安樂區,30573,85117,42534,42583
2007/6/1,基隆市,信義區,19180,50858,25618,25240
2007/6/1,新竹市,東區,62717,189478,94136,95342
2007/6/1,新竹市,北區,45812,137922,69021,68901
2007/6/1,新竹市,香山區,20664,69583,35752,33831
2007/6/1,臺中市,中區,8406,23901,11840,12061
2007/6/1,臺中市,東區,24666,73488,37419,36069
2007/6/1,臺中市,西區,40943,116405,56310,60095
2007/6/1,臺中市,南區,38749,109475,53572,55903
2007/6/1,臺中市,北區,53061,147146,71809,75337
2007/6/1,臺中市,西屯區,66147,196748,96249,100499
2007/6/1,臺中市,南屯區,48131,144833,70166,74667
2007/6/1,臺中市,北屯區,77481,238164,116443,121721
2007/6/1,嘉義市,東區,43116,128777,63220,65557
2007/6/1,嘉義市,西區,47112,143941,71841,72100
2007/6/1,臺南市,東區,67798,193477,94227,99250
2007/6/1,臺南市,南區,41642,127849,64504,63345
2007/6/1,臺南市,北區,44769,127981,63783,64198
2007/6/1,臺南市,安南區,50409,173155,88597,84558
2007/6/1,臺南市,安平區,20836,58458,28154,30304
2007/6/1,臺南市,中西區,29543,81566,40264,41302
2007/6/1,臺北市,松山區,75764,210292,100130,110162
2007/6/1,臺北市,信義區,84473,229829,112089,117740
2007/6/1,臺北市,大安區,113550,314291,149290,165001
2007/6/1,臺北市,中山區,86702,218277,104077,114200
2007/6/1,臺北市,中正區,59657,159380,77469,81911
2007/6/1,臺北市,大同區,45374,126392,62827,63565
2007/6/1,臺北市,萬華區,72058,192980,97388,95592
2007/6/1,臺北市,文山區,93057,261339,127618,133721
2007/6/1,臺北市,南港區,39163,113101,56300,56801
2007/6/1,臺北市,內湖區,90220,265215,128836,136379
2007/6/1,臺北市,士林區,96658,287336,140612,146724
2007/6/1,臺北市,北投區,85315,249558,122069,127489
2007/6/1,高雄市,鹽埕區,11202,28803,14666,14137
2007/6/1,高雄市,鼓山區,45249,120351,59981,60370
2007/6/1,高雄市,左營區,69083,184778,92033,92745
2007/6/1,高雄市,楠梓區,57853,167287,83630,83657
2007/6/1,高雄市,三民區,127147,360722,178020,182702
2007/6/1,高雄市,新興區,22701,57692,28305,29387
2007/6/1,高雄市,前金區,12249,30086,14835,15251
2007/6/1,高雄市,苓雅區,69704,189056,92758,96298
2007/6/1,高雄市,前鎮區,72302,200429,100754,99675
2007/6/1,高雄市,旗津區,10635,30050,15790,14260
2007/6/1,高雄市,小港區,57747,150358,76454,73904
2007/6/1,金門縣,金城鎮,9824,27148,14347,12801
2007/6/1,金門縣,金湖鎮,6392,17646,9406,8240
2007/6/1,金門縣,金沙鎮,4889,12728,6718,6010
2007/6/1,金門縣,金寧鄉,5401,14163,7653,6510
2007/6/1,金門縣,烈嶼鄉,2274,6892,3644,3248
2007/6/1,金門縣,烏坵鄉,133,446,229,217
2007/6/1,連江縣,南竿鄉,1057,5842,3385,2457
2007/6/1,連江縣,北竿鄉,369,1819,1073,746
2007/6/1,連江縣,莒光鄉,235,1172,691,481
2007/6/1,連江縣,東引鄉,246,981,577,404
2007/7/1,總計,臺灣地區,7426135,22821995,11546255,11275740
2007/7/1,總計,臺灣省,5926677,18676345,9511941,9164404
2007/7/1,總計,新北市,1295618,3782184,1892653,1889531
2007/7/1,總計,宜蘭縣,145857,460211,236091,224120
2007/7/1,總計,桃園市,613118,1923945,976834,947111
2007/7/1,總計,新竹縣,145637,492309,254901,237408
2007/7/1,總計,苗栗縣,161921,559850,292572,267278
2007/7/1,總計,臺中市,439847,1546890,787772,759118
2007/7/1,總計,彰化縣,346399,1314018,677722,636296
2007/7/1,總計,南投縣,163334,533899,276676,257223
2007/7/1,總計,雲林縣,217483,726577,381714,344863
2007/7/1,總計,嘉義縣,167937,551880,289674,262206
2007/7/1,總計,臺南市,351193,1105247,567254,537993
2007/7/1,總計,高雄市,413140,1244060,641166,602894
2007/7/1,總計,屏東縣,265823,890573,460781,429792
2007/7/1,總計,臺東縣,77641,234455,123800,110655
2007/7/1,總計,花蓮縣,116230,343934,178950,164984
2007/7/1,總計,澎湖縣,30245,92142,47646,44496
2007/7/1,總計,基隆市,141776,390229,197942,192287
2007/7/1,總計,新竹市,129286,396982,198841,198141
2007/7/1,總計,臺中市,358273,1051090,514160,536930
2007/7/1,總計,嘉義市,90406,272811,135047,137764
2007/7/1,總計,臺南市,255513,763059,379745,383314
2007/7/1,總計,臺北市,943079,2628330,1278496,1349834
2007/7/1,總計,高雄市,556379,1517320,755818,761502
2007/7/1,總計,福建省,30891,89297,47977,41320
2007/7/1,總計,金門縣,28980,79445,42227,37218
2007/7/1,總計,連江縣,1911,9852,5750,4102
2007/7/1,新北市,板橋區,180610,545873,272438,273435
2007/7/1,新北市,三重區,129732,383324,192467,190857
2007/7/1,新北市,永和區,87287,236272,114117,122155
2007/7/1,新北市,中和區,145499,409838,204051,205787
2007/7/1,新北市,新莊區,128286,395068,196494,198574
2007/7/1,新北市,新店區,109682,289749,143279,146470
2007/7/1,新北市,土城區,77786,237055,118988,118067
2007/7/1,新北市,蘆洲區,60615,190977,95056,95921
2007/7/1,新北市,汐止區,73155,179725,90002,89723
2007/7/1,新北市,樹林區,51397,163324,82853,80471
2007/7/1,新北市,鶯歌區,25332,85351,43528,41823
2007/7/1,新北市,三峽區,29776,93807,48411,45396
2007/7/1,新北市,淡水區,48896,131107,64594,66513
2007/7/1,新北市,瑞芳區,15411,43553,22379,21174
2007/7/1,新北市,五股區,25218,76720,39102,37618
2007/7/1,新北市,泰山區,24316,73939,37488,36451
2007/7/1,新北市,林口區,21177,64838,32448,32390
2007/7/1,新北市,深坑區,8020,22002,11244,10758
2007/7/1,新北市,石碇區,3137,7918,4407,3511
2007/7/1,新北市,坪林區,2328,6609,3717,2892
2007/7/1,新北市,三芝區,8431,23530,12261,11269
2007/7/1,新北市,石門區,3617,11717,6223,5494
2007/7/1,新北市,八里區,10985,32508,16684,15824
2007/7/1,新北市,平溪區,2336,5682,3179,2503
2007/7/1,新北市,雙溪區,3773,9967,5395,4572
2007/7/1,新北市,貢寮區,4286,13838,7218,6620
2007/7/1,新北市,金山區,6374,22147,11300,10847
2007/7/1,新北市,萬里區,6496,20428,10581,9847
2007/7/1,新北市,烏來區,1660,5318,2749,2569
2007/7/1,宜蘭縣,宜蘭市,31701,95876,47560,48316
2007/7/1,宜蘭縣,羅東鎮,24007,74281,35770,38511
2007/7/1,宜蘭縣,蘇澳鎮,12996,42961,22340,20621
2007/7/1,宜蘭縣,頭城鎮,9145,31716,16473,15243
2007/7/1,宜蘭縣,礁溪鄉,11614,35922,18901,17021
2007/7/1,宜蘭縣,壯圍鄉,7720,25263,13356,11907
2007/7/1,宜蘭縣,員山鄉,10152,32423,17490,14933
2007/7/1,宜蘭縣,冬山鄉,16153,51224,26591,24633
2007/7/1,宜蘭縣,五結鄉,12008,37679,19756,17923
2007/7/1,宜蘭縣,三星鄉,6902,21219,11527,9692
2007/7/1,宜蘭縣,大同鄉,1757,5793,3216,2577
2007/7/1,宜蘭縣,南澳鄉,1702,5854,3111,2743
2007/7/1,桃園市,桃園區,131720,388952,191390,197562
2007/7/1,桃園市,中壢區,115627,356983,179618,177365
2007/7/1,桃園市,平鎮區,61014,201795,102260,99535
2007/7/1,桃園市,八德區,52712,171737,88346,83391
2007/7/1,桃園市,大溪區,27245,89958,46642,43316
2007/7/1,桃園市,楊梅區,43472,141853,72696,69157
2007/7/1,桃園市,蘆竹區,42343,130362,65855,64507
2007/7/1,桃園市,大園區,23524,79271,41408,37863
2007/7/1,桃園市,龜山區,45481,130739,66973,63766
2007/7/1,桃園市,龍潭區,34348,112348,57445,54903
2007/7/1,桃園市,新屋區,14276,49933,26702,23231
2007/7/1,桃園市,觀音區,17770,59367,31521,27846
2007/7/1,桃園市,復興區,3586,10647,5978,4669
2007/7/1,新竹縣,竹北市,38634,123511,62260,61251
2007/7/1,新竹縣,關西鎮,8819,32700,17492,15208
2007/7/1,新竹縣,新埔鎮,9798,36100,19162,16938
2007/7/1,新竹縣,竹東鎮,28538,96326,48718,47608
2007/7/1,新竹縣,湖口鄉,21842,73930,38019,35911
2007/7/1,新竹縣,橫山鄉,4163,14675,8036,6639
2007/7/1,新竹縣,新豐鄉,14420,51398,26696,24702
2007/7/1,新竹縣,芎林鄉,5899,20761,10932,9829
2007/7/1,新竹縣,寶山鄉,4398,13762,7458,6304
2007/7/1,新竹縣,北埔鄉,2949,10403,5657,4746
2007/7/1,新竹縣,峨眉鄉,1978,6149,3428,2721
2007/7/1,新竹縣,尖石鄉,2537,8144,4503,3641
2007/7/1,新竹縣,五峰鄉,1662,4450,2540,1910
2007/7/1,苗栗縣,苗栗市,27689,91042,46215,44827
2007/7/1,苗栗縣,苑裡鎮,13168,49000,25674,23326
2007/7/1,苗栗縣,通霄鎮,10884,39360,21060,18300
2007/7/1,苗栗縣,竹南鎮,21492,74876,38271,36605
2007/7/1,苗栗縣,頭份市,26883,94205,48312,45893
2007/7/1,苗栗縣,後龍鎮,11334,40526,21521,19005
2007/7/1,苗栗縣,卓蘭鎮,5705,18587,9893,8694
2007/7/1,苗栗縣,大湖鄉,5057,16293,8796,7497
2007/7/1,苗栗縣,公館鄉,9501,34647,18227,16420
2007/7/1,苗栗縣,銅鑼鄉,5817,19882,10606,9276
2007/7/1,苗栗縣,南庄鄉,3808,11549,6437,5112
2007/7/1,苗栗縣,頭屋鄉,3427,11925,6285,5640
2007/7/1,苗栗縣,三義鄉,5062,17722,9388,8334
2007/7/1,苗栗縣,西湖鄉,2553,8009,4447,3562
2007/7/1,苗栗縣,造橋鄉,3860,13899,7347,6552
2007/7/1,苗栗縣,三灣鄉,2277,7513,4092,3421
2007/7/1,苗栗縣,獅潭鄉,1602,5154,2886,2268
2007/7/1,苗栗縣,泰安鄉,1802,5661,3115,2546
2007/7/1,臺中市,豐原區,46753,164378,82128,82250
2007/7/1,臺中市,大里區,57550,191613,95566,96047
2007/7/1,臺中市,太平區,51905,171225,86314,84911
2007/7/1,臺中市,東勢區,16464,54996,28692,26304
2007/7/1,臺中市,大甲區,20691,79367,40312,39055
2007/7/1,臺中市,清水區,23714,85780,44432,41348
2007/7/1,臺中市,沙鹿區,21142,78078,39925,38153
2007/7/1,臺中市,梧棲區,15159,54010,27520,26490
2007/7/1,臺中市,后里區,14157,54595,28349,26246
2007/7/1,臺中市,神岡區,16810,64136,33128,31008
2007/7/1,臺中市,潭子區,29925,96825,48639,48186
2007/7/1,臺中市,大雅區,24743,87511,44417,43094
2007/7/1,臺中市,新社區,7086,25831,13663,12168
2007/7/1,臺中市,石岡區,4635,16180,8407,7773
2007/7/1,臺中市,外埔區,8260,31814,16443,15371
2007/7/1,臺中市,大安區,5092,20702,10956,9746
2007/7/1,臺中市,烏日區,18887,67214,34297,32917
2007/7/1,臺中市,大肚區,15135,55843,28764,27079
2007/7/1,臺中市,龍井區,19241,71391,36584,34807
2007/7/1,臺中市,霧峰區,18022,64517,33240,31277
2007/7/1,臺中市,和平區,4476,10884,5996,4888
2007/7/1,彰化縣,彰化市,68207,235669,118193,117476
2007/7/1,彰化縣,鹿港鎮,21096,85196,43762,41434
2007/7/1,彰化縣,和美鎮,22696,88981,45779,43202
2007/7/1,彰化縣,北斗鎮,9411,33520,17031,16489
2007/7/1,彰化縣,員林市,34964,126153,63776,62377
2007/7/1,彰化縣,溪湖鎮,14360,56569,29067,27502
2007/7/1,彰化縣,田中鎮,12090,45164,23766,21398
2007/7/1,彰化縣,二林鎮,13751,55151,28529,26622
2007/7/1,彰化縣,線西鄉,3909,17000,8786,8214
2007/7/1,彰化縣,伸港鄉,8399,35606,18373,17233
2007/7/1,彰化縣,福興鄉,11397,48815,25647,23168
2007/7/1,彰化縣,秀水鄉,9126,38784,20111,18673
2007/7/1,彰化縣,花壇鄉,12158,46204,23920,22284
2007/7/1,彰化縣,芬園鄉,6734,25366,13486,11880
2007/7/1,彰化縣,大村鄉,9701,36409,19064,17345
2007/7/1,彰化縣,埔鹽鄉,8458,34754,18306,16448
2007/7/1,彰化縣,埔心鄉,9441,35505,18453,17052
2007/7/1,彰化縣,永靖鄉,9947,39819,20755,19064
2007/7/1,彰化縣,社頭鄉,11834,45486,23483,22003
2007/7/1,彰化縣,二水鄉,5166,17141,9079,8062
2007/7/1,彰化縣,田尾鄉,7433,29243,15251,13992
2007/7/1,彰化縣,埤頭鄉,8163,32084,16851,15233
2007/7/1,彰化縣,芳苑鄉,9790,37116,19729,17387
2007/7/1,彰化縣,大城鄉,5278,19337,10584,8753
2007/7/1,彰化縣,竹塘鄉,4456,16726,8867,7859
2007/7/1,彰化縣,溪州鄉,8434,32220,17074,15146
2007/7/1,南投縣,南投市,31938,105786,53494,52292
2007/7/1,南投縣,埔里鎮,27329,86473,43923,42550
2007/7/1,南投縣,草屯鎮,29275,99727,50677,49050
2007/7/1,南投縣,竹山鎮,17894,59325,30815,28510
2007/7/1,南投縣,集集鎮,4082,12170,6396,5774
2007/7/1,南投縣,名間鄉,11639,41610,22026,19584
2007/7/1,南投縣,鹿谷鄉,6228,19599,10470,9129
2007/7/1,南投縣,中寮鄉,5403,16639,9100,7539
2007/7/1,南投縣,魚池鄉,5585,17314,9256,8058
2007/7/1,南投縣,國姓鄉,6989,21568,11847,9721
2007/7/1,南投縣,水里鄉,7131,21035,11089,9946
2007/7/1,南投縣,信義鄉,5002,17215,9394,7821
2007/7/1,南投縣,仁愛鄉,4839,15438,8189,7249
2007/7/1,雲林縣,斗六市,32250,105299,53297,52002
2007/7/1,雲林縣,斗南鎮,14576,47782,24443,23339
2007/7/1,雲林縣,虎尾鎮,20898,69229,35456,33773
2007/7/1,雲林縣,西螺鎮,13520,49356,25124,24232
2007/7/1,雲林縣,土庫鎮,8342,31230,16410,14820
2007/7/1,雲林縣,北港鎮,14733,44565,23258,21307
2007/7/1,雲林縣,古坑鄉,10248,35019,18585,16434
2007/7/1,雲林縣,大埤鄉,6370,21947,11689,10258
2007/7/1,雲林縣,莿桐鄉,8615,30918,16233,14685
2007/7/1,雲林縣,林內鄉,5526,20666,10863,9803
2007/7/1,雲林縣,二崙鄉,8528,30663,16509,14154
2007/7/1,雲林縣,崙背鄉,7974,28175,14968,13207
2007/7/1,雲林縣,麥寮鄉,11139,33176,17771,15405
2007/7/1,雲林縣,東勢鄉,5571,17720,9604,8116
2007/7/1,雲林縣,褒忠鄉,4123,14871,7970,6901
2007/7/1,雲林縣,臺西鄉,8424,27447,14796,12651
2007/7/1,雲林縣,元長鄉,9042,29840,16322,13518
2007/7/1,雲林縣,四湖鄉,8690,27633,15272,12361
2007/7/1,雲林縣,口湖鄉,9273,31152,16732,14420
2007/7/1,雲林縣,水林鄉,9641,29889,16412,13477
2007/7/1,嘉義縣,太保市,10270,35491,18484,17007
2007/7/1,嘉義縣,朴子市,13483,44393,22825,21568
2007/7/1,嘉義縣,布袋鎮,9851,31395,16280,15115
2007/7/1,嘉義縣,大林鎮,10851,34473,17845,16628
2007/7/1,嘉義縣,民雄鄉,21449,72703,37589,35114
2007/7/1,嘉義縣,溪口鄉,5157,16884,9023,7861
2007/7/1,嘉義縣,新港鄉,10007,35403,18707,16696
2007/7/1,嘉義縣,六腳鄉,8877,27343,14564,12779
2007/7/1,嘉義縣,東石鄉,9100,28769,15345,13424
2007/7/1,嘉義縣,義竹鄉,7214,21890,11403,10487
2007/7/1,嘉義縣,鹿草鄉,5507,17519,9402,8117
2007/7/1,嘉義縣,水上鄉,17021,53684,28027,25657
2007/7/1,嘉義縣,中埔鄉,14407,48111,25242,22869
2007/7/1,嘉義縣,竹崎鄉,11010,39528,21121,18407
2007/7/1,嘉義縣,梅山鄉,6290,22342,11879,10463
2007/7/1,嘉義縣,番路鄉,3755,11837,6472,5365
2007/7/1,嘉義縣,大埔鄉,1759,3964,2152,1812
2007/7/1,嘉義縣,阿里山鄉,1929,6151,3314,2837
2007/7/1,臺南市,新營區,25995,78935,39661,39274
2007/7/1,臺南市,永康區,69724,209736,105010,104726
2007/7/1,臺南市,鹽水區,9577,27949,14578,13371
2007/7/1,臺南市,白河區,10671,32451,17199,15252
2007/7/1,臺南市,麻豆區,14193,46452,23888,22564
2007/7/1,臺南市,佳里區,18209,59238,29592,29646
2007/7/1,臺南市,新化區,13038,44610,22938,21672
2007/7/1,臺南市,善化區,13424,42425,21667,20758
2007/7/1,臺南市,學甲區,9143,28691,14779,13912
2007/7/1,臺南市,柳營區,7523,23263,12189,11074
2007/7/1,臺南市,後壁區,8360,26609,13896,12713
2007/7/1,臺南市,東山區,7994,23845,12787,11058
2007/7/1,臺南市,下營區,8828,26862,13932,12930
2007/7/1,臺南市,六甲區,7385,24484,12773,11711
2007/7/1,臺南市,官田區,7438,22692,11745,10947
2007/7/1,臺南市,大內區,4000,11394,6105,5289
2007/7/1,臺南市,西港區,7498,25626,13115,12511
2007/7/1,臺南市,七股區,7722,25216,13256,11960
2007/7/1,臺南市,將軍區,7231,22153,11348,10805
2007/7/1,臺南市,北門區,4156,12663,6524,6139
2007/7/1,臺南市,新市區,10351,35613,17944,17669
2007/7/1,臺南市,安定區,8652,29964,15600,14364
2007/7/1,臺南市,山上區,2673,8071,4277,3794
2007/7/1,臺南市,玉井區,4967,15878,8285,7593
2007/7/1,臺南市,楠西區,3574,11082,5907,5175
2007/7/1,臺南市,南化區,2809,8994,4942,4052
2007/7/1,臺南市,左鎮區,1921,5633,3117,2516
2007/7/1,臺南市,仁德區,22859,67749,35035,32714
2007/7/1,臺南市,歸仁區,19295,65398,33417,31981
2007/7/1,臺南市,關廟區,10438,37170,19346,17824
2007/7/1,臺南市,龍崎區,1545,4401,2402,1999
2007/7/1,高雄市,鳳山區,120835,338779,170020,168759
2007/7/1,高雄市,岡山區,31746,95917,48592,47325
2007/7/1,高雄市,旗山區,13500,41222,21618,19604
2007/7/1,高雄市,美濃區,13495,44241,23236,21005
2007/7/1,高雄市,林園區,23301,71460,36953,34507
2007/7/1,高雄市,大寮區,36257,109206,57156,52050
2007/7/1,高雄市,大樹區,12829,44881,23404,21477
2007/7/1,高雄市,仁武區,22935,67195,34809,32386
2007/7/1,高雄市,大社區,11132,32676,16840,15836
2007/7/1,高雄市,鳥松區,15506,41188,21079,20109
2007/7/1,高雄市,橋頭區,12232,36785,18985,17800
2007/7/1,高雄市,燕巢區,9558,31285,16770,14515
2007/7/1,高雄市,田寮區,3594,8601,4819,3782
2007/7/1,高雄市,阿蓮區,8829,30921,15652,15269
2007/7/1,高雄市,路竹區,15326,54502,27916,26586
2007/7/1,高雄市,湖內區,8990,28637,14870,13767
2007/7/1,高雄市,茄萣區,9872,32082,16842,15240
2007/7/1,高雄市,永安區,5612,14261,7328,6933
2007/7/1,高雄市,彌陀區,6372,20832,10972,9860
2007/7/1,高雄市,梓官區,11454,37319,19583,17736
2007/7/1,高雄市,六龜區,5645,15708,8563,7145
2007/7/1,高雄市,甲仙區,2571,8273,4468,3805
2007/7/1,高雄市,杉林區,3985,11440,6300,5140
2007/7/1,高雄市,內門區,4969,16605,9075,7530
2007/7/1,高雄市,茂林區,518,1772,901,871
2007/7/1,高雄市,桃源區,1205,4790,2578,2212
2007/7/1,屏東縣,屏東市,70476,216236,108477,107759
2007/7/1,屏東縣,潮州鎮,17483,57014,28848,28166
2007/7/1,屏東縣,東港鎮,14511,50530,25820,24710
2007/7/1,屏東縣,恆春鎮,10231,31286,16269,15017
2007/7/1,屏東縣,萬丹鄉,13644,54484,28310,26174
2007/7/1,屏東縣,長治鄉,9390,30930,16298,14632
2007/7/1,屏東縣,麟洛鄉,3446,11721,6082,5639
2007/7/1,屏東縣,九如鄉,6371,23284,12125,11159
2007/7/1,屏東縣,里港鄉,7742,26544,13668,12876
2007/7/1,屏東縣,鹽埔鄉,7420,27771,14526,13245
2007/7/1,屏東縣,高樹鄉,9482,27577,14812,12765
2007/7/1,屏東縣,萬巒鄉,6269,22767,12051,10716
2007/7/1,屏東縣,內埔鄉,17118,59554,31191,28363
2007/7/1,屏東縣,竹田鄉,5375,18591,9951,8640
2007/7/1,屏東縣,新埤鄉,3287,11094,5903,5191
2007/7/1,屏東縣,枋寮鄉,8240,27434,14576,12858
2007/7/1,屏東縣,新園鄉,10780,39641,20574,19067
2007/7/1,屏東縣,崁頂鄉,3915,16903,8750,8153
2007/7/1,屏東縣,林邊鄉,6152,21311,11087,10224
2007/7/1,屏東縣,南州鄉,3567,12162,6251,5911
2007/7/1,屏東縣,佳冬鄉,6582,21835,11429,10406
2007/7/1,屏東縣,琉球鄉,3695,12658,7020,5638
2007/7/1,屏東縣,車城鄉,3394,10182,5524,4658
2007/7/1,屏東縣,滿州鄉,2960,8669,4759,3910
2007/7/1,屏東縣,枋山鄉,2096,6261,3385,2876
2007/7/1,屏東縣,三地門鄉,2017,7255,3731,3524
2007/7/1,屏東縣,霧臺鄉,809,2740,1472,1268
2007/7/1,屏東縣,瑪家鄉,1799,6527,3418,3109
2007/7/1,屏東縣,泰武鄉,1077,4911,2620,2291
2007/7/1,屏東縣,來義鄉,2064,7794,4026,3768
2007/7/1,屏東縣,春日鄉,1263,5033,2645,2388
2007/7/1,屏東縣,獅子鄉,1412,4974,2648,2326
2007/7/1,屏東縣,牡丹鄉,1756,4900,2535,2365
2007/7/1,臺東縣,臺東市,36788,110393,56449,53944
2007/7/1,臺東縣,成功鎮,5298,16493,8860,7633
2007/7/1,臺東縣,關山鎮,3161,10037,5308,4729
2007/7/1,臺東縣,卑南鄉,6417,18556,10222,8334
2007/7/1,臺東縣,大武鄉,2460,7174,3775,3399
2007/7/1,臺東縣,太麻里鄉,4461,12269,6608,5661
2007/7/1,臺東縣,東河鄉,3434,9805,5452,4353
2007/7/1,臺東縣,長濱鄉,2824,8909,5056,3853
2007/7/1,臺東縣,鹿野鄉,3079,8997,4873,4124
2007/7/1,臺東縣,池上鄉,3177,9531,5114,4417
2007/7/1,臺東縣,綠島鄉,878,3080,1630,1450
2007/7/1,臺東縣,延平鄉,1050,3630,2041,1589
2007/7/1,臺東縣,海端鄉,1071,4589,2506,2083
2007/7/1,臺東縣,達仁鄉,1388,3760,2071,1689
2007/7/1,臺東縣,金峰鄉,980,3325,1764,1561
2007/7/1,臺東縣,蘭嶼鄉,1175,3907,2071,1836
2007/7/1,花蓮縣,花蓮市,38797,109655,54350,55305
2007/7/1,花蓮縣,鳳林鎮,4376,12573,6676,5897
2007/7/1,花蓮縣,玉里鎮,8747,28352,15501,12851
2007/7/1,花蓮縣,新城鄉,7133,20629,10771,9858
2007/7/1,花蓮縣,吉安鄉,27199,78865,40722,38143
2007/7/1,花蓮縣,壽豐鄉,6642,19399,10590,8809
2007/7/1,花蓮縣,光復鄉,4968,14792,7945,6847
2007/7/1,花蓮縣,豐濱鄉,1818,5398,3016,2382
2007/7/1,花蓮縣,瑞穗鄉,4500,13435,7291,6144
2007/7/1,花蓮縣,富里鄉,3873,12145,6731,5414
2007/7/1,花蓮縣,秀林鄉,4437,14963,7854,7109
2007/7/1,花蓮縣,萬榮鄉,2139,7155,3845,3310
2007/7/1,花蓮縣,卓溪鄉,1601,6573,3658,2915
2007/7/1,澎湖縣,馬公市,17665,54423,27772,26651
2007/7/1,澎湖縣,湖西鄉,4238,12817,6717,6100
2007/7/1,澎湖縣,白沙鄉,2916,9141,4853,4288
2007/7/1,澎湖縣,西嶼鄉,2650,8173,4243,3930
2007/7/1,澎湖縣,望安鄉,1699,4435,2377,2058
2007/7/1,澎湖縣,七美鄉,1077,3153,1684,1469
2007/7/1,基隆市,中正區,21600,57781,29794,27987
2007/7/1,基隆市,七堵區,18990,55113,28107,27006
2007/7/1,基隆市,暖暖區,13987,38463,19703,18760
2007/7/1,基隆市,仁愛區,18745,50379,25181,25198
2007/7/1,基隆市,中山區,18628,52486,26969,25517
2007/7/1,基隆市,安樂區,30638,85195,42582,42613
2007/7/1,基隆市,信義區,19188,50812,25606,25206
2007/7/1,新竹市,東區,62696,189378,94052,95326
2007/7/1,新竹市,北區,45905,138043,69070,68973
2007/7/1,新竹市,香山區,20685,69561,35719,33842
2007/7/1,臺中市,中區,8413,23920,11852,12068
2007/7/1,臺中市,東區,24696,73566,37449,36117
2007/7/1,臺中市,西區,40963,116374,56262,60112
2007/7/1,臺中市,南區,38849,109625,53601,56024
2007/7/1,臺中市,北區,53082,147095,71774,75321
2007/7/1,臺中市,西屯區,66354,197061,96397,100664
2007/7/1,臺中市,南屯區,48243,145037,70252,74785
2007/7/1,臺中市,北屯區,77673,238412,116573,121839
2007/7/1,嘉義市,東區,43181,128685,63129,65556
2007/7/1,嘉義市,西區,47225,144126,71918,72208
2007/7/1,臺南市,東區,67979,193675,94283,99392
2007/7/1,臺南市,南區,41686,127867,64512,63355
2007/7/1,臺南市,北區,44859,128042,63778,64264
2007/7/1,臺南市,安南區,50523,173354,88694,84660
2007/7/1,臺南市,安平區,20938,58658,28238,30420
2007/7/1,臺南市,中西區,29528,81463,40240,41223
2007/7/1,臺北市,松山區,75851,210369,100110,110259
2007/7/1,臺北市,信義區,84499,229649,111945,117704
2007/7/1,臺北市,大安區,113695,314415,149274,165141
2007/7/1,臺北市,中山區,86794,218229,103980,114249
2007/7/1,臺北市,中正區,59795,159605,77569,82036
2007/7/1,臺北市,大同區,45414,126399,62813,63586
2007/7/1,臺北市,萬華區,72090,192879,97340,95539
2007/7/1,臺北市,文山區,93117,261190,127529,133661
2007/7/1,臺北市,南港區,39270,113215,56366,56849
2007/7/1,臺北市,內湖區,90384,265446,128961,136485
2007/7/1,臺北市,士林區,96713,287164,140486,146678
2007/7/1,臺北市,北投區,85457,249770,122123,127647
2007/7/1,高雄市,鹽埕區,11227,28830,14664,14166
2007/7/1,高雄市,鼓山區,45546,120789,60164,60625
2007/7/1,高雄市,左營區,69202,184890,92038,92852
2007/7/1,高雄市,楠梓區,58032,167499,83759,83740
2007/7/1,高雄市,三民區,127325,360760,178024,182736
2007/7/1,高雄市,新興區,22718,57610,28290,29320
2007/7/1,高雄市,前金區,12266,30079,14842,15237
2007/7/1,高雄市,苓雅區,69790,188894,92667,96227
2007/7/1,高雄市,前鎮區,72448,200451,100745,99706
2007/7/1,高雄市,旗津區,10623,30022,15763,14259
2007/7/1,高雄市,小港區,58074,150978,76699,74279
2007/7/1,金門縣,金城鎮,9828,27281,14417,12864
2007/7/1,金門縣,金湖鎮,6426,17765,9471,8294
2007/7/1,金門縣,金沙鎮,4901,12784,6740,6044
2007/7/1,金門縣,金寧鄉,5415,14242,7706,6536
2007/7/1,金門縣,烈嶼鄉,2277,6927,3665,3262
2007/7/1,金門縣,烏坵鄉,133,446,228,218
2007/7/1,連江縣,南竿鄉,1062,5867,3397,2470
2007/7/1,連江縣,北竿鄉,369,1827,1080,747
2007/7/1,連江縣,莒光鄉,234,1178,695,483
2007/7/1,連江縣,東引鄉,246,980,578,402
2007/8/1,總計,臺灣地區,7441048,22830522,11548507,11282015
2007/8/1,總計,臺灣省,5938917,18685380,9515046,9170334
2007/8/1,總計,新北市,1299143,3785828,1894226,1891602
2007/8/1,總計,宜蘭縣,146110,460312,236115,224197
2007/8/1,總計,桃園市,615132,1926895,978148,948747
2007/8/1,總計,新竹縣,146271,493406,255478,237928
2007/8/1,總計,苗栗縣,162245,559888,292564,267324
2007/8/1,總計,臺中市,440666,1548034,788198,759836
2007/8/1,總計,彰化縣,346868,1313922,677619,636303
2007/8/1,總計,南投縣,163556,533782,276554,257228
2007/8/1,總計,雲林縣,217857,726314,381560,344754
2007/8/1,總計,嘉義縣,168126,551734,289496,262238
2007/8/1,總計,臺南市,351590,1105152,567110,538042
2007/8/1,總計,高雄市,413613,1244206,641148,603058
2007/8/1,總計,屏東縣,266066,890227,460515,429712
2007/8/1,總計,臺東縣,77695,234124,123568,110556
2007/8/1,總計,花蓮縣,116383,343687,178819,164868
2007/8/1,總計,澎湖縣,30313,92163,47641,44522
2007/8/1,總計,基隆市,142037,390185,197841,192344
2007/8/1,總計,新竹市,129554,397273,198958,198315
2007/8/1,總計,臺中市,359171,1052108,514571,537537
2007/8/1,總計,嘉義市,90540,272797,135043,137754
2007/8/1,總計,臺南市,255981,763343,379874,383469
2007/8/1,總計,臺北市,944519,2627253,1277562,1349691
2007/8/1,總計,高雄市,557612,1517889,755899,761990
2007/8/1,總計,福建省,30962,89728,48209,41519
2007/8/1,總計,金門縣,29041,79865,42448,37417
2007/8/1,總計,連江縣,1921,9863,5761,4102
2007/8/1,新北市,板橋區,181044,546032,272443,273589
2007/8/1,新北市,三重區,129963,383314,192432,190882
2007/8/1,新北市,永和區,87465,236235,114089,122146
2007/8/1,新北市,中和區,145789,409957,204127,205830
2007/8/1,新北市,新莊區,128496,395324,196558,198766
2007/8/1,新北市,新店區,109919,289977,143350,146627
2007/8/1,新北市,土城區,77932,237081,119017,118064
2007/8/1,新北市,蘆洲區,60813,191291,95203,96088
2007/8/1,新北市,汐止區,73354,180038,90184,89854
2007/8/1,新北市,樹林區,51585,163626,82974,80652
2007/8/1,新北市,鶯歌區,25416,85407,43538,41869
2007/8/1,新北市,三峽區,30045,94224,48619,45605
2007/8/1,新北市,淡水區,49106,131370,64721,66649
2007/8/1,新北市,瑞芳區,15432,43540,22354,21186
2007/8/1,新北市,五股區,25330,76965,39225,37740
2007/8/1,新北市,泰山區,24423,74092,37569,36523
2007/8/1,新北市,林口區,21472,65402,32736,32666
2007/8/1,新北市,深坑區,8058,22088,11294,10794
2007/8/1,新北市,石碇區,3138,7893,4397,3496
2007/8/1,新北市,坪林區,2336,6622,3721,2901
2007/8/1,新北市,三芝區,8450,23539,12264,11275
2007/8/1,新北市,石門區,3629,11749,6242,5507
2007/8/1,新北市,八里區,11021,32604,16718,15886
2007/8/1,新北市,平溪區,2340,5663,3169,2494
2007/8/1,新北市,雙溪區,3768,9969,5390,4579
2007/8/1,新北市,貢寮區,4283,13873,7235,6638
2007/8/1,新北市,金山區,6370,22132,11293,10839
2007/8/1,新北市,萬里區,6507,20490,10609,9881
2007/8/1,新北市,烏來區,1659,5331,2755,2576
2007/8/1,宜蘭縣,宜蘭市,31791,95901,47557,48344
2007/8/1,宜蘭縣,羅東鎮,24019,74228,35755,38473
2007/8/1,宜蘭縣,蘇澳鎮,13002,42974,22336,20638
2007/8/1,宜蘭縣,頭城鎮,9154,31692,16469,15223
2007/8/1,宜蘭縣,礁溪鄉,11633,35935,18895,17040
2007/8/1,宜蘭縣,壯圍鄉,7729,25270,13368,11902
2007/8/1,宜蘭縣,員山鄉,10157,32418,17471,14947
2007/8/1,宜蘭縣,冬山鄉,16193,51294,26615,24679
2007/8/1,宜蘭縣,五結鄉,12057,37771,19802,17969
2007/8/1,宜蘭縣,三星鄉,6911,21197,11527,9670
2007/8/1,宜蘭縣,大同鄉,1755,5792,3215,2577
2007/8/1,宜蘭縣,南澳鄉,1709,5840,3105,2735
2007/8/1,桃園市,桃園區,132268,389790,191824,197966
2007/8/1,桃園市,中壢區,115906,357363,179739,177624
2007/8/1,桃園市,平鎮區,61166,201958,102299,99659
2007/8/1,桃園市,八德區,52886,171941,88411,83530
2007/8/1,桃園市,大溪區,27329,90007,46675,43332
2007/8/1,桃園市,楊梅區,43684,142181,72836,69345
2007/8/1,桃園市,蘆竹區,42537,130655,66013,64642
2007/8/1,桃園市,大園區,23592,79428,41472,37956
2007/8/1,桃園市,龜山區,45613,130996,67083,63913
2007/8/1,桃園市,龍潭區,34438,112544,57572,54972
2007/8/1,桃園市,新屋區,14308,49951,26700,23251
2007/8/1,桃園市,觀音區,17831,59457,31554,27903
2007/8/1,桃園市,復興區,3574,10624,5970,4654
2007/8/1,新竹縣,竹北市,38972,124283,62678,61605
2007/8/1,新竹縣,關西鎮,8830,32694,17498,15196
2007/8/1,新竹縣,新埔鎮,9814,36121,19165,16956
2007/8/1,新竹縣,竹東鎮,28617,96365,48727,47638
2007/8/1,新竹縣,湖口鄉,21922,74034,38079,35955
2007/8/1,新竹縣,橫山鄉,4171,14650,8026,6624
2007/8/1,新竹縣,新豐鄉,14477,51527,26761,24766
2007/8/1,新竹縣,芎林鄉,5919,20797,10965,9832
2007/8/1,新竹縣,寶山鄉,4409,13777,7455,6322
2007/8/1,新竹縣,北埔鄉,2952,10373,5638,4735
2007/8/1,新竹縣,峨眉鄉,1981,6157,3429,2728
2007/8/1,新竹縣,尖石鄉,2541,8159,4506,3653
2007/8/1,新竹縣,五峰鄉,1666,4469,2551,1918
2007/8/1,苗栗縣,苗栗市,27762,91100,46236,44864
2007/8/1,苗栗縣,苑裡鎮,13196,49024,25689,23335
2007/8/1,苗栗縣,通霄鎮,10879,39340,21038,18302
2007/8/1,苗栗縣,竹南鎮,21569,74959,38281,36678
2007/8/1,苗栗縣,頭份市,26968,94292,48352,45940
2007/8/1,苗栗縣,後龍鎮,11343,40500,21524,18976
2007/8/1,苗栗縣,卓蘭鎮,5712,18584,9889,8695
2007/8/1,苗栗縣,大湖鄉,5066,16271,8778,7493
2007/8/1,苗栗縣,公館鄉,9523,34648,18229,16419
2007/8/1,苗栗縣,銅鑼鄉,5817,19859,10589,9270
2007/8/1,苗栗縣,南庄鄉,3808,11494,6412,5082
2007/8/1,苗栗縣,頭屋鄉,3424,11914,6283,5631
2007/8/1,苗栗縣,三義鄉,5070,17705,9387,8318
2007/8/1,苗栗縣,西湖鄉,2554,7992,4443,3549
2007/8/1,苗栗縣,造橋鄉,3858,13874,7331,6543
2007/8/1,苗栗縣,三灣鄉,2278,7517,4096,3421
2007/8/1,苗栗縣,獅潭鄉,1609,5159,2892,2267
2007/8/1,苗栗縣,泰安鄉,1809,5656,3115,2541
2007/8/1,臺中市,豐原區,46846,164328,82065,82263
2007/8/1,臺中市,大里區,57717,191892,95671,96221
2007/8/1,臺中市,太平區,51993,171445,86398,85047
2007/8/1,臺中市,東勢區,16474,54961,28676,26285
2007/8/1,臺中市,大甲區,20713,79328,40291,39037
2007/8/1,臺中市,清水區,23758,85810,44440,41370
2007/8/1,臺中市,沙鹿區,21218,78189,39977,38212
2007/8/1,臺中市,梧棲區,15175,54091,27547,26544
2007/8/1,臺中市,后里區,14153,54578,28323,26255
2007/8/1,臺中市,神岡區,16848,64156,33138,31018
2007/8/1,臺中市,潭子區,30019,97018,48755,48263
2007/8/1,臺中市,大雅區,24799,87661,44497,43164
2007/8/1,臺中市,新社區,7091,25879,13683,12196
2007/8/1,臺中市,石岡區,4638,16199,8409,7790
2007/8/1,臺中市,外埔區,8274,31836,16450,15386
2007/8/1,臺中市,大安區,5095,20721,10960,9761
2007/8/1,臺中市,烏日區,18937,67273,34320,32953
2007/8/1,臺中市,大肚區,15162,55879,28770,27109
2007/8/1,臺中市,龍井區,19249,71443,36607,34836
2007/8/1,臺中市,霧峰區,18033,64486,33237,31249
2007/8/1,臺中市,和平區,4474,10861,5984,4877
2007/8/1,彰化縣,彰化市,68323,235702,118196,117506
2007/8/1,彰化縣,鹿港鎮,21124,85220,43766,41454
2007/8/1,彰化縣,和美鎮,22714,88972,45763,43209
2007/8/1,彰化縣,北斗鎮,9433,33541,17050,16491
2007/8/1,彰化縣,員林市,35040,126147,63754,62393
2007/8/1,彰化縣,溪湖鎮,14397,56572,29077,27495
2007/8/1,彰化縣,田中鎮,12088,45118,23747,21371
2007/8/1,彰化縣,二林鎮,13764,55131,28517,26614
2007/8/1,彰化縣,線西鄉,3919,16993,8781,8212
2007/8/1,彰化縣,伸港鄉,8416,35615,18379,17236
2007/8/1,彰化縣,福興鄉,11419,48839,25646,23193
2007/8/1,彰化縣,秀水鄉,9139,38789,20117,18672
2007/8/1,彰化縣,花壇鄉,12165,46155,23894,22261
2007/8/1,彰化縣,芬園鄉,6739,25335,13468,11867
2007/8/1,彰化縣,大村鄉,9716,36445,19085,17360
2007/8/1,彰化縣,埔鹽鄉,8462,34766,18314,16452
2007/8/1,彰化縣,埔心鄉,9459,35515,18455,17060
2007/8/1,彰化縣,永靖鄉,9952,39799,20739,19060
2007/8/1,彰化縣,社頭鄉,11851,45494,23491,22003
2007/8/1,彰化縣,二水鄉,5171,17129,9068,8061
2007/8/1,彰化縣,田尾鄉,7441,29226,15248,13978
2007/8/1,彰化縣,埤頭鄉,8163,32062,16838,15224
2007/8/1,彰化縣,芳苑鄉,9791,37104,19714,17390
2007/8/1,彰化縣,大城鄉,5280,19322,10574,8748
2007/8/1,彰化縣,竹塘鄉,4461,16721,8870,7851
2007/8/1,彰化縣,溪州鄉,8441,32210,17068,15142
2007/8/1,南投縣,南投市,31977,105775,53463,52312
2007/8/1,南投縣,埔里鎮,27361,86517,43934,42583
2007/8/1,南投縣,草屯鎮,29335,99730,50661,49069
2007/8/1,南投縣,竹山鎮,17937,59343,30806,28537
2007/8/1,南投縣,集集鎮,4079,12149,6385,5764
2007/8/1,南投縣,名間鄉,11641,41586,22011,19575
2007/8/1,南投縣,鹿谷鄉,6243,19584,10453,9131
2007/8/1,南投縣,中寮鄉,5413,16615,9088,7527
2007/8/1,南投縣,魚池鄉,5590,17317,9259,8058
2007/8/1,南投縣,國姓鄉,6994,21539,11831,9708
2007/8/1,南投縣,水里鄉,7134,21013,11087,9926
2007/8/1,南投縣,信義鄉,5007,17221,9404,7817
2007/8/1,南投縣,仁愛鄉,4845,15393,8172,7221
2007/8/1,雲林縣,斗六市,32342,105330,53324,52006
2007/8/1,雲林縣,斗南鎮,14575,47787,24432,23355
2007/8/1,雲林縣,虎尾鎮,20953,69308,35485,33823
2007/8/1,雲林縣,西螺鎮,13552,49352,25125,24227
2007/8/1,雲林縣,土庫鎮,8350,31185,16387,14798
2007/8/1,雲林縣,北港鎮,14750,44527,23243,21284
2007/8/1,雲林縣,古坑鄉,10259,35001,18574,16427
2007/8/1,雲林縣,大埤鄉,6375,21941,11688,10253
2007/8/1,雲林縣,莿桐鄉,8624,30906,16228,14678
2007/8/1,雲林縣,林內鄉,5535,20634,10843,9791
2007/8/1,雲林縣,二崙鄉,8546,30637,16495,14142
2007/8/1,雲林縣,崙背鄉,7983,28132,14949,13183
2007/8/1,雲林縣,麥寮鄉,11154,33197,17777,15420
2007/8/1,雲林縣,東勢鄉,5572,17684,9582,8102
2007/8/1,雲林縣,褒忠鄉,4121,14852,7963,6889
2007/8/1,雲林縣,臺西鄉,8460,27454,14794,12660
2007/8/1,雲林縣,元長鄉,9053,29811,16313,13498
2007/8/1,雲林縣,四湖鄉,8716,27648,15273,12375
2007/8/1,雲林縣,口湖鄉,9290,31096,16695,14401
2007/8/1,雲林縣,水林鄉,9647,29832,16390,13442
2007/8/1,嘉義縣,太保市,10317,35575,18531,17044
2007/8/1,嘉義縣,朴子市,13502,44380,22825,21555
2007/8/1,嘉義縣,布袋鎮,9852,31351,16255,15096
2007/8/1,嘉義縣,大林鎮,10841,34449,17825,16624
2007/8/1,嘉義縣,民雄鄉,21477,72716,37583,35133
2007/8/1,嘉義縣,溪口鄉,5159,16855,9006,7849
2007/8/1,嘉義縣,新港鄉,10013,35379,18701,16678
2007/8/1,嘉義縣,六腳鄉,8882,27321,14533,12788
2007/8/1,嘉義縣,東石鄉,9101,28755,15319,13436
2007/8/1,嘉義縣,義竹鄉,7231,21911,11407,10504
2007/8/1,嘉義縣,鹿草鄉,5513,17515,9402,8113
2007/8/1,嘉義縣,水上鄉,17035,53665,28003,25662
2007/8/1,嘉義縣,中埔鄉,14437,48100,25218,22882
2007/8/1,嘉義縣,竹崎鄉,11015,39494,21103,18391
2007/8/1,嘉義縣,梅山鄉,6299,22326,11859,10467
2007/8/1,嘉義縣,番路鄉,3761,11822,6463,5359
2007/8/1,嘉義縣,大埔鄉,1763,3958,2148,1810
2007/8/1,嘉義縣,阿里山鄉,1928,6162,3315,2847
2007/8/1,臺南市,新營區,26048,78958,39653,39305
2007/8/1,臺南市,永康區,69847,209930,105068,104862
2007/8/1,臺南市,鹽水區,9585,27933,14567,13366
2007/8/1,臺南市,白河區,10683,32451,17198,15253
2007/8/1,臺南市,麻豆區,14212,46421,23874,22547
2007/8/1,臺南市,佳里區,18247,59255,29606,29649
2007/8/1,臺南市,新化區,13039,44562,22905,21657
2007/8/1,臺南市,善化區,13461,42468,21691,20777
2007/8/1,臺南市,學甲區,9140,28657,14755,13902
2007/8/1,臺南市,柳營區,7522,23250,12185,11065
2007/8/1,臺南市,後壁區,8371,26596,13883,12713
2007/8/1,臺南市,東山區,7990,23811,12776,11035
2007/8/1,臺南市,下營區,8843,26851,13923,12928
2007/8/1,臺南市,六甲區,7384,24428,12744,11684
2007/8/1,臺南市,官田區,7429,22683,11743,10940
2007/8/1,臺南市,大內區,4001,11372,6096,5276
2007/8/1,臺南市,西港區,7509,25619,13109,12510
2007/8/1,臺南市,七股區,7739,25230,13252,11978
2007/8/1,臺南市,將軍區,7233,22146,11336,10810
2007/8/1,臺南市,北門區,4167,12657,6525,6132
2007/8/1,臺南市,新市區,10363,35590,17929,17661
2007/8/1,臺南市,安定區,8665,29991,15616,14375
2007/8/1,臺南市,山上區,2673,8075,4279,3796
2007/8/1,臺南市,玉井區,4973,15870,8275,7595
2007/8/1,臺南市,楠西區,3576,11056,5890,5166
2007/8/1,臺南市,南化區,2808,8992,4934,4058
2007/8/1,臺南市,左鎮區,1922,5637,3121,2516
2007/8/1,臺南市,仁德區,22827,67688,35014,32674
2007/8/1,臺南市,歸仁區,19352,65445,33436,32009
2007/8/1,臺南市,關廟區,10434,37104,19312,17792
2007/8/1,臺南市,龍崎區,1547,4426,2415,2011
2007/8/1,高雄市,鳳山區,120998,338909,170069,168840
2007/8/1,高雄市,岡山區,31798,95997,48631,47366
2007/8/1,高雄市,旗山區,13505,41171,21586,19585
2007/8/1,高雄市,美濃區,13522,44229,23237,20992
2007/8/1,高雄市,林園區,23297,71377,36886,34491
2007/8/1,高雄市,大寮區,36315,109282,57175,52107
2007/8/1,高雄市,大樹區,12838,44925,23419,21506
2007/8/1,高雄市,仁武區,23014,67347,34910,32437
2007/8/1,高雄市,大社區,11148,32663,16815,15848
2007/8/1,高雄市,鳥松區,15520,41207,21077,20130
2007/8/1,高雄市,橋頭區,12228,36743,18973,17770
2007/8/1,高雄市,燕巢區,9553,31256,16750,14506
2007/8/1,高雄市,田寮區,3595,8604,4826,3778
2007/8/1,高雄市,阿蓮區,8841,30925,15651,15274
2007/8/1,高雄市,路竹區,15349,54520,27904,26616
2007/8/1,高雄市,湖內區,9007,28687,14885,13802
2007/8/1,高雄市,茄萣區,9881,32027,16828,15199
2007/8/1,高雄市,永安區,5608,14245,7319,6926
2007/8/1,高雄市,彌陀區,6372,20820,10954,9866
2007/8/1,高雄市,梓官區,11459,37294,19573,17721
2007/8/1,高雄市,六龜區,5642,15691,8557,7134
2007/8/1,高雄市,甲仙區,2570,8256,4454,3802
2007/8/1,高雄市,杉林區,3991,11417,6287,5130
2007/8/1,高雄市,內門區,4967,16587,9069,7518
2007/8/1,高雄市,茂林區,519,1752,896,856
2007/8/1,高雄市,桃源區,1204,4791,2578,2213
2007/8/1,屏東縣,屏東市,70528,216107,108394,107713
2007/8/1,屏東縣,潮州鎮,17504,57064,28878,28186
2007/8/1,屏東縣,東港鎮,14548,50541,25819,24722
2007/8/1,屏東縣,恆春鎮,10230,31266,16258,15008
2007/8/1,屏東縣,萬丹鄉,13659,54479,28288,26191
2007/8/1,屏東縣,長治鄉,9419,30955,16309,14646
2007/8/1,屏東縣,麟洛鄉,3445,11702,6076,5626
2007/8/1,屏東縣,九如鄉,6377,23245,12108,11137
2007/8/1,屏東縣,里港鄉,7745,26520,13659,12861
2007/8/1,屏東縣,鹽埔鄉,7433,27754,14511,13243
2007/8/1,屏東縣,高樹鄉,9491,27587,14811,12776
2007/8/1,屏東縣,萬巒鄉,6273,22786,12053,10733
2007/8/1,屏東縣,內埔鄉,17150,59460,31131,28329
2007/8/1,屏東縣,竹田鄉,5363,18548,9932,8616
2007/8/1,屏東縣,新埤鄉,3288,11097,5902,5195
2007/8/1,屏東縣,枋寮鄉,8239,27451,14578,12873
2007/8/1,屏東縣,新園鄉,10788,39648,20582,19066
2007/8/1,屏東縣,崁頂鄉,3922,16930,8756,8174
2007/8/1,屏東縣,林邊鄉,6151,21339,11090,10249
2007/8/1,屏東縣,南州鄉,3571,12153,6244,5909
2007/8/1,屏東縣,佳冬鄉,6586,21818,11414,10404
2007/8/1,屏東縣,琉球鄉,3699,12666,7025,5641
2007/8/1,屏東縣,車城鄉,3391,10163,5494,4669
2007/8/1,屏東縣,滿州鄉,2971,8667,4757,3910
2007/8/1,屏東縣,枋山鄉,2097,6256,3382,2874
2007/8/1,屏東縣,三地門鄉,2017,7244,3731,3513
2007/8/1,屏東縣,霧臺鄉,810,2725,1457,1268
2007/8/1,屏東縣,瑪家鄉,1791,6521,3416,3105
2007/8/1,屏東縣,泰武鄉,1078,4900,2619,2281
2007/8/1,屏東縣,來義鄉,2064,7772,4018,3754
2007/8/1,屏東縣,春日鄉,1265,5014,2635,2379
2007/8/1,屏東縣,獅子鄉,1410,4951,2638,2313
2007/8/1,屏東縣,牡丹鄉,1763,4898,2550,2348
2007/8/1,臺東縣,臺東市,36823,110304,56360,53944
2007/8/1,臺東縣,成功鎮,5302,16448,8846,7602
2007/8/1,臺東縣,關山鎮,3165,10019,5297,4722
2007/8/1,臺東縣,卑南鄉,6422,18539,10204,8335
2007/8/1,臺東縣,大武鄉,2460,7126,3749,3377
2007/8/1,臺東縣,太麻里鄉,4459,12258,6598,5660
2007/8/1,臺東縣,東河鄉,3421,9779,5438,4341
2007/8/1,臺東縣,長濱鄉,2834,8898,5061,3837
2007/8/1,臺東縣,鹿野鄉,3074,8971,4855,4116
2007/8/1,臺東縣,池上鄉,3173,9502,5088,4414
2007/8/1,臺東縣,綠島鄉,884,3086,1635,1451
2007/8/1,臺東縣,延平鄉,1050,3634,2040,1594
2007/8/1,臺東縣,海端鄉,1073,4592,2502,2090
2007/8/1,臺東縣,達仁鄉,1390,3741,2066,1675
2007/8/1,臺東縣,金峰鄉,976,3306,1752,1554
2007/8/1,臺東縣,蘭嶼鄉,1189,3921,2077,1844
2007/8/1,花蓮縣,花蓮市,38871,109693,54344,55349
2007/8/1,花蓮縣,鳳林鎮,4378,12536,6667,5869
2007/8/1,花蓮縣,玉里鎮,8747,28247,15450,12797
2007/8/1,花蓮縣,新城鄉,7124,20546,10740,9806
2007/8/1,花蓮縣,吉安鄉,27245,78945,40772,38173
2007/8/1,花蓮縣,壽豐鄉,6650,19357,10559,8798
2007/8/1,花蓮縣,光復鄉,4974,14763,7918,6845
2007/8/1,花蓮縣,豐濱鄉,1817,5388,3002,2386
2007/8/1,花蓮縣,瑞穗鄉,4517,13446,7310,6136
2007/8/1,花蓮縣,富里鄉,3876,12126,6718,5408
2007/8/1,花蓮縣,秀林鄉,4443,14946,7857,7089
2007/8/1,花蓮縣,萬榮鄉,2142,7139,3834,3305
2007/8/1,花蓮縣,卓溪鄉,1599,6555,3648,2907
2007/8/1,澎湖縣,馬公市,17696,54421,27757,26664
2007/8/1,澎湖縣,湖西鄉,4244,12800,6710,6090
2007/8/1,澎湖縣,白沙鄉,2922,9156,4862,4294
2007/8/1,澎湖縣,西嶼鄉,2655,8189,4250,3939
2007/8/1,澎湖縣,望安鄉,1698,4428,2376,2052
2007/8/1,澎湖縣,七美鄉,1098,3169,1686,1483
2007/8/1,基隆市,中正區,21607,57646,29694,27952
2007/8/1,基隆市,七堵區,19037,55143,28112,27031
2007/8/1,基隆市,暖暖區,14016,38481,19710,18771
2007/8/1,基隆市,仁愛區,18762,50275,25144,25131
2007/8/1,基隆市,中山區,18630,52438,26945,25493
2007/8/1,基隆市,安樂區,30725,85172,42541,42631
2007/8/1,基隆市,信義區,19260,51030,25695,25335
2007/8/1,新竹市,東區,62783,189335,94010,95325
2007/8/1,新竹市,北區,46031,138279,69185,69094
2007/8/1,新竹市,香山區,20740,69659,35763,33896
2007/8/1,臺中市,中區,8423,23875,11836,12039
2007/8/1,臺中市,東區,24760,73576,37462,36114
2007/8/1,臺中市,西區,41051,116302,56223,60079
2007/8/1,臺中市,南區,38973,109860,53716,56144
2007/8/1,臺中市,北區,53154,147174,71791,75383
2007/8/1,臺中市,西屯區,66590,197327,96479,100848
2007/8/1,臺中市,南屯區,48353,145202,70339,74863
2007/8/1,臺中市,北屯區,77867,238792,116725,122067
2007/8/1,嘉義市,東區,43225,128669,63119,65550
2007/8/1,嘉義市,西區,47315,144128,71924,72204
2007/8/1,臺南市,東區,68067,193591,94236,99355
2007/8/1,臺南市,南區,41731,127860,64503,63357
2007/8/1,臺南市,北區,44930,128126,63853,64273
2007/8/1,臺南市,安南區,50680,173561,88803,84758
2007/8/1,臺南市,安平區,21028,58887,28341,30546
2007/8/1,臺南市,中西區,29545,81318,40138,41180
2007/8/1,臺北市,松山區,75985,210211,99960,110251
2007/8/1,臺北市,信義區,84594,229407,111799,117608
2007/8/1,臺北市,大安區,113856,314231,149171,165060
2007/8/1,臺北市,中山區,86993,218269,103948,114321
2007/8/1,臺北市,中正區,59845,159387,77468,81919
2007/8/1,臺北市,大同區,45436,126295,62760,63535
2007/8/1,臺北市,萬華區,72202,192844,97284,95560
2007/8/1,臺北市,文山區,93274,261261,127507,133754
2007/8/1,臺北市,南港區,39345,113274,56373,56901
2007/8/1,臺北市,內湖區,90517,265324,128864,136460
2007/8/1,臺北市,士林區,96860,287035,140391,146644
2007/8/1,臺北市,北投區,85612,249715,122037,127678
2007/8/1,高雄市,鹽埕區,11234,28749,14626,14123
2007/8/1,高雄市,鼓山區,45858,121215,60389,60826
2007/8/1,高雄市,左營區,69379,185122,92112,93010
2007/8/1,高雄市,楠梓區,58215,167891,83931,83960
2007/8/1,高雄市,三民區,127487,360638,177942,182696
2007/8/1,高雄市,新興區,22735,57496,28252,29244
2007/8/1,高雄市,前金區,12309,30106,14831,15275
2007/8/1,高雄市,苓雅區,69818,188521,92431,96090
2007/8/1,高雄市,前鎮區,72574,200235,100647,99588
2007/8/1,高雄市,旗津區,10623,29981,15734,14247
2007/8/1,高雄市,小港區,58252,151419,76843,74576
2007/8/1,金門縣,金城鎮,9858,27431,14498,12933
2007/8/1,金門縣,金湖鎮,6432,17851,9517,8334
2007/8/1,金門縣,金沙鎮,4899,12837,6761,6076
2007/8/1,金門縣,金寧鄉,5437,14321,7750,6571
2007/8/1,金門縣,烈嶼鄉,2282,6986,3697,3289
2007/8/1,金門縣,烏坵鄉,133,439,225,214
2007/8/1,連江縣,南竿鄉,1068,5875,3400,2475
2007/8/1,連江縣,北竿鄉,371,1818,1079,739
2007/8/1,連江縣,莒光鄉,234,1182,697,485
2007/8/1,連江縣,東引鄉,248,988,585,403
2007/9/1,總計,臺灣地區,7460871,22835242,11549291,11285951
2007/9/1,總計,臺灣省,5954158,18691315,9516799,9174516
2007/9/1,總計,新北市,1304190,3789488,1895845,1893643
2007/9/1,總計,宜蘭縣,146422,460193,235986,224207
2007/9/1,總計,桃園市,617189,1928968,978931,950037
2007/9/1,總計,新竹縣,146977,494225,255895,238330
2007/9/1,總計,苗栗縣,162626,559802,292497,267305
2007/9/1,總計,臺中市,441535,1548435,788359,760076
2007/9/1,總計,彰化縣,347409,1313709,677429,636280
2007/9/1,總計,南投縣,163793,533494,276394,257100
2007/9/1,總計,雲林縣,218264,725949,381343,344606
2007/9/1,總計,嘉義縣,168403,551498,289318,262180
2007/9/1,總計,臺南市,352205,1105079,567053,538026
2007/9/1,總計,高雄市,414149,1243944,640938,603006
2007/9/1,總計,屏東縣,266447,889806,460254,429552
2007/9/1,總計,臺東縣,77750,233954,123458,110496
2007/9/1,總計,花蓮縣,116545,343610,178721,164889
2007/9/1,總計,澎湖縣,30360,92157,47632,44525
2007/9/1,總計,基隆市,142408,390188,197759,192429
2007/9/1,總計,新竹市,129961,397577,199129,198448
2007/9/1,總計,臺中市,360238,1052946,514899,538047
2007/9/1,總計,嘉義市,90777,272804,135052,137752
2007/9/1,總計,臺南市,256510,763489,379907,383582
2007/9/1,總計,臺北市,947372,2625359,1276455,1348904
2007/9/1,總計,高雄市,559341,1518568,756037,762531
2007/9/1,總計,福建省,31045,90069,48414,41655
2007/9/1,總計,金門縣,29120,80191,42632,37559
2007/9/1,總計,連江縣,1925,9878,5782,4096
2007/9/1,新北市,板橋區,181733,546276,272504,273772
2007/9/1,新北市,三重區,130363,383429,192486,190943
2007/9/1,新北市,永和區,87704,236151,114011,122140
2007/9/1,新北市,中和區,146164,409906,204081,205825
2007/9/1,新北市,新莊區,128877,395573,196627,198946
2007/9/1,新北市,新店區,110393,290244,143465,146779
2007/9/1,新北市,土城區,78166,237231,119142,118089
2007/9/1,新北市,蘆洲區,61043,191500,95345,96155
2007/9/1,新北市,汐止區,73695,180428,90345,90083
2007/9/1,新北市,樹林區,51895,164002,83143,80859
2007/9/1,新北市,鶯歌區,25480,85477,43574,41903
2007/9/1,新北市,三峽區,30336,94541,48794,45747
2007/9/1,新北市,淡水區,49367,131603,64826,66777
2007/9/1,新北市,瑞芳區,15446,43538,22344,21194
2007/9/1,新北市,五股區,25422,77046,39260,37786
2007/9/1,新北市,泰山區,24510,74202,37605,36597
2007/9/1,新北市,林口區,21854,66067,33066,33001
2007/9/1,新北市,深坑區,8135,22221,11361,10860
2007/9/1,新北市,石碇區,3127,7854,4373,3481
2007/9/1,新北市,坪林區,2341,6620,3720,2900
2007/9/1,新北市,三芝區,8481,23566,12271,11295
2007/9/1,新北市,石門區,3632,11771,6243,5528
2007/9/1,新北市,八里區,11053,32657,16752,15905
2007/9/1,新北市,平溪區,2344,5651,3163,2488
2007/9/1,新北市,雙溪區,3777,9952,5383,4569
2007/9/1,新北市,貢寮區,4282,13932,7262,6670
2007/9/1,新北市,金山區,6389,22160,11304,10856
2007/9/1,新北市,萬里區,6523,20523,10625,9898
2007/9/1,新北市,烏來區,1658,5367,2770,2597
2007/9/1,宜蘭縣,宜蘭市,31895,95989,47585,48404
2007/9/1,宜蘭縣,羅東鎮,24059,74221,35739,38482
2007/9/1,宜蘭縣,蘇澳鎮,13010,42899,22290,20609
2007/9/1,宜蘭縣,頭城鎮,9167,31667,16461,15206
2007/9/1,宜蘭縣,礁溪鄉,11661,35893,18881,17012
2007/9/1,宜蘭縣,壯圍鄉,7749,25282,13369,11913
2007/9/1,宜蘭縣,員山鄉,10185,32421,17461,14960
2007/9/1,宜蘭縣,冬山鄉,16213,51260,26581,24679
2007/9/1,宜蘭縣,五結鄉,12081,37750,19797,17953
2007/9/1,宜蘭縣,三星鄉,6933,21208,11509,9699
2007/9/1,宜蘭縣,大同鄉,1757,5790,3217,2573
2007/9/1,宜蘭縣,南澳鄉,1712,5813,3096,2717
2007/9/1,桃園市,桃園區,132731,390216,191978,198238
2007/9/1,桃園市,中壢區,116273,357587,179799,177788
2007/9/1,桃園市,平鎮區,61334,202064,102333,99731
2007/9/1,桃園市,八德區,53032,172066,88437,83629
2007/9/1,桃園市,大溪區,27419,90117,46716,43401
2007/9/1,桃園市,楊梅區,43901,142450,72956,69494
2007/9/1,桃園市,蘆竹區,42780,131056,66186,64870
2007/9/1,桃園市,大園區,23608,79484,41487,37997
2007/9/1,桃園市,龜山區,45785,131141,67168,63973
2007/9/1,桃園市,龍潭區,34532,112601,57597,55004
2007/9/1,桃園市,新屋區,14337,49964,26699,23265
2007/9/1,桃園市,觀音區,17880,59591,31605,27986
2007/9/1,桃園市,復興區,3577,10631,5970,4661
2007/9/1,新竹縣,竹北市,39394,124990,63021,61969
2007/9/1,新竹縣,關西鎮,8850,32704,17500,15204
2007/9/1,新竹縣,新埔鎮,9835,36107,19167,16940
2007/9/1,新竹縣,竹東鎮,28746,96451,48783,47668
2007/9/1,新竹縣,湖口鄉,21958,74047,38072,35975
2007/9/1,新竹縣,橫山鄉,4172,14634,8016,6618
2007/9/1,新竹縣,新豐鄉,14502,51582,26803,24779
2007/9/1,新竹縣,芎林鄉,5923,20777,10953,9824
2007/9/1,新竹縣,寶山鄉,4442,13779,7471,6308
2007/9/1,新竹縣,北埔鄉,2957,10347,5623,4724
2007/9/1,新竹縣,峨眉鄉,1982,6160,3427,2733
2007/9/1,新竹縣,尖石鄉,2550,8170,4508,3662
2007/9/1,新竹縣,五峰鄉,1666,4477,2551,1926
2007/9/1,苗栗縣,苗栗市,27837,91062,46217,44845
2007/9/1,苗栗縣,苑裡鎮,13211,49013,25680,23333
2007/9/1,苗栗縣,通霄鎮,10889,39291,21014,18277
2007/9/1,苗栗縣,竹南鎮,21672,75021,38332,36689
2007/9/1,苗栗縣,頭份市,27079,94374,48378,45996
2007/9/1,苗栗縣,後龍鎮,11349,40492,21515,18977
2007/9/1,苗栗縣,卓蘭鎮,5719,18574,9882,8692
2007/9/1,苗栗縣,大湖鄉,5075,16240,8759,7481
2007/9/1,苗栗縣,公館鄉,9550,34627,18213,16414
2007/9/1,苗栗縣,銅鑼鄉,5811,19837,10574,9263
2007/9/1,苗栗縣,南庄鄉,3816,11470,6392,5078
2007/9/1,苗栗縣,頭屋鄉,3423,11923,6291,5632
2007/9/1,苗栗縣,三義鄉,5081,17705,9387,8318
2007/9/1,苗栗縣,西湖鄉,2553,7987,4436,3551
2007/9/1,苗栗縣,造橋鄉,3853,13851,7319,6532
2007/9/1,苗栗縣,三灣鄉,2280,7514,4101,3413
2007/9/1,苗栗縣,獅潭鄉,1610,5159,2891,2268
2007/9/1,苗栗縣,泰安鄉,1818,5662,3116,2546
2007/9/1,臺中市,豐原區,46967,164362,82065,82297
2007/9/1,臺中市,大里區,57829,192089,95764,96325
2007/9/1,臺中市,太平區,52065,171454,86430,85024
2007/9/1,臺中市,東勢區,16515,54851,28631,26220
2007/9/1,臺中市,大甲區,20752,79272,40248,39024
2007/9/1,臺中市,清水區,23812,85861,44455,41406
2007/9/1,臺中市,沙鹿區,21303,78239,40013,38226
2007/9/1,臺中市,梧棲區,15196,54096,27536,26560
2007/9/1,臺中市,后里區,14172,54572,28309,26263
2007/9/1,臺中市,神岡區,16876,64173,33141,31032
2007/9/1,臺中市,潭子區,30097,97110,48802,48308
2007/9/1,臺中市,大雅區,24814,87653,44494,43159
2007/9/1,臺中市,新社區,7100,25858,13673,12185
2007/9/1,臺中市,石岡區,4650,16187,8409,7778
2007/9/1,臺中市,外埔區,8298,31866,16466,15400
2007/9/1,臺中市,大安區,5099,20750,10964,9786
2007/9/1,臺中市,烏日區,18989,67301,34315,32986
2007/9/1,臺中市,大肚區,15177,55891,28769,27122
2007/9/1,臺中市,龍井區,19285,71550,36665,34885
2007/9/1,臺中市,霧峰區,18063,64434,33223,31211
2007/9/1,臺中市,和平區,4476,10866,5987,4879
2007/9/1,彰化縣,彰化市,68495,235682,118200,117482
2007/9/1,彰化縣,鹿港鎮,21162,85254,43777,41477
2007/9/1,彰化縣,和美鎮,22767,88994,45772,43222
2007/9/1,彰化縣,北斗鎮,9462,33538,17048,16490
2007/9/1,彰化縣,員林市,35097,126027,63674,62353
2007/9/1,彰化縣,溪湖鎮,14428,56532,29060,27472
2007/9/1,彰化縣,田中鎮,12088,45059,23692,21367
2007/9/1,彰化縣,二林鎮,13770,55111,28505,26606
2007/9/1,彰化縣,線西鄉,3922,16996,8776,8220
2007/9/1,彰化縣,伸港鄉,8434,35640,18393,17247
2007/9/1,彰化縣,福興鄉,11444,48841,25647,23194
2007/9/1,彰化縣,秀水鄉,9150,38787,20121,18666
2007/9/1,彰化縣,花壇鄉,12185,46135,23879,22256
2007/9/1,彰化縣,芬園鄉,6745,25358,13473,11885
2007/9/1,彰化縣,大村鄉,9721,36455,19096,17359
2007/9/1,彰化縣,埔鹽鄉,8464,34786,18318,16468
2007/9/1,彰化縣,埔心鄉,9478,35513,18452,17061
2007/9/1,彰化縣,永靖鄉,9963,39776,20721,19055
2007/9/1,彰化縣,社頭鄉,11863,45470,23478,21992
2007/9/1,彰化縣,二水鄉,5175,17141,9070,8071
2007/9/1,彰化縣,田尾鄉,7441,29204,15229,13975
2007/9/1,彰化縣,埤頭鄉,8178,32076,16853,15223
2007/9/1,彰化縣,芳苑鄉,9790,37087,19693,17394
2007/9/1,彰化縣,大城鄉,5279,19294,10556,8738
2007/9/1,彰化縣,竹塘鄉,4462,16719,8862,7857
2007/9/1,彰化縣,溪州鄉,8446,32234,17084,15150
2007/9/1,南投縣,南投市,32024,105625,53405,52220
2007/9/1,南投縣,埔里鎮,27406,86447,43885,42562
2007/9/1,南投縣,草屯鎮,29406,99737,50654,49083
2007/9/1,南投縣,竹山鎮,17960,59330,30796,28534
2007/9/1,南投縣,集集鎮,4080,12126,6373,5753
2007/9/1,南投縣,名間鄉,11666,41596,22007,19589
2007/9/1,南投縣,鹿谷鄉,6255,19583,10457,9126
2007/9/1,南投縣,中寮鄉,5412,16613,9083,7530
2007/9/1,南投縣,魚池鄉,5591,17306,9256,8050
2007/9/1,南投縣,國姓鄉,7012,21532,11831,9701
2007/9/1,南投縣,水里鄉,7132,20982,11074,9908
2007/9/1,南投縣,信義鄉,5007,17222,9398,7824
2007/9/1,南投縣,仁愛鄉,4842,15395,8175,7220
2007/9/1,雲林縣,斗六市,32445,105322,53325,51997
2007/9/1,雲林縣,斗南鎮,14609,47761,24411,23350
2007/9/1,雲林縣,虎尾鎮,21042,69368,35494,33874
2007/9/1,雲林縣,西螺鎮,13572,49291,25112,24179
2007/9/1,雲林縣,土庫鎮,8366,31144,16371,14773
2007/9/1,雲林縣,北港鎮,14775,44459,23215,21244
2007/9/1,雲林縣,古坑鄉,10274,35000,18567,16433
2007/9/1,雲林縣,大埤鄉,6382,21934,11692,10242
2007/9/1,雲林縣,莿桐鄉,8630,30858,16187,14671
2007/9/1,雲林縣,林內鄉,5529,20577,10816,9761
2007/9/1,雲林縣,二崙鄉,8561,30648,16501,14147
2007/9/1,雲林縣,崙背鄉,7998,28149,14955,13194
2007/9/1,雲林縣,麥寮鄉,11188,33210,17781,15429
2007/9/1,雲林縣,東勢鄉,5577,17650,9568,8082
2007/9/1,雲林縣,褒忠鄉,4120,14825,7950,6875
2007/9/1,雲林縣,臺西鄉,8477,27456,14804,12652
2007/9/1,雲林縣,元長鄉,9053,29781,16291,13490
2007/9/1,雲林縣,四湖鄉,8718,27650,15259,12391
2007/9/1,雲林縣,口湖鄉,9300,31074,16677,14397
2007/9/1,雲林縣,水林鄉,9648,29792,16367,13425
2007/9/1,嘉義縣,太保市,10362,35624,18546,17078
2007/9/1,嘉義縣,朴子市,13519,44306,22795,21511
2007/9/1,嘉義縣,布袋鎮,9870,31366,16261,15105
2007/9/1,嘉義縣,大林鎮,10850,34435,17814,16621
2007/9/1,嘉義縣,民雄鄉,21515,72669,37537,35132
2007/9/1,嘉義縣,溪口鄉,5177,16862,9010,7852
2007/9/1,嘉義縣,新港鄉,10026,35344,18684,16660
2007/9/1,嘉義縣,六腳鄉,8893,27321,14536,12785
2007/9/1,嘉義縣,東石鄉,9111,28765,15321,13444
2007/9/1,嘉義縣,義竹鄉,7246,21900,11402,10498
2007/9/1,嘉義縣,鹿草鄉,5515,17513,9400,8113
2007/9/1,嘉義縣,水上鄉,17043,53602,27953,25649
2007/9/1,嘉義縣,中埔鄉,14469,48073,25212,22861
2007/9/1,嘉義縣,竹崎鄉,11022,39466,21088,18378
2007/9/1,嘉義縣,梅山鄉,6305,22323,11847,10476
2007/9/1,嘉義縣,番路鄉,3768,11819,6457,5362
2007/9/1,嘉義縣,大埔鄉,1772,3963,2144,1819
2007/9/1,嘉義縣,阿里山鄉,1940,6147,3311,2836
2007/9/1,臺南市,新營區,26124,78912,39636,39276
2007/9/1,臺南市,永康區,70014,210147,105175,104972
2007/9/1,臺南市,鹽水區,9589,27902,14550,13352
2007/9/1,臺南市,白河區,10692,32426,17185,15241
2007/9/1,臺南市,麻豆區,14246,46382,23846,22536
2007/9/1,臺南市,佳里區,18287,59243,29618,29625
2007/9/1,臺南市,新化區,13066,44596,22921,21675
2007/9/1,臺南市,善化區,13508,42492,21698,20794
2007/9/1,臺南市,學甲區,9139,28615,14736,13879
2007/9/1,臺南市,柳營區,7532,23260,12192,11068
2007/9/1,臺南市,後壁區,8385,26568,13869,12699
2007/9/1,臺南市,東山區,7984,23795,12767,11028
2007/9/1,臺南市,下營區,8848,26815,13912,12903
2007/9/1,臺南市,六甲區,7390,24411,12737,11674
2007/9/1,臺南市,官田區,7439,22683,11738,10945
2007/9/1,臺南市,大內區,3995,11370,6097,5273
2007/9/1,臺南市,西港區,7519,25568,13092,12476
2007/9/1,臺南市,七股區,7742,25244,13244,12000
2007/9/1,臺南市,將軍區,7236,22116,11319,10797
2007/9/1,臺南市,北門區,4167,12670,6526,6144
2007/9/1,臺南市,新市區,10363,35526,17898,17628
2007/9/1,臺南市,安定區,8693,30012,15629,14383
2007/9/1,臺南市,山上區,2679,8081,4280,3801
2007/9/1,臺南市,玉井區,4983,15864,8274,7590
2007/9/1,臺南市,楠西區,3584,11038,5875,5163
2007/9/1,臺南市,南化區,2806,8982,4929,4053
2007/9/1,臺南市,左鎮區,1927,5642,3126,2516
2007/9/1,臺南市,仁德區,22903,67777,35052,32725
2007/9/1,臺南市,歸仁區,19376,65452,33435,32017
2007/9/1,臺南市,關廟區,10438,37069,19287,17782
2007/9/1,臺南市,龍崎區,1551,4421,2410,2011
2007/9/1,高雄市,鳳山區,121157,338771,169961,168810
2007/9/1,高雄市,岡山區,31858,95993,48637,47356
2007/9/1,高雄市,旗山區,13514,41137,21556,19581
2007/9/1,高雄市,美濃區,13541,44180,23223,20957
2007/9/1,高雄市,林園區,23310,71332,36872,34460
2007/9/1,高雄市,大寮區,36381,109316,57201,52115
2007/9/1,高雄市,大樹區,12851,44929,23403,21526
2007/9/1,高雄市,仁武區,23128,67499,34979,32520
2007/9/1,高雄市,大社區,11167,32662,16819,15843
2007/9/1,高雄市,鳥松區,15531,41177,21057,20120
2007/9/1,高雄市,橋頭區,12226,36731,18969,17762
2007/9/1,高雄市,燕巢區,9551,31269,16755,14514
2007/9/1,高雄市,田寮區,3596,8597,4813,3784
2007/9/1,高雄市,阿蓮區,8845,30902,15637,15265
2007/9/1,高雄市,路竹區,15370,54550,27920,26630
2007/9/1,高雄市,湖內區,9028,28659,14862,13797
2007/9/1,高雄市,茄萣區,9874,31982,16804,15178
2007/9/1,高雄市,永安區,5606,14224,7314,6910
2007/9/1,高雄市,彌陀區,6369,20797,10941,9856
2007/9/1,高雄市,梓官區,11465,37279,19559,17720
2007/9/1,高雄市,六龜區,5649,15695,8554,7141
2007/9/1,高雄市,甲仙區,2571,8259,4452,3807
2007/9/1,高雄市,杉林區,3996,11406,6281,5125
2007/9/1,高雄市,內門區,4965,16571,9057,7514
2007/9/1,高雄市,茂林區,521,1753,898,855
2007/9/1,高雄市,桃源區,1201,4782,2575,2207
2007/9/1,屏東縣,屏東市,70665,215989,108333,107656
2007/9/1,屏東縣,潮州鎮,17549,56965,28823,28142
2007/9/1,屏東縣,東港鎮,14569,50490,25773,24717
2007/9/1,屏東縣,恆春鎮,10241,31270,16257,15013
2007/9/1,屏東縣,萬丹鄉,13670,54479,28296,26183
2007/9/1,屏東縣,長治鄉,9437,30962,16312,14650
2007/9/1,屏東縣,麟洛鄉,3448,11702,6079,5623
2007/9/1,屏東縣,九如鄉,6381,23230,12095,11135
2007/9/1,屏東縣,里港鄉,7762,26501,13650,12851
2007/9/1,屏東縣,鹽埔鄉,7439,27751,14504,13247
2007/9/1,屏東縣,高樹鄉,9497,27558,14798,12760
2007/9/1,屏東縣,萬巒鄉,6275,22752,12033,10719
2007/9/1,屏東縣,內埔鄉,17186,59466,31129,28337
2007/9/1,屏東縣,竹田鄉,5352,18528,9915,8613
2007/9/1,屏東縣,新埤鄉,3290,11103,5914,5189
2007/9/1,屏東縣,枋寮鄉,8243,27437,14565,12872
2007/9/1,屏東縣,新園鄉,10805,39603,20553,19050
2007/9/1,屏東縣,崁頂鄉,3934,16989,8796,8193
2007/9/1,屏東縣,林邊鄉,6154,21330,11093,10237
2007/9/1,屏東縣,南州鄉,3572,12159,6247,5912
2007/9/1,屏東縣,佳冬鄉,6591,21792,11397,10395
2007/9/1,屏東縣,琉球鄉,3705,12676,7027,5649
2007/9/1,屏東縣,車城鄉,3393,10142,5485,4657
2007/9/1,屏東縣,滿州鄉,2967,8649,4750,3899
2007/9/1,屏東縣,枋山鄉,2103,6246,3373,2873
2007/9/1,屏東縣,三地門鄉,2015,7250,3726,3524
2007/9/1,屏東縣,霧臺鄉,822,2737,1462,1275
2007/9/1,屏東縣,瑪家鄉,1796,6515,3409,3106
2007/9/1,屏東縣,泰武鄉,1079,4908,2621,2287
2007/9/1,屏東縣,來義鄉,2066,7784,4021,3763
2007/9/1,屏東縣,春日鄉,1268,4997,2623,2374
2007/9/1,屏東縣,獅子鄉,1411,4952,2642,2310
2007/9/1,屏東縣,牡丹鄉,1762,4894,2553,2341
2007/9/1,臺東縣,臺東市,36852,110254,56315,53939
2007/9/1,臺東縣,成功鎮,5307,16420,8830,7590
2007/9/1,臺東縣,關山鎮,3169,10014,5293,4721
2007/9/1,臺東縣,卑南鄉,6427,18517,10190,8327
2007/9/1,臺東縣,大武鄉,2460,7127,3751,3376
2007/9/1,臺東縣,太麻里鄉,4446,12247,6597,5650
2007/9/1,臺東縣,東河鄉,3422,9747,5418,4329
2007/9/1,臺東縣,長濱鄉,2834,8866,5041,3825
2007/9/1,臺東縣,鹿野鄉,3073,8967,4853,4114
2007/9/1,臺東縣,池上鄉,3172,9490,5080,4410
2007/9/1,臺東縣,綠島鄉,889,3087,1638,1449
2007/9/1,臺東縣,延平鄉,1058,3632,2044,1588
2007/9/1,臺東縣,海端鄉,1073,4592,2503,2089
2007/9/1,臺東縣,達仁鄉,1390,3748,2069,1679
2007/9/1,臺東縣,金峰鄉,981,3311,1754,1557
2007/9/1,臺東縣,蘭嶼鄉,1197,3935,2082,1853
2007/9/1,花蓮縣,花蓮市,38935,109724,54340,55384
2007/9/1,花蓮縣,鳳林鎮,4382,12517,6667,5850
2007/9/1,花蓮縣,玉里鎮,8760,28214,15414,12800
2007/9/1,花蓮縣,新城鄉,7131,20568,10749,9819
2007/9/1,花蓮縣,吉安鄉,27305,79004,40797,38207
2007/9/1,花蓮縣,壽豐鄉,6649,19306,10528,8778
2007/9/1,花蓮縣,光復鄉,4988,14731,7891,6840
2007/9/1,花蓮縣,豐濱鄉,1821,5379,3000,2379
2007/9/1,花蓮縣,瑞穗鄉,4510,13432,7299,6133
2007/9/1,花蓮縣,富里鄉,3874,12103,6707,5396
2007/9/1,花蓮縣,秀林鄉,4450,14946,7855,7091
2007/9/1,花蓮縣,萬榮鄉,2141,7135,3829,3306
2007/9/1,花蓮縣,卓溪鄉,1599,6551,3645,2906
2007/9/1,澎湖縣,馬公市,17726,54398,27748,26650
2007/9/1,澎湖縣,湖西鄉,4243,12816,6720,6096
2007/9/1,澎湖縣,白沙鄉,2921,9147,4850,4297
2007/9/1,澎湖縣,西嶼鄉,2658,8177,4246,3931
2007/9/1,澎湖縣,望安鄉,1707,4443,2380,2063
2007/9/1,澎湖縣,七美鄉,1105,3176,1688,1488
2007/9/1,基隆市,中正區,21672,57642,29686,27956
2007/9/1,基隆市,七堵區,19097,55155,28123,27032
2007/9/1,基隆市,暖暖區,14032,38457,19687,18770
2007/9/1,基隆市,仁愛區,18833,50232,25101,25131
2007/9/1,基隆市,中山區,18645,52424,26916,25508
2007/9/1,基隆市,安樂區,30824,85184,42520,42664
2007/9/1,基隆市,信義區,19305,51094,25726,25368
2007/9/1,新竹市,東區,62955,189360,94059,95301
2007/9/1,新竹市,北區,46204,138523,69291,69232
2007/9/1,新竹市,香山區,20802,69694,35779,33915
2007/9/1,臺中市,中區,8424,23876,11821,12055
2007/9/1,臺中市,東區,24805,73594,37460,36134
2007/9/1,臺中市,西區,41196,116392,56264,60128
2007/9/1,臺中市,南區,39097,109926,53747,56179
2007/9/1,臺中市,北區,53276,147236,71839,75397
2007/9/1,臺中市,西屯區,66800,197421,96513,100908
2007/9/1,臺中市,南屯區,48551,145461,70433,75028
2007/9/1,臺中市,北屯區,78089,239040,116822,122218
2007/9/1,嘉義市,東區,43316,128562,63073,65489
2007/9/1,嘉義市,西區,47461,144242,71979,72263
2007/9/1,臺南市,東區,68158,193513,94198,99315
2007/9/1,臺南市,南區,41791,127775,64437,63338
2007/9/1,臺南市,北區,45010,128169,63860,64309
2007/9/1,臺南市,安南區,50833,173743,88879,84864
2007/9/1,臺南市,安平區,21148,59077,28448,30629
2007/9/1,臺南市,中西區,29570,81212,40085,41127
2007/9/1,臺北市,松山區,76190,210117,99893,110224
2007/9/1,臺北市,信義區,84778,228970,111520,117450
2007/9/1,臺北市,大安區,114164,313866,148998,164868
2007/9/1,臺北市,中山區,87272,218067,103810,114257
2007/9/1,臺北市,中正區,59974,159074,77313,81761
2007/9/1,臺北市,大同區,45579,126188,62719,63469
2007/9/1,臺北市,萬華區,72388,192733,97231,95502
2007/9/1,臺北市,文山區,93627,261258,127478,133780
2007/9/1,臺北市,南港區,39533,113406,56450,56956
2007/9/1,臺北市,內湖區,90889,265317,128808,136509
2007/9/1,臺北市,士林區,97106,286770,140269,146501
2007/9/1,臺北市,北投區,85872,249593,121966,127627
2007/9/1,高雄市,鹽埕區,11232,28682,14608,14074
2007/9/1,高雄市,鼓山區,46346,121845,60617,61228
2007/9/1,高雄市,左營區,69630,185331,92192,93139
2007/9/1,高雄市,楠梓區,58419,168163,84046,84117
2007/9/1,高雄市,三民區,127776,360561,177868,182693
2007/9/1,高雄市,新興區,22789,57454,28246,29208
2007/9/1,高雄市,前金區,12357,30045,14805,15240
2007/9/1,高雄市,苓雅區,69929,188255,92284,95971
2007/9/1,高雄市,前鎮區,72772,200258,100605,99653
2007/9/1,高雄市,旗津區,10629,30020,15748,14272
2007/9/1,高雄市,小港區,58340,151446,76857,74589
2007/9/1,金門縣,金城鎮,9876,27505,14540,12965
2007/9/1,金門縣,金湖鎮,6452,17933,9549,8384
2007/9/1,金門縣,金沙鎮,4918,12878,6789,6089
2007/9/1,金門縣,金寧鄉,5456,14423,7811,6612
2007/9/1,金門縣,烈嶼鄉,2284,7014,3718,3296
2007/9/1,金門縣,烏坵鄉,134,438,225,213
2007/9/1,連江縣,南竿鄉,1073,5893,3422,2471
2007/9/1,連江縣,北竿鄉,370,1816,1079,737
2007/9/1,連江縣,莒光鄉,234,1183,695,488
2007/9/1,連江縣,東引鄉,248,986,586,400
2007/10/1,總計,臺灣地區,7466449,22844441,11552051,11292390
2007/10/1,總計,臺灣省,5959508,18699367,9519475,9179892
2007/10/1,總計,新北市,1305688,3792402,1897077,1895325
2007/10/1,總計,宜蘭縣,146597,460218,235941,224277
2007/10/1,總計,桃園市,617895,1930818,979696,951122
2007/10/1,總計,新竹縣,147157,494780,256144,238636
2007/10/1,總計,苗栗縣,162782,559956,292500,267456
2007/10/1,總計,臺中市,441812,1548976,788627,760349
2007/10/1,總計,彰化縣,347669,1313798,677443,636355
2007/10/1,總計,南投縣,163871,533731,276420,257311
2007/10/1,總計,雲林縣,218491,725930,381316,344614
2007/10/1,總計,嘉義縣,168524,551409,289262,262147
2007/10/1,總計,臺南市,352445,1105061,567015,538046
2007/10/1,總計,高雄市,414434,1244129,640971,603158
2007/10/1,總計,屏東縣,266615,889793,460202,429591
2007/10/1,總計,臺東縣,77820,233841,123368,110473
2007/10/1,總計,花蓮縣,116685,343574,178623,164951
2007/10/1,總計,澎湖縣,30416,92174,47604,44570
2007/10/1,總計,基隆市,142487,390310,197780,192530
2007/10/1,總計,新竹市,130094,398032,199316,198716
2007/10/1,總計,臺中市,360602,1053828,515150,538678
2007/10/1,總計,嘉義市,90840,272851,135052,137799
2007/10/1,總計,臺南市,256584,763756,379968,383788
2007/10/1,總計,臺北市,947212,2626104,1276478,1349626
2007/10/1,總計,高雄市,559729,1518970,756098,762872
2007/10/1,總計,福建省,31098,90556,48679,41877
2007/10/1,總計,金門縣,29170,80636,42872,37764
2007/10/1,總計,連江縣,1928,9920,5807,4113
2007/10/1,新北市,板橋區,182018,546585,272636,273949
2007/10/1,新北市,三重區,130450,383468,192466,191002
2007/10/1,新北市,永和區,87710,236172,114017,122155
2007/10/1,新北市,中和區,146232,410023,204098,205925
2007/10/1,新北市,新莊區,128995,395796,196752,199044
2007/10/1,新北市,新店區,110414,290404,143521,146883
2007/10/1,新北市,土城區,78263,237432,119236,118196
2007/10/1,新北市,蘆洲區,61093,191628,95389,96239
2007/10/1,新北市,汐止區,73803,180644,90439,90205
2007/10/1,新北市,樹林區,52014,164285,83290,80995
2007/10/1,新北市,鶯歌區,25529,85569,43617,41952
2007/10/1,新北市,三峽區,30412,94707,48878,45829
2007/10/1,新北市,淡水區,49462,131851,64906,66945
2007/10/1,新北市,瑞芳區,15449,43541,22350,21191
2007/10/1,新北市,五股區,25453,77191,39345,37846
2007/10/1,新北市,泰山區,24558,74292,37633,36659
2007/10/1,新北市,林口區,21985,66316,33171,33145
2007/10/1,新北市,深坑區,8146,22232,11356,10876
2007/10/1,新北市,石碇區,3139,7868,4384,3484
2007/10/1,新北市,坪林區,2347,6619,3720,2899
2007/10/1,新北市,三芝區,8496,23592,12291,11301
2007/10/1,新北市,石門區,3638,11779,6254,5525
2007/10/1,新北市,八里區,11065,32663,16755,15908
2007/10/1,新北市,平溪區,2346,5653,3165,2488
2007/10/1,新北市,雙溪區,3785,9962,5386,4576
2007/10/1,新北市,貢寮區,4291,14014,7301,6713
2007/10/1,新北市,金山區,6398,22187,11318,10869
2007/10/1,新北市,萬里區,6533,20546,10621,9925
2007/10/1,新北市,烏來區,1664,5383,2782,2601
2007/10/1,宜蘭縣,宜蘭市,31903,95990,47565,48425
2007/10/1,宜蘭縣,羅東鎮,24091,74194,35727,38467
2007/10/1,宜蘭縣,蘇澳鎮,13028,42919,22288,20631
2007/10/1,宜蘭縣,頭城鎮,9192,31653,16452,15201
2007/10/1,宜蘭縣,礁溪鄉,11679,35908,18880,17028
2007/10/1,宜蘭縣,壯圍鄉,7753,25274,13368,11906
2007/10/1,宜蘭縣,員山鄉,10188,32369,17441,14928
2007/10/1,宜蘭縣,冬山鄉,16216,51272,26577,24695
2007/10/1,宜蘭縣,五結鄉,12110,37811,19815,17996
2007/10/1,宜蘭縣,三星鄉,6959,21196,11501,9695
2007/10/1,宜蘭縣,大同鄉,1763,5816,3228,2588
2007/10/1,宜蘭縣,南澳鄉,1715,5816,3099,2717
2007/10/1,桃園市,桃園區,132841,390684,192183,198501
2007/10/1,桃園市,中壢區,116430,357943,179933,178010
2007/10/1,桃園市,平鎮區,61383,202254,102406,99848
2007/10/1,桃園市,八德區,53058,172078,88416,83662
2007/10/1,桃園市,大溪區,27454,90152,46723,43429
2007/10/1,桃園市,楊梅區,43934,142533,73004,69529
2007/10/1,桃園市,蘆竹區,42880,131411,66353,65058
2007/10/1,桃園市,大園區,23622,79536,41506,38030
2007/10/1,桃園市,龜山區,45878,131381,67274,64107
2007/10/1,桃園市,龍潭區,34546,112600,57584,55016
2007/10/1,桃園市,新屋區,14359,49942,26691,23251
2007/10/1,桃園市,觀音區,17929,59688,31661,28027
2007/10/1,桃園市,復興區,3581,10616,5962,4654
2007/10/1,新竹縣,竹北市,39503,125375,63208,62167
2007/10/1,新竹縣,關西鎮,8859,32737,17511,15226
2007/10/1,新竹縣,新埔鎮,9837,36096,19172,16924
2007/10/1,新竹縣,竹東鎮,28745,96503,48811,47692
2007/10/1,新竹縣,湖口鄉,21964,74073,38059,36014
2007/10/1,新竹縣,橫山鄉,4176,14650,8027,6623
2007/10/1,新竹縣,新豐鄉,14522,51607,26813,24794
2007/10/1,新竹縣,芎林鄉,5932,20790,10956,9834
2007/10/1,新竹縣,寶山鄉,4452,13796,7485,6311
2007/10/1,新竹縣,北埔鄉,2961,10340,5615,4725
2007/10/1,新竹縣,峨眉鄉,1985,6151,3422,2729
2007/10/1,新竹縣,尖石鄉,2557,8195,4518,3677
2007/10/1,新竹縣,五峰鄉,1664,4467,2547,1920
2007/10/1,苗栗縣,苗栗市,27875,91074,46199,44875
2007/10/1,苗栗縣,苑裡鎮,13223,49058,25699,23359
2007/10/1,苗栗縣,通霄鎮,10878,39275,20994,18281
2007/10/1,苗栗縣,竹南鎮,21703,75068,38354,36714
2007/10/1,苗栗縣,頭份市,27121,94434,48392,46042
2007/10/1,苗栗縣,後龍鎮,11346,40479,21500,18979
2007/10/1,苗栗縣,卓蘭鎮,5719,18565,9865,8700
2007/10/1,苗栗縣,大湖鄉,5086,16263,8768,7495
2007/10/1,苗栗縣,公館鄉,9563,34627,18200,16427
2007/10/1,苗栗縣,銅鑼鄉,5815,19863,10589,9274
2007/10/1,苗栗縣,南庄鄉,3812,11446,6375,5071
2007/10/1,苗栗縣,頭屋鄉,3429,11927,6303,5624
2007/10/1,苗栗縣,三義鄉,5084,17690,9381,8309
2007/10/1,苗栗縣,西湖鄉,2554,7983,4438,3545
2007/10/1,苗栗縣,造橋鄉,3851,13854,7324,6530
2007/10/1,苗栗縣,三灣鄉,2280,7502,4092,3410
2007/10/1,苗栗縣,獅潭鄉,1617,5178,2909,2269
2007/10/1,苗栗縣,泰安鄉,1826,5670,3118,2552
2007/10/1,臺中市,豐原區,46982,164317,82047,82270
2007/10/1,臺中市,大里區,57877,192141,95808,96333
2007/10/1,臺中市,太平區,52074,171516,86453,85063
2007/10/1,臺中市,東勢區,16519,54812,28618,26194
2007/10/1,臺中市,大甲區,20757,79270,40245,39025
2007/10/1,臺中市,清水區,23818,85879,44449,41430
2007/10/1,臺中市,沙鹿區,21325,78258,40020,38238
2007/10/1,臺中市,梧棲區,15207,54133,27554,26579
2007/10/1,臺中市,后里區,14176,54570,28290,26280
2007/10/1,臺中市,神岡區,16895,64238,33180,31058
2007/10/1,臺中市,潭子區,30149,97221,48864,48357
2007/10/1,臺中市,大雅區,24836,87736,44516,43220
2007/10/1,臺中市,新社區,7105,25864,13685,12179
2007/10/1,臺中市,石岡區,4649,16170,8399,7771
2007/10/1,臺中市,外埔區,8308,31896,16479,15417
2007/10/1,臺中市,大安區,5097,20764,10966,9798
2007/10/1,臺中市,烏日區,19000,67375,34342,33033
2007/10/1,臺中市,大肚區,15183,55886,28782,27104
2007/10/1,臺中市,龍井區,19288,71626,36715,34911
2007/10/1,臺中市,霧峰區,18085,64452,33231,31221
2007/10/1,臺中市,和平區,4482,10852,5984,4868
2007/10/1,彰化縣,彰化市,68532,235745,118214,117531
2007/10/1,彰化縣,鹿港鎮,21155,85210,43755,41455
2007/10/1,彰化縣,和美鎮,22783,89021,45792,43229
2007/10/1,彰化縣,北斗鎮,9465,33538,17053,16485
2007/10/1,彰化縣,員林市,35129,126033,63678,62355
2007/10/1,彰化縣,溪湖鎮,14451,56564,29069,27495
2007/10/1,彰化縣,田中鎮,12097,45036,23690,21346
2007/10/1,彰化縣,二林鎮,13798,55101,28487,26614
2007/10/1,彰化縣,線西鄉,3922,17014,8790,8224
2007/10/1,彰化縣,伸港鄉,8452,35679,18408,17271
2007/10/1,彰化縣,福興鄉,11454,48908,25685,23223
2007/10/1,彰化縣,秀水鄉,9166,38808,20117,18691
2007/10/1,彰化縣,花壇鄉,12193,46140,23879,22261
2007/10/1,彰化縣,芬園鄉,6741,25323,13463,11860
2007/10/1,彰化縣,大村鄉,9734,36456,19098,17358
2007/10/1,彰化縣,埔鹽鄉,8467,34784,18317,16467
2007/10/1,彰化縣,埔心鄉,9489,35528,18448,17080
2007/10/1,彰化縣,永靖鄉,9975,39719,20685,19034
2007/10/1,彰化縣,社頭鄉,11878,45491,23492,21999
2007/10/1,彰化縣,二水鄉,5169,17132,9055,8077
2007/10/1,彰化縣,田尾鄉,7445,29183,15224,13959
2007/10/1,彰化縣,埤頭鄉,8177,32071,16849,15222
2007/10/1,彰化縣,芳苑鄉,9790,37087,19694,17393
2007/10/1,彰化縣,大城鄉,5287,19279,10543,8736
2007/10/1,彰化縣,竹塘鄉,4470,16742,8877,7865
2007/10/1,彰化縣,溪州鄉,8450,32206,17081,15125
2007/10/1,南投縣,南投市,32038,105664,53412,52252
2007/10/1,南投縣,埔里鎮,27393,86402,43839,42563
2007/10/1,南投縣,草屯鎮,29418,99861,50698,49163
2007/10/1,南投縣,竹山鎮,17982,59346,30813,28533
2007/10/1,南投縣,集集鎮,4079,12122,6369,5753
2007/10/1,南投縣,名間鄉,11683,41668,22042,19626
2007/10/1,南投縣,鹿谷鄉,6263,19586,10452,9134
2007/10/1,南投縣,中寮鄉,5418,16613,9073,7540
2007/10/1,南投縣,魚池鄉,5601,17331,9251,8080
2007/10/1,南投縣,國姓鄉,7012,21513,11816,9697
2007/10/1,南投縣,水里鄉,7124,20949,11061,9888
2007/10/1,南投縣,信義鄉,5013,17261,9408,7853
2007/10/1,南投縣,仁愛鄉,4847,15415,8186,7229
2007/10/1,雲林縣,斗六市,32475,105391,53354,52037
2007/10/1,雲林縣,斗南鎮,14651,47804,24444,23360
2007/10/1,雲林縣,虎尾鎮,21049,69381,35494,33887
2007/10/1,雲林縣,西螺鎮,13577,49300,25132,24168
2007/10/1,雲林縣,土庫鎮,8379,31129,16356,14773
2007/10/1,雲林縣,北港鎮,14773,44399,23188,21211
2007/10/1,雲林縣,古坑鄉,10274,34967,18553,16414
2007/10/1,雲林縣,大埤鄉,6391,21921,11692,10229
2007/10/1,雲林縣,莿桐鄉,8637,30865,16193,14672
2007/10/1,雲林縣,林內鄉,5531,20539,10806,9733
2007/10/1,雲林縣,二崙鄉,8549,30620,16488,14132
2007/10/1,雲林縣,崙背鄉,8009,28142,14942,13200
2007/10/1,雲林縣,麥寮鄉,11216,33247,17786,15461
2007/10/1,雲林縣,東勢鄉,5578,17637,9569,8068
2007/10/1,雲林縣,褒忠鄉,4129,14821,7943,6878
2007/10/1,雲林縣,臺西鄉,8496,27468,14807,12661
2007/10/1,雲林縣,元長鄉,9066,29771,16285,13486
2007/10/1,雲林縣,四湖鄉,8736,27632,15238,12394
2007/10/1,雲林縣,口湖鄉,9305,31068,16670,14398
2007/10/1,雲林縣,水林鄉,9670,29828,16376,13452
2007/10/1,嘉義縣,太保市,10379,35657,18559,17098
2007/10/1,嘉義縣,朴子市,13539,44270,22776,21494
2007/10/1,嘉義縣,布袋鎮,9876,31371,16257,15114
2007/10/1,嘉義縣,大林鎮,10850,34430,17810,16620
2007/10/1,嘉義縣,民雄鄉,21542,72698,37560,35138
2007/10/1,嘉義縣,溪口鄉,5178,16837,9003,7834
2007/10/1,嘉義縣,新港鄉,10036,35331,18673,16658
2007/10/1,嘉義縣,六腳鄉,8889,27292,14523,12769
2007/10/1,嘉義縣,東石鄉,9109,28744,15328,13416
2007/10/1,嘉義縣,義竹鄉,7249,21889,11401,10488
2007/10/1,嘉義縣,鹿草鄉,5518,17503,9391,8112
2007/10/1,嘉義縣,水上鄉,17059,53593,27936,25657
2007/10/1,嘉義縣,中埔鄉,14478,48048,25196,22852
2007/10/1,嘉義縣,竹崎鄉,11021,39454,21081,18373
2007/10/1,嘉義縣,梅山鄉,6308,22351,11856,10495
2007/10/1,嘉義縣,番路鄉,3777,11815,6460,5355
2007/10/1,嘉義縣,大埔鄉,1774,3973,2144,1829
2007/10/1,嘉義縣,阿里山鄉,1942,6153,3308,2845
2007/10/1,臺南市,新營區,26138,78939,39651,39288
2007/10/1,臺南市,永康區,70071,210206,105203,105003
2007/10/1,臺南市,鹽水區,9588,27857,14534,13323
2007/10/1,臺南市,白河區,10686,32383,17154,15229
2007/10/1,臺南市,麻豆區,14246,46342,23826,22516
2007/10/1,臺南市,佳里區,18313,59217,29606,29611
2007/10/1,臺南市,新化區,13079,44564,22906,21658
2007/10/1,臺南市,善化區,13532,42544,21709,20835
2007/10/1,臺南市,學甲區,9146,28610,14741,13869
2007/10/1,臺南市,柳營區,7535,23278,12208,11070
2007/10/1,臺南市,後壁區,8395,26559,13850,12709
2007/10/1,臺南市,東山區,7993,23780,12764,11016
2007/10/1,臺南市,下營區,8850,26794,13911,12883
2007/10/1,臺南市,六甲區,7394,24401,12730,11671
2007/10/1,臺南市,官田區,7439,22668,11723,10945
2007/10/1,臺南市,大內區,3995,11352,6084,5268
2007/10/1,臺南市,西港區,7528,25571,13100,12471
2007/10/1,臺南市,七股區,7743,25329,13283,12046
2007/10/1,臺南市,將軍區,7236,22104,11316,10788
2007/10/1,臺南市,北門區,4162,12652,6512,6140
2007/10/1,臺南市,新市區,10367,35460,17862,17598
2007/10/1,臺南市,安定區,8708,30054,15648,14406
2007/10/1,臺南市,山上區,2683,8094,4286,3808
2007/10/1,臺南市,玉井區,4986,15854,8273,7581
2007/10/1,臺南市,楠西區,3587,11040,5875,5165
2007/10/1,臺南市,南化區,2809,8982,4931,4051
2007/10/1,臺南市,左鎮區,1927,5646,3135,2511
2007/10/1,臺南市,仁德區,22938,67853,35081,32772
2007/10/1,臺南市,歸仁區,19375,65452,33421,32031
2007/10/1,臺南市,關廟區,10442,37051,19284,17767
2007/10/1,臺南市,龍崎區,1554,4425,2408,2017
2007/10/1,高雄市,鳳山區,121164,338825,169954,168871
2007/10/1,高雄市,岡山區,31874,96033,48664,47369
2007/10/1,高雄市,旗山區,13513,41084,21528,19556
2007/10/1,高雄市,美濃區,13558,44156,23212,20944
2007/10/1,高雄市,林園區,23334,71334,36868,34466
2007/10/1,高雄市,大寮區,36424,109352,57216,52136
2007/10/1,高雄市,大樹區,12871,44906,23385,21521
2007/10/1,高雄市,仁武區,23170,67652,35044,32608
2007/10/1,高雄市,大社區,11180,32643,16835,15808
2007/10/1,高雄市,鳥松區,15551,41248,21086,20162
2007/10/1,高雄市,橋頭區,12226,36719,18959,17760
2007/10/1,高雄市,燕巢區,9559,31288,16755,14533
2007/10/1,高雄市,田寮區,3597,8604,4812,3792
2007/10/1,高雄市,阿蓮區,8850,30897,15636,15261
2007/10/1,高雄市,路竹區,15379,54558,27914,26644
2007/10/1,高雄市,湖內區,9036,28632,14832,13800
2007/10/1,高雄市,茄萣區,9882,32005,16813,15192
2007/10/1,高雄市,永安區,5617,14217,7319,6898
2007/10/1,高雄市,彌陀區,6384,20819,10942,9877
2007/10/1,高雄市,梓官區,11475,37244,19557,17687
2007/10/1,高雄市,六龜區,5658,15680,8552,7128
2007/10/1,高雄市,甲仙區,2565,8234,4445,3789
2007/10/1,高雄市,杉林區,3999,11408,6286,5122
2007/10/1,高雄市,內門區,4965,16568,9051,7517
2007/10/1,高雄市,茂林區,520,1748,893,855
2007/10/1,高雄市,桃源區,1206,4788,2577,2211
2007/10/1,屏東縣,屏東市,70705,215975,108318,107657
2007/10/1,屏東縣,潮州鎮,17539,56933,28796,28137
2007/10/1,屏東縣,東港鎮,14576,50481,25782,24699
2007/10/1,屏東縣,恆春鎮,10252,31267,16263,15004
2007/10/1,屏東縣,萬丹鄉,13693,54494,28298,26196
2007/10/1,屏東縣,長治鄉,9437,30962,16304,14658
2007/10/1,屏東縣,麟洛鄉,3448,11695,6072,5623
2007/10/1,屏東縣,九如鄉,6390,23236,12094,11142
2007/10/1,屏東縣,里港鄉,7763,26504,13658,12846
2007/10/1,屏東縣,鹽埔鄉,7449,27785,14514,13271
2007/10/1,屏東縣,高樹鄉,9499,27562,14784,12778
2007/10/1,屏東縣,萬巒鄉,6279,22730,12026,10704
2007/10/1,屏東縣,內埔鄉,17194,59441,31111,28330
2007/10/1,屏東縣,竹田鄉,5342,18523,9908,8615
2007/10/1,屏東縣,新埤鄉,3289,11096,5904,5192
2007/10/1,屏東縣,枋寮鄉,8246,27431,14557,12874
2007/10/1,屏東縣,新園鄉,10810,39561,20531,19030
2007/10/1,屏東縣,崁頂鄉,3946,17016,8810,8206
2007/10/1,屏東縣,林邊鄉,6160,21343,11090,10253
2007/10/1,屏東縣,南州鄉,3573,12155,6245,5910
2007/10/1,屏東縣,佳冬鄉,6587,21816,11421,10395
2007/10/1,屏東縣,琉球鄉,3732,12673,7029,5644
2007/10/1,屏東縣,車城鄉,3393,10126,5479,4647
2007/10/1,屏東縣,滿州鄉,2966,8674,4759,3915
2007/10/1,屏東縣,枋山鄉,2107,6236,3371,2865
2007/10/1,屏東縣,三地門鄉,2018,7257,3725,3532
2007/10/1,屏東縣,霧臺鄉,827,2741,1462,1279
2007/10/1,屏東縣,瑪家鄉,1801,6522,3411,3111
2007/10/1,屏東縣,泰武鄉,1078,4907,2624,2283
2007/10/1,屏東縣,來義鄉,2070,7790,4029,3761
2007/10/1,屏東縣,春日鄉,1268,4999,2622,2377
2007/10/1,屏東縣,獅子鄉,1416,4967,2649,2318
2007/10/1,屏東縣,牡丹鄉,1762,4895,2556,2339
2007/10/1,臺東縣,臺東市,36866,110232,56303,53929
2007/10/1,臺東縣,成功鎮,5310,16406,8817,7589
2007/10/1,臺東縣,關山鎮,3178,9997,5282,4715
2007/10/1,臺東縣,卑南鄉,6436,18535,10188,8347
2007/10/1,臺東縣,大武鄉,2457,7099,3739,3360
2007/10/1,臺東縣,太麻里鄉,4463,12232,6584,5648
2007/10/1,臺東縣,東河鄉,3421,9724,5403,4321
2007/10/1,臺東縣,長濱鄉,2836,8864,5036,3828
2007/10/1,臺東縣,鹿野鄉,3081,8943,4845,4098
2007/10/1,臺東縣,池上鄉,3173,9493,5080,4413
2007/10/1,臺東縣,綠島鄉,889,3088,1642,1446
2007/10/1,臺東縣,延平鄉,1062,3633,2039,1594
2007/10/1,臺東縣,海端鄉,1072,4590,2499,2091
2007/10/1,臺東縣,達仁鄉,1391,3740,2066,1674
2007/10/1,臺東縣,金峰鄉,984,3321,1761,1560
2007/10/1,臺東縣,蘭嶼鄉,1201,3944,2084,1860
2007/10/1,花蓮縣,花蓮市,39006,109818,54336,55482
2007/10/1,花蓮縣,鳳林鎮,4386,12518,6662,5856
2007/10/1,花蓮縣,玉里鎮,8768,28217,15419,12798
2007/10/1,花蓮縣,新城鄉,7130,20553,10752,9801
2007/10/1,花蓮縣,吉安鄉,27339,78940,40765,38175
2007/10/1,花蓮縣,壽豐鄉,6663,19323,10529,8794
2007/10/1,花蓮縣,光復鄉,4985,14711,7884,6827
2007/10/1,花蓮縣,豐濱鄉,1817,5363,2987,2376
2007/10/1,花蓮縣,瑞穗鄉,4514,13397,7285,6112
2007/10/1,花蓮縣,富里鄉,3876,12081,6688,5393
2007/10/1,花蓮縣,秀林鄉,4457,14956,7845,7111
2007/10/1,花蓮縣,萬榮鄉,2143,7134,3823,3311
2007/10/1,花蓮縣,卓溪鄉,1601,6563,3648,2915
2007/10/1,澎湖縣,馬公市,17753,54385,27713,26672
2007/10/1,澎湖縣,湖西鄉,4257,12844,6729,6115
2007/10/1,澎湖縣,白沙鄉,2934,9157,4856,4301
2007/10/1,澎湖縣,西嶼鄉,2663,8172,4241,3931
2007/10/1,澎湖縣,望安鄉,1704,4437,2374,2063
2007/10/1,澎湖縣,七美鄉,1105,3179,1691,1488
2007/10/1,基隆市,中正區,21697,57679,29707,27972
2007/10/1,基隆市,七堵區,19086,55163,28112,27051
2007/10/1,基隆市,暖暖區,14037,38458,19682,18776
2007/10/1,基隆市,仁愛區,18849,50216,25091,25125
2007/10/1,基隆市,中山區,18659,52445,26912,25533
2007/10/1,基隆市,安樂區,30844,85222,42525,42697
2007/10/1,基隆市,信義區,19315,51127,25751,25376
2007/10/1,新竹市,東區,63007,189571,94152,95419
2007/10/1,新竹市,北區,46251,138661,69322,69339
2007/10/1,新竹市,香山區,20836,69800,35842,33958
2007/10/1,臺中市,中區,8433,23981,11854,12127
2007/10/1,臺中市,東區,24813,73662,37485,36177
2007/10/1,臺中市,西區,41220,116401,56264,60137
2007/10/1,臺中市,南區,39168,110029,53771,56258
2007/10/1,臺中市,北區,53293,147222,71850,75372
2007/10/1,臺中市,西屯區,66881,197659,96591,101068
2007/10/1,臺中市,南屯區,48625,145610,70473,75137
2007/10/1,臺中市,北屯區,78169,239264,116862,122402
2007/10/1,嘉義市,東區,43325,128531,63050,65481
2007/10/1,嘉義市,西區,47515,144320,72002,72318
2007/10/1,臺南市,東區,68138,193483,94159,99324
2007/10/1,臺南市,南區,41782,127730,64384,63346
2007/10/1,臺南市,北區,45004,128244,63884,64360
2007/10/1,臺南市,安南區,50897,173885,88959,84926
2007/10/1,臺南市,安平區,21176,59127,28464,30663
2007/10/1,臺南市,中西區,29587,81287,40118,41169
2007/10/1,臺北市,松山區,76207,210378,100029,110349
2007/10/1,臺北市,信義區,84665,228883,111438,117445
2007/10/1,臺北市,大安區,114164,314004,149043,164961
2007/10/1,臺北市,中山區,87219,218078,103779,114299
2007/10/1,臺北市,中正區,60020,159227,77332,81895
2007/10/1,臺北市,大同區,45571,126203,62739,63464
2007/10/1,臺北市,萬華區,72374,192611,97145,95466
2007/10/1,臺北市,文山區,93606,261321,127433,133888
2007/10/1,臺北市,南港區,39565,113511,56479,57032
2007/10/1,臺北市,內湖區,90869,265389,128824,136565
2007/10/1,臺北市,士林區,97095,286768,140259,146509
2007/10/1,臺北市,北投區,85857,249731,121978,127753
2007/10/1,高雄市,鹽埕區,11218,28631,14573,14058
2007/10/1,高雄市,鼓山區,46443,122038,60668,61370
2007/10/1,高雄市,左營區,69735,185595,92305,93290
2007/10/1,高雄市,楠梓區,58475,168395,84157,84238
2007/10/1,高雄市,三民區,127834,360469,177829,182640
2007/10/1,高雄市,新興區,22780,57423,28216,29207
2007/10/1,高雄市,前金區,12339,30005,14784,15221
2007/10/1,高雄市,苓雅區,69928,188143,92228,95915
2007/10/1,高雄市,前鎮區,72899,200304,100593,99711
2007/10/1,高雄市,旗津區,10643,30033,15754,14279
2007/10/1,高雄市,小港區,58312,151421,76827,74594
2007/10/1,金門縣,金城鎮,9901,27671,14634,13037
2007/10/1,金門縣,金湖鎮,6461,18009,9583,8426
2007/10/1,金門縣,金沙鎮,4923,12929,6824,6105
2007/10/1,金門縣,金寧鄉,5463,14556,7874,6682
2007/10/1,金門縣,烈嶼鄉,2288,7038,3734,3304
2007/10/1,金門縣,烏坵鄉,134,433,223,210
2007/10/1,連江縣,南竿鄉,1075,5930,3447,2483
2007/10/1,連江縣,北竿鄉,372,1823,1082,741
2007/10/1,連江縣,莒光鄉,233,1175,690,485
2007/10/1,連江縣,東引鄉,248,992,588,404
2007/11/1,總計,臺灣地區,7473892,22854745,11555412,11299333
2007/11/1,總計,臺灣省,5966134,18707507,9522185,9185322
2007/11/1,總計,新北市,1307205,3794929,1897971,1896958
2007/11/1,總計,宜蘭縣,146802,460358,235963,224395
2007/11/1,總計,桃園市,618946,1932908,980598,952310
2007/11/1,總計,新竹縣,147380,495351,256398,238953
2007/11/1,總計,苗栗縣,162965,560050,292503,267547
2007/11/1,總計,臺中市,442360,1549852,788953,760899
2007/11/1,總計,彰化縣,347973,1314013,677477,636536
2007/11/1,總計,南投縣,164046,533709,276423,257286
2007/11/1,總計,雲林縣,218740,725759,381180,344579
2007/11/1,總計,嘉義縣,168698,551363,289232,262131
2007/11/1,總計,臺南市,352854,1105249,567051,538198
2007/11/1,總計,高雄市,414696,1244077,640868,603209
2007/11/1,總計,屏東縣,266782,889698,460106,429592
2007/11/1,總計,臺東縣,77870,233725,123283,110442
2007/11/1,總計,花蓮縣,116706,343461,178511,164950
2007/11/1,總計,澎湖縣,30469,92239,47632,44607
2007/11/1,總計,基隆市,142550,390339,197784,192555
2007/11/1,總計,新竹市,130228,398539,199491,199048
2007/11/1,總計,臺中市,361101,1054842,515580,539262
2007/11/1,總計,嘉義市,90945,272899,135060,137839
2007/11/1,總計,臺南市,256818,764147,380121,384026
2007/11/1,總計,臺北市,947443,2627527,1276883,1350644
2007/11/1,總計,高雄市,560315,1519711,756344,763367
2007/11/1,總計,福建省,31182,91037,48977,42060
2007/11/1,總計,金門縣,29254,81101,43166,37935
2007/11/1,總計,連江縣,1928,9936,5811,4125
2007/11/1,新北市,板橋區,182344,547147,272799,274348
2007/11/1,新北市,三重區,130569,383487,192451,191036
2007/11/1,新北市,永和區,87735,236238,114021,122217
2007/11/1,新北市,中和區,146282,409974,204029,205945
2007/11/1,新北市,新莊區,129158,396094,196857,199237
2007/11/1,新北市,新店區,110452,290563,143559,147004
2007/11/1,新北市,土城區,78286,237366,119226,118140
2007/11/1,新北市,蘆洲區,61156,191784,95438,96346
2007/11/1,新北市,汐止區,73860,180824,90523,90301
2007/11/1,新北市,樹林區,52149,164508,83401,81107
2007/11/1,新北市,鶯歌區,25564,85661,43677,41984
2007/11/1,新北市,三峽區,30514,94829,48958,45871
2007/11/1,新北市,淡水區,49535,131960,64936,67024
2007/11/1,新北市,瑞芳區,15457,43557,22353,21204
2007/11/1,新北市,五股區,25497,77241,39379,37862
2007/11/1,新北市,泰山區,24591,74345,37654,36691
2007/11/1,新北市,林口區,22143,66709,33336,33373
2007/11/1,新北市,深坑區,8169,22268,11355,10913
2007/11/1,新北市,石碇區,3137,7862,4374,3488
2007/11/1,新北市,坪林區,2351,6614,3714,2900
2007/11/1,新北市,三芝區,8506,23609,12300,11309
2007/11/1,新北市,石門區,3650,11810,6270,5540
2007/11/1,新北市,八里區,11076,32700,16776,15924
2007/11/1,新北市,平溪區,2337,5631,3156,2475
2007/11/1,新北市,雙溪區,3780,9965,5388,4577
2007/11/1,新北市,貢寮區,4293,14016,7304,6712
2007/11/1,新北市,金山區,6406,22205,11326,10879
2007/11/1,新北市,萬里區,6545,20572,10624,9948
2007/11/1,新北市,烏來區,1663,5390,2787,2603
2007/11/1,宜蘭縣,宜蘭市,31961,96079,47607,48472
2007/11/1,宜蘭縣,羅東鎮,24109,74188,35715,38473
2007/11/1,宜蘭縣,蘇澳鎮,13039,42889,22269,20620
2007/11/1,宜蘭縣,頭城鎮,9208,31643,16445,15198
2007/11/1,宜蘭縣,礁溪鄉,11691,35925,18889,17036
2007/11/1,宜蘭縣,壯圍鄉,7756,25273,13360,11913
2007/11/1,宜蘭縣,員山鄉,10201,32350,17440,14910
2007/11/1,宜蘭縣,冬山鄉,16251,51346,26585,24761
2007/11/1,宜蘭縣,五結鄉,12124,37809,19802,18007
2007/11/1,宜蘭縣,三星鄉,6979,21213,11514,9699
2007/11/1,宜蘭縣,大同鄉,1766,5828,3236,2592
2007/11/1,宜蘭縣,南澳鄉,1717,5815,3101,2714
2007/11/1,桃園市,桃園區,132992,391198,192429,198769
2007/11/1,桃園市,中壢區,116644,358300,180101,178199
2007/11/1,桃園市,平鎮區,61480,202426,102469,99957
2007/11/1,桃園市,八德區,53121,172065,88403,83662
2007/11/1,桃園市,大溪區,27507,90286,46766,43520
2007/11/1,桃園市,楊梅區,44032,142724,73094,69630
2007/11/1,桃園市,蘆竹區,43017,131786,66524,65262
2007/11/1,桃園市,大園區,23662,79587,41536,38051
2007/11/1,桃園市,龜山區,45969,131552,67329,64223
2007/11/1,桃園市,龍潭區,34582,112682,57607,55075
2007/11/1,桃園市,新屋區,14395,49973,26716,23257
2007/11/1,桃園市,觀音區,17957,59714,31659,28055
2007/11/1,桃園市,復興區,3588,10615,5965,4650
2007/11/1,新竹縣,竹北市,39626,125770,63405,62365
2007/11/1,新竹縣,關西鎮,8863,32719,17497,15222
2007/11/1,新竹縣,新埔鎮,9843,36110,19173,16937
2007/11/1,新竹縣,竹東鎮,28761,96536,48823,47713
2007/11/1,新竹縣,湖口鄉,21984,74161,38099,36062
2007/11/1,新竹縣,橫山鄉,4182,14635,8010,6625
2007/11/1,新竹縣,新豐鄉,14542,51675,26854,24821
2007/11/1,新竹縣,芎林鄉,5939,20773,10943,9830
2007/11/1,新竹縣,寶山鄉,4458,13803,7486,6317
2007/11/1,新竹縣,北埔鄉,2966,10349,5615,4734
2007/11/1,新竹縣,峨眉鄉,1983,6153,3426,2727
2007/11/1,新竹縣,尖石鄉,2566,8206,4524,3682
2007/11/1,新竹縣,五峰鄉,1667,4461,2543,1918
2007/11/1,苗栗縣,苗栗市,27905,91088,46195,44893
2007/11/1,苗栗縣,苑裡鎮,13236,49056,25698,23358
2007/11/1,苗栗縣,通霄鎮,10885,39230,20968,18262
2007/11/1,苗栗縣,竹南鎮,21753,75185,38407,36778
2007/11/1,苗栗縣,頭份市,27136,94453,48392,46061
2007/11/1,苗栗縣,後龍鎮,11348,40480,21487,18993
2007/11/1,苗栗縣,卓蘭鎮,5726,18542,9849,8693
2007/11/1,苗栗縣,大湖鄉,5096,16232,8754,7478
2007/11/1,苗栗縣,公館鄉,9586,34634,18211,16423
2007/11/1,苗栗縣,銅鑼鄉,5818,19869,10590,9279
2007/11/1,苗栗縣,南庄鄉,3819,11445,6372,5073
2007/11/1,苗栗縣,頭屋鄉,3426,11910,6297,5613
2007/11/1,苗栗縣,三義鄉,5079,17683,9380,8303
2007/11/1,苗栗縣,西湖鄉,2557,7990,4442,3548
2007/11/1,苗栗縣,造橋鄉,3855,13861,7330,6531
2007/11/1,苗栗縣,三灣鄉,2287,7513,4097,3416
2007/11/1,苗栗縣,獅潭鄉,1619,5181,2907,2274
2007/11/1,苗栗縣,泰安鄉,1834,5698,3127,2571
2007/11/1,臺中市,豐原區,47047,164431,82081,82350
2007/11/1,臺中市,大里區,57962,192267,95878,96389
2007/11/1,臺中市,太平區,52138,171593,86495,85098
2007/11/1,臺中市,東勢區,16537,54790,28597,26193
2007/11/1,臺中市,大甲區,20764,79267,40254,39013
2007/11/1,臺中市,清水區,23824,85932,44465,41467
2007/11/1,臺中市,沙鹿區,21385,78329,40040,38289
2007/11/1,臺中市,梧棲區,15208,54131,27544,26587
2007/11/1,臺中市,后里區,14192,54551,28271,26280
2007/11/1,臺中市,神岡區,16902,64246,33173,31073
2007/11/1,臺中市,潭子區,30204,97343,48901,48442
2007/11/1,臺中市,大雅區,24906,87856,44549,43307
2007/11/1,臺中市,新社區,7111,25826,13674,12152
2007/11/1,臺中市,石岡區,4653,16171,8409,7762
2007/11/1,臺中市,外埔區,8313,31885,16465,15420
2007/11/1,臺中市,大安區,5097,20781,10977,9804
2007/11/1,臺中市,烏日區,19028,67404,34348,33056
2007/11/1,臺中市,大肚區,15187,55909,28794,27115
2007/11/1,臺中市,龍井區,19315,71796,36803,34993
2007/11/1,臺中市,霧峰區,18103,64476,33242,31234
2007/11/1,臺中市,和平區,4484,10868,5993,4875
2007/11/1,彰化縣,彰化市,68639,235868,118237,117631
2007/11/1,彰化縣,鹿港鎮,21182,85223,43738,41485
2007/11/1,彰化縣,和美鎮,22794,89036,45789,43247
2007/11/1,彰化縣,北斗鎮,9469,33551,17066,16485
2007/11/1,彰化縣,員林市,35147,126076,63699,62377
2007/11/1,彰化縣,溪湖鎮,14470,56611,29083,27528
2007/11/1,彰化縣,田中鎮,12106,45047,23709,21338
2007/11/1,彰化縣,二林鎮,13792,55034,28450,26584
2007/11/1,彰化縣,線西鄉,3925,17035,8789,8246
2007/11/1,彰化縣,伸港鄉,8477,35703,18419,17284
2007/11/1,彰化縣,福興鄉,11464,48927,25699,23228
2007/11/1,彰化縣,秀水鄉,9174,38810,20117,18693
2007/11/1,彰化縣,花壇鄉,12210,46150,23876,22274
2007/11/1,彰化縣,芬園鄉,6743,25350,13481,11869
2007/11/1,彰化縣,大村鄉,9735,36432,19085,17347
2007/11/1,彰化縣,埔鹽鄉,8465,34769,18309,16460
2007/11/1,彰化縣,埔心鄉,9507,35528,18454,17074
2007/11/1,彰化縣,永靖鄉,9988,39736,20698,19038
2007/11/1,彰化縣,社頭鄉,11886,45478,23483,21995
2007/11/1,彰化縣,二水鄉,5168,17125,9049,8076
2007/11/1,彰化縣,田尾鄉,7450,29177,15226,13951
2007/11/1,彰化縣,埤頭鄉,8180,32084,16843,15241
2007/11/1,彰化縣,芳苑鄉,9787,37067,19681,17386
2007/11/1,彰化縣,大城鄉,5286,19258,10531,8727
2007/11/1,彰化縣,竹塘鄉,4473,16733,8877,7856
2007/11/1,彰化縣,溪州鄉,8456,32205,17089,15116
2007/11/1,南投縣,南投市,32065,105682,53434,52248
2007/11/1,南投縣,埔里鎮,27423,86406,43845,42561
2007/11/1,南投縣,草屯鎮,29449,99875,50694,49181
2007/11/1,南投縣,竹山鎮,18015,59337,30802,28535
2007/11/1,南投縣,集集鎮,4081,12115,6363,5752
2007/11/1,南投縣,名間鄉,11689,41667,22045,19622
2007/11/1,南投縣,鹿谷鄉,6269,19584,10456,9128
2007/11/1,南投縣,中寮鄉,5419,16581,9066,7515
2007/11/1,南投縣,魚池鄉,5614,17329,9243,8086
2007/11/1,南投縣,國姓鄉,7022,21496,11813,9683
2007/11/1,南投縣,水里鄉,7123,20923,11046,9877
2007/11/1,南投縣,信義鄉,5025,17262,9409,7853
2007/11/1,南投縣,仁愛鄉,4852,15452,8207,7245
2007/11/1,雲林縣,斗六市,32525,105487,53404,52083
2007/11/1,雲林縣,斗南鎮,14669,47801,24433,23368
2007/11/1,雲林縣,虎尾鎮,21093,69437,35516,33921
2007/11/1,雲林縣,西螺鎮,13588,49279,25135,24144
2007/11/1,雲林縣,土庫鎮,8390,31099,16333,14766
2007/11/1,雲林縣,北港鎮,14806,44360,23158,21202
2007/11/1,雲林縣,古坑鄉,10272,34949,18531,16418
2007/11/1,雲林縣,大埤鄉,6397,21921,11692,10229
2007/11/1,雲林縣,莿桐鄉,8644,30861,16190,14671
2007/11/1,雲林縣,林內鄉,5540,20478,10765,9713
2007/11/1,雲林縣,二崙鄉,8557,30598,16471,14127
2007/11/1,雲林縣,崙背鄉,8012,28099,14917,13182
2007/11/1,雲林縣,麥寮鄉,11220,33261,17788,15473
2007/11/1,雲林縣,東勢鄉,5582,17628,9573,8055
2007/11/1,雲林縣,褒忠鄉,4131,14806,7935,6871
2007/11/1,雲林縣,臺西鄉,8513,27467,14812,12655
2007/11/1,雲林縣,元長鄉,9075,29749,16264,13485
2007/11/1,雲林縣,四湖鄉,8743,27601,15226,12375
2007/11/1,雲林縣,口湖鄉,9309,31031,16654,14377
2007/11/1,雲林縣,水林鄉,9674,29847,16383,13464
2007/11/1,嘉義縣,太保市,10392,35634,18556,17078
2007/11/1,嘉義縣,朴子市,13555,44234,22746,21488
2007/11/1,嘉義縣,布袋鎮,9894,31373,16253,15120
2007/11/1,嘉義縣,大林鎮,10857,34396,17797,16599
2007/11/1,嘉義縣,民雄鄉,21564,72716,37556,35160
2007/11/1,嘉義縣,溪口鄉,5182,16832,9001,7831
2007/11/1,嘉義縣,新港鄉,10043,35347,18683,16664
2007/11/1,嘉義縣,六腳鄉,8902,27317,14523,12794
2007/11/1,嘉義縣,東石鄉,9116,28771,15355,13416
2007/11/1,嘉義縣,義竹鄉,7256,21892,11404,10488
2007/11/1,嘉義縣,鹿草鄉,5529,17505,9395,8110
2007/11/1,嘉義縣,水上鄉,17073,53569,27916,25653
2007/11/1,嘉義縣,中埔鄉,14494,48020,25179,22841
2007/11/1,嘉義縣,竹崎鄉,11022,39458,21086,18372
2007/11/1,嘉義縣,梅山鄉,6310,22356,11870,10486
2007/11/1,嘉義縣,番路鄉,3779,11794,6453,5341
2007/11/1,嘉義縣,大埔鄉,1783,3983,2149,1834
2007/11/1,嘉義縣,阿里山鄉,1947,6166,3310,2856
2007/11/1,臺南市,新營區,26145,78968,39674,39294
2007/11/1,臺南市,永康區,70177,210399,105289,105110
2007/11/1,臺南市,鹽水區,9610,27874,14533,13341
2007/11/1,臺南市,白河區,10701,32358,17144,15214
2007/11/1,臺南市,麻豆區,14252,46330,23808,22522
2007/11/1,臺南市,佳里區,18356,59221,29605,29616
2007/11/1,臺南市,新化區,13078,44552,22902,21650
2007/11/1,臺南市,善化區,13560,42547,21702,20845
2007/11/1,臺南市,學甲區,9159,28600,14734,13866
2007/11/1,臺南市,柳營區,7544,23264,12192,11072
2007/11/1,臺南市,後壁區,8405,26551,13842,12709
2007/11/1,臺南市,東山區,7998,23785,12761,11024
2007/11/1,臺南市,下營區,8864,26784,13905,12879
2007/11/1,臺南市,六甲區,7405,24409,12726,11683
2007/11/1,臺南市,官田區,7450,22681,11724,10957
2007/11/1,臺南市,大內區,3996,11345,6081,5264
2007/11/1,臺南市,西港區,7537,25544,13092,12452
2007/11/1,臺南市,七股區,7742,25324,13280,12044
2007/11/1,臺南市,將軍區,7239,22118,11316,10802
2007/11/1,臺南市,北門區,4161,12634,6507,6127
2007/11/1,臺南市,新市區,10376,35467,17867,17600
2007/11/1,臺南市,安定區,8718,30065,15644,14421
2007/11/1,臺南市,山上區,2691,8116,4295,3821
2007/11/1,臺南市,玉井區,4991,15861,8276,7585
2007/11/1,臺南市,楠西區,3587,11024,5874,5150
2007/11/1,臺南市,南化區,2808,8977,4923,4054
2007/11/1,臺南市,左鎮區,1933,5647,3138,2509
2007/11/1,臺南市,仁德區,22980,67891,35106,32785
2007/11/1,臺南市,歸仁區,19393,65455,33432,32023
2007/11/1,臺南市,關廟區,10444,37028,19269,17759
2007/11/1,臺南市,龍崎區,1554,4430,2410,2020
2007/11/1,高雄市,鳳山區,121236,338820,169941,168879
2007/11/1,高雄市,岡山區,31899,96068,48663,47405
2007/11/1,高雄市,旗山區,13509,41068,21522,19546
2007/11/1,高雄市,美濃區,13566,44129,23185,20944
2007/11/1,高雄市,林園區,23360,71347,36884,34463
2007/11/1,高雄市,大寮區,36459,109344,57214,52130
2007/11/1,高雄市,大樹區,12872,44895,23363,21532
2007/11/1,高雄市,仁武區,23191,67762,35107,32655
2007/11/1,高雄市,大社區,11193,32657,16829,15828
2007/11/1,高雄市,鳥松區,15554,41271,21079,20192
2007/11/1,高雄市,橋頭區,12215,36676,18947,17729
2007/11/1,高雄市,燕巢區,9570,31244,16729,14515
2007/11/1,高雄市,田寮區,3593,8570,4795,3775
2007/11/1,高雄市,阿蓮區,8864,30911,15639,15272
2007/11/1,高雄市,路竹區,15384,54541,27914,26627
2007/11/1,高雄市,湖內區,9040,28628,14829,13799
2007/11/1,高雄市,茄萣區,9899,32023,16817,15206
2007/11/1,高雄市,永安區,5628,14215,7315,6900
2007/11/1,高雄市,彌陀區,6385,20814,10937,9877
2007/11/1,高雄市,梓官區,11487,37220,19547,17673
2007/11/1,高雄市,六龜區,5666,15668,8542,7126
2007/11/1,高雄市,甲仙區,2562,8223,4434,3789
2007/11/1,高雄市,杉林區,3996,11387,6275,5112
2007/11/1,高雄市,內門區,4966,16574,9057,7517
2007/11/1,高雄市,茂林區,520,1754,896,858
2007/11/1,高雄市,桃源區,1207,4784,2574,2210
2007/11/1,屏東縣,屏東市,70746,215929,108300,107629
2007/11/1,屏東縣,潮州鎮,17540,56910,28771,28139
2007/11/1,屏東縣,東港鎮,14602,50524,25789,24735
2007/11/1,屏東縣,恆春鎮,10276,31295,16261,15034
2007/11/1,屏東縣,萬丹鄉,13695,54522,28317,26205
2007/11/1,屏東縣,長治鄉,9457,30990,16301,14689
2007/11/1,屏東縣,麟洛鄉,3451,11683,6066,5617
2007/11/1,屏東縣,九如鄉,6396,23224,12089,11135
2007/11/1,屏東縣,里港鄉,7762,26511,13659,12852
2007/11/1,屏東縣,鹽埔鄉,7445,27785,14505,13280
2007/11/1,屏東縣,高樹鄉,9499,27551,14777,12774
2007/11/1,屏東縣,萬巒鄉,6278,22719,12016,10703
2007/11/1,屏東縣,內埔鄉,17222,59476,31139,28337
2007/11/1,屏東縣,竹田鄉,5341,18501,9897,8604
2007/11/1,屏東縣,新埤鄉,3290,11080,5899,5181
2007/11/1,屏東縣,枋寮鄉,8249,27422,14548,12874
2007/11/1,屏東縣,新園鄉,10809,39509,20506,19003
2007/11/1,屏東縣,崁頂鄉,3952,17053,8833,8220
2007/11/1,屏東縣,林邊鄉,6164,21318,11081,10237
2007/11/1,屏東縣,南州鄉,3575,12161,6247,5914
2007/11/1,屏東縣,佳冬鄉,6591,21799,11413,10386
2007/11/1,屏東縣,琉球鄉,3734,12680,7037,5643
2007/11/1,屏東縣,車城鄉,3380,10091,5458,4633
2007/11/1,屏東縣,滿州鄉,2969,8668,4758,3910
2007/11/1,屏東縣,枋山鄉,2108,6244,3374,2870
2007/11/1,屏東縣,三地門鄉,2023,7246,3720,3526
2007/11/1,屏東縣,霧臺鄉,827,2733,1460,1273
2007/11/1,屏東縣,瑪家鄉,1802,6524,3410,3114
2007/11/1,屏東縣,泰武鄉,1080,4913,2625,2288
2007/11/1,屏東縣,來義鄉,2068,7795,4032,3763
2007/11/1,屏東縣,春日鄉,1267,4993,2621,2372
2007/11/1,屏東縣,獅子鄉,1421,4960,2642,2318
2007/11/1,屏東縣,牡丹鄉,1763,4889,2555,2334
2007/11/1,臺東縣,臺東市,36906,110227,56298,53929
2007/11/1,臺東縣,成功鎮,5318,16415,8821,7594
2007/11/1,臺東縣,關山鎮,3175,9991,5283,4708
2007/11/1,臺東縣,卑南鄉,6427,18463,10147,8316
2007/11/1,臺東縣,大武鄉,2459,7100,3731,3369
2007/11/1,臺東縣,太麻里鄉,4468,12218,6573,5645
2007/11/1,臺東縣,東河鄉,3432,9718,5395,4323
2007/11/1,臺東縣,長濱鄉,2838,8854,5026,3828
2007/11/1,臺東縣,鹿野鄉,3083,8936,4837,4099
2007/11/1,臺東縣,池上鄉,3168,9485,5070,4415
2007/11/1,臺東縣,綠島鄉,894,3093,1650,1443
2007/11/1,臺東縣,延平鄉,1058,3629,2041,1588
2007/11/1,臺東縣,海端鄉,1071,4584,2498,2086
2007/11/1,臺東縣,達仁鄉,1391,3738,2063,1675
2007/11/1,臺東縣,金峰鄉,983,3324,1764,1560
2007/11/1,臺東縣,蘭嶼鄉,1199,3950,2086,1864
2007/11/1,花蓮縣,花蓮市,39015,109811,54312,55499
2007/11/1,花蓮縣,鳳林鎮,4385,12477,6637,5840
2007/11/1,花蓮縣,玉里鎮,8784,28197,15395,12802
2007/11/1,花蓮縣,新城鄉,7123,20529,10733,9796
2007/11/1,花蓮縣,吉安鄉,27334,78940,40765,38175
2007/11/1,花蓮縣,壽豐鄉,6675,19338,10535,8803
2007/11/1,花蓮縣,光復鄉,4978,14698,7877,6821
2007/11/1,花蓮縣,豐濱鄉,1818,5362,2983,2379
2007/11/1,花蓮縣,瑞穗鄉,4515,13380,7279,6101
2007/11/1,花蓮縣,富里鄉,3876,12065,6672,5393
2007/11/1,花蓮縣,秀林鄉,4452,14952,7845,7107
2007/11/1,花蓮縣,萬榮鄉,2147,7149,3832,3317
2007/11/1,花蓮縣,卓溪鄉,1604,6563,3646,2917
2007/11/1,澎湖縣,馬公市,17789,54441,27743,26698
2007/11/1,澎湖縣,湖西鄉,4266,12850,6722,6128
2007/11/1,澎湖縣,白沙鄉,2934,9170,4866,4304
2007/11/1,澎湖縣,西嶼鄉,2664,8165,4238,3927
2007/11/1,澎湖縣,望安鄉,1711,4429,2369,2060
2007/11/1,澎湖縣,七美鄉,1105,3184,1694,1490
2007/11/1,基隆市,中正區,21701,57644,29692,27952
2007/11/1,基隆市,七堵區,19080,55136,28108,27028
2007/11/1,基隆市,暖暖區,14031,38448,19656,18792
2007/11/1,基隆市,仁愛區,18866,50297,25108,25189
2007/11/1,基隆市,中山區,18655,52402,26892,25510
2007/11/1,基隆市,安樂區,30883,85262,42565,42697
2007/11/1,基隆市,信義區,19334,51150,25763,25387
2007/11/1,新竹市,東區,63069,189828,94244,95584
2007/11/1,新竹市,北區,46295,138843,69385,69458
2007/11/1,新竹市,香山區,20864,69868,35862,34006
2007/11/1,臺中市,中區,8438,23978,11838,12140
2007/11/1,臺中市,東區,24842,73731,37498,36233
2007/11/1,臺中市,西區,41289,116547,56337,60210
2007/11/1,臺中市,南區,39241,110200,53836,56364
2007/11/1,臺中市,北區,53383,147351,71894,75457
2007/11/1,臺中市,西屯區,66960,197854,96688,101166
2007/11/1,臺中市,南屯區,48711,145797,70561,75236
2007/11/1,臺中市,北屯區,78237,239384,116928,122456
2007/11/1,嘉義市,東區,43353,128445,63011,65434
2007/11/1,嘉義市,西區,47592,144454,72049,72405
2007/11/1,臺南市,東區,68185,193534,94190,99344
2007/11/1,臺南市,南區,41821,127735,64387,63348
2007/11/1,臺南市,北區,45050,128298,63865,64433
2007/11/1,臺南市,安南區,50969,174086,89060,85026
2007/11/1,臺南市,安平區,21199,59213,28508,30705
2007/11/1,臺南市,中西區,29594,81281,40111,41170
2007/11/1,臺北市,松山區,76262,210560,100064,110496
2007/11/1,臺北市,信義區,84656,228819,111385,117434
2007/11/1,臺北市,大安區,114171,314454,149147,165307
2007/11/1,臺北市,中山區,87230,218213,103832,114381
2007/11/1,臺北市,中正區,60042,159330,77352,81978
2007/11/1,臺北市,大同區,45563,126186,62720,63466
2007/11/1,臺北市,萬華區,72367,192561,97116,95445
2007/11/1,臺北市,文山區,93639,261528,127578,133950
2007/11/1,臺北市,南港區,39581,113582,56488,57094
2007/11/1,臺北市,內湖區,90896,265494,128853,136641
2007/11/1,臺北市,士林區,97169,286906,140286,146620
2007/11/1,臺北市,北投區,85867,249894,122062,127832
2007/11/1,高雄市,鹽埕區,11229,28617,14563,14054
2007/11/1,高雄市,鼓山區,46582,122307,60789,61518
2007/11/1,高雄市,左營區,69793,185758,92381,93377
2007/11/1,高雄市,楠梓區,58580,168568,84243,84325
2007/11/1,高雄市,三民區,127915,360612,177891,182721
2007/11/1,高雄市,新興區,22772,57390,28215,29175
2007/11/1,高雄市,前金區,12330,29964,14749,15215
2007/11/1,高雄市,苓雅區,69927,187997,92160,95837
2007/11/1,高雄市,前鎮區,72996,200418,100599,99819
2007/11/1,高雄市,旗津區,10664,30067,15763,14304
2007/11/1,高雄市,小港區,58402,151497,76825,74672
2007/11/1,金門縣,金城鎮,9928,27820,14737,13083
2007/11/1,金門縣,金湖鎮,6487,18088,9634,8454
2007/11/1,金門縣,金沙鎮,4928,12967,6840,6127
2007/11/1,金門縣,金寧鄉,5481,14728,7987,6741
2007/11/1,金門縣,烈嶼鄉,2296,7063,3745,3318
2007/11/1,金門縣,烏坵鄉,134,435,223,212
2007/11/1,連江縣,南竿鄉,1076,5937,3447,2490
2007/11/1,連江縣,北竿鄉,370,1823,1083,740
2007/11/1,連江縣,莒光鄉,233,1182,693,489
2007/11/1,連江縣,東引鄉,249,994,588,406
2007/12/1,總計,臺灣地區,7481207,22866867,11559552,11307315
2007/12/1,總計,臺灣省,5972541,18717043,9525389,9191654
2007/12/1,總計,新北市,1308848,3798015,1899122,1898893
2007/12/1,總計,宜蘭縣,146924,460398,235952,224446
2007/12/1,總計,桃園市,619870,1934968,981486,953482
2007/12/1,總計,新竹縣,147635,495821,256596,239225
2007/12/1,總計,苗栗縣,163163,560163,292522,267641
2007/12/1,總計,臺中市,442923,1550896,789358,761538
2007/12/1,總計,彰化縣,348265,1314354,677590,636764
2007/12/1,總計,南投縣,164152,533717,276368,257349
2007/12/1,總計,雲林縣,218962,725672,381078,344594
2007/12/1,總計,嘉義縣,168916,551345,289202,262143
2007/12/1,總計,臺南市,353149,1105403,567059,538344
2007/12/1,總計,高雄市,414985,1244313,640859,603454
2007/12/1,總計,屏東縣,266942,889563,459947,429616
2007/12/1,總計,臺東縣,77892,233660,123197,110463
2007/12/1,總計,花蓮縣,116766,343302,178376,164926
2007/12/1,總計,澎湖縣,30525,92390,47705,44685
2007/12/1,總計,基隆市,142640,390397,197788,192609
2007/12/1,總計,新竹市,130420,399035,199683,199352
2007/12/1,總計,臺中市,361503,1055898,516052,539846
2007/12/1,總計,嘉義市,91065,273075,135112,137963
2007/12/1,總計,臺南市,256996,764658,380337,384321
2007/12/1,總計,臺北市,947745,2629269,1277556,1351713
2007/12/1,總計,高雄市,560921,1520555,756607,763948
2007/12/1,總計,福建省,31242,91493,49215,42278
2007/12/1,總計,金門縣,29315,81547,43399,38148
2007/12/1,總計,連江縣,1927,9946,5816,4130
2007/12/1,新北市,板橋區,182683,547625,272988,274637
2007/12/1,新北市,三重區,130671,383621,192463,191158
2007/12/1,新北市,永和區,87767,236413,114086,122327
2007/12/1,新北市,中和區,146413,410183,204057,206126
2007/12/1,新北市,新莊區,129259,396337,196938,199399
2007/12/1,新北市,新店區,110477,290590,143543,147047
2007/12/1,新北市,土城區,78305,237443,119235,118208
2007/12/1,新北市,蘆洲區,61274,192066,95560,96506
2007/12/1,新北市,汐止區,73980,180993,90607,90386
2007/12/1,新北市,樹林區,52230,164723,83505,81218
2007/12/1,新北市,鶯歌區,25593,85656,43679,41977
2007/12/1,新北市,三峽區,30639,95024,49056,45968
2007/12/1,新北市,淡水區,49618,132101,64991,67110
2007/12/1,新北市,瑞芳區,15460,43526,22330,21196
2007/12/1,新北市,五股區,25545,77329,39419,37910
2007/12/1,新北市,泰山區,24611,74422,37693,36729
2007/12/1,新北市,林口區,22331,67127,33521,33606
2007/12/1,新北市,深坑區,8178,22301,11370,10931
2007/12/1,新北市,石碇區,3138,7846,4366,3480
2007/12/1,新北市,坪林區,2355,6607,3713,2894
2007/12/1,新北市,三芝區,8529,23613,12301,11312
2007/12/1,新北市,石門區,3654,11857,6295,5562
2007/12/1,新北市,八里區,11090,32738,16793,15945
2007/12/1,新北市,平溪區,2335,5627,3146,2481
2007/12/1,新北市,雙溪區,3780,9963,5395,4568
2007/12/1,新北市,貢寮區,4301,14032,7311,6721
2007/12/1,新北市,金山區,6409,22215,11320,10895
2007/12/1,新北市,萬里區,6557,20635,10650,9985
2007/12/1,新北市,烏來區,1666,5402,2791,2611
2007/12/1,宜蘭縣,宜蘭市,31955,96094,47619,48475
2007/12/1,宜蘭縣,羅東鎮,24126,74173,35703,38470
2007/12/1,宜蘭縣,蘇澳鎮,13056,42915,22263,20652
2007/12/1,宜蘭縣,頭城鎮,9214,31610,16432,15178
2007/12/1,宜蘭縣,礁溪鄉,11695,35900,18882,17018
2007/12/1,宜蘭縣,壯圍鄉,7760,25271,13349,11922
2007/12/1,宜蘭縣,員山鄉,10215,32345,17437,14908
2007/12/1,宜蘭縣,冬山鄉,16272,51391,26611,24780
2007/12/1,宜蘭縣,五結鄉,12150,37821,19804,18017
2007/12/1,宜蘭縣,三星鄉,6988,21203,11501,9702
2007/12/1,宜蘭縣,大同鄉,1771,5830,3234,2596
2007/12/1,宜蘭縣,南澳鄉,1722,5845,3117,2728
2007/12/1,桃園市,桃園區,133210,391822,192720,199102
2007/12/1,桃園市,中壢區,116831,358656,180279,178377
2007/12/1,桃園市,平鎮區,61569,202680,102544,100136
2007/12/1,桃園市,八德區,53205,172125,88419,83706
2007/12/1,桃園市,大溪區,27532,90393,46801,43592
2007/12/1,桃園市,楊梅區,44120,142895,73180,69715
2007/12/1,桃園市,蘆竹區,43059,131942,66593,65349
2007/12/1,桃園市,大園區,23671,79627,41548,38079
2007/12/1,桃園市,龜山區,46059,131691,67396,64295
2007/12/1,桃園市,龍潭區,34635,112758,57636,55122
2007/12/1,桃園市,新屋區,14402,49961,26707,23254
2007/12/1,桃園市,觀音區,17990,59799,31702,28097
2007/12/1,桃園市,復興區,3587,10619,5961,4658
2007/12/1,新竹縣,竹北市,39804,126255,63641,62614
2007/12/1,新竹縣,關西鎮,8858,32673,17470,15203
2007/12/1,新竹縣,新埔鎮,9861,36102,19177,16925
2007/12/1,新竹縣,竹東鎮,28795,96546,48820,47726
2007/12/1,新竹縣,湖口鄉,21997,74214,38112,36102
2007/12/1,新竹縣,橫山鄉,4180,14635,8007,6628
2007/12/1,新竹縣,新豐鄉,14554,51664,26836,24828
2007/12/1,新竹縣,芎林鄉,5944,20778,10947,9831
2007/12/1,新竹縣,寶山鄉,4461,13788,7476,6312
2007/12/1,新竹縣,北埔鄉,2968,10341,5613,4728
2007/12/1,新竹縣,峨眉鄉,1983,6154,3425,2729
2007/12/1,新竹縣,尖石鄉,2565,8207,4524,3683
2007/12/1,新竹縣,五峰鄉,1665,4464,2548,1916
2007/12/1,苗栗縣,苗栗市,27913,91082,46187,44895
2007/12/1,苗栗縣,苑裡鎮,13247,49071,25708,23363
2007/12/1,苗栗縣,通霄鎮,10887,39218,20965,18253
2007/12/1,苗栗縣,竹南鎮,21777,75246,38412,36834
2007/12/1,苗栗縣,頭份市,27198,94525,48414,46111
2007/12/1,苗栗縣,後龍鎮,11362,40460,21473,18987
2007/12/1,苗栗縣,卓蘭鎮,5742,18536,9847,8689
2007/12/1,苗栗縣,大湖鄉,5110,16218,8744,7474
2007/12/1,苗栗縣,公館鄉,9604,34647,18221,16426
2007/12/1,苗栗縣,銅鑼鄉,5828,19885,10597,9288
2007/12/1,苗栗縣,南庄鄉,3826,11449,6376,5073
2007/12/1,苗栗縣,頭屋鄉,3428,11906,6293,5613
2007/12/1,苗栗縣,三義鄉,5081,17687,9377,8310
2007/12/1,苗栗縣,西湖鄉,2558,7985,4439,3546
2007/12/1,苗栗縣,造橋鄉,3855,13857,7331,6526
2007/12/1,苗栗縣,三灣鄉,2291,7496,4093,3403
2007/12/1,苗栗縣,獅潭鄉,1622,5188,2910,2278
2007/12/1,苗栗縣,泰安鄉,1834,5707,3135,2572
2007/12/1,臺中市,豐原區,47120,164619,82136,82483
2007/12/1,臺中市,大里區,58054,192437,95953,96484
2007/12/1,臺中市,太平區,52199,171628,86532,85096
2007/12/1,臺中市,東勢區,16547,54790,28597,26193
2007/12/1,臺中市,大甲區,20784,79264,40246,39018
2007/12/1,臺中市,清水區,23862,85948,44478,41470
2007/12/1,臺中市,沙鹿區,21420,78436,40071,38365
2007/12/1,臺中市,梧棲區,15230,54195,27568,26627
2007/12/1,臺中市,后里區,14193,54562,28270,26292
2007/12/1,臺中市,神岡區,16920,64271,33190,31081
2007/12/1,臺中市,潭子區,30253,97416,48937,48479
2007/12/1,臺中市,大雅區,24945,87976,44588,43388
2007/12/1,臺中市,新社區,7126,25820,13675,12145
2007/12/1,臺中市,石岡區,4657,16167,8410,7757
2007/12/1,臺中市,外埔區,8323,31888,16459,15429
2007/12/1,臺中市,大安區,5093,20787,10969,9818
2007/12/1,臺中市,烏日區,19047,67445,34365,33080
2007/12/1,臺中市,大肚區,15197,55932,28813,27119
2007/12/1,臺中市,龍井區,19347,71961,36870,35091
2007/12/1,臺中市,霧峰區,18120,64474,33234,31240
2007/12/1,臺中市,和平區,4486,10880,5997,4883
2007/12/1,彰化縣,彰化市,68699,235998,118297,117701
2007/12/1,彰化縣,鹿港鎮,21205,85239,43764,41475
2007/12/1,彰化縣,和美鎮,22826,89053,45785,43268
2007/12/1,彰化縣,北斗鎮,9474,33548,17068,16480
2007/12/1,彰化縣,員林市,35181,126189,63751,62438
2007/12/1,彰化縣,溪湖鎮,14479,56607,29083,27524
2007/12/1,彰化縣,田中鎮,12116,45061,23705,21356
2007/12/1,彰化縣,二林鎮,13800,55045,28463,26582
2007/12/1,彰化縣,線西鄉,3920,17042,8800,8242
2007/12/1,彰化縣,伸港鄉,8496,35724,18419,17305
2007/12/1,彰化縣,福興鄉,11470,48940,25695,23245
2007/12/1,彰化縣,秀水鄉,9183,38853,20139,18714
2007/12/1,彰化縣,花壇鄉,12228,46125,23863,22262
2007/12/1,彰化縣,芬園鄉,6747,25340,13476,11864
2007/12/1,彰化縣,大村鄉,9740,36412,19069,17343
2007/12/1,彰化縣,埔鹽鄉,8467,34764,18303,16461
2007/12/1,彰化縣,埔心鄉,9520,35550,18478,17072
2007/12/1,彰化縣,永靖鄉,9993,39723,20697,19026
2007/12/1,彰化縣,社頭鄉,11898,45498,23477,22021
2007/12/1,彰化縣,二水鄉,5170,17122,9049,8073
2007/12/1,彰化縣,田尾鄉,7450,29163,15221,13942
2007/12/1,彰化縣,埤頭鄉,8183,32080,16839,15241
2007/12/1,彰化縣,芳苑鄉,9799,37065,19654,17411
2007/12/1,彰化縣,大城鄉,5284,19241,10522,8719
2007/12/1,彰化縣,竹塘鄉,4478,16763,8888,7875
2007/12/1,彰化縣,溪州鄉,8459,32209,17085,15124
2007/12/1,南投縣,南投市,32096,105671,53454,52217
2007/12/1,南投縣,埔里鎮,27437,86415,43841,42574
2007/12/1,南投縣,草屯鎮,29463,99884,50679,49205
2007/12/1,南投縣,竹山鎮,18024,59329,30787,28542
2007/12/1,南投縣,集集鎮,4083,12109,6364,5745
2007/12/1,南投縣,名間鄉,11693,41677,22039,19638
2007/12/1,南投縣,鹿谷鄉,6282,19581,10453,9128
2007/12/1,南投縣,中寮鄉,5424,16587,9059,7528
2007/12/1,南投縣,魚池鄉,5623,17342,9243,8099
2007/12/1,南投縣,國姓鄉,7035,21497,11806,9691
2007/12/1,南投縣,水里鄉,7117,20913,11036,9877
2007/12/1,南投縣,信義鄉,5024,17258,9403,7855
2007/12/1,南投縣,仁愛鄉,4851,15454,8204,7250
2007/12/1,雲林縣,斗六市,32568,105574,53433,52141
2007/12/1,雲林縣,斗南鎮,14689,47823,24430,23393
2007/12/1,雲林縣,虎尾鎮,21102,69420,35493,33927
2007/12/1,雲林縣,西螺鎮,13589,49282,25120,24162
2007/12/1,雲林縣,土庫鎮,8400,31099,16332,14767
2007/12/1,雲林縣,北港鎮,14827,44336,23148,21188
2007/12/1,雲林縣,古坑鄉,10277,34952,18531,16421
2007/12/1,雲林縣,大埤鄉,6405,21912,11686,10226
2007/12/1,雲林縣,莿桐鄉,8654,30841,16192,14649
2007/12/1,雲林縣,林內鄉,5542,20415,10728,9687
2007/12/1,雲林縣,二崙鄉,8565,30570,16452,14118
2007/12/1,雲林縣,崙背鄉,8023,28099,14914,13185
2007/12/1,雲林縣,麥寮鄉,11236,33279,17792,15487
2007/12/1,雲林縣,東勢鄉,5582,17616,9579,8037
2007/12/1,雲林縣,褒忠鄉,4139,14813,7939,6874
2007/12/1,雲林縣,臺西鄉,8525,27468,14805,12663
2007/12/1,雲林縣,元長鄉,9080,29739,16264,13475
2007/12/1,雲林縣,四湖鄉,8750,27583,15217,12366
2007/12/1,雲林縣,口湖鄉,9326,31031,16652,14379
2007/12/1,雲林縣,水林鄉,9683,29820,16371,13449
2007/12/1,嘉義縣,太保市,10413,35669,18560,17109
2007/12/1,嘉義縣,朴子市,13568,44222,22748,21474
2007/12/1,嘉義縣,布袋鎮,9899,31372,16248,15124
2007/12/1,嘉義縣,大林鎮,10853,34382,17783,16599
2007/12/1,嘉義縣,民雄鄉,21598,72762,37574,35188
2007/12/1,嘉義縣,溪口鄉,5185,16812,8989,7823
2007/12/1,嘉義縣,新港鄉,10048,35363,18680,16683
2007/12/1,嘉義縣,六腳鄉,8911,27327,14520,12807
2007/12/1,嘉義縣,東石鄉,9115,28761,15340,13421
2007/12/1,嘉義縣,義竹鄉,7258,21880,11403,10477
2007/12/1,嘉義縣,鹿草鄉,5528,17512,9397,8115
2007/12/1,嘉義縣,水上鄉,17079,53498,27889,25609
2007/12/1,嘉義縣,中埔鄉,14519,48039,25188,22851
2007/12/1,嘉義縣,竹崎鄉,11034,39460,21087,18373
2007/12/1,嘉義縣,梅山鄉,6314,22332,11862,10470
2007/12/1,嘉義縣,番路鄉,3784,11778,6454,5324
2007/12/1,嘉義縣,大埔鄉,1861,4011,2171,1840
2007/12/1,嘉義縣,阿里山鄉,1949,6165,3309,2856
2007/12/1,臺南市,新營區,26165,78985,39673,39312
2007/12/1,臺南市,永康區,70218,210585,105348,105237
2007/12/1,臺南市,鹽水區,9618,27872,14533,13339
2007/12/1,臺南市,白河區,10704,32323,17126,15197
2007/12/1,臺南市,麻豆區,14261,46322,23787,22535
2007/12/1,臺南市,佳里區,18391,59244,29630,29614
2007/12/1,臺南市,新化區,13073,44500,22878,21622
2007/12/1,臺南市,善化區,13602,42614,21728,20886
2007/12/1,臺南市,學甲區,9163,28582,14737,13845
2007/12/1,臺南市,柳營區,7550,23241,12173,11068
2007/12/1,臺南市,後壁區,8419,26538,13838,12700
2007/12/1,臺南市,東山區,8006,23793,12756,11037
2007/12/1,臺南市,下營區,8870,26793,13911,12882
2007/12/1,臺南市,六甲區,7411,24400,12722,11678
2007/12/1,臺南市,官田區,7445,22642,11694,10948
2007/12/1,臺南市,大內區,3997,11342,6082,5260
2007/12/1,臺南市,西港區,7537,25542,13083,12459
2007/12/1,臺南市,七股區,7736,25348,13278,12070
2007/12/1,臺南市,將軍區,7246,22103,11300,10803
2007/12/1,臺南市,北門區,4166,12625,6494,6131
2007/12/1,臺南市,新市區,10383,35433,17854,17579
2007/12/1,臺南市,安定區,8733,30066,15637,14429
2007/12/1,臺南市,山上區,2690,8112,4293,3819
2007/12/1,臺南市,玉井區,4997,15868,8280,7588
2007/12/1,臺南市,楠西區,3590,11024,5873,5151
2007/12/1,臺南市,南化區,2810,8982,4929,4053
2007/12/1,臺南市,左鎮區,1931,5646,3139,2507
2007/12/1,臺南市,仁德區,23009,67838,35104,32734
2007/12/1,臺南市,歸仁區,19421,65564,33492,32072
2007/12/1,臺南市,關廟區,10452,37036,19273,17763
2007/12/1,臺南市,龍崎區,1555,4440,2414,2026
2007/12/1,高雄市,鳳山區,121294,338900,169930,168970
2007/12/1,高雄市,岡山區,31909,96138,48688,47450
2007/12/1,高雄市,旗山區,13515,41054,21510,19544
2007/12/1,高雄市,美濃區,13589,44130,23181,20949
2007/12/1,高雄市,林園區,23364,71336,36871,34465
2007/12/1,高雄市,大寮區,36471,109313,57200,52113
2007/12/1,高雄市,大樹區,12864,44871,23343,21528
2007/12/1,高雄市,仁武區,23249,67881,35169,32712
2007/12/1,高雄市,大社區,11206,32692,16851,15841
2007/12/1,高雄市,鳥松區,15587,41314,21104,20210
2007/12/1,高雄市,橋頭區,12224,36653,18922,17731
2007/12/1,高雄市,燕巢區,9573,31227,16723,14504
2007/12/1,高雄市,田寮區,3592,8576,4798,3778
2007/12/1,高雄市,阿蓮區,8868,30907,15635,15272
2007/12/1,高雄市,路竹區,15401,54576,27925,26651
2007/12/1,高雄市,湖內區,9058,28605,14813,13792
2007/12/1,高雄市,茄萣區,9908,32021,16808,15213
2007/12/1,高雄市,永安區,5636,14223,7315,6908
2007/12/1,高雄市,彌陀區,6389,20830,10948,9882
2007/12/1,高雄市,梓官區,11491,37218,19544,17674
2007/12/1,高雄市,六龜區,5667,15660,8529,7131
2007/12/1,高雄市,甲仙區,2565,8222,4435,3787
2007/12/1,高雄市,杉林區,3993,11390,6265,5125
2007/12/1,高雄市,內門區,4967,16550,9049,7501
2007/12/1,高雄市,茂林區,520,1756,898,858
2007/12/1,高雄市,桃源區,1212,4787,2574,2213
2007/12/1,屏東縣,屏東市,70773,215962,108282,107680
2007/12/1,屏東縣,潮州鎮,17562,56896,28766,28130
2007/12/1,屏東縣,東港鎮,14626,50524,25807,24717
2007/12/1,屏東縣,恆春鎮,10286,31288,16250,15038
2007/12/1,屏東縣,萬丹鄉,13706,54542,28307,26235
2007/12/1,屏東縣,長治鄉,9466,30983,16303,14680
2007/12/1,屏東縣,麟洛鄉,3453,11694,6072,5622
2007/12/1,屏東縣,九如鄉,6405,23226,12093,11133
2007/12/1,屏東縣,里港鄉,7767,26489,13645,12844
2007/12/1,屏東縣,鹽埔鄉,7447,27778,14506,13272
2007/12/1,屏東縣,高樹鄉,9497,27533,14760,12773
2007/12/1,屏東縣,萬巒鄉,6284,22694,12008,10686
2007/12/1,屏東縣,內埔鄉,17213,59441,31121,28320
2007/12/1,屏東縣,竹田鄉,5344,18491,9890,8601
2007/12/1,屏東縣,新埤鄉,3292,11097,5900,5197
2007/12/1,屏東縣,枋寮鄉,8246,27419,14543,12876
2007/12/1,屏東縣,新園鄉,10817,39486,20484,19002
2007/12/1,屏東縣,崁頂鄉,3953,17058,8825,8233
2007/12/1,屏東縣,林邊鄉,6173,21305,11062,10243
2007/12/1,屏東縣,南州鄉,3572,12168,6249,5919
2007/12/1,屏東縣,佳冬鄉,6589,21787,11408,10379
2007/12/1,屏東縣,琉球鄉,3743,12652,7018,5634
2007/12/1,屏東縣,車城鄉,3381,10082,5457,4625
2007/12/1,屏東縣,滿州鄉,2972,8675,4758,3917
2007/12/1,屏東縣,枋山鄉,2109,6240,3368,2872
2007/12/1,屏東縣,三地門鄉,2020,7234,3711,3523
2007/12/1,屏東縣,霧臺鄉,835,2737,1462,1275
2007/12/1,屏東縣,瑪家鄉,1801,6531,3411,3120
2007/12/1,屏東縣,泰武鄉,1086,4918,2629,2289
2007/12/1,屏東縣,來義鄉,2069,7791,4024,3767
2007/12/1,屏東縣,春日鄉,1272,5001,2626,2375
2007/12/1,屏東縣,獅子鄉,1419,4971,2649,2322
2007/12/1,屏東縣,牡丹鄉,1764,4870,2553,2317
2007/12/1,臺東縣,臺東市,36920,110204,56261,53943
2007/12/1,臺東縣,成功鎮,5328,16422,8818,7604
2007/12/1,臺東縣,關山鎮,3177,9987,5280,4707
2007/12/1,臺東縣,卑南鄉,6423,18447,10124,8323
2007/12/1,臺東縣,大武鄉,2454,7085,3727,3358
2007/12/1,臺東縣,太麻里鄉,4467,12210,6569,5641
2007/12/1,臺東縣,東河鄉,3436,9729,5402,4327
2007/12/1,臺東縣,長濱鄉,2837,8839,5022,3817
2007/12/1,臺東縣,鹿野鄉,3079,8940,4835,4105
2007/12/1,臺東縣,池上鄉,3169,9478,5067,4411
2007/12/1,臺東縣,綠島鄉,899,3093,1649,1444
2007/12/1,臺東縣,延平鄉,1058,3629,2038,1591
2007/12/1,臺東縣,海端鄉,1071,4576,2488,2088
2007/12/1,臺東縣,達仁鄉,1392,3739,2065,1674
2007/12/1,臺東縣,金峰鄉,981,3322,1765,1557
2007/12/1,臺東縣,蘭嶼鄉,1201,3960,2087,1873
2007/12/1,花蓮縣,花蓮市,39047,109847,54301,55546
2007/12/1,花蓮縣,鳳林鎮,4382,12451,6622,5829
2007/12/1,花蓮縣,玉里鎮,8796,28138,15364,12774
2007/12/1,花蓮縣,新城鄉,7117,20501,10712,9789
2007/12/1,花蓮縣,吉安鄉,27360,78922,40737,38185
2007/12/1,花蓮縣,壽豐鄉,6670,19325,10529,8796
2007/12/1,花蓮縣,光復鄉,4972,14680,7869,6811
2007/12/1,花蓮縣,豐濱鄉,1815,5356,2977,2379
2007/12/1,花蓮縣,瑞穗鄉,4532,13380,7281,6099
2007/12/1,花蓮縣,富里鄉,3871,12049,6659,5390
2007/12/1,花蓮縣,秀林鄉,4458,14951,7852,7099
2007/12/1,花蓮縣,萬榮鄉,2142,7137,3824,3313
2007/12/1,花蓮縣,卓溪鄉,1604,6565,3649,2916
2007/12/1,澎湖縣,馬公市,17837,54566,27794,26772
2007/12/1,澎湖縣,湖西鄉,4270,12860,6733,6127
2007/12/1,澎湖縣,白沙鄉,2932,9176,4873,4303
2007/12/1,澎湖縣,西嶼鄉,2668,8171,4243,3928
2007/12/1,澎湖縣,望安鄉,1710,4426,2369,2057
2007/12/1,澎湖縣,七美鄉,1108,3191,1693,1498
2007/12/1,基隆市,中正區,21705,57601,29684,27917
2007/12/1,基隆市,七堵區,19079,55169,28120,27049
2007/12/1,基隆市,暖暖區,14041,38469,19659,18810
2007/12/1,基隆市,仁愛區,18890,50362,25104,25258
2007/12/1,基隆市,中山區,18649,52330,26849,25481
2007/12/1,基隆市,安樂區,30920,85303,42594,42709
2007/12/1,基隆市,信義區,19356,51163,25778,25385
2007/12/1,新竹市,東區,63171,190163,94383,95780
2007/12/1,新竹市,北區,46365,139039,69470,69569
2007/12/1,新竹市,香山區,20884,69833,35830,34003
2007/12/1,臺中市,中區,8454,24010,11837,12173
2007/12/1,臺中市,東區,24849,73748,37508,36240
2007/12/1,臺中市,西區,41400,116812,56457,60355
2007/12/1,臺中市,南區,39296,110358,53904,56454
2007/12/1,臺中市,北區,53388,147469,71940,75529
2007/12/1,臺中市,西屯區,67030,197900,96721,101179
2007/12/1,臺中市,南屯區,48794,145983,70654,75329
2007/12/1,臺中市,北屯區,78292,239618,117031,122587
2007/12/1,嘉義市,東區,43381,128497,63028,65469
2007/12/1,嘉義市,西區,47684,144578,72084,72494
2007/12/1,臺南市,東區,68253,193764,94316,99448
2007/12/1,臺南市,南區,41802,127750,64413,63337
2007/12/1,臺南市,北區,45074,128314,63848,64466
2007/12/1,臺南市,安南區,51050,174309,89144,85165
2007/12/1,臺南市,安平區,21231,59275,28511,30764
2007/12/1,臺南市,中西區,29586,81246,40105,41141
2007/12/1,臺北市,松山區,76302,210986,100263,110723
2007/12/1,臺北市,信義區,84629,228868,111384,117484
2007/12/1,臺北市,大安區,114241,314924,149326,165598
2007/12/1,臺北市,中山區,87274,218483,103912,114571
2007/12/1,臺北市,中正區,60048,159486,77406,82080
2007/12/1,臺北市,大同區,45550,126128,62662,63466
2007/12/1,臺北市,萬華區,72388,192470,97058,95412
2007/12/1,臺北市,文山區,93653,261666,127659,134007
2007/12/1,臺北市,南港區,39593,113716,56555,57161
2007/12/1,臺北市,內湖區,90930,265518,128861,136657
2007/12/1,臺北市,士林區,97199,287048,140376,146672
2007/12/1,臺北市,北投區,85938,249976,122094,127882
2007/12/1,高雄市,鹽埕區,11239,28635,14556,14079
2007/12/1,高雄市,鼓山區,46676,122551,60892,61659
2007/12/1,高雄市,左營區,69894,186026,92493,93533
2007/12/1,高雄市,楠梓區,58631,168728,84314,84414
2007/12/1,高雄市,三民區,127932,360579,177842,182737
2007/12/1,高雄市,新興區,22768,57373,28211,29162
2007/12/1,高雄市,前金區,12342,29965,14745,15220
2007/12/1,高雄市,苓雅區,69935,188020,92152,95868
2007/12/1,高雄市,前鎮區,73054,200427,100576,99851
2007/12/1,高雄市,旗津區,10662,30049,15736,14313
2007/12/1,高雄市,小港區,58661,151685,76921,74764
2007/12/1,金門縣,金城鎮,9945,27954,14805,13149
2007/12/1,金門縣,金湖鎮,6506,18203,9693,8510
2007/12/1,金門縣,金沙鎮,4939,13035,6878,6157
2007/12/1,金門縣,金寧鄉,5493,14832,8039,6793
2007/12/1,金門縣,烈嶼鄉,2298,7091,3762,3329
2007/12/1,金門縣,烏坵鄉,134,432,222,210
2007/12/1,連江縣,南竿鄉,1077,5945,3454,2491
2007/12/1,連江縣,北竿鄉,371,1824,1080,744
2007/12/1,連江縣,莒光鄉,232,1180,691,489
2007/12/1,連江縣,東引鄉,247,997,591,406
2008/1/1,總計,臺灣地區,7487267,22874602,11561609,11312993
2008/1/1,總計,臺灣省,5978005,18723987,9527411,9196576
2008/1/1,總計,新北市,1310111,3800575,1900138,1900437
2008/1/1,總計,宜蘭縣,147007,460319,235862,224457
2008/1/1,總計,桃園市,620724,1937045,982363,954682
2008/1/1,總計,新竹縣,147891,496422,256838,239584
2008/1/1,總計,苗栗縣,163356,560197,292524,267673
2008/1/1,總計,臺中市,443313,1551722,789610,762112
2008/1/1,總計,彰化縣,348512,1314311,677612,636699
2008/1/1,總計,南投縣,164340,533607,276287,257320
2008/1/1,總計,雲林縣,219157,725376,380854,344522
2008/1/1,總計,嘉義縣,169034,551154,289057,262097
2008/1/1,總計,臺南市,353410,1105348,567068,538280
2008/1/1,總計,高雄市,415206,1244354,640764,603590
2008/1/1,總計,屏東縣,267052,889319,459729,429590
2008/1/1,總計,臺東縣,77880,233609,123129,110480
2008/1/1,總計,花蓮縣,116867,343262,178322,164940
2008/1/1,總計,澎湖縣,30537,92423,47723,44700
2008/1/1,總計,基隆市,142686,390216,197670,192546
2008/1/1,總計,新竹市,130557,399599,199880,199719
2008/1/1,總計,臺中市,361958,1056993,516461,540532
2008/1/1,總計,嘉義市,91183,273137,135133,138004
2008/1/1,總計,臺南市,257224,764999,380387,384612
2008/1/1,總計,臺北市,947801,2629689,1277533,1352156
2008/1/1,總計,高雄市,561461,1520926,756665,764261
2008/1/1,總計,福建省,31294,91857,49417,42440
2008/1/1,總計,金門縣,29367,81903,43598,38305
2008/1/1,總計,連江縣,1927,9954,5819,4135
2008/1/1,新北市,板橋區,182937,548047,273193,274854
2008/1/1,新北市,三重區,130765,383695,192460,191235
2008/1/1,新北市,永和區,87770,236528,114115,122413
2008/1/1,新北市,中和區,146417,410029,203984,206045
2008/1/1,新北市,新莊區,129397,396540,196993,199547
2008/1/1,新北市,新店區,110499,290686,143573,147113
2008/1/1,新北市,土城區,78346,237519,119273,118246
2008/1/1,新北市,蘆洲區,61323,192201,95635,96566
2008/1/1,新北市,汐止區,74007,181153,90660,90493
2008/1/1,新北市,樹林區,52321,164862,83554,81308
2008/1/1,新北市,鶯歌區,25663,85751,43706,42045
2008/1/1,新北市,三峽區,30728,95204,49137,46067
2008/1/1,新北市,淡水區,49710,132333,65100,67233
2008/1/1,新北市,瑞芳區,15456,43522,22322,21200
2008/1/1,新北市,五股區,25560,77399,39416,37983
2008/1/1,新北市,泰山區,24626,74542,37775,36767
2008/1/1,新北市,林口區,22525,67574,33727,33847
2008/1/1,新北市,深坑區,8197,22376,11397,10979
2008/1/1,新北市,石碇區,3143,7870,4379,3491
2008/1/1,新北市,坪林區,2359,6599,3705,2894
2008/1/1,新北市,三芝區,8539,23597,12295,11302
2008/1/1,新北市,石門區,3653,11842,6287,5555
2008/1/1,新北市,八里區,11092,32753,16807,15946
2008/1/1,新北市,平溪區,2335,5610,3139,2471
2008/1/1,新北市,雙溪區,3781,9959,5389,4570
2008/1/1,新北市,貢寮區,4305,14008,7303,6705
2008/1/1,新北市,金山區,6424,22253,11336,10917
2008/1/1,新北市,萬里區,6566,20690,10676,10014
2008/1/1,新北市,烏來區,1667,5433,2802,2631
2008/1/1,宜蘭縣,宜蘭市,31973,96106,47603,48503
2008/1/1,宜蘭縣,羅東鎮,24126,74110,35675,38435
2008/1/1,宜蘭縣,蘇澳鎮,13062,42892,22247,20645
2008/1/1,宜蘭縣,頭城鎮,9227,31586,16409,15177
2008/1/1,宜蘭縣,礁溪鄉,11687,35887,18870,17017
2008/1/1,宜蘭縣,壯圍鄉,7751,25232,13337,11895
2008/1/1,宜蘭縣,員山鄉,10223,32328,17416,14912
2008/1/1,宜蘭縣,冬山鄉,16287,51404,26629,24775
2008/1/1,宜蘭縣,五結鄉,12181,37917,19841,18076
2008/1/1,宜蘭縣,三星鄉,6997,21195,11493,9702
2008/1/1,宜蘭縣,大同鄉,1772,5817,3221,2596
2008/1/1,宜蘭縣,南澳鄉,1721,5845,3121,2724
2008/1/1,桃園市,桃園區,133411,392381,192976,199405
2008/1/1,桃園市,中壢區,116981,358964,180425,178539
2008/1/1,桃園市,平鎮區,61662,202912,102637,100275
2008/1/1,桃園市,八德區,53281,172192,88442,83750
2008/1/1,桃園市,大溪區,27554,90481,46829,43652
2008/1/1,桃園市,楊梅區,44169,143088,73272,69816
2008/1/1,桃園市,蘆竹區,43174,132415,66808,65607
2008/1/1,桃園市,大園區,23726,79666,41551,38115
2008/1/1,桃園市,龜山區,46123,131764,67414,64350
2008/1/1,桃園市,龍潭區,34646,112789,57662,55127
2008/1/1,桃園市,新屋區,14394,49939,26680,23259
2008/1/1,桃園市,觀音區,18013,59826,31699,28127
2008/1/1,桃園市,復興區,3590,10628,5968,4660
2008/1/1,新竹縣,竹北市,39915,126631,63822,62809
2008/1/1,新竹縣,關西鎮,8866,32654,17451,15203
2008/1/1,新竹縣,新埔鎮,9874,36085,19163,16922
2008/1/1,新竹縣,竹東鎮,28848,96631,48836,47795
2008/1/1,新竹縣,湖口鄉,22023,74296,38140,36156
2008/1/1,新竹縣,橫山鄉,4178,14646,8007,6639
2008/1/1,新竹縣,新豐鄉,14572,51741,26889,24852
2008/1/1,新竹縣,芎林鄉,5959,20792,10968,9824
2008/1/1,新竹縣,寶山鄉,4460,13795,7475,6320
2008/1/1,新竹縣,北埔鄉,2971,10337,5604,4733
2008/1/1,新竹縣,峨眉鄉,1987,6145,3418,2727
2008/1/1,新竹縣,尖石鄉,2574,8213,4523,3690
2008/1/1,新竹縣,五峰鄉,1664,4456,2542,1914
2008/1/1,苗栗縣,苗栗市,27946,91107,46178,44929
2008/1/1,苗栗縣,苑裡鎮,13257,49049,25697,23352
2008/1/1,苗栗縣,通霄鎮,10896,39217,20973,18244
2008/1/1,苗栗縣,竹南鎮,21811,75294,38437,36857
2008/1/1,苗栗縣,頭份市,27245,94604,48451,46153
2008/1/1,苗栗縣,後龍鎮,11378,40472,21483,18989
2008/1/1,苗栗縣,卓蘭鎮,5749,18520,9835,8685
2008/1/1,苗栗縣,大湖鄉,5112,16188,8733,7455
2008/1/1,苗栗縣,公館鄉,9630,34669,18223,16446
2008/1/1,苗栗縣,銅鑼鄉,5831,19869,10590,9279
2008/1/1,苗栗縣,南庄鄉,3826,11426,6362,5064
2008/1/1,苗栗縣,頭屋鄉,3425,11903,6291,5612
2008/1/1,苗栗縣,三義鄉,5079,17691,9378,8313
2008/1/1,苗栗縣,西湖鄉,2563,7982,4439,3543
2008/1/1,苗栗縣,造橋鄉,3857,13838,7327,6511
2008/1/1,苗栗縣,三灣鄉,2288,7488,4088,3400
2008/1/1,苗栗縣,獅潭鄉,1626,5177,2909,2268
2008/1/1,苗栗縣,泰安鄉,1837,5703,3130,2573
2008/1/1,臺中市,豐原區,47175,164661,82142,82519
2008/1/1,臺中市,大里區,58109,192683,96057,96626
2008/1/1,臺中市,太平區,52240,171677,86568,85109
2008/1/1,臺中市,東勢區,16548,54774,28573,26201
2008/1/1,臺中市,大甲區,20799,79273,40244,39029
2008/1/1,臺中市,清水區,23877,85976,44468,41508
2008/1/1,臺中市,沙鹿區,21492,78652,40183,38469
2008/1/1,臺中市,梧棲區,15215,54232,27584,26648
2008/1/1,臺中市,后里區,14201,54578,28268,26310
2008/1/1,臺中市,神岡區,16920,64276,33173,31103
2008/1/1,臺中市,潭子區,30271,97503,48973,48530
2008/1/1,臺中市,大雅區,24972,88074,44619,43455
2008/1/1,臺中市,新社區,7130,25807,13659,12148
2008/1/1,臺中市,石岡區,4652,16162,8411,7751
2008/1/1,臺中市,外埔區,8327,31852,16440,15412
2008/1/1,臺中市,大安區,5099,20782,10956,9826
2008/1/1,臺中市,烏日區,19089,67523,34395,33128
2008/1/1,臺中市,大肚區,15214,55949,28815,27134
2008/1/1,臺中市,龍井區,19345,71982,36882,35100
2008/1/1,臺中市,霧峰區,18153,64446,33217,31229
2008/1/1,臺中市,和平區,4485,10860,5983,4877
2008/1/1,彰化縣,彰化市,68751,236152,118361,117791
2008/1/1,彰化縣,鹿港鎮,21201,85250,43780,41470
2008/1/1,彰化縣,和美鎮,22849,89091,45839,43252
2008/1/1,彰化縣,北斗鎮,9470,33540,17060,16480
2008/1/1,彰化縣,員林市,35207,126242,63781,62461
2008/1/1,彰化縣,溪湖鎮,14501,56642,29098,27544
2008/1/1,彰化縣,田中鎮,12128,45090,23714,21376
2008/1/1,彰化縣,二林鎮,13799,55007,28441,26566
2008/1/1,彰化縣,線西鄉,3922,17031,8786,8245
2008/1/1,彰化縣,伸港鄉,8506,35731,18434,17297
2008/1/1,彰化縣,福興鄉,11490,48944,25698,23246
2008/1/1,彰化縣,秀水鄉,9191,38849,20133,18716
2008/1/1,彰化縣,花壇鄉,12238,46158,23877,22281
2008/1/1,彰化縣,芬園鄉,6752,25282,13444,11838
2008/1/1,彰化縣,大村鄉,9746,36363,19057,17306
2008/1/1,彰化縣,埔鹽鄉,8476,34736,18295,16441
2008/1/1,彰化縣,埔心鄉,9531,35554,18482,17072
2008/1/1,彰化縣,永靖鄉,9988,39664,20671,18993
2008/1/1,彰化縣,社頭鄉,11917,45426,23451,21975
2008/1/1,彰化縣,二水鄉,5168,17086,9042,8044
2008/1/1,彰化縣,田尾鄉,7452,29153,15210,13943
2008/1/1,彰化縣,埤頭鄉,8193,32079,16833,15246
2008/1/1,彰化縣,芳苑鄉,9804,37073,19661,17412
2008/1/1,彰化縣,大城鄉,5287,19226,10512,8714
2008/1/1,彰化縣,竹塘鄉,4481,16748,8882,7866
2008/1/1,彰化縣,溪州鄉,8464,32194,17070,15124
2008/1/1,南投縣,南投市,32143,105679,53450,52229
2008/1/1,南投縣,埔里鎮,27457,86391,43827,42564
2008/1/1,南投縣,草屯鎮,29527,99944,50700,49244
2008/1/1,南投縣,竹山鎮,18039,59282,30757,28525
2008/1/1,南投縣,集集鎮,4086,12090,6347,5743
2008/1/1,南投縣,名間鄉,11704,41656,22024,19632
2008/1/1,南投縣,鹿谷鄉,6292,19554,10446,9108
2008/1/1,南投縣,中寮鄉,5420,16546,9040,7506
2008/1/1,南投縣,魚池鄉,5628,17367,9254,8113
2008/1/1,南投縣,國姓鄉,7044,21478,11797,9681
2008/1/1,南投縣,水里鄉,7122,20896,11028,9868
2008/1/1,南投縣,信義鄉,5021,17265,9406,7859
2008/1/1,南投縣,仁愛鄉,4857,15459,8211,7248
2008/1/1,雲林縣,斗六市,32616,105608,53450,52158
2008/1/1,雲林縣,斗南鎮,14704,47773,24400,23373
2008/1/1,雲林縣,虎尾鎮,21123,69467,35508,33959
2008/1/1,雲林縣,西螺鎮,13584,49278,25103,24175
2008/1/1,雲林縣,土庫鎮,8410,31110,16333,14777
2008/1/1,雲林縣,北港鎮,14814,44282,23106,21176
2008/1/1,雲林縣,古坑鄉,10289,34918,18517,16401
2008/1/1,雲林縣,大埤鄉,6413,21877,11671,10206
2008/1/1,雲林縣,莿桐鄉,8655,30811,16175,14636
2008/1/1,雲林縣,林內鄉,5537,20385,10707,9678
2008/1/1,雲林縣,二崙鄉,8571,30535,16430,14105
2008/1/1,雲林縣,崙背鄉,8039,28109,14913,13196
2008/1/1,雲林縣,麥寮鄉,11270,33322,17818,15504
2008/1/1,雲林縣,東勢鄉,5582,17598,9580,8018
2008/1/1,雲林縣,褒忠鄉,4145,14790,7931,6859
2008/1/1,雲林縣,臺西鄉,8547,27442,14776,12666
2008/1/1,雲林縣,元長鄉,9084,29718,16245,13473
2008/1/1,雲林縣,四湖鄉,8760,27540,15191,12349
2008/1/1,雲林縣,口湖鄉,9330,31000,16634,14366
2008/1/1,雲林縣,水林鄉,9684,29813,16366,13447
2008/1/1,嘉義縣,太保市,10417,35680,18561,17119
2008/1/1,嘉義縣,朴子市,13588,44224,22743,21481
2008/1/1,嘉義縣,布袋鎮,9895,31346,16225,15121
2008/1/1,嘉義縣,大林鎮,10854,34346,17766,16580
2008/1/1,嘉義縣,民雄鄉,21618,72785,37581,35204
2008/1/1,嘉義縣,溪口鄉,5195,16787,8966,7821
2008/1/1,嘉義縣,新港鄉,10063,35378,18682,16696
2008/1/1,嘉義縣,六腳鄉,8917,27318,14519,12799
2008/1/1,嘉義縣,東石鄉,9115,28694,15313,13381
2008/1/1,嘉義縣,義竹鄉,7260,21855,11394,10461
2008/1/1,嘉義縣,鹿草鄉,5530,17489,9391,8098
2008/1/1,嘉義縣,水上鄉,17105,53536,27894,25642
2008/1/1,嘉義縣,中埔鄉,14517,48026,25181,22845
2008/1/1,嘉義縣,竹崎鄉,11045,39433,21051,18382
2008/1/1,嘉義縣,梅山鄉,6321,22315,11856,10459
2008/1/1,嘉義縣,番路鄉,3784,11762,6443,5319
2008/1/1,嘉義縣,大埔鄉,1864,4021,2180,1841
2008/1/1,嘉義縣,阿里山鄉,1946,6159,3311,2848
2008/1/1,臺南市,新營區,26173,78963,39658,39305
2008/1/1,臺南市,永康區,70278,210766,105431,105335
2008/1/1,臺南市,鹽水區,9620,27843,14531,13312
2008/1/1,臺南市,白河區,10711,32287,17109,15178
2008/1/1,臺南市,麻豆區,14281,46344,23783,22561
2008/1/1,臺南市,佳里區,18411,59251,29625,29626
2008/1/1,臺南市,新化區,13086,44530,22903,21627
2008/1/1,臺南市,善化區,13629,42693,21766,20927
2008/1/1,臺南市,學甲區,9160,28558,14724,13834
2008/1/1,臺南市,柳營區,7552,23212,12163,11049
2008/1/1,臺南市,後壁區,8427,26516,13833,12683
2008/1/1,臺南市,東山區,8002,23774,12745,11029
2008/1/1,臺南市,下營區,8866,26754,13899,12855
2008/1/1,臺南市,六甲區,7408,24397,12725,11672
2008/1/1,臺南市,官田區,7444,22615,11673,10942
2008/1/1,臺南市,大內區,4002,11318,6071,5247
2008/1/1,臺南市,西港區,7541,25513,13076,12437
2008/1/1,臺南市,七股區,7743,25373,13291,12082
2008/1/1,臺南市,將軍區,7254,22077,11289,10788
2008/1/1,臺南市,北門區,4165,12605,6494,6111
2008/1/1,臺南市,新市區,10396,35420,17847,17573
2008/1/1,臺南市,安定區,8748,30062,15652,14410
2008/1/1,臺南市,山上區,2691,8110,4291,3819
2008/1/1,臺南市,玉井區,4989,15839,8264,7575
2008/1/1,臺南市,楠西區,3591,11013,5864,5149
2008/1/1,臺南市,南化區,2808,8981,4927,4054
2008/1/1,臺南市,左鎮區,1932,5640,3136,2504
2008/1/1,臺南市,仁德區,23057,67849,35108,32741
2008/1/1,臺南市,歸仁區,19443,65608,33522,32086
2008/1/1,臺南市,關廟區,10448,37004,19257,17747
2008/1/1,臺南市,龍崎區,1554,4433,2411,2022
2008/1/1,高雄市,鳳山區,121308,338978,169930,169048
2008/1/1,高雄市,岡山區,31922,96092,48651,47441
2008/1/1,高雄市,旗山區,13523,41062,21508,19554
2008/1/1,高雄市,美濃區,13605,44103,23160,20943
2008/1/1,高雄市,林園區,23388,71395,36895,34500
2008/1/1,高雄市,大寮區,36471,109223,57147,52076
2008/1/1,高雄市,大樹區,12862,44890,23327,21563
2008/1/1,高雄市,仁武區,23299,67991,35227,32764
2008/1/1,高雄市,大社區,11218,32733,16864,15869
2008/1/1,高雄市,鳥松區,15601,41379,21120,20259
2008/1/1,高雄市,橋頭區,12228,36621,18910,17711
2008/1/1,高雄市,燕巢區,9592,31231,16721,14510
2008/1/1,高雄市,田寮區,3585,8557,4783,3774
2008/1/1,高雄市,阿蓮區,8879,30903,15623,15280
2008/1/1,高雄市,路竹區,15418,54561,27932,26629
2008/1/1,高雄市,湖內區,9067,28619,14822,13797
2008/1/1,高雄市,茄萣區,9906,31991,16793,15198
2008/1/1,高雄市,永安區,5646,14246,7322,6924
2008/1/1,高雄市,彌陀區,6394,20833,10952,9881
2008/1/1,高雄市,梓官區,11500,37167,19534,17633
2008/1/1,高雄市,六龜區,5663,15634,8506,7128
2008/1/1,高雄市,甲仙區,2569,8207,4430,3777
2008/1/1,高雄市,杉林區,3986,11383,6254,5129
2008/1/1,高雄市,內門區,4965,16530,9046,7484
2008/1/1,高雄市,茂林區,521,1761,900,861
2008/1/1,高雄市,桃源區,1216,4781,2572,2209
2008/1/1,屏東縣,屏東市,70780,215870,108238,107632
2008/1/1,屏東縣,潮州鎮,17577,56924,28782,28142
2008/1/1,屏東縣,東港鎮,14650,50555,25824,24731
2008/1/1,屏東縣,恆春鎮,10295,31281,16243,15038
2008/1/1,屏東縣,萬丹鄉,13720,54590,28328,26262
2008/1/1,屏東縣,長治鄉,9478,30978,16302,14676
2008/1/1,屏東縣,麟洛鄉,3450,11693,6067,5626
2008/1/1,屏東縣,九如鄉,6413,23242,12093,11149
2008/1/1,屏東縣,里港鄉,7768,26499,13649,12850
2008/1/1,屏東縣,鹽埔鄉,7447,27763,14491,13272
2008/1/1,屏東縣,高樹鄉,9493,27495,14734,12761
2008/1/1,屏東縣,萬巒鄉,6284,22649,11990,10659
2008/1/1,屏東縣,內埔鄉,17219,59432,31096,28336
2008/1/1,屏東縣,竹田鄉,5348,18481,9870,8611
2008/1/1,屏東縣,新埤鄉,3292,11080,5889,5191
2008/1/1,屏東縣,枋寮鄉,8250,27407,14547,12860
2008/1/1,屏東縣,新園鄉,10825,39456,20468,18988
2008/1/1,屏東縣,崁頂鄉,3957,17088,8837,8251
2008/1/1,屏東縣,林邊鄉,6174,21295,11045,10250
2008/1/1,屏東縣,南州鄉,3572,12132,6232,5900
2008/1/1,屏東縣,佳冬鄉,6585,21788,11407,10381
2008/1/1,屏東縣,琉球鄉,3744,12640,7002,5638
2008/1/1,屏東縣,車城鄉,3384,10068,5450,4618
2008/1/1,屏東縣,滿州鄉,2968,8655,4750,3905
2008/1/1,屏東縣,枋山鄉,2102,6231,3357,2874
2008/1/1,屏東縣,三地門鄉,2022,7235,3709,3526
2008/1/1,屏東縣,霧臺鄉,845,2734,1459,1275
2008/1/1,屏東縣,瑪家鄉,1800,6520,3403,3117
2008/1/1,屏東縣,泰武鄉,1086,4908,2626,2282
2008/1/1,屏東縣,來義鄉,2065,7794,4021,3773
2008/1/1,屏東縣,春日鄉,1272,4994,2620,2374
2008/1/1,屏東縣,獅子鄉,1421,4976,2649,2327
2008/1/1,屏東縣,牡丹鄉,1766,4866,2551,2315
2008/1/1,臺東縣,臺東市,36922,110234,56265,53969
2008/1/1,臺東縣,成功鎮,5329,16393,8802,7591
2008/1/1,臺東縣,關山鎮,3179,9986,5279,4707
2008/1/1,臺東縣,卑南鄉,6421,18418,10088,8330
2008/1/1,臺東縣,大武鄉,2445,7097,3727,3370
2008/1/1,臺東縣,太麻里鄉,4463,12214,6566,5648
2008/1/1,臺東縣,東河鄉,3430,9712,5398,4314
2008/1/1,臺東縣,長濱鄉,2835,8833,5020,3813
2008/1/1,臺東縣,鹿野鄉,3078,8911,4818,4093
2008/1/1,臺東縣,池上鄉,3171,9481,5062,4419
2008/1/1,臺東縣,綠島鄉,902,3106,1663,1443
2008/1/1,臺東縣,延平鄉,1058,3630,2039,1591
2008/1/1,臺東縣,海端鄉,1072,4573,2484,2089
2008/1/1,臺東縣,達仁鄉,1394,3735,2062,1673
2008/1/1,臺東縣,金峰鄉,980,3324,1766,1558
2008/1/1,臺東縣,蘭嶼鄉,1201,3962,2090,1872
2008/1/1,花蓮縣,花蓮市,39099,109937,54321,55616
2008/1/1,花蓮縣,鳳林鎮,4391,12459,6620,5839
2008/1/1,花蓮縣,玉里鎮,8795,28115,15343,12772
2008/1/1,花蓮縣,新城鄉,7113,20477,10711,9766
2008/1/1,花蓮縣,吉安鄉,27383,78916,40728,38188
2008/1/1,花蓮縣,壽豐鄉,6678,19321,10526,8795
2008/1/1,花蓮縣,光復鄉,4971,14685,7876,6809
2008/1/1,花蓮縣,豐濱鄉,1814,5345,2973,2372
2008/1/1,花蓮縣,瑞穗鄉,4538,13362,7272,6090
2008/1/1,花蓮縣,富里鄉,3873,12031,6648,5383
2008/1/1,花蓮縣,秀林鄉,4469,14942,7847,7095
2008/1/1,花蓮縣,萬榮鄉,2141,7131,3818,3313
2008/1/1,花蓮縣,卓溪鄉,1602,6541,3639,2902
2008/1/1,澎湖縣,馬公市,17846,54588,27806,26782
2008/1/1,澎湖縣,湖西鄉,4269,12843,6717,6126
2008/1/1,澎湖縣,白沙鄉,2930,9175,4868,4307
2008/1/1,澎湖縣,西嶼鄉,2669,8187,4252,3935
2008/1/1,澎湖縣,望安鄉,1710,4414,2369,2045
2008/1/1,澎湖縣,七美鄉,1113,3216,1711,1505
2008/1/1,基隆市,中正區,21711,57504,29628,27876
2008/1/1,基隆市,七堵區,19086,55153,28111,27042
2008/1/1,基隆市,暖暖區,14031,38451,19660,18791
2008/1/1,基隆市,仁愛區,18880,50318,25086,25232
2008/1/1,基隆市,中山區,18661,52335,26850,25485
2008/1/1,基隆市,安樂區,30943,85297,42570,42727
2008/1/1,基隆市,信義區,19374,51158,25765,25393
2008/1/1,新竹市,東區,63226,190407,94458,95949
2008/1/1,新竹市,北區,46405,139208,69526,69682
2008/1/1,新竹市,香山區,20926,69984,35896,34088
2008/1/1,臺中市,中區,8447,23984,11819,12165
2008/1/1,臺中市,東區,24872,73866,37555,36311
2008/1/1,臺中市,西區,41477,117010,56539,60471
2008/1/1,臺中市,南區,39367,110469,53940,56529
2008/1/1,臺中市,北區,53419,147514,71971,75543
2008/1/1,臺中市,西屯區,67102,198064,96785,101279
2008/1/1,臺中市,南屯區,48878,146191,70734,75457
2008/1/1,臺中市,北屯區,78396,239895,117118,122777
2008/1/1,嘉義市,東區,43430,128524,63031,65493
2008/1/1,嘉義市,西區,47753,144613,72102,72511
2008/1/1,臺南市,東區,68242,193751,94279,99472
2008/1/1,臺南市,南區,41813,127745,64388,63357
2008/1/1,臺南市,北區,45128,128359,63835,64524
2008/1/1,臺南市,安南區,51139,174434,89187,85247
2008/1/1,臺南市,安平區,21305,59503,28605,30898
2008/1/1,臺南市,中西區,29597,81207,40093,41114
2008/1/1,臺北市,松山區,76289,211051,100265,110786
2008/1/1,臺北市,信義區,84615,228880,111352,117528
2008/1/1,臺北市,大安區,114286,315025,149350,165675
2008/1/1,臺北市,中山區,87312,218667,103947,114720
2008/1/1,臺北市,中正區,60043,159558,77441,82117
2008/1/1,臺北市,大同區,45587,126163,62670,63493
2008/1/1,臺北市,萬華區,72349,192278,96900,95378
2008/1/1,臺北市,文山區,93643,261717,127699,134018
2008/1/1,臺北市,南港區,39565,113667,56561,57106
2008/1/1,臺北市,內湖區,90956,265556,128886,136670
2008/1/1,臺北市,士林區,97214,287164,140422,146742
2008/1/1,臺北市,北投區,85942,249963,122040,127923
2008/1/1,高雄市,鹽埕區,11243,28615,14537,14078
2008/1/1,高雄市,鼓山區,46741,122667,60935,61732
2008/1/1,高雄市,左營區,69959,186299,92600,93699
2008/1/1,高雄市,楠梓區,58691,168890,84387,84503
2008/1/1,高雄市,三民區,127923,360379,177744,182635
2008/1/1,高雄市,新興區,22762,57353,28187,29166
2008/1/1,高雄市,前金區,12352,29952,14724,15228
2008/1/1,高雄市,苓雅區,69940,187974,92131,95843
2008/1/1,高雄市,前鎮區,73094,200367,100579,99788
2008/1/1,高雄市,旗津區,10651,29981,15692,14289
2008/1/1,高雄市,小港區,58979,151932,76984,74948
2008/1/1,金門縣,金城鎮,9970,28067,14855,13212
2008/1/1,金門縣,金湖鎮,6515,18286,9743,8543
2008/1/1,金門縣,金沙鎮,4944,13089,6911,6178
2008/1/1,金門縣,金寧鄉,5507,14920,8092,6828
2008/1/1,金門縣,烈嶼鄉,2297,7106,3774,3332
2008/1/1,金門縣,烏坵鄉,134,435,223,212
2008/1/1,連江縣,南竿鄉,1075,5959,3461,2498
2008/1/1,連江縣,北竿鄉,372,1811,1069,742
2008/1/1,連江縣,莒光鄉,232,1180,692,488
2008/1/1,連江縣,東引鄉,248,1004,597,407
2008/2/1,總計,臺灣地區,7492773,22881605,11563244,11318361
2008/2/1,總計,臺灣省,5982792,18729194,9528675,9200519
2008/2/1,總計,新北市,1311225,3802970,1901156,1901814
2008/2/1,總計,宜蘭縣,147172,460584,235924,224660
2008/2/1,總計,桃園市,621396,1938591,983012,955579
2008/2/1,總計,新竹縣,148065,496780,257010,239770
2008/2/1,總計,苗栗縣,163518,560159,292404,267755
2008/2/1,總計,臺中市,443659,1552215,789804,762411
2008/2/1,總計,彰化縣,348731,1314453,677611,636842
2008/2/1,總計,南投縣,164439,533501,276176,257325
2008/2/1,總計,雲林縣,219356,725427,380842,344585
2008/2/1,總計,嘉義縣,169129,550759,288818,261941
2008/2/1,總計,臺南市,353633,1105117,566923,538194
2008/2/1,總計,高雄市,415411,1244282,640579,603703
2008/2/1,總計,屏東縣,267191,888905,459480,429425
2008/2/1,總計,臺東縣,77875,233491,123063,110428
2008/2/1,總計,花蓮縣,116933,343142,178234,164908
2008/2/1,總計,澎湖縣,30548,92384,47694,44690
2008/2/1,總計,基隆市,142746,390084,197597,192487
2008/2/1,總計,新竹市,130672,399957,199987,199970
2008/2/1,總計,臺中市,362262,1057781,516740,541041
2008/2/1,總計,嘉義市,91280,273285,135162,138123
2008/2/1,總計,臺南市,257551,765327,380459,384868
2008/2/1,總計,臺北市,947940,2630966,1277751,1353215
2008/2/1,總計,高雄市,562041,1521445,756818,764627
2008/2/1,總計,福建省,31317,92017,49511,42506
2008/2/1,總計,金門縣,29389,82063,43698,38365
2008/2/1,總計,連江縣,1928,9954,5813,4141
2008/2/1,新北市,板橋區,183164,548531,273408,275123
2008/2/1,新北市,三重區,130862,383774,192480,191294
2008/2/1,新北市,永和區,87747,236623,114168,122455
2008/2/1,新北市,中和區,146429,410077,203956,206121
2008/2/1,新北市,新莊區,129445,396614,197047,199567
2008/2/1,新北市,新店區,110547,290816,143628,147188
2008/2/1,新北市,土城區,78390,237617,119324,118293
2008/2/1,新北市,蘆洲區,61399,192369,95698,96671
2008/2/1,新北市,汐止區,74029,181193,90666,90527
2008/2/1,新北市,樹林區,52433,165059,83645,81414
2008/2/1,新北市,鶯歌區,25696,85784,43727,42057
2008/2/1,新北市,三峽區,30821,95398,49213,46185
2008/2/1,新北市,淡水區,49809,132581,65200,67381
2008/2/1,新北市,瑞芳區,15468,43483,22302,21181
2008/2/1,新北市,五股區,25556,77413,39441,37972
2008/2/1,新北市,泰山區,24625,74592,37800,36792
2008/2/1,新北市,林口區,22680,67963,33904,34059
2008/2/1,新北市,深坑區,8223,22460,11432,11028
2008/2/1,新北市,石碇區,3142,7853,4367,3486
2008/2/1,新北市,坪林區,2361,6582,3699,2883
2008/2/1,新北市,三芝區,8534,23584,12276,11308
2008/2/1,新北市,石門區,3665,11849,6292,5557
2008/2/1,新北市,八里區,11108,32786,16824,15962
2008/2/1,新北市,平溪區,2334,5609,3141,2468
2008/2/1,新北市,雙溪區,3785,9941,5385,4556
2008/2/1,新北市,貢寮區,4309,14032,7310,6722
2008/2/1,新北市,金山區,6423,22241,11329,10912
2008/2/1,新北市,萬里區,6574,20717,10694,10023
2008/2/1,新北市,烏來區,1667,5429,2800,2629
2008/2/1,宜蘭縣,宜蘭市,31999,96147,47607,48540
2008/2/1,宜蘭縣,羅東鎮,24145,74119,35670,38449
2008/2/1,宜蘭縣,蘇澳鎮,13076,43030,22285,20745
2008/2/1,宜蘭縣,頭城鎮,9240,31550,16384,15166
2008/2/1,宜蘭縣,礁溪鄉,11683,35884,18873,17011
2008/2/1,宜蘭縣,壯圍鄉,7756,25197,13329,11868
2008/2/1,宜蘭縣,員山鄉,10240,32334,17405,14929
2008/2/1,宜蘭縣,冬山鄉,16321,51406,26641,24765
2008/2/1,宜蘭縣,五結鄉,12210,38048,19890,18158
2008/2/1,宜蘭縣,三星鄉,7015,21220,11507,9713
2008/2/1,宜蘭縣,大同鄉,1771,5820,3226,2594
2008/2/1,宜蘭縣,南澳鄉,1716,5829,3107,2722
2008/2/1,桃園市,桃園區,133588,392919,193233,199686
2008/2/1,桃園市,中壢區,117108,359234,180537,178697
2008/2/1,桃園市,平鎮區,61757,203125,102741,100384
2008/2/1,桃園市,八德區,53348,172225,88418,83807
2008/2/1,桃園市,大溪區,27548,90501,46808,43693
2008/2/1,桃園市,楊梅區,44212,143168,73340,69828
2008/2/1,桃園市,蘆竹區,43248,132662,66947,65715
2008/2/1,桃園市,大園區,23729,79616,41529,38087
2008/2/1,桃園市,龜山區,46150,131892,67439,64453
2008/2/1,桃園市,龍潭區,34684,112869,57678,55191
2008/2/1,桃園市,新屋區,14404,49934,26671,23263
2008/2/1,桃園市,觀音區,18039,59863,31725,28138
2008/2/1,桃園市,復興區,3581,10583,5946,4637
2008/2/1,新竹縣,竹北市,40003,126964,63981,62983
2008/2/1,新竹縣,關西鎮,8867,32618,17429,15189
2008/2/1,新竹縣,新埔鎮,9879,36078,19154,16924
2008/2/1,新竹縣,竹東鎮,28867,96658,48865,47793
2008/2/1,新竹縣,湖口鄉,22062,74408,38185,36223
2008/2/1,新竹縣,橫山鄉,4176,14633,8000,6633
2008/2/1,新竹縣,新豐鄉,14607,51781,26908,24873
2008/2/1,新竹縣,芎林鄉,5954,20762,10953,9809
2008/2/1,新竹縣,寶山鄉,4449,13752,7449,6303
2008/2/1,新竹縣,北埔鄉,2970,10325,5603,4722
2008/2/1,新竹縣,峨眉鄉,1989,6141,3412,2729
2008/2/1,新竹縣,尖石鄉,2578,8215,4534,3681
2008/2/1,新竹縣,五峰鄉,1664,4445,2537,1908
2008/2/1,苗栗縣,苗栗市,27977,91180,46203,44977
2008/2/1,苗栗縣,苑裡鎮,13256,49015,25676,23339
2008/2/1,苗栗縣,通霄鎮,10894,39146,20923,18223
2008/2/1,苗栗縣,竹南鎮,21846,75367,38451,36916
2008/2/1,苗栗縣,頭份市,27323,94733,48503,46230
2008/2/1,苗栗縣,後龍鎮,11382,40466,21473,18993
2008/2/1,苗栗縣,卓蘭鎮,5753,18492,9812,8680
2008/2/1,苗栗縣,大湖鄉,5116,16153,8706,7447
2008/2/1,苗栗縣,公館鄉,9639,34640,18201,16439
2008/2/1,苗栗縣,銅鑼鄉,5832,19849,10574,9275
2008/2/1,苗栗縣,南庄鄉,3815,11395,6341,5054
2008/2/1,苗栗縣,頭屋鄉,3426,11898,6292,5606
2008/2/1,苗栗縣,三義鄉,5087,17695,9380,8315
2008/2/1,苗栗縣,西湖鄉,2561,7971,4432,3539
2008/2/1,苗栗縣,造橋鄉,3857,13819,7316,6503
2008/2/1,苗栗縣,三灣鄉,2287,7472,4078,3394
2008/2/1,苗栗縣,獅潭鄉,1628,5165,2902,2263
2008/2/1,苗栗縣,泰安鄉,1839,5703,3141,2562
2008/2/1,臺中市,豐原區,47210,164707,82161,82546
2008/2/1,臺中市,大里區,58173,192878,96146,96732
2008/2/1,臺中市,太平區,52273,171706,86579,85127
2008/2/1,臺中市,東勢區,16538,54738,28536,26202
2008/2/1,臺中市,大甲區,20806,79231,40231,39000
2008/2/1,臺中市,清水區,23877,85976,44473,41503
2008/2/1,臺中市,沙鹿區,21535,78749,40239,38510
2008/2/1,臺中市,梧棲區,15236,54285,27599,26686
2008/2/1,臺中市,后里區,14201,54550,28251,26299
2008/2/1,臺中市,神岡區,16917,64209,33145,31064
2008/2/1,臺中市,潭子區,30311,97592,49007,48585
2008/2/1,臺中市,大雅區,25008,88237,44681,43556
2008/2/1,臺中市,新社區,7137,25831,13672,12159
2008/2/1,臺中市,石岡區,4652,16159,8411,7748
2008/2/1,臺中市,外埔區,8328,31857,16442,15415
2008/2/1,臺中市,大安區,5104,20771,10933,9838
2008/2/1,臺中市,烏日區,19126,67555,34421,33134
2008/2/1,臺中市,大肚區,15223,55990,28843,27147
2008/2/1,臺中市,龍井區,19357,71944,36865,35079
2008/2/1,臺中市,霧峰區,18169,64420,33199,31221
2008/2/1,臺中市,和平區,4478,10830,5970,4860
2008/2/1,彰化縣,彰化市,68811,236276,118381,117895
2008/2/1,彰化縣,鹿港鎮,21227,85234,43779,41455
2008/2/1,彰化縣,和美鎮,22885,89137,45870,43267
2008/2/1,彰化縣,北斗鎮,9472,33542,17059,16483
2008/2/1,彰化縣,員林市,35218,126334,63828,62506
2008/2/1,彰化縣,溪湖鎮,14518,56725,29128,27597
2008/2/1,彰化縣,田中鎮,12132,45069,23714,21355
2008/2/1,彰化縣,二林鎮,13808,55014,28441,26573
2008/2/1,彰化縣,線西鄉,3926,17066,8813,8253
2008/2/1,彰化縣,伸港鄉,8514,35744,18444,17300
2008/2/1,彰化縣,福興鄉,11492,48939,25679,23260
2008/2/1,彰化縣,秀水鄉,9200,38840,20125,18715
2008/2/1,彰化縣,花壇鄉,12237,46185,23886,22299
2008/2/1,彰化縣,芬園鄉,6753,25277,13436,11841
2008/2/1,彰化縣,大村鄉,9754,36354,19039,17315
2008/2/1,彰化縣,埔鹽鄉,8480,34680,18273,16407
2008/2/1,彰化縣,埔心鄉,9546,35563,18494,17069
2008/2/1,彰化縣,永靖鄉,9988,39644,20656,18988
2008/2/1,彰化縣,社頭鄉,11925,45419,23442,21977
2008/2/1,彰化縣,二水鄉,5169,17077,9028,8049
2008/2/1,彰化縣,田尾鄉,7457,29119,15193,13926
2008/2/1,彰化縣,埤頭鄉,8197,32069,16833,15236
2008/2/1,彰化縣,芳苑鄉,9798,37017,19631,17386
2008/2/1,彰化縣,大城鄉,5282,19242,10519,8723
2008/2/1,彰化縣,竹塘鄉,4479,16735,8873,7862
2008/2/1,彰化縣,溪州鄉,8463,32152,17047,15105
2008/2/1,南投縣,南投市,32158,105708,53464,52244
2008/2/1,南投縣,埔里鎮,27482,86384,43827,42557
2008/2/1,南投縣,草屯鎮,29544,99971,50703,49268
2008/2/1,南投縣,竹山鎮,18055,59271,30735,28536
2008/2/1,南投縣,集集鎮,4088,12051,6330,5721
2008/2/1,南投縣,名間鄉,11703,41611,21997,19614
2008/2/1,南投縣,鹿谷鄉,6308,19544,10443,9101
2008/2/1,南投縣,中寮鄉,5424,16528,9017,7511
2008/2/1,南投縣,魚池鄉,5635,17361,9251,8110
2008/2/1,南投縣,國姓鄉,7035,21449,11781,9668
2008/2/1,南投縣,水里鄉,7129,20884,11018,9866
2008/2/1,南投縣,信義鄉,5017,17251,9391,7860
2008/2/1,南投縣,仁愛鄉,4861,15488,8219,7269
2008/2/1,雲林縣,斗六市,32648,105570,53442,52128
2008/2/1,雲林縣,斗南鎮,14710,47799,24409,23390
2008/2/1,雲林縣,虎尾鎮,21157,69543,35536,34007
2008/2/1,雲林縣,西螺鎮,13592,49255,25102,24153
2008/2/1,雲林縣,土庫鎮,8409,31123,16334,14789
2008/2/1,雲林縣,北港鎮,14820,44265,23096,21169
2008/2/1,雲林縣,古坑鄉,10290,34882,18496,16386
2008/2/1,雲林縣,大埤鄉,6408,21839,11651,10188
2008/2/1,雲林縣,莿桐鄉,8662,30800,16165,14635
2008/2/1,雲林縣,林內鄉,5530,20342,10684,9658
2008/2/1,雲林縣,二崙鄉,8570,30529,16427,14102
2008/2/1,雲林縣,崙背鄉,8058,28093,14903,13190
2008/2/1,雲林縣,麥寮鄉,11301,33441,17860,15581
2008/2/1,雲林縣,東勢鄉,5593,17577,9563,8014
2008/2/1,雲林縣,褒忠鄉,4156,14786,7925,6861
2008/2/1,雲林縣,臺西鄉,8552,27466,14779,12687
2008/2/1,雲林縣,元長鄉,9082,29678,16232,13446
2008/2/1,雲林縣,四湖鄉,8789,27585,15201,12384
2008/2/1,雲林縣,口湖鄉,9337,31095,16686,14409
2008/2/1,雲林縣,水林鄉,9692,29759,16351,13408
2008/2/1,嘉義縣,太保市,10432,35689,18568,17121
2008/2/1,嘉義縣,朴子市,13592,44213,22729,21484
2008/2/1,嘉義縣,布袋鎮,9898,31292,16188,15104
2008/2/1,嘉義縣,大林鎮,10856,34324,17747,16577
2008/2/1,嘉義縣,民雄鄉,21652,72804,37595,35209
2008/2/1,嘉義縣,溪口鄉,5202,16805,8977,7828
2008/2/1,嘉義縣,新港鄉,10060,35335,18660,16675
2008/2/1,嘉義縣,六腳鄉,8921,27271,14495,12776
2008/2/1,嘉義縣,東石鄉,9111,28619,15260,13359
2008/2/1,嘉義縣,義竹鄉,7261,21840,11384,10456
2008/2/1,嘉義縣,鹿草鄉,5538,17485,9388,8097
2008/2/1,嘉義縣,水上鄉,17116,53453,27859,25594
2008/2/1,嘉義縣,中埔鄉,14523,47993,25159,22834
2008/2/1,嘉義縣,竹崎鄉,11051,39404,21040,18364
2008/2/1,嘉義縣,梅山鄉,6325,22291,11847,10444
2008/2/1,嘉義縣,番路鄉,3781,11750,6427,5323
2008/2/1,嘉義縣,大埔鄉,1864,4021,2180,1841
2008/2/1,嘉義縣,阿里山鄉,1946,6170,3315,2855
2008/2/1,臺南市,新營區,26191,79017,39687,39330
2008/2/1,臺南市,永康區,70342,210873,105465,105408
2008/2/1,臺南市,鹽水區,9612,27804,14527,13277
2008/2/1,臺南市,白河區,10713,32250,17085,15165
2008/2/1,臺南市,麻豆區,14301,46353,23792,22561
2008/2/1,臺南市,佳里區,18433,59304,29654,29650
2008/2/1,臺南市,新化區,13094,44566,22922,21644
2008/2/1,臺南市,善化區,13643,42699,21761,20938
2008/2/1,臺南市,學甲區,9169,28528,14700,13828
2008/2/1,臺南市,柳營區,7563,23214,12160,11054
2008/2/1,臺南市,後壁區,8427,26448,13799,12649
2008/2/1,臺南市,東山區,7999,23746,12726,11020
2008/2/1,臺南市,下營區,8868,26725,13883,12842
2008/2/1,臺南市,六甲區,7412,24381,12729,11652
2008/2/1,臺南市,官田區,7443,22578,11646,10932
2008/2/1,臺南市,大內區,4006,11319,6062,5257
2008/2/1,臺南市,西港區,7554,25493,13053,12440
2008/2/1,臺南市,七股區,7745,25363,13293,12070
2008/2/1,臺南市,將軍區,7253,22047,11276,10771
2008/2/1,臺南市,北門區,4163,12590,6484,6106
2008/2/1,臺南市,新市區,10396,35414,17842,17572
2008/2/1,臺南市,安定區,8759,30051,15645,14406
2008/2/1,臺南市,山上區,2691,8103,4284,3819
2008/2/1,臺南市,玉井區,4990,15827,8257,7570
2008/2/1,臺南市,楠西區,3588,11000,5861,5139
2008/2/1,臺南市,南化區,2812,8976,4926,4050
2008/2/1,臺南市,左鎮區,1933,5634,3133,2501
2008/2/1,臺南市,仁德區,23073,67830,35104,32726
2008/2/1,臺南市,歸仁區,19455,65584,33518,32066
2008/2/1,臺南市,關廟區,10447,36969,19239,17730
2008/2/1,臺南市,龍崎區,1558,4431,2410,2021
2008/2/1,高雄市,鳳山區,121424,339118,169925,169193
2008/2/1,高雄市,岡山區,31923,96152,48662,47490
2008/2/1,高雄市,旗山區,13540,41053,21503,19550
2008/2/1,高雄市,美濃區,13617,44071,23136,20935
2008/2/1,高雄市,林園區,23374,71354,36858,34496
2008/2/1,高雄市,大寮區,36513,109177,57122,52055
2008/2/1,高雄市,大樹區,12860,44858,23307,21551
2008/2/1,高雄市,仁武區,23323,68086,35287,32799
2008/2/1,高雄市,大社區,11231,32742,16867,15875
2008/2/1,高雄市,鳥松區,15601,41395,21117,20278
2008/2/1,高雄市,橋頭區,12220,36572,18881,17691
2008/2/1,高雄市,燕巢區,9596,31199,16703,14496
2008/2/1,高雄市,田寮區,3579,8541,4771,3770
2008/2/1,高雄市,阿蓮區,8884,30893,15615,15278
2008/2/1,高雄市,路竹區,15425,54557,27931,26626
2008/2/1,高雄市,湖內區,9060,28602,14805,13797
2008/2/1,高雄市,茄萣區,9909,31965,16782,15183
2008/2/1,高雄市,永安區,5651,14246,7319,6927
2008/2/1,高雄市,彌陀區,6390,20815,10939,9876
2008/2/1,高雄市,梓官區,11496,37169,19547,17622
2008/2/1,高雄市,六龜區,5664,15615,8498,7117
2008/2/1,高雄市,甲仙區,2564,8201,4422,3779
2008/2/1,高雄市,杉林區,3985,11374,6252,5122
2008/2/1,高雄市,內門區,4966,16508,9034,7474
2008/2/1,高雄市,茂林區,520,1758,895,863
2008/2/1,高雄市,桃源區,1222,4781,2570,2211
2008/2/1,屏東縣,屏東市,70814,215818,108206,107612
2008/2/1,屏東縣,潮州鎮,17586,56945,28790,28155
2008/2/1,屏東縣,東港鎮,14653,50572,25844,24728
2008/2/1,屏東縣,恆春鎮,10306,31276,16237,15039
2008/2/1,屏東縣,萬丹鄉,13746,54593,28335,26258
2008/2/1,屏東縣,長治鄉,9480,30983,16308,14675
2008/2/1,屏東縣,麟洛鄉,3449,11677,6058,5619
2008/2/1,屏東縣,九如鄉,6412,23224,12088,11136
2008/2/1,屏東縣,里港鄉,7766,26534,13670,12864
2008/2/1,屏東縣,鹽埔鄉,7458,27748,14476,13272
2008/2/1,屏東縣,高樹鄉,9490,27480,14719,12761
2008/2/1,屏東縣,萬巒鄉,6292,22660,11994,10666
2008/2/1,屏東縣,內埔鄉,17229,59439,31098,28341
2008/2/1,屏東縣,竹田鄉,5356,18500,9880,8620
2008/2/1,屏東縣,新埤鄉,3290,11033,5863,5170
2008/2/1,屏東縣,枋寮鄉,8256,27361,14525,12836
2008/2/1,屏東縣,新園鄉,10834,39420,20429,18991
2008/2/1,屏東縣,崁頂鄉,3960,17065,8822,8243
2008/2/1,屏東縣,林邊鄉,6180,21266,11032,10234
2008/2/1,屏東縣,南州鄉,3571,12115,6219,5896
2008/2/1,屏東縣,佳冬鄉,6581,21774,11399,10375
2008/2/1,屏東縣,琉球鄉,3749,12617,6993,5624
2008/2/1,屏東縣,車城鄉,3385,10035,5425,4610
2008/2/1,屏東縣,滿州鄉,2972,8626,4731,3895
2008/2/1,屏東縣,枋山鄉,2099,6222,3352,2870
2008/2/1,屏東縣,三地門鄉,2021,7225,3705,3520
2008/2/1,屏東縣,霧臺鄉,850,2733,1459,1274
2008/2/1,屏東縣,瑪家鄉,1801,6480,3385,3095
2008/2/1,屏東縣,泰武鄉,1087,4904,2622,2282
2008/2/1,屏東縣,來義鄉,2064,7774,4016,3758
2008/2/1,屏東縣,春日鄉,1271,4985,2609,2376
2008/2/1,屏東縣,獅子鄉,1421,4966,2644,2322
2008/2/1,屏東縣,牡丹鄉,1762,4855,2547,2308
2008/2/1,臺東縣,臺東市,36914,110185,56242,53943
2008/2/1,臺東縣,成功鎮,5329,16368,8786,7582
2008/2/1,臺東縣,關山鎮,3178,9987,5280,4707
2008/2/1,臺東縣,卑南鄉,6416,18419,10084,8335
2008/2/1,臺東縣,大武鄉,2445,7088,3714,3374
2008/2/1,臺東縣,太麻里鄉,4470,12203,6564,5639
2008/2/1,臺東縣,東河鄉,3428,9697,5388,4309
2008/2/1,臺東縣,長濱鄉,2836,8826,5019,3807
2008/2/1,臺東縣,鹿野鄉,3077,8900,4810,4090
2008/2/1,臺東縣,池上鄉,3175,9473,5057,4416
2008/2/1,臺東縣,綠島鄉,900,3113,1667,1446
2008/2/1,臺東縣,延平鄉,1060,3639,2046,1593
2008/2/1,臺東縣,海端鄉,1071,4574,2484,2090
2008/2/1,臺東縣,達仁鄉,1398,3728,2065,1663
2008/2/1,臺東縣,金峰鄉,978,3325,1763,1562
2008/2/1,臺東縣,蘭嶼鄉,1200,3966,2094,1872
2008/2/1,花蓮縣,花蓮市,39144,109933,54296,55637
2008/2/1,花蓮縣,鳳林鎮,4384,12426,6612,5814
2008/2/1,花蓮縣,玉里鎮,8796,28079,15335,12744
2008/2/1,花蓮縣,新城鄉,7097,20440,10683,9757
2008/2/1,花蓮縣,吉安鄉,27421,78950,40739,38211
2008/2/1,花蓮縣,壽豐鄉,6680,19296,10513,8783
2008/2/1,花蓮縣,光復鄉,4974,14663,7858,6805
2008/2/1,花蓮縣,豐濱鄉,1805,5331,2964,2367
2008/2/1,花蓮縣,瑞穗鄉,4545,13347,7260,6087
2008/2/1,花蓮縣,富里鄉,3876,12010,6643,5367
2008/2/1,花蓮縣,秀林鄉,4467,14976,7867,7109
2008/2/1,花蓮縣,萬榮鄉,2141,7153,3827,3326
2008/2/1,花蓮縣,卓溪鄉,1603,6538,3637,2901
2008/2/1,澎湖縣,馬公市,17858,54584,27798,26786
2008/2/1,澎湖縣,湖西鄉,4270,12829,6712,6117
2008/2/1,澎湖縣,白沙鄉,2929,9155,4853,4302
2008/2/1,澎湖縣,西嶼鄉,2670,8184,4246,3938
2008/2/1,澎湖縣,望安鄉,1709,4416,2372,2044
2008/2/1,澎湖縣,七美鄉,1112,3216,1713,1503
2008/2/1,基隆市,中正區,21716,57443,29611,27832
2008/2/1,基隆市,七堵區,19109,55187,28121,27066
2008/2/1,基隆市,暖暖區,14019,38422,19654,18768
2008/2/1,基隆市,仁愛區,18897,50309,25069,25240
2008/2/1,基隆市,中山區,18647,52284,26827,25457
2008/2/1,基隆市,安樂區,30976,85316,42577,42739
2008/2/1,基隆市,信義區,19382,51123,25738,25385
2008/2/1,新竹市,東區,63265,190561,94492,96069
2008/2/1,新竹市,北區,46453,139356,69569,69787
2008/2/1,新竹市,香山區,20954,70040,35926,34114
2008/2/1,臺中市,中區,8445,23927,11798,12129
2008/2/1,臺中市,東區,24899,73940,37574,36366
2008/2/1,臺中市,西區,41503,117118,56563,60555
2008/2/1,臺中市,南區,39412,110561,53986,56575
2008/2/1,臺中市,北區,53471,147600,71977,75623
2008/2/1,臺中市,西屯區,67145,198146,96811,101335
2008/2/1,臺中市,南屯區,48909,146329,70808,75521
2008/2/1,臺中市,北屯區,78478,240160,117223,122937
2008/2/1,嘉義市,東區,43480,128563,63022,65541
2008/2/1,嘉義市,西區,47800,144722,72140,72582
2008/2/1,臺南市,東區,68311,193870,94299,99571
2008/2/1,臺南市,南區,41840,127715,64355,63360
2008/2/1,臺南市,北區,45223,128509,63896,64613
2008/2/1,臺南市,安南區,51238,174510,89206,85304
2008/2/1,臺南市,安平區,21340,59550,28629,30921
2008/2/1,臺南市,中西區,29599,81173,40074,41099
2008/2/1,臺北市,松山區,76268,211229,100350,110879
2008/2/1,臺北市,信義區,84598,228981,111346,117635
2008/2/1,臺北市,大安區,114281,315334,149449,165885
2008/2/1,臺北市,中山區,87383,218826,103989,114837
2008/2/1,臺北市,中正區,60015,159622,77460,82162
2008/2/1,臺北市,大同區,45610,126167,62649,63518
2008/2/1,臺北市,萬華區,72340,192237,96833,95404
2008/2/1,臺北市,文山區,93658,261848,127705,134143
2008/2/1,臺北市,南港區,39588,113675,56527,57148
2008/2/1,臺北市,內湖區,90993,265757,128968,136789
2008/2/1,臺北市,士林區,97228,287260,140439,146821
2008/2/1,臺北市,北投區,85978,250030,122036,127994
2008/2/1,高雄市,鹽埕區,11266,28639,14533,14106
2008/2/1,高雄市,鼓山區,46833,122885,61031,61854
2008/2/1,高雄市,左營區,70012,186425,92651,93774
2008/2/1,高雄市,楠梓區,58755,169046,84441,84605
2008/2/1,高雄市,三民區,127949,360285,177710,182575
2008/2/1,高雄市,新興區,22752,57315,28161,29154
2008/2/1,高雄市,前金區,12368,29909,14710,15199
2008/2/1,高雄市,苓雅區,69996,188015,92093,95922
2008/2/1,高雄市,前鎮區,73173,200414,100604,99810
2008/2/1,高雄市,旗津區,10651,29954,15678,14276
2008/2/1,高雄市,小港區,59160,152038,77037,75001
2008/2/1,金門縣,金城鎮,9972,28129,14889,13240
2008/2/1,金門縣,金湖鎮,6525,18297,9766,8531
2008/2/1,金門縣,金沙鎮,4944,13108,6920,6188
2008/2/1,金門縣,金寧鄉,5515,14971,8120,6851
2008/2/1,金門縣,烈嶼鄉,2299,7123,3780,3343
2008/2/1,金門縣,烏坵鄉,134,435,223,212
2008/2/1,連江縣,南竿鄉,1077,5958,3461,2497
2008/2/1,連江縣,北竿鄉,372,1813,1069,744
2008/2/1,連江縣,莒光鄉,232,1179,689,490
2008/2/1,連江縣,東引鄉,247,1004,594,410
2008/3/1,總計,臺灣地區,7501587,22886499,11563647,11322852
2008/3/1,總計,臺灣省,5990494,18733137,9529135,9204002
2008/3/1,總計,新北市,1313005,3804969,1901791,1903178
2008/3/1,總計,宜蘭縣,147380,460656,235908,224748
2008/3/1,總計,桃園市,622330,1940014,983553,956461
2008/3/1,總計,新竹縣,148395,497245,257181,240064
2008/3/1,總計,苗栗縣,163775,560142,292375,267767
2008/3/1,總計,臺中市,444183,1552511,789898,762613
2008/3/1,總計,彰化縣,349067,1314253,677457,636796
2008/3/1,總計,南投縣,164660,533320,276035,257285
2008/3/1,總計,雲林縣,219716,725378,380753,344625
2008/3/1,總計,嘉義縣,169370,550344,288567,261777
2008/3/1,總計,臺南市,354125,1105000,566845,538155
2008/3/1,總計,高雄市,415625,1244027,640364,603663
2008/3/1,總計,屏東縣,267370,888504,459195,429309
2008/3/1,總計,臺東縣,77932,233310,122958,110352
2008/3/1,總計,花蓮縣,117047,343026,178103,164923
2008/3/1,總計,澎湖縣,30598,92363,47680,44683
2008/3/1,總計,基隆市,142804,389915,197480,192435
2008/3/1,總計,新竹市,130854,400430,200190,200240
2008/3/1,總計,臺中市,362875,1058529,516982,541547
2008/3/1,總計,嘉義市,91452,273422,135207,138215
2008/3/1,總計,臺南市,257931,765779,380613,385166
2008/3/1,總計,臺北市,948331,2631605,1277650,1353955
2008/3/1,總計,高雄市,562762,1521757,756862,764895
2008/3/1,總計,福建省,31364,92301,49678,42623
2008/3/1,總計,金門縣,29433,82323,43846,38477
2008/3/1,總計,連江縣,1931,9978,5832,4146
2008/3/1,新北市,板橋區,183512,548816,273469,275347
2008/3/1,新北市,三重區,130966,383749,192441,191308
2008/3/1,新北市,永和區,87850,236927,114279,122648
2008/3/1,新北市,中和區,146523,409846,203812,206034
2008/3/1,新北市,新莊區,129591,396762,197070,199692
2008/3/1,新北市,新店區,110591,290868,143614,147254
2008/3/1,新北市,土城區,78423,237643,119322,118321
2008/3/1,新北市,蘆洲區,61482,192515,95785,96730
2008/3/1,新北市,汐止區,74026,181195,90636,90559
2008/3/1,新北市,樹林區,52584,165333,83768,81565
2008/3/1,新北市,鶯歌區,25769,85891,43786,42105
2008/3/1,新北市,三峽區,30925,95617,49318,46299
2008/3/1,新北市,淡水區,49948,132804,65281,67523
2008/3/1,新北市,瑞芳區,15486,43434,22287,21147
2008/3/1,新北市,五股區,25609,77456,39462,37994
2008/3/1,新北市,泰山區,24638,74670,37825,36845
2008/3/1,新北市,林口區,22870,68296,34062,34234
2008/3/1,新北市,深坑區,8238,22509,11449,11060
2008/3/1,新北市,石碇區,3144,7862,4368,3494
2008/3/1,新北市,坪林區,2365,6582,3694,2888
2008/3/1,新北市,三芝區,8546,23579,12268,11311
2008/3/1,新北市,石門區,3674,11875,6301,5574
2008/3/1,新北市,八里區,11115,32773,16825,15948
2008/3/1,新北市,平溪區,2332,5602,3139,2463
2008/3/1,新北市,雙溪區,3792,9937,5382,4555
2008/3/1,新北市,貢寮區,4316,14020,7302,6718
2008/3/1,新北市,金山區,6429,22249,11336,10913
2008/3/1,新北市,萬里區,6595,20732,10710,10022
2008/3/1,新北市,烏來區,1666,5427,2800,2627
2008/3/1,宜蘭縣,宜蘭市,32036,96122,47574,48548
2008/3/1,宜蘭縣,羅東鎮,24154,74123,35661,38462
2008/3/1,宜蘭縣,蘇澳鎮,13109,43164,22341,20823
2008/3/1,宜蘭縣,頭城鎮,9257,31534,16388,15146
2008/3/1,宜蘭縣,礁溪鄉,11705,35877,18873,17004
2008/3/1,宜蘭縣,壯圍鄉,7770,25169,13309,11860
2008/3/1,宜蘭縣,員山鄉,10268,32318,17384,14934
2008/3/1,宜蘭縣,冬山鄉,16346,51435,26651,24784
2008/3/1,宜蘭縣,五結鄉,12218,38043,19889,18154
2008/3/1,宜蘭縣,三星鄉,7024,21221,11504,9717
2008/3/1,宜蘭縣,大同鄉,1778,5820,3223,2597
2008/3/1,宜蘭縣,南澳鄉,1715,5830,3111,2719
2008/3/1,桃園市,桃園區,133795,393335,193393,199942
2008/3/1,桃園市,中壢區,117273,359455,180571,178884
2008/3/1,桃園市,平鎮區,61866,203369,102879,100490
2008/3/1,桃園市,八德區,53406,172187,88352,83835
2008/3/1,桃園市,大溪區,27578,90516,46814,43702
2008/3/1,桃園市,楊梅區,44307,143343,73432,69911
2008/3/1,桃園市,蘆竹區,43335,132880,67078,65802
2008/3/1,桃園市,大園區,23769,79662,41569,38093
2008/3/1,桃園市,龜山區,46241,132009,67494,64515
2008/3/1,桃園市,龍潭區,34714,112976,57698,55278
2008/3/1,桃園市,新屋區,14414,49902,26652,23250
2008/3/1,桃園市,觀音區,18054,59829,31693,28136
2008/3/1,桃園市,復興區,3578,10551,5928,4623
2008/3/1,新竹縣,竹北市,40177,127389,64213,63176
2008/3/1,新竹縣,關西鎮,8866,32592,17410,15182
2008/3/1,新竹縣,新埔鎮,9898,36070,19140,16930
2008/3/1,新竹縣,竹東鎮,28897,96668,48848,47820
2008/3/1,新竹縣,湖口鄉,22102,74448,38186,36262
2008/3/1,新竹縣,橫山鄉,4187,14636,7993,6643
2008/3/1,新竹縣,新豐鄉,14653,51884,26947,24937
2008/3/1,新竹縣,芎林鄉,5960,20759,10955,9804
2008/3/1,新竹縣,寶山鄉,4448,13715,7429,6286
2008/3/1,新竹縣,北埔鄉,2976,10302,5594,4708
2008/3/1,新竹縣,峨眉鄉,1994,6150,3419,2731
2008/3/1,新竹縣,尖石鄉,2577,8201,4519,3682
2008/3/1,新竹縣,五峰鄉,1660,4431,2528,1903
2008/3/1,苗栗縣,苗栗市,27998,91184,46212,44972
2008/3/1,苗栗縣,苑裡鎮,13282,49000,25672,23328
2008/3/1,苗栗縣,通霄鎮,10908,39115,20899,18216
2008/3/1,苗栗縣,竹南鎮,21894,75445,38491,36954
2008/3/1,苗栗縣,頭份市,27400,94836,48554,46282
2008/3/1,苗栗縣,後龍鎮,11384,40420,21446,18974
2008/3/1,苗栗縣,卓蘭鎮,5757,18470,9796,8674
2008/3/1,苗栗縣,大湖鄉,5122,16132,8696,7436
2008/3/1,苗栗縣,公館鄉,9657,34670,18218,16452
2008/3/1,苗栗縣,銅鑼鄉,5834,19838,10570,9268
2008/3/1,苗栗縣,南庄鄉,3825,11355,6321,5034
2008/3/1,苗栗縣,頭屋鄉,3424,11869,6274,5595
2008/3/1,苗栗縣,三義鄉,5094,17674,9365,8309
2008/3/1,苗栗縣,西湖鄉,2566,7978,4431,3547
2008/3/1,苗栗縣,造橋鄉,3861,13813,7313,6500
2008/3/1,苗栗縣,三灣鄉,2296,7469,4069,3400
2008/3/1,苗栗縣,獅潭鄉,1634,5150,2896,2254
2008/3/1,苗栗縣,泰安鄉,1839,5724,3152,2572
2008/3/1,臺中市,豐原區,47257,164762,82164,82598
2008/3/1,臺中市,大里區,58283,193133,96287,96846
2008/3/1,臺中市,太平區,52313,171737,86583,85154
2008/3/1,臺中市,東勢區,16524,54645,28479,26166
2008/3/1,臺中市,大甲區,20835,79294,40253,39041
2008/3/1,臺中市,清水區,23907,85956,44482,41474
2008/3/1,臺中市,沙鹿區,21594,78883,40305,38578
2008/3/1,臺中市,梧棲區,15254,54313,27616,26697
2008/3/1,臺中市,后里區,14200,54533,28243,26290
2008/3/1,臺中市,神岡區,16938,64198,33139,31059
2008/3/1,臺中市,潭子區,30366,97560,48996,48564
2008/3/1,臺中市,大雅區,25047,88329,44710,43619
2008/3/1,臺中市,新社區,7147,25836,13670,12166
2008/3/1,臺中市,石岡區,4660,16125,8404,7721
2008/3/1,臺中市,外埔區,8335,31833,16432,15401
2008/3/1,臺中市,大安區,5106,20741,10921,9820
2008/3/1,臺中市,烏日區,19161,67570,34428,33142
2008/3/1,臺中市,大肚區,15224,55981,28837,27144
2008/3/1,臺中市,龍井區,19370,71880,36815,35065
2008/3/1,臺中市,霧峰區,18189,64384,33181,31203
2008/3/1,臺中市,和平區,4473,10818,5953,4865
2008/3/1,彰化縣,彰化市,68882,236338,118401,117937
2008/3/1,彰化縣,鹿港鎮,21241,85283,43789,41494
2008/3/1,彰化縣,和美鎮,22915,89133,45876,43257
2008/3/1,彰化縣,北斗鎮,9487,33559,17076,16483
2008/3/1,彰化縣,員林市,35231,126285,63817,62468
2008/3/1,彰化縣,溪湖鎮,14538,56720,29130,27590
2008/3/1,彰化縣,田中鎮,12137,45055,23712,21343
2008/3/1,彰化縣,二林鎮,13828,54988,28430,26558
2008/3/1,彰化縣,線西鄉,3931,17055,8803,8252
2008/3/1,彰化縣,伸港鄉,8527,35765,18443,17322
2008/3/1,彰化縣,福興鄉,11508,48924,25665,23259
2008/3/1,彰化縣,秀水鄉,9212,38863,20144,18719
2008/3/1,彰化縣,花壇鄉,12250,46141,23868,22273
2008/3/1,彰化縣,芬園鄉,6757,25229,13419,11810
2008/3/1,彰化縣,大村鄉,9779,36397,19044,17353
2008/3/1,彰化縣,埔鹽鄉,8482,34663,18256,16407
2008/3/1,彰化縣,埔心鄉,9556,35537,18479,17058
2008/3/1,彰化縣,永靖鄉,10000,39658,20653,19005
2008/3/1,彰化縣,社頭鄉,11933,45412,23437,21975
2008/3/1,彰化縣,二水鄉,5178,17085,9029,8056
2008/3/1,彰化縣,田尾鄉,7458,29089,15171,13918
2008/3/1,彰化縣,埤頭鄉,8205,32060,16827,15233
2008/3/1,彰化縣,芳苑鄉,9800,36946,19589,17357
2008/3/1,彰化縣,大城鄉,5284,19206,10493,8713
2008/3/1,彰化縣,竹塘鄉,4479,16750,8884,7866
2008/3/1,彰化縣,溪州鄉,8469,32112,17022,15090
2008/3/1,南投縣,南投市,32193,105677,53433,52244
2008/3/1,南投縣,埔里鎮,27509,86372,43827,42545
2008/3/1,南投縣,草屯鎮,29586,99964,50685,49279
2008/3/1,南投縣,竹山鎮,18088,59255,30717,28538
2008/3/1,南投縣,集集鎮,4100,12032,6330,5702
2008/3/1,南投縣,名間鄉,11719,41623,21997,19626
2008/3/1,南投縣,鹿谷鄉,6333,19540,10435,9105
2008/3/1,南投縣,中寮鄉,5434,16530,9021,7509
2008/3/1,南投縣,魚池鄉,5635,17324,9229,8095
2008/3/1,南投縣,國姓鄉,7037,21413,11771,9642
2008/3/1,南投縣,水里鄉,7138,20852,11002,9850
2008/3/1,南投縣,信義鄉,5026,17241,9380,7861
2008/3/1,南投縣,仁愛鄉,4862,15497,8208,7289
2008/3/1,雲林縣,斗六市,32747,105655,53483,52172
2008/3/1,雲林縣,斗南鎮,14733,47798,24387,23411
2008/3/1,雲林縣,虎尾鎮,21192,69583,35540,34043
2008/3/1,雲林縣,西螺鎮,13597,49228,25077,24151
2008/3/1,雲林縣,土庫鎮,8417,31116,16328,14788
2008/3/1,雲林縣,北港鎮,14845,44246,23091,21155
2008/3/1,雲林縣,古坑鄉,10301,34869,18492,16377
2008/3/1,雲林縣,大埤鄉,6410,21803,11641,10162
2008/3/1,雲林縣,莿桐鄉,8679,30776,16154,14622
2008/3/1,雲林縣,林內鄉,5530,20272,10650,9622
2008/3/1,雲林縣,二崙鄉,8578,30527,16413,14114
2008/3/1,雲林縣,崙背鄉,8074,28086,14898,13188
2008/3/1,雲林縣,麥寮鄉,11338,33518,17898,15620
2008/3/1,雲林縣,東勢鄉,5592,17559,9558,8001
2008/3/1,雲林縣,褒忠鄉,4161,14764,7916,6848
2008/3/1,雲林縣,臺西鄉,8553,27434,14761,12673
2008/3/1,雲林縣,元長鄉,9086,29656,16221,13435
2008/3/1,雲林縣,四湖鄉,8816,27597,15199,12398
2008/3/1,雲林縣,口湖鄉,9353,31153,16708,14445
2008/3/1,雲林縣,水林鄉,9714,29738,16338,13400
2008/3/1,嘉義縣,太保市,10453,35683,18561,17122
2008/3/1,嘉義縣,朴子市,13644,44311,22747,21564
2008/3/1,嘉義縣,布袋鎮,9910,31223,16151,15072
2008/3/1,嘉義縣,大林鎮,10867,34292,17724,16568
2008/3/1,嘉義縣,民雄鄉,21689,72812,37579,35233
2008/3/1,嘉義縣,溪口鄉,5212,16758,8953,7805
2008/3/1,嘉義縣,新港鄉,10082,35346,18656,16690
2008/3/1,嘉義縣,六腳鄉,8930,27201,14458,12743
2008/3/1,嘉義縣,東石鄉,9120,28551,15240,13311
2008/3/1,嘉義縣,義竹鄉,7270,21798,11372,10426
2008/3/1,嘉義縣,鹿草鄉,5544,17474,9382,8092
2008/3/1,嘉義縣,水上鄉,17117,53389,27827,25562
2008/3/1,嘉義縣,中埔鄉,14531,47890,25118,22772
2008/3/1,嘉義縣,竹崎鄉,11067,39391,21037,18354
2008/3/1,嘉義縣,梅山鄉,6338,22283,11846,10437
2008/3/1,嘉義縣,番路鄉,3785,11744,6420,5324
2008/3/1,嘉義縣,大埔鄉,1864,4027,2182,1845
2008/3/1,嘉義縣,阿里山鄉,1947,6171,3314,2857
2008/3/1,臺南市,新營區,26214,79049,39684,39365
2008/3/1,臺南市,永康區,70482,211067,105602,105465
2008/3/1,臺南市,鹽水區,9624,27795,14513,13282
2008/3/1,臺南市,白河區,10726,32237,17057,15180
2008/3/1,臺南市,麻豆區,14316,46354,23785,22569
2008/3/1,臺南市,佳里區,18448,59289,29628,29661
2008/3/1,臺南市,新化區,13109,44555,22916,21639
2008/3/1,臺南市,善化區,13674,42782,21804,20978
2008/3/1,臺南市,學甲區,9180,28529,14700,13829
2008/3/1,臺南市,柳營區,7572,23197,12150,11047
2008/3/1,臺南市,後壁區,8450,26374,13759,12615
2008/3/1,臺南市,東山區,8012,23738,12729,11009
2008/3/1,臺南市,下營區,8883,26727,13885,12842
2008/3/1,臺南市,六甲區,7419,24349,12705,11644
2008/3/1,臺南市,官田區,7461,22555,11642,10913
2008/3/1,臺南市,大內區,4005,11297,6045,5252
2008/3/1,臺南市,西港區,7561,25473,13043,12430
2008/3/1,臺南市,七股區,7750,25374,13300,12074
2008/3/1,臺南市,將軍區,7261,21995,11261,10734
2008/3/1,臺南市,北門區,4164,12569,6466,6103
2008/3/1,臺南市,新市區,10410,35382,17832,17550
2008/3/1,臺南市,安定區,8776,30039,15643,14396
2008/3/1,臺南市,山上區,2688,8091,4278,3813
2008/3/1,臺南市,玉井區,4995,15825,8256,7569
2008/3/1,臺南市,楠西區,3593,10984,5856,5128
2008/3/1,臺南市,南化區,2811,8972,4924,4048
2008/3/1,臺南市,左鎮區,1930,5620,3125,2495
2008/3/1,臺南市,仁德區,23118,67835,35110,32725
2008/3/1,臺南市,歸仁區,19478,65611,33524,32087
2008/3/1,臺南市,關廟區,10456,36912,19220,17692
2008/3/1,臺南市,龍崎區,1559,4424,2403,2021
2008/3/1,高雄市,鳳山區,121468,338995,169869,169126
2008/3/1,高雄市,岡山區,31905,96211,48680,47531
2008/3/1,高雄市,旗山區,13533,41050,21500,19550
2008/3/1,高雄市,美濃區,13630,44034,23117,20917
2008/3/1,高雄市,林園區,23361,71335,36840,34495
2008/3/1,高雄市,大寮區,36577,109175,57104,52071
2008/3/1,高雄市,大樹區,12860,44813,23276,21537
2008/3/1,高雄市,仁武區,23359,68185,35304,32881
2008/3/1,高雄市,大社區,11239,32750,16876,15874
2008/3/1,高雄市,鳥松區,15617,41427,21149,20278
2008/3/1,高雄市,橋頭區,12228,36510,18851,17659
2008/3/1,高雄市,燕巢區,9611,31183,16695,14488
2008/3/1,高雄市,田寮區,3579,8519,4757,3762
2008/3/1,高雄市,阿蓮區,8896,30909,15626,15283
2008/3/1,高雄市,路竹區,15417,54487,27899,26588
2008/3/1,高雄市,湖內區,9081,28647,14820,13827
2008/3/1,高雄市,茄萣區,9912,31945,16775,15170
2008/3/1,高雄市,永安區,5648,14209,7308,6901
2008/3/1,高雄市,彌陀區,6389,20811,10926,9885
2008/3/1,高雄市,梓官區,11508,37183,19541,17642
2008/3/1,高雄市,六龜區,5668,15608,8493,7115
2008/3/1,高雄市,甲仙區,2568,8208,4421,3787
2008/3/1,高雄市,杉林區,3982,11344,6229,5115
2008/3/1,高雄市,內門區,4964,16475,9012,7463
2008/3/1,高雄市,茂林區,522,1761,897,864
2008/3/1,高雄市,桃源區,1230,4779,2568,2211
2008/3/1,屏東縣,屏東市,70876,215849,108204,107645
2008/3/1,屏東縣,潮州鎮,17605,56956,28794,28162
2008/3/1,屏東縣,東港鎮,14677,50595,25855,24740
2008/3/1,屏東縣,恆春鎮,10314,31282,16225,15057
2008/3/1,屏東縣,萬丹鄉,13752,54576,28307,26269
2008/3/1,屏東縣,長治鄉,9479,30950,16282,14668
2008/3/1,屏東縣,麟洛鄉,3446,11652,6048,5604
2008/3/1,屏東縣,九如鄉,6409,23210,12092,11118
2008/3/1,屏東縣,里港鄉,7759,26525,13654,12871
2008/3/1,屏東縣,鹽埔鄉,7470,27721,14459,13262
2008/3/1,屏東縣,高樹鄉,9502,27448,14714,12734
2008/3/1,屏東縣,萬巒鄉,6294,22619,11964,10655
2008/3/1,屏東縣,內埔鄉,17232,59374,31071,28303
2008/3/1,屏東縣,竹田鄉,5364,18506,9882,8624
2008/3/1,屏東縣,新埤鄉,3297,11015,5852,5163
2008/3/1,屏東縣,枋寮鄉,8256,27339,14515,12824
2008/3/1,屏東縣,新園鄉,10844,39381,20396,18985
2008/3/1,屏東縣,崁頂鄉,3961,17082,8843,8239
2008/3/1,屏東縣,林邊鄉,6178,21250,11019,10231
2008/3/1,屏東縣,南州鄉,3572,12104,6218,5886
2008/3/1,屏東縣,佳冬鄉,6582,21743,11382,10361
2008/3/1,屏東縣,琉球鄉,3758,12634,6993,5641
2008/3/1,屏東縣,車城鄉,3385,10019,5414,4605
2008/3/1,屏東縣,滿州鄉,2970,8598,4721,3877
2008/3/1,屏東縣,枋山鄉,2104,6222,3351,2871
2008/3/1,屏東縣,三地門鄉,2017,7220,3702,3518
2008/3/1,屏東縣,霧臺鄉,852,2721,1451,1270
2008/3/1,屏東縣,瑪家鄉,1802,6470,3378,3092
2008/3/1,屏東縣,泰武鄉,1086,4892,2617,2275
2008/3/1,屏東縣,來義鄉,2063,7762,4010,3752
2008/3/1,屏東縣,春日鄉,1271,4977,2608,2369
2008/3/1,屏東縣,獅子鄉,1424,4960,2637,2323
2008/3/1,屏東縣,牡丹鄉,1769,4852,2537,2315
2008/3/1,臺東縣,臺東市,36918,110123,56188,53935
2008/3/1,臺東縣,成功鎮,5326,16338,8772,7566
2008/3/1,臺東縣,關山鎮,3191,10004,5292,4712
2008/3/1,臺東縣,卑南鄉,6423,18420,10081,8339
2008/3/1,臺東縣,大武鄉,2444,7069,3707,3362
2008/3/1,臺東縣,太麻里鄉,4485,12214,6577,5637
2008/3/1,臺東縣,東河鄉,3433,9681,5382,4299
2008/3/1,臺東縣,長濱鄉,2839,8813,5013,3800
2008/3/1,臺東縣,鹿野鄉,3091,8883,4804,4079
2008/3/1,臺東縣,池上鄉,3174,9450,5044,4406
2008/3/1,臺東縣,綠島鄉,903,3108,1665,1443
2008/3/1,臺東縣,延平鄉,1058,3633,2038,1595
2008/3/1,臺東縣,海端鄉,1071,4565,2479,2086
2008/3/1,臺東縣,達仁鄉,1397,3725,2068,1657
2008/3/1,臺東縣,金峰鄉,975,3325,1759,1566
2008/3/1,臺東縣,蘭嶼鄉,1204,3959,2089,1870
2008/3/1,花蓮縣,花蓮市,39189,109983,54301,55682
2008/3/1,花蓮縣,鳳林鎮,4387,12426,6609,5817
2008/3/1,花蓮縣,玉里鎮,8805,28062,15319,12743
2008/3/1,花蓮縣,新城鄉,7106,20404,10656,9748
2008/3/1,花蓮縣,吉安鄉,27471,78957,40739,38218
2008/3/1,花蓮縣,壽豐鄉,6682,19295,10510,8785
2008/3/1,花蓮縣,光復鄉,4971,14633,7849,6784
2008/3/1,花蓮縣,豐濱鄉,1805,5323,2958,2365
2008/3/1,花蓮縣,瑞穗鄉,4543,13339,7249,6090
2008/3/1,花蓮縣,富里鄉,3881,11991,6624,5367
2008/3/1,花蓮縣,秀林鄉,4469,14975,7853,7122
2008/3/1,花蓮縣,萬榮鄉,2133,7113,3804,3309
2008/3/1,花蓮縣,卓溪鄉,1605,6525,3632,2893
2008/3/1,澎湖縣,馬公市,17885,54579,27797,26782
2008/3/1,澎湖縣,湖西鄉,4283,12846,6725,6121
2008/3/1,澎湖縣,白沙鄉,2939,9162,4848,4314
2008/3/1,澎湖縣,西嶼鄉,2671,8150,4232,3918
2008/3/1,澎湖縣,望安鄉,1708,4415,2372,2043
2008/3/1,澎湖縣,七美鄉,1112,3211,1706,1505
2008/3/1,基隆市,中正區,21715,57393,29598,27795
2008/3/1,基隆市,七堵區,19124,55179,28105,27074
2008/3/1,基隆市,暖暖區,14033,38434,19657,18777
2008/3/1,基隆市,仁愛區,18929,50316,25051,25265
2008/3/1,基隆市,中山區,18634,52196,26788,25408
2008/3/1,基隆市,安樂區,30969,85280,42533,42747
2008/3/1,基隆市,信義區,19400,51117,25748,25369
2008/3/1,新竹市,東區,63341,190744,94580,96164
2008/3/1,新竹市,北區,46543,139586,69667,69919
2008/3/1,新竹市,香山區,20970,70100,35943,34157
2008/3/1,臺中市,中區,8467,23963,11824,12139
2008/3/1,臺中市,東區,24904,73938,37562,36376
2008/3/1,臺中市,西區,41555,117145,56569,60576
2008/3/1,臺中市,南區,39440,110514,53929,56585
2008/3/1,臺中市,北區,53565,147644,71977,75667
2008/3/1,臺中市,西屯區,67313,198385,96900,101485
2008/3/1,臺中市,南屯區,49021,146566,70914,75652
2008/3/1,臺中市,北屯區,78610,240374,117307,123067
2008/3/1,嘉義市,東區,43550,128650,63057,65593
2008/3/1,嘉義市,西區,47902,144772,72150,72622
2008/3/1,臺南市,東區,68416,194013,94354,99659
2008/3/1,臺南市,南區,41894,127681,64340,63341
2008/3/1,臺南市,北區,45296,128641,63916,64725
2008/3/1,臺南市,安南區,51326,174637,89251,85386
2008/3/1,臺南市,安平區,21361,59554,28637,30917
2008/3/1,臺南市,中西區,29638,81253,40115,41138
2008/3/1,臺北市,松山區,76249,211540,100509,111031
2008/3/1,臺北市,信義區,84560,228935,111306,117629
2008/3/1,臺北市,大安區,114308,315511,149500,166011
2008/3/1,臺北市,中山區,87428,218705,103880,114825
2008/3/1,臺北市,中正區,60061,159829,77509,82320
2008/3/1,臺北市,大同區,45667,126201,62634,63567
2008/3/1,臺北市,萬華區,72343,192040,96713,95327
2008/3/1,臺北市,文山區,93689,261915,127677,134238
2008/3/1,臺北市,南港區,39617,113726,56517,57209
2008/3/1,臺北市,內湖區,91119,265894,129017,136877
2008/3/1,臺北市,士林區,97269,287177,140335,146842
2008/3/1,臺北市,北投區,86021,250132,122053,128079
2008/3/1,高雄市,鹽埕區,11267,28632,14520,14112
2008/3/1,高雄市,鼓山區,46993,123103,61126,61977
2008/3/1,高雄市,左營區,70112,186510,92661,93849
2008/3/1,高雄市,楠梓區,58829,169163,84482,84681
2008/3/1,高雄市,三民區,128038,360273,177720,182553
2008/3/1,高雄市,新興區,22754,57241,28115,29126
2008/3/1,高雄市,前金區,12371,29871,14688,15183
2008/3/1,高雄市,苓雅區,70058,188028,92061,95967
2008/3/1,高雄市,前鎮區,73217,200311,100540,99771
2008/3/1,高雄市,旗津區,10661,29929,15681,14248
2008/3/1,高雄市,小港區,59335,152170,77099,75071
2008/3/1,金門縣,金城鎮,9991,28203,14929,13274
2008/3/1,金門縣,金湖鎮,6534,18365,9811,8554
2008/3/1,金門縣,金沙鎮,4952,13149,6939,6210
2008/3/1,金門縣,金寧鄉,5521,15024,8152,6872
2008/3/1,金門縣,烈嶼鄉,2302,7147,3792,3355
2008/3/1,金門縣,烏坵鄉,133,435,223,212
2008/3/1,連江縣,南竿鄉,1077,5951,3458,2493
2008/3/1,連江縣,北竿鄉,374,1827,1078,749
2008/3/1,連江縣,莒光鄉,232,1181,690,491
2008/3/1,連江縣,東引鄉,248,1019,606,413
2008/4/1,總計,臺灣地區,7514501,22890532,11564007,11326525
2008/4/1,總計,臺灣省,6001384,18737223,9529835,9207388
2008/4/1,總計,新北市,1315725,3806380,1902124,1904256
2008/4/1,總計,宜蘭縣,147697,460992,236000,224992
2008/4/1,總計,桃園市,623855,1941878,984386,957492
2008/4/1,總計,新竹縣,148850,497975,257553,240422
2008/4/1,總計,苗栗縣,164049,559920,292234,267686
2008/4/1,總計,臺中市,444966,1552711,789918,762793
2008/4/1,總計,彰化縣,349427,1313669,677122,636547
2008/4/1,總計,南投縣,164886,533170,275914,257256
2008/4/1,總計,雲林縣,220143,725491,380752,344739
2008/4/1,總計,嘉義縣,169624,549828,288253,261575
2008/4/1,總計,臺南市,354576,1104906,566726,538180
2008/4/1,總計,高雄市,416111,1243463,640089,603374
2008/4/1,總計,屏東縣,267643,887914,458805,429109
2008/4/1,總計,臺東縣,78005,233176,122846,110330
2008/4/1,總計,花蓮縣,117280,342898,177999,164899
2008/4/1,總計,澎湖縣,30658,92415,47704,44711
2008/4/1,總計,基隆市,142826,389730,197346,192384
2008/4/1,總計,新竹市,131149,401108,200527,200581
2008/4/1,總計,臺中市,363820,1059821,517463,542358
2008/4/1,總計,嘉義市,91631,273486,135245,138241
2008/4/1,總計,臺南市,258463,766292,380829,385463
2008/4/1,總計,臺北市,949432,2630966,1277234,1353732
2008/4/1,總計,高雄市,563685,1522343,756938,765405
2008/4/1,總計,福建省,31453,92754,49893,42861
2008/4/1,總計,金門縣,29520,82768,44058,38710
2008/4/1,總計,連江縣,1933,9986,5835,4151
2008/4/1,新北市,板橋區,183990,548949,273512,275437
2008/4/1,新北市,三重區,131159,383570,192304,191266
2008/4/1,新北市,永和區,87923,236904,114255,122649
2008/4/1,新北市,中和區,146668,409525,203629,205896
2008/4/1,新北市,新莊區,129811,396751,197026,199725
2008/4/1,新北市,新店區,110723,290782,143534,147248
2008/4/1,新北市,土城區,78520,237648,119322,118326
2008/4/1,新北市,蘆洲區,61603,192738,95873,96865
2008/4/1,新北市,汐止區,74127,181278,90628,90650
2008/4/1,新北市,樹林區,52845,165777,84005,81772
2008/4/1,新北市,鶯歌區,25837,85945,43800,42145
2008/4/1,新北市,三峽區,31104,95927,49449,46478
2008/4/1,新北市,淡水區,50089,133022,65383,67639
2008/4/1,新北市,瑞芳區,15492,43376,22239,21137
2008/4/1,新北市,五股區,25651,77467,39459,38008
2008/4/1,新北市,泰山區,24699,74765,37845,36920
2008/4/1,新北市,林口區,23170,68877,34361,34516
2008/4/1,新北市,深坑區,8264,22550,11468,11082
2008/4/1,新北市,石碇區,3146,7850,4364,3486
2008/4/1,新北市,坪林區,2368,6563,3686,2877
2008/4/1,新北市,三芝區,8558,23582,12269,11313
2008/4/1,新北市,石門區,3680,11855,6292,5563
2008/4/1,新北市,八里區,11139,32776,16811,15965
2008/4/1,新北市,平溪區,2331,5587,3128,2459
2008/4/1,新北市,雙溪區,3796,9929,5370,4559
2008/4/1,新北市,貢寮區,4315,13993,7281,6712
2008/4/1,新北市,金山區,6442,22235,11333,10902
2008/4/1,新北市,萬里區,6613,20741,10712,10029
2008/4/1,新北市,烏來區,1662,5418,2786,2632
2008/4/1,宜蘭縣,宜蘭市,32067,96097,47557,48540
2008/4/1,宜蘭縣,羅東鎮,24211,74118,35680,38438
2008/4/1,宜蘭縣,蘇澳鎮,13179,43553,22496,21057
2008/4/1,宜蘭縣,頭城鎮,9291,31517,16374,15143
2008/4/1,宜蘭縣,礁溪鄉,11745,35891,18857,17034
2008/4/1,宜蘭縣,壯圍鄉,7775,25146,13306,11840
2008/4/1,宜蘭縣,員山鄉,10292,32323,17378,14945
2008/4/1,宜蘭縣,冬山鄉,16367,51436,26626,24810
2008/4/1,宜蘭縣,五結鄉,12230,38048,19877,18171
2008/4/1,宜蘭縣,三星鄉,7043,21221,11517,9704
2008/4/1,宜蘭縣,大同鄉,1782,5815,3219,2596
2008/4/1,宜蘭縣,南澳鄉,1715,5827,3113,2714
2008/4/1,桃園市,桃園區,134063,393740,193596,200144
2008/4/1,桃園市,中壢區,117612,359735,180714,179021
2008/4/1,桃園市,平鎮區,62029,203683,103047,100636
2008/4/1,桃園市,八德區,53540,172251,88335,83916
2008/4/1,桃園市,大溪區,27650,90609,46841,43768
2008/4/1,桃園市,楊梅區,44376,143497,73498,69999
2008/4/1,桃園市,蘆竹區,43514,133196,67234,65962
2008/4/1,桃園市,大園區,23810,79724,41588,38136
2008/4/1,桃園市,龜山區,46347,132182,67541,64641
2008/4/1,桃園市,龍潭區,34808,113082,57758,55324
2008/4/1,桃園市,新屋區,14426,49832,26595,23237
2008/4/1,桃園市,觀音區,18094,59870,31733,28137
2008/4/1,桃園市,復興區,3586,10477,5906,4571
2008/4/1,新竹縣,竹北市,40392,127902,64478,63424
2008/4/1,新竹縣,關西鎮,8890,32594,17414,15180
2008/4/1,新竹縣,新埔鎮,9921,36085,19150,16935
2008/4/1,新竹縣,竹東鎮,28931,96652,48856,47796
2008/4/1,新竹縣,湖口鄉,22162,74507,38226,36281
2008/4/1,新竹縣,橫山鄉,4197,14629,7983,6646
2008/4/1,新竹縣,新豐鄉,14691,51988,26989,24999
2008/4/1,新竹縣,芎林鄉,5978,20807,10977,9830
2008/4/1,新竹縣,寶山鄉,4469,13746,7438,6308
2008/4/1,新竹縣,北埔鄉,2976,10301,5588,4713
2008/4/1,新竹縣,峨眉鄉,1998,6156,3424,2732
2008/4/1,新竹縣,尖石鄉,2585,8189,4513,3676
2008/4/1,新竹縣,五峰鄉,1660,4419,2517,1902
2008/4/1,苗栗縣,苗栗市,28019,91185,46202,44983
2008/4/1,苗栗縣,苑裡鎮,13299,48970,25666,23304
2008/4/1,苗栗縣,通霄鎮,10930,39058,20867,18191
2008/4/1,苗栗縣,竹南鎮,21954,75497,38520,36977
2008/4/1,苗栗縣,頭份市,27475,94911,48596,46315
2008/4/1,苗栗縣,後龍鎮,11390,40371,21417,18954
2008/4/1,苗栗縣,卓蘭鎮,5767,18453,9779,8674
2008/4/1,苗栗縣,大湖鄉,5127,16085,8669,7416
2008/4/1,苗栗縣,公館鄉,9680,34689,18218,16471
2008/4/1,苗栗縣,銅鑼鄉,5841,19828,10566,9262
2008/4/1,苗栗縣,南庄鄉,3830,11332,6299,5033
2008/4/1,苗栗縣,頭屋鄉,3425,11839,6261,5578
2008/4/1,苗栗縣,三義鄉,5101,17666,9368,8298
2008/4/1,苗栗縣,西湖鄉,2572,7954,4423,3531
2008/4/1,苗栗縣,造橋鄉,3859,13780,7290,6490
2008/4/1,苗栗縣,三灣鄉,2302,7466,4065,3401
2008/4/1,苗栗縣,獅潭鄉,1639,5131,2885,2246
2008/4/1,苗栗縣,泰安鄉,1839,5705,3143,2562
2008/4/1,臺中市,豐原區,47349,164857,82166,82691
2008/4/1,臺中市,大里區,58376,193214,96295,96919
2008/4/1,臺中市,太平區,52412,171777,86597,85180
2008/4/1,臺中市,東勢區,16540,54623,28460,26163
2008/4/1,臺中市,大甲區,20882,79329,40256,39073
2008/4/1,臺中市,清水區,23930,85925,44460,41465
2008/4/1,臺中市,沙鹿區,21662,78940,40315,38625
2008/4/1,臺中市,梧棲區,15282,54340,27619,26721
2008/4/1,臺中市,后里區,14223,54498,28222,26276
2008/4/1,臺中市,神岡區,16959,64129,33124,31005
2008/4/1,臺中市,潭子區,30425,97620,49014,48606
2008/4/1,臺中市,大雅區,25117,88393,44741,43652
2008/4/1,臺中市,新社區,7142,25822,13667,12155
2008/4/1,臺中市,石岡區,4664,16106,8398,7708
2008/4/1,臺中市,外埔區,8347,31814,16440,15374
2008/4/1,臺中市,大安區,5107,20698,10898,9800
2008/4/1,臺中市,烏日區,19199,67611,34437,33174
2008/4/1,臺中市,大肚區,15236,55921,28798,27123
2008/4/1,臺中市,龍井區,19421,71954,36899,35055
2008/4/1,臺中市,霧峰區,18218,64340,33160,31180
2008/4/1,臺中市,和平區,4475,10800,5952,4848
2008/4/1,彰化縣,彰化市,68958,236401,118444,117957
2008/4/1,彰化縣,鹿港鎮,21265,85249,43779,41470
2008/4/1,彰化縣,和美鎮,22935,89121,45870,43251
2008/4/1,彰化縣,北斗鎮,9497,33574,17083,16491
2008/4/1,彰化縣,員林市,35255,126265,63795,62470
2008/4/1,彰化縣,溪湖鎮,14541,56719,29123,27596
2008/4/1,彰化縣,田中鎮,12161,45012,23696,21316
2008/4/1,彰化縣,二林鎮,13845,54926,28384,26542
2008/4/1,彰化縣,線西鄉,3937,17046,8795,8251
2008/4/1,彰化縣,伸港鄉,8545,35775,18450,17325
2008/4/1,彰化縣,福興鄉,11533,48892,25642,23250
2008/4/1,彰化縣,秀水鄉,9226,38886,20161,18725
2008/4/1,彰化縣,花壇鄉,12281,46144,23860,22284
2008/4/1,彰化縣,芬園鄉,6749,25145,13376,11769
2008/4/1,彰化縣,大村鄉,9800,36396,19040,17356
2008/4/1,彰化縣,埔鹽鄉,8483,34638,18239,16399
2008/4/1,彰化縣,埔心鄉,9569,35508,18443,17065
2008/4/1,彰化縣,永靖鄉,10007,39609,20624,18985
2008/4/1,彰化縣,社頭鄉,11946,45367,23417,21950
2008/4/1,彰化縣,二水鄉,5184,17052,9017,8035
2008/4/1,彰化縣,田尾鄉,7455,29030,15144,13886
2008/4/1,彰化縣,埤頭鄉,8222,32059,16821,15238
2008/4/1,彰化縣,芳苑鄉,9803,36894,19567,17327
2008/4/1,彰化縣,大城鄉,5281,19171,10477,8694
2008/4/1,彰化縣,竹塘鄉,4476,16739,8882,7857
2008/4/1,彰化縣,溪州鄉,8473,32051,16993,15058
2008/4/1,南投縣,南投市,32241,105660,53422,52238
2008/4/1,南投縣,埔里鎮,27541,86401,43827,42574
2008/4/1,南投縣,草屯鎮,29640,100008,50693,49315
2008/4/1,南投縣,竹山鎮,18119,59217,30687,28530
2008/4/1,南投縣,集集鎮,4106,12014,6328,5686
2008/4/1,南投縣,名間鄉,11724,41588,21965,19623
2008/4/1,南投縣,鹿谷鄉,6347,19519,10425,9094
2008/4/1,南投縣,中寮鄉,5443,16535,9017,7518
2008/4/1,南投縣,魚池鄉,5643,17334,9233,8101
2008/4/1,南投縣,國姓鄉,7050,21353,11749,9604
2008/4/1,南投縣,水里鄉,7134,20794,10965,9829
2008/4/1,南投縣,信義鄉,5030,17243,9383,7860
2008/4/1,南投縣,仁愛鄉,4868,15504,8220,7284
2008/4/1,雲林縣,斗六市,32812,105735,53549,52186
2008/4/1,雲林縣,斗南鎮,14764,47789,24373,23416
2008/4/1,雲林縣,虎尾鎮,21226,69602,35571,34031
2008/4/1,雲林縣,西螺鎮,13624,49288,25068,24220
2008/4/1,雲林縣,土庫鎮,8421,31105,16312,14793
2008/4/1,雲林縣,北港鎮,14856,44224,23094,21130
2008/4/1,雲林縣,古坑鄉,10312,34821,18484,16337
2008/4/1,雲林縣,大埤鄉,6428,21775,11617,10158
2008/4/1,雲林縣,莿桐鄉,8688,30737,16134,14603
2008/4/1,雲林縣,林內鄉,5543,20261,10646,9615
2008/4/1,雲林縣,二崙鄉,8584,30489,16406,14083
2008/4/1,雲林縣,崙背鄉,8099,28073,14896,13177
2008/4/1,雲林縣,麥寮鄉,11392,33599,17916,15683
2008/4/1,雲林縣,東勢鄉,5598,17531,9544,7987
2008/4/1,雲林縣,褒忠鄉,4172,14753,7907,6846
2008/4/1,雲林縣,臺西鄉,8580,27471,14770,12701
2008/4/1,雲林縣,元長鄉,9104,29602,16190,13412
2008/4/1,雲林縣,四湖鄉,8852,27703,15227,12476
2008/4/1,雲林縣,口湖鄉,9355,31187,16712,14475
2008/4/1,雲林縣,水林鄉,9733,29746,16336,13410
2008/4/1,嘉義縣,太保市,10481,35688,18551,17137
2008/4/1,嘉義縣,朴子市,13662,44284,22729,21555
2008/4/1,嘉義縣,布袋鎮,9912,31159,16106,15053
2008/4/1,嘉義縣,大林鎮,10868,34256,17690,16566
2008/4/1,嘉義縣,民雄鄉,21705,72757,37547,35210
2008/4/1,嘉義縣,溪口鄉,5232,16729,8940,7789
2008/4/1,嘉義縣,新港鄉,10088,35353,18671,16682
2008/4/1,嘉義縣,六腳鄉,8945,27137,14417,12720
2008/4/1,嘉義縣,東石鄉,9130,28476,15224,13252
2008/4/1,嘉義縣,義竹鄉,7290,21796,11369,10427
2008/4/1,嘉義縣,鹿草鄉,5565,17474,9385,8089
2008/4/1,嘉義縣,水上鄉,17122,53316,27773,25543
2008/4/1,嘉義縣,中埔鄉,14562,47828,25091,22737
2008/4/1,嘉義縣,竹崎鄉,11083,39375,21023,18352
2008/4/1,嘉義縣,梅山鄉,6358,22258,11820,10438
2008/4/1,嘉義縣,番路鄉,3795,11718,6412,5306
2008/4/1,嘉義縣,大埔鄉,1872,4037,2184,1853
2008/4/1,嘉義縣,阿里山鄉,1954,6187,3321,2866
2008/4/1,臺南市,新營區,26221,79043,39686,39357
2008/4/1,臺南市,永康區,70639,211267,105661,105606
2008/4/1,臺南市,鹽水區,9640,27746,14495,13251
2008/4/1,臺南市,白河區,10732,32203,17037,15166
2008/4/1,臺南市,麻豆區,14336,46331,23757,22574
2008/4/1,臺南市,佳里區,18456,59208,29586,29622
2008/4/1,臺南市,新化區,13134,44557,22915,21642
2008/4/1,臺南市,善化區,13692,42795,21814,20981
2008/4/1,臺南市,學甲區,9184,28489,14677,13812
2008/4/1,臺南市,柳營區,7573,23167,12136,11031
2008/4/1,臺南市,後壁區,8462,26380,13769,12611
2008/4/1,臺南市,東山區,8027,23710,12719,10991
2008/4/1,臺南市,下營區,8892,26718,13889,12829
2008/4/1,臺南市,六甲區,7420,24349,12703,11646
2008/4/1,臺南市,官田區,7460,22510,11623,10887
2008/4/1,臺南市,大內區,4004,11289,6031,5258
2008/4/1,臺南市,西港區,7579,25507,13054,12453
2008/4/1,臺南市,七股區,7759,25415,13326,12089
2008/4/1,臺南市,將軍區,7263,21964,11253,10711
2008/4/1,臺南市,北門區,4164,12551,6454,6097
2008/4/1,臺南市,新市區,10414,35390,17844,17546
2008/4/1,臺南市,安定區,8786,30038,15635,14403
2008/4/1,臺南市,山上區,2692,8071,4273,3798
2008/4/1,臺南市,玉井區,4999,15792,8231,7561
2008/4/1,臺南市,楠西區,3590,10970,5843,5127
2008/4/1,臺南市,南化區,2814,8971,4927,4044
2008/4/1,臺南市,左鎮區,1935,5610,3121,2489
2008/4/1,臺南市,仁德區,23172,67881,35104,32777
2008/4/1,臺南市,歸仁區,19521,65682,33552,32130
2008/4/1,臺南市,關廟區,10453,36882,19200,17682
2008/4/1,臺南市,龍崎區,1563,4420,2411,2009
2008/4/1,高雄市,鳳山區,121642,338830,169745,169085
2008/4/1,高雄市,岡山區,31953,96275,48709,47566
2008/4/1,高雄市,旗山區,13530,41041,21498,19543
2008/4/1,高雄市,美濃區,13643,43990,23089,20901
2008/4/1,高雄市,林園區,23371,71342,36833,34509
2008/4/1,高雄市,大寮區,36621,109131,57077,52054
2008/4/1,高雄市,大樹區,12862,44763,23250,21513
2008/4/1,高雄市,仁武區,23426,68298,35359,32939
2008/4/1,高雄市,大社區,11266,32714,16897,15817
2008/4/1,高雄市,鳥松區,15641,41432,21153,20279
2008/4/1,高雄市,橋頭區,12212,36459,18838,17621
2008/4/1,高雄市,燕巢區,9620,31169,16697,14472
2008/4/1,高雄市,田寮區,3577,8489,4734,3755
2008/4/1,高雄市,阿蓮區,8903,30894,15623,15271
2008/4/1,高雄市,路竹區,15445,54483,27900,26583
2008/4/1,高雄市,湖內區,9089,28590,14805,13785
2008/4/1,高雄市,茄萣區,9927,31921,16758,15163
2008/4/1,高雄市,永安區,5644,14161,7292,6869
2008/4/1,高雄市,彌陀區,6396,20780,10915,9865
2008/4/1,高雄市,梓官區,11515,37166,19517,17649
2008/4/1,高雄市,六龜區,5673,15591,8487,7104
2008/4/1,高雄市,甲仙區,2568,8184,4410,3774
2008/4/1,高雄市,杉林區,3990,11317,6212,5105
2008/4/1,高雄市,內門區,4969,16434,8993,7441
2008/4/1,高雄市,茂林區,524,1762,899,863
2008/4/1,高雄市,桃源區,1232,4776,2567,2209
2008/4/1,高雄市,那瑪夏區,872,3471,1832,1639
2008/4/1,屏東縣,屏東市,70964,215797,108139,107658
2008/4/1,屏東縣,潮州鎮,17611,56924,28767,28157
2008/4/1,屏東縣,東港鎮,14709,50556,25823,24733
2008/4/1,屏東縣,恆春鎮,10321,31257,16208,15049
2008/4/1,屏東縣,萬丹鄉,13784,54561,28305,26256
2008/4/1,屏東縣,長治鄉,9499,30963,16282,14681
2008/4/1,屏東縣,麟洛鄉,3443,11632,6040,5592
2008/4/1,屏東縣,九如鄉,6409,23215,12096,11119
2008/4/1,屏東縣,里港鄉,7761,26519,13642,12877
2008/4/1,屏東縣,鹽埔鄉,7487,27669,14434,13235
2008/4/1,屏東縣,高樹鄉,9503,27397,14688,12709
2008/4/1,屏東縣,萬巒鄉,6304,22618,11951,10667
2008/4/1,屏東縣,內埔鄉,17246,59325,31036,28289
2008/4/1,屏東縣,竹田鄉,5358,18478,9865,8613
2008/4/1,屏東縣,新埤鄉,3295,10988,5835,5153
2008/4/1,屏東縣,枋寮鄉,8259,27312,14504,12808
2008/4/1,屏東縣,新園鄉,10851,39368,20388,18980
2008/4/1,屏東縣,崁頂鄉,3967,17061,8825,8236
2008/4/1,屏東縣,林邊鄉,6183,21242,11014,10228
2008/4/1,屏東縣,南州鄉,3575,12085,6208,5877
2008/4/1,屏東縣,佳冬鄉,6585,21725,11380,10345
2008/4/1,屏東縣,琉球鄉,3763,12609,6991,5618
2008/4/1,屏東縣,車城鄉,3387,10004,5402,4602
2008/4/1,屏東縣,滿州鄉,2974,8585,4714,3871
2008/4/1,屏東縣,枋山鄉,2102,6221,3347,2874
2008/4/1,屏東縣,三地門鄉,2020,7212,3698,3514
2008/4/1,屏東縣,霧臺鄉,858,2711,1450,1261
2008/4/1,屏東縣,瑪家鄉,1804,6448,3364,3084
2008/4/1,屏東縣,泰武鄉,1091,4895,2620,2275
2008/4/1,屏東縣,來義鄉,2062,7740,4002,3738
2008/4/1,屏東縣,春日鄉,1273,4972,2604,2368
2008/4/1,屏東縣,獅子鄉,1426,4969,2647,2322
2008/4/1,屏東縣,牡丹鄉,1769,4856,2536,2320
2008/4/1,臺東縣,臺東市,36963,110184,56168,54016
2008/4/1,臺東縣,成功鎮,5322,16308,8748,7560
2008/4/1,臺東縣,關山鎮,3194,9969,5272,4697
2008/4/1,臺東縣,卑南鄉,6413,18381,10063,8318
2008/4/1,臺東縣,大武鄉,2441,7048,3702,3346
2008/4/1,臺東縣,太麻里鄉,4495,12209,6572,5637
2008/4/1,臺東縣,東河鄉,3441,9654,5371,4283
2008/4/1,臺東縣,長濱鄉,2845,8803,5010,3793
2008/4/1,臺東縣,鹿野鄉,3083,8856,4796,4060
2008/4/1,臺東縣,池上鄉,3180,9452,5043,4409
2008/4/1,臺東縣,綠島鄉,917,3122,1676,1446
2008/4/1,臺東縣,延平鄉,1055,3615,2030,1585
2008/4/1,臺東縣,海端鄉,1071,4564,2479,2085
2008/4/1,臺東縣,達仁鄉,1399,3728,2069,1659
2008/4/1,臺東縣,金峰鄉,977,3323,1754,1569
2008/4/1,臺東縣,蘭嶼鄉,1209,3960,2093,1867
2008/4/1,花蓮縣,花蓮市,39275,110066,54322,55744
2008/4/1,花蓮縣,鳳林鎮,4386,12416,6607,5809
2008/4/1,花蓮縣,玉里鎮,8816,28039,15305,12734
2008/4/1,花蓮縣,新城鄉,7106,20326,10620,9706
2008/4/1,花蓮縣,吉安鄉,27561,78971,40733,38238
2008/4/1,花蓮縣,壽豐鄉,6691,19284,10501,8783
2008/4/1,花蓮縣,光復鄉,4967,14597,7824,6773
2008/4/1,花蓮縣,豐濱鄉,1801,5302,2949,2353
2008/4/1,花蓮縣,瑞穗鄉,4560,13338,7247,6091
2008/4/1,花蓮縣,富里鄉,3893,11975,6616,5359
2008/4/1,花蓮縣,秀林鄉,4473,14975,7857,7118
2008/4/1,花蓮縣,萬榮鄉,2138,7096,3795,3301
2008/4/1,花蓮縣,卓溪鄉,1613,6513,3623,2890
2008/4/1,澎湖縣,馬公市,17924,54639,27821,26818
2008/4/1,澎湖縣,湖西鄉,4295,12832,6713,6119
2008/4/1,澎湖縣,白沙鄉,2942,9153,4854,4299
2008/4/1,澎湖縣,西嶼鄉,2674,8155,4235,3920
2008/4/1,澎湖縣,望安鄉,1712,4426,2379,2047
2008/4/1,澎湖縣,七美鄉,1111,3210,1702,1508
2008/4/1,基隆市,中正區,21705,57335,29584,27751
2008/4/1,基隆市,七堵區,19129,55139,28068,27071
2008/4/1,基隆市,暖暖區,14032,38422,19643,18779
2008/4/1,基隆市,仁愛區,18950,50357,25044,25313
2008/4/1,基隆市,中山區,18635,52151,26769,25382
2008/4/1,基隆市,安樂區,30971,85233,42515,42718
2008/4/1,基隆市,信義區,19404,51093,25723,25370
2008/4/1,新竹市,東區,63456,191009,94685,96324
2008/4/1,新竹市,北區,46668,139909,69833,70076
2008/4/1,新竹市,香山區,21025,70190,36009,34181
2008/4/1,臺中市,中區,8498,24022,11840,12182
2008/4/1,臺中市,東區,24944,73977,37578,36399
2008/4/1,臺中市,西區,41645,117181,56565,60616
2008/4/1,臺中市,南區,39529,110578,53948,56630
2008/4/1,臺中市,北區,53721,147945,72090,75855
2008/4/1,臺中市,西屯區,67566,198811,97077,101734
2008/4/1,臺中市,南屯區,49165,146713,70976,75737
2008/4/1,臺中市,北屯區,78752,240594,117389,123205
2008/4/1,嘉義市,東區,43627,128635,63049,65586
2008/4/1,嘉義市,西區,48004,144851,72196,72655
2008/4/1,臺南市,東區,68563,194162,94451,99711
2008/4/1,臺南市,南區,41943,127713,64343,63370
2008/4/1,臺南市,北區,45446,128780,63978,64802
2008/4/1,臺南市,安南區,51415,174765,89291,85474
2008/4/1,臺南市,安平區,21404,59611,28667,30944
2008/4/1,臺南市,中西區,29692,81261,40099,41162
2008/4/1,臺北市,松山區,76345,211574,100527,111047
2008/4/1,臺北市,信義區,84588,228783,111216,117567
2008/4/1,臺北市,大安區,114459,315564,149501,166063
2008/4/1,臺北市,中山區,87517,218528,103768,114760
2008/4/1,臺北市,中正區,60158,159964,77539,82425
2008/4/1,臺北市,大同區,45751,126156,62575,63581
2008/4/1,臺北市,萬華區,72374,191805,96630,95175
2008/4/1,臺北市,文山區,93751,261965,127713,134252
2008/4/1,臺北市,南港區,39628,113603,56456,57147
2008/4/1,臺北市,內湖區,91295,265987,129069,136918
2008/4/1,臺北市,士林區,97386,287021,140262,146759
2008/4/1,臺北市,北投區,86180,250016,121978,128038
2008/4/1,高雄市,鹽埕區,11266,28650,14519,14131
2008/4/1,高雄市,鼓山區,47142,123350,61233,62117
2008/4/1,高雄市,左營區,70224,186562,92643,93919
2008/4/1,高雄市,楠梓區,58975,169387,84524,84863
2008/4/1,高雄市,三民區,127325,356755,175865,180890
2008/4/1,高雄市,新興區,22747,57217,28115,29102
2008/4/1,高雄市,前金區,12362,29804,14664,15140
2008/4/1,高雄市,苓雅區,70111,187922,91993,95929
2008/4/1,高雄市,前鎮區,73378,200485,100576,99909
2008/4/1,高雄市,旗津區,10651,29884,15665,14219
2008/4/1,高雄市,小港區,59504,152327,77141,75186
2008/4/1,金門縣,金城鎮,10014,28333,14982,13351
2008/4/1,金門縣,金湖鎮,6560,18452,9853,8599
2008/4/1,金門縣,金沙鎮,4967,13221,6968,6253
2008/4/1,金門縣,金寧鄉,5535,15127,8220,6907
2008/4/1,金門縣,烈嶼鄉,2311,7202,3812,3390
2008/4/1,金門縣,烏坵鄉,133,433,223,210
2008/4/1,連江縣,南竿鄉,1078,5947,3452,2495
2008/4/1,連江縣,北竿鄉,375,1824,1072,752
2008/4/1,連江縣,莒光鄉,232,1191,701,490
2008/4/1,連江縣,東引鄉,248,1024,610,414
2008/5/1,總計,臺灣地區,7529874,22895392,11564838,11330554
2008/5/1,總計,臺灣省,6014585,18742221,9531063,9211158
2008/5/1,總計,新北市,1319376,3808875,1903025,1905850
2008/5/1,總計,宜蘭縣,147985,460918,235932,224986
2008/5/1,總計,桃園市,625615,1943756,985229,958527
2008/5/1,總計,新竹縣,149469,498777,257903,240874
2008/5/1,總計,苗栗縣,164392,559861,292219,267642
2008/5/1,總計,臺中市,445734,1552886,789876,763010
2008/5/1,總計,彰化縣,349945,1313264,676924,636340
2008/5/1,總計,南投縣,165189,532883,275707,257176
2008/5/1,總計,雲林縣,220471,725468,380659,344809
2008/5/1,總計,嘉義縣,169883,549454,288021,261433
2008/5/1,總計,臺南市,355233,1104691,566565,538126
2008/5/1,總計,高雄市,416686,1243192,639818,603374
2008/5/1,總計,屏東縣,267987,887275,458438,428837
2008/5/1,總計,臺東縣,78093,232891,122675,110216
2008/5/1,總計,花蓮縣,117532,342700,177859,164841
2008/5/1,總計,澎湖縣,30753,92458,47722,44736
2008/5/1,總計,基隆市,142993,389600,197287,192313
2008/5/1,總計,新竹市,131516,401825,200820,201005
2008/5/1,總計,臺中市,364859,1061065,518098,542967
2008/5/1,總計,嘉義市,91898,273675,135285,138390
2008/5/1,總計,臺南市,258976,766707,381001,385706
2008/5/1,總計,臺北市,950430,2630515,1276788,1353727
2008/5/1,總計,高雄市,564859,1522656,756987,765669
2008/5/1,總計,福建省,31548,93036,50012,43024
2008/5/1,總計,金門縣,29612,83078,44187,38891
2008/5/1,總計,連江縣,1936,9958,5825,4133
2008/5/1,新北市,板橋區,184585,549394,273562,275832
2008/5/1,新北市,三重區,131432,383358,192188,191170
2008/5/1,新北市,永和區,88116,237025,114304,122721
2008/5/1,新北市,中和區,146933,409320,203524,205796
2008/5/1,新北市,新莊區,130099,396987,197086,199901
2008/5/1,新北市,新店區,110871,290768,143448,147320
2008/5/1,新北市,土城區,78674,237608,119357,118251
2008/5/1,新北市,蘆洲區,61780,192981,95964,97017
2008/5/1,新北市,汐止區,74251,181451,90688,90763
2008/5/1,新北市,樹林區,53163,166263,84230,82033
2008/5/1,新北市,鶯歌區,25934,86029,43843,42186
2008/5/1,新北市,三峽區,31278,96195,49595,46600
2008/5/1,新北市,淡水區,50335,133308,65513,67795
2008/5/1,新北市,瑞芳區,15500,43331,22219,21112
2008/5/1,新北市,五股區,25708,77507,39476,38031
2008/5/1,新北市,泰山區,24825,74961,37942,37019
2008/5/1,新北市,林口區,23467,69399,34606,34793
2008/5/1,新北市,深坑區,8273,22563,11478,11085
2008/5/1,新北市,石碇區,3160,7842,4362,3480
2008/5/1,新北市,坪林區,2367,6545,3675,2870
2008/5/1,新北市,三芝區,8582,23585,12277,11308
2008/5/1,新北市,石門區,3683,11830,6291,5539
2008/5/1,新北市,八里區,11174,32808,16836,15972
2008/5/1,新北市,平溪區,2335,5573,3118,2455
2008/5/1,新北市,雙溪區,3801,9919,5371,4548
2008/5/1,新北市,貢寮區,4315,13935,7246,6689
2008/5/1,新北市,金山區,6456,22227,11341,10886
2008/5/1,新北市,萬里區,6620,20734,10697,10037
2008/5/1,新北市,烏來區,1659,5429,2788,2641
2008/5/1,宜蘭縣,宜蘭市,32118,96152,47585,48567
2008/5/1,宜蘭縣,羅東鎮,24236,74109,35677,38432
2008/5/1,宜蘭縣,蘇澳鎮,13210,43572,22502,21070
2008/5/1,宜蘭縣,頭城鎮,9304,31488,16350,15138
2008/5/1,宜蘭縣,礁溪鄉,11797,35893,18872,17021
2008/5/1,宜蘭縣,壯圍鄉,7790,25093,13281,11812
2008/5/1,宜蘭縣,員山鄉,10321,32302,17362,14940
2008/5/1,宜蘭縣,冬山鄉,16405,51422,26610,24812
2008/5/1,宜蘭縣,五結鄉,12259,38059,19865,18194
2008/5/1,宜蘭縣,三星鄉,7051,21200,11506,9694
2008/5/1,宜蘭縣,大同鄉,1782,5808,3212,2596
2008/5/1,宜蘭縣,南澳鄉,1712,5820,3110,2710
2008/5/1,桃園市,桃園區,134374,394221,193813,200408
2008/5/1,桃園市,中壢區,117904,359885,180771,179114
2008/5/1,桃園市,平鎮區,62246,204035,103215,100820
2008/5/1,桃園市,八德區,53628,172281,88385,83896
2008/5/1,桃園市,大溪區,27710,90645,46864,43781
2008/5/1,桃園市,楊梅區,44583,143770,73604,70166
2008/5/1,桃園市,蘆竹區,43727,133566,67393,66173
2008/5/1,桃園市,大園區,23872,79750,41590,38160
2008/5/1,桃園市,龜山區,46489,132356,67611,64745
2008/5/1,桃園市,龍潭區,34883,113112,57771,55341
2008/5/1,桃園市,新屋區,14466,49783,26575,23208
2008/5/1,桃園市,觀音區,18145,59904,31746,28158
2008/5/1,桃園市,復興區,3588,10448,5891,4557
2008/5/1,新竹縣,竹北市,40705,128531,64770,63761
2008/5/1,新竹縣,關西鎮,8900,32554,17386,15168
2008/5/1,新竹縣,新埔鎮,9960,36109,19162,16947
2008/5/1,新竹縣,竹東鎮,29052,96764,48937,47827
2008/5/1,新竹縣,湖口鄉,22221,74572,38229,36343
2008/5/1,新竹縣,橫山鄉,4201,14621,7970,6651
2008/5/1,新竹縣,新豐鄉,14738,52084,27039,25045
2008/5/1,新竹縣,芎林鄉,5979,20818,10973,9845
2008/5/1,新竹縣,寶山鄉,4484,13736,7419,6317
2008/5/1,新竹縣,北埔鄉,2984,10297,5582,4715
2008/5/1,新竹縣,峨眉鄉,2004,6145,3425,2720
2008/5/1,新竹縣,尖石鄉,2588,8153,4505,3648
2008/5/1,新竹縣,五峰鄉,1653,4393,2506,1887
2008/5/1,苗栗縣,苗栗市,28050,91177,46194,44983
2008/5/1,苗栗縣,苑裡鎮,13325,48953,25639,23314
2008/5/1,苗栗縣,通霄鎮,10941,38993,20814,18179
2008/5/1,苗栗縣,竹南鎮,22028,75652,38611,37041
2008/5/1,苗栗縣,頭份市,27580,95004,48652,46352
2008/5/1,苗栗縣,後龍鎮,11408,40304,21385,18919
2008/5/1,苗栗縣,卓蘭鎮,5773,18408,9759,8649
2008/5/1,苗栗縣,大湖鄉,5149,16077,8672,7405
2008/5/1,苗栗縣,公館鄉,9694,34726,18241,16485
2008/5/1,苗栗縣,銅鑼鄉,5841,19791,10551,9240
2008/5/1,苗栗縣,南庄鄉,3840,11299,6285,5014
2008/5/1,苗栗縣,頭屋鄉,3434,11833,6261,5572
2008/5/1,苗栗縣,三義鄉,5103,17657,9363,8294
2008/5/1,苗栗縣,西湖鄉,2577,7934,4417,3517
2008/5/1,苗栗縣,造橋鄉,3862,13785,7300,6485
2008/5/1,苗栗縣,三灣鄉,2305,7456,4065,3391
2008/5/1,苗栗縣,獅潭鄉,1638,5116,2876,2240
2008/5/1,苗栗縣,泰安鄉,1844,5696,3134,2562
2008/5/1,臺中市,豐原區,47421,164940,82175,82765
2008/5/1,臺中市,大里區,58507,193348,96294,97054
2008/5/1,臺中市,太平區,52496,171784,86580,85204
2008/5/1,臺中市,東勢區,16550,54535,28399,26136
2008/5/1,臺中市,大甲區,20913,79299,40251,39048
2008/5/1,臺中市,清水區,23955,85859,44415,41444
2008/5/1,臺中市,沙鹿區,21742,79038,40343,38695
2008/5/1,臺中市,梧棲區,15312,54410,27663,26747
2008/5/1,臺中市,后里區,14228,54437,28186,26251
2008/5/1,臺中市,神岡區,16962,64063,33076,30987
2008/5/1,臺中市,潭子區,30516,97718,49071,48647
2008/5/1,臺中市,大雅區,25152,88415,44780,43635
2008/5/1,臺中市,新社區,7145,25797,13655,12142
2008/5/1,臺中市,石岡區,4673,16112,8405,7707
2008/5/1,臺中市,外埔區,8360,31766,16414,15352
2008/5/1,臺中市,大安區,5114,20672,10889,9783
2008/5/1,臺中市,烏日區,19262,67653,34449,33204
2008/5/1,臺中市,大肚區,15256,55942,28824,27118
2008/5/1,臺中市,龍井區,19442,72009,36924,35085
2008/5/1,臺中市,霧峰區,18262,64336,33151,31185
2008/5/1,臺中市,和平區,4466,10753,5932,4821
2008/5/1,彰化縣,彰化市,69062,236430,118433,117997
2008/5/1,彰化縣,鹿港鎮,21303,85262,43803,41459
2008/5/1,彰化縣,和美鎮,22974,89084,45846,43238
2008/5/1,彰化縣,北斗鎮,9517,33566,17091,16475
2008/5/1,彰化縣,員林市,35288,126321,63816,62505
2008/5/1,彰化縣,溪湖鎮,14559,56694,29114,27580
2008/5/1,彰化縣,田中鎮,12168,44984,23681,21303
2008/5/1,彰化縣,二林鎮,13872,54902,28367,26535
2008/5/1,彰化縣,線西鄉,3940,17023,8787,8236
2008/5/1,彰化縣,伸港鄉,8551,35781,18462,17319
2008/5/1,彰化縣,福興鄉,11546,48865,25625,23240
2008/5/1,彰化縣,秀水鄉,9249,38917,20172,18745
2008/5/1,彰化縣,花壇鄉,12315,46115,23852,22263
2008/5/1,彰化縣,芬園鄉,6756,25130,13373,11757
2008/5/1,彰化縣,大村鄉,9813,36392,19044,17348
2008/5/1,彰化縣,埔鹽鄉,8504,34621,18222,16399
2008/5/1,彰化縣,埔心鄉,9588,35491,18436,17055
2008/5/1,彰化縣,永靖鄉,10030,39567,20607,18960
2008/5/1,彰化縣,社頭鄉,11952,45348,23399,21949
2008/5/1,彰化縣,二水鄉,5195,16997,8988,8009
2008/5/1,彰化縣,田尾鄉,7467,29006,15135,13871
2008/5/1,彰化縣,埤頭鄉,8240,32059,16821,15238
2008/5/1,彰化縣,芳苑鄉,9816,36839,19555,17284
2008/5/1,彰化縣,大城鄉,5280,19146,10455,8691
2008/5/1,彰化縣,竹塘鄉,4478,16700,8859,7841
2008/5/1,彰化縣,溪州鄉,8482,32024,16981,15043
2008/5/1,南投縣,南投市,32286,105646,53401,52245
2008/5/1,南投縣,埔里鎮,27574,86332,43763,42569
2008/5/1,南投縣,草屯鎮,29721,100001,50695,49306
2008/5/1,南投縣,竹山鎮,18151,59142,30647,28495
2008/5/1,南投縣,集集鎮,4123,12028,6328,5700
2008/5/1,南投縣,名間鄉,11743,41575,21954,19621
2008/5/1,南投縣,鹿谷鄉,6360,19469,10405,9064
2008/5/1,南投縣,中寮鄉,5459,16518,9000,7518
2008/5/1,南投縣,魚池鄉,5669,17331,9224,8107
2008/5/1,南投縣,國姓鄉,7067,21336,11741,9595
2008/5/1,南投縣,水里鄉,7132,20778,10953,9825
2008/5/1,南投縣,信義鄉,5035,17217,9370,7847
2008/5/1,南投縣,仁愛鄉,4869,15510,8226,7284
2008/5/1,雲林縣,斗六市,32898,105919,53616,52303
2008/5/1,雲林縣,斗南鎮,14762,47759,24347,23412
2008/5/1,雲林縣,虎尾鎮,21284,69666,35585,34081
2008/5/1,雲林縣,西螺鎮,13640,49330,25060,24270
2008/5/1,雲林縣,土庫鎮,8430,31063,16283,14780
2008/5/1,雲林縣,北港鎮,14863,44265,23106,21159
2008/5/1,雲林縣,古坑鄉,10324,34871,18516,16355
2008/5/1,雲林縣,大埤鄉,6445,21768,11606,10162
2008/5/1,雲林縣,莿桐鄉,8701,30732,16136,14596
2008/5/1,雲林縣,林內鄉,5550,20297,10680,9617
2008/5/1,雲林縣,二崙鄉,8591,30454,16402,14052
2008/5/1,雲林縣,崙背鄉,8120,28064,14887,13177
2008/5/1,雲林縣,麥寮鄉,11413,33626,17930,15696
2008/5/1,雲林縣,東勢鄉,5600,17492,9530,7962
2008/5/1,雲林縣,褒忠鄉,4175,14727,7897,6830
2008/5/1,雲林縣,臺西鄉,8582,27415,14741,12674
2008/5/1,雲林縣,元長鄉,9111,29529,16155,13374
2008/5/1,雲林縣,四湖鄉,8864,27663,15194,12469
2008/5/1,雲林縣,口湖鄉,9377,31152,16691,14461
2008/5/1,雲林縣,水林鄉,9741,29676,16297,13379
2008/5/1,嘉義縣,太保市,10525,35734,18572,17162
2008/5/1,嘉義縣,朴子市,13703,44358,22759,21599
2008/5/1,嘉義縣,布袋鎮,9916,31118,16075,15043
2008/5/1,嘉義縣,大林鎮,10891,34240,17681,16559
2008/5/1,嘉義縣,民雄鄉,21722,72702,37525,35177
2008/5/1,嘉義縣,溪口鄉,5243,16712,8933,7779
2008/5/1,嘉義縣,新港鄉,10097,35320,18643,16677
2008/5/1,嘉義縣,六腳鄉,8961,27077,14385,12692
2008/5/1,嘉義縣,東石鄉,9152,28404,15184,13220
2008/5/1,嘉義縣,義竹鄉,7298,21744,11352,10392
2008/5/1,嘉義縣,鹿草鄉,5574,17460,9382,8078
2008/5/1,嘉義縣,水上鄉,17131,53249,27725,25524
2008/5/1,嘉義縣,中埔鄉,14583,47811,25085,22726
2008/5/1,嘉義縣,竹崎鄉,11100,39366,21012,18354
2008/5/1,嘉義縣,梅山鄉,6372,22255,11815,10440
2008/5/1,嘉義縣,番路鄉,3792,11683,6394,5289
2008/5/1,嘉義縣,大埔鄉,1871,4044,2184,1860
2008/5/1,嘉義縣,阿里山鄉,1952,6177,3315,2862
2008/5/1,臺南市,新營區,26255,79027,39703,39324
2008/5/1,臺南市,永康區,70843,211501,105776,105725
2008/5/1,臺南市,鹽水區,9670,27728,14476,13252
2008/5/1,臺南市,白河區,10726,32127,17002,15125
2008/5/1,臺南市,麻豆區,14369,46280,23730,22550
2008/5/1,臺南市,佳里區,18493,59198,29571,29627
2008/5/1,臺南市,新化區,13152,44532,22893,21639
2008/5/1,臺南市,善化區,13732,42837,21822,21015
2008/5/1,臺南市,學甲區,9194,28465,14657,13808
2008/5/1,臺南市,柳營區,7588,23130,12120,11010
2008/5/1,臺南市,後壁區,8485,26384,13781,12603
2008/5/1,臺南市,東山區,8038,23682,12712,10970
2008/5/1,臺南市,下營區,8893,26684,13867,12817
2008/5/1,臺南市,六甲區,7425,24328,12683,11645
2008/5/1,臺南市,官田區,7473,22511,11627,10884
2008/5/1,臺南市,大內區,4011,11275,6027,5248
2008/5/1,臺南市,西港區,7591,25489,13043,12446
2008/5/1,臺南市,七股區,7766,25429,13332,12097
2008/5/1,臺南市,將軍區,7264,21916,11212,10704
2008/5/1,臺南市,北門區,4159,12514,6431,6083
2008/5/1,臺南市,新市區,10442,35382,17840,17542
2008/5/1,臺南市,安定區,8813,30057,15632,14425
2008/5/1,臺南市,山上區,2694,8063,4267,3796
2008/5/1,臺南市,玉井區,4998,15759,8220,7539
2008/5/1,臺南市,楠西區,3588,10959,5832,5127
2008/5/1,臺南市,南化區,2816,8960,4919,4041
2008/5/1,臺南市,左鎮區,1936,5604,3117,2487
2008/5/1,臺南市,仁德區,23219,67934,35157,32777
2008/5/1,臺南市,歸仁區,19582,65668,33527,32141
2008/5/1,臺南市,關廟區,10452,36848,19178,17670
2008/5/1,臺南市,龍崎區,1566,4420,2411,2009
2008/5/1,高雄市,鳳山區,121848,338784,169670,169114
2008/5/1,高雄市,岡山區,32000,96338,48732,47606
2008/5/1,高雄市,旗山區,13544,41023,21481,19542
2008/5/1,高雄市,美濃區,13656,43933,23036,20897
2008/5/1,高雄市,林園區,23391,71283,36796,34487
2008/5/1,高雄市,大寮區,36665,109036,57029,52007
2008/5/1,高雄市,大樹區,12858,44766,23255,21511
2008/5/1,高雄市,仁武區,23482,68382,35405,32977
2008/5/1,高雄市,大社區,11293,32766,16919,15847
2008/5/1,高雄市,鳥松區,15653,41458,21136,20322
2008/5/1,高雄市,橋頭區,12213,36469,18838,17631
2008/5/1,高雄市,燕巢區,9651,31204,16722,14482
2008/5/1,高雄市,田寮區,3575,8490,4734,3756
2008/5/1,高雄市,阿蓮區,8920,30860,15613,15247
2008/5/1,高雄市,路竹區,15476,54422,27863,26559
2008/5/1,高雄市,湖內區,9110,28561,14801,13760
2008/5/1,高雄市,茄萣區,9931,31906,16746,15160
2008/5/1,高雄市,永安區,5652,14180,7299,6881
2008/5/1,高雄市,彌陀區,6396,20739,10883,9856
2008/5/1,高雄市,梓官區,11543,37170,19508,17662
2008/5/1,高雄市,六龜區,5679,15588,8485,7103
2008/5/1,高雄市,甲仙區,2569,8168,4404,3764
2008/5/1,高雄市,杉林區,3988,11289,6202,5087
2008/5/1,高雄市,內門區,4967,16386,8971,7415
2008/5/1,高雄市,茂林區,525,1756,899,857
2008/5/1,高雄市,桃源區,1230,4768,2560,2208
2008/5/1,高雄市,那瑪夏區,871,3467,1831,1636
2008/5/1,屏東縣,屏東市,71070,215706,108040,107666
2008/5/1,屏東縣,潮州鎮,17614,56912,28752,28160
2008/5/1,屏東縣,東港鎮,14723,50558,25809,24749
2008/5/1,屏東縣,恆春鎮,10349,31255,16208,15047
2008/5/1,屏東縣,萬丹鄉,13823,54531,28297,26234
2008/5/1,屏東縣,長治鄉,9510,30961,16286,14675
2008/5/1,屏東縣,麟洛鄉,3447,11622,6041,5581
2008/5/1,屏東縣,九如鄉,6412,23215,12107,11108
2008/5/1,屏東縣,里港鄉,7774,26488,13615,12873
2008/5/1,屏東縣,鹽埔鄉,7500,27646,14431,13215
2008/5/1,屏東縣,高樹鄉,9510,27382,14664,12718
2008/5/1,屏東縣,萬巒鄉,6302,22586,11939,10647
2008/5/1,屏東縣,內埔鄉,17273,59317,31023,28294
2008/5/1,屏東縣,竹田鄉,5365,18458,9861,8597
2008/5/1,屏東縣,新埤鄉,3295,10970,5825,5145
2008/5/1,屏東縣,枋寮鄉,8260,27296,14501,12795
2008/5/1,屏東縣,新園鄉,10860,39273,20348,18925
2008/5/1,屏東縣,崁頂鄉,3974,17001,8797,8204
2008/5/1,屏東縣,林邊鄉,6188,21204,10999,10205
2008/5/1,屏東縣,南州鄉,3580,12042,6196,5846
2008/5/1,屏東縣,佳冬鄉,6596,21713,11371,10342
2008/5/1,屏東縣,琉球鄉,3770,12602,6979,5623
2008/5/1,屏東縣,車城鄉,3387,9993,5395,4598
2008/5/1,屏東縣,滿州鄉,2980,8588,4716,3872
2008/5/1,屏東縣,枋山鄉,2105,6214,3342,2872
2008/5/1,屏東縣,三地門鄉,2025,7222,3707,3515
2008/5/1,屏東縣,霧臺鄉,860,2706,1449,1257
2008/5/1,屏東縣,瑪家鄉,1805,6438,3357,3081
2008/5/1,屏東縣,泰武鄉,1097,4897,2616,2281
2008/5/1,屏東縣,來義鄉,2062,7703,3986,3717
2008/5/1,屏東縣,春日鄉,1274,4958,2598,2360
2008/5/1,屏東縣,獅子鄉,1423,4962,2646,2316
2008/5/1,屏東縣,牡丹鄉,1774,4856,2537,2319
2008/5/1,臺東縣,臺東市,37013,110149,56137,54012
2008/5/1,臺東縣,成功鎮,5318,16278,8729,7549
2008/5/1,臺東縣,關山鎮,3206,9976,5273,4703
2008/5/1,臺東縣,卑南鄉,6419,18345,10049,8296
2008/5/1,臺東縣,大武鄉,2436,7021,3684,3337
2008/5/1,臺東縣,太麻里鄉,4496,12182,6548,5634
2008/5/1,臺東縣,東河鄉,3438,9604,5340,4264
2008/5/1,臺東縣,長濱鄉,2853,8776,4998,3778
2008/5/1,臺東縣,鹿野鄉,3085,8837,4790,4047
2008/5/1,臺東縣,池上鄉,3190,9434,5038,4396
2008/5/1,臺東縣,綠島鄉,926,3139,1689,1450
2008/5/1,臺東縣,延平鄉,1054,3606,2019,1587
2008/5/1,臺東縣,海端鄉,1070,4542,2465,2077
2008/5/1,臺東縣,達仁鄉,1399,3716,2066,1650
2008/5/1,臺東縣,金峰鄉,976,3329,1757,1572
2008/5/1,臺東縣,蘭嶼鄉,1214,3957,2093,1864
2008/5/1,花蓮縣,花蓮市,39478,110270,54388,55882
2008/5/1,花蓮縣,鳳林鎮,4383,12400,6602,5798
2008/5/1,花蓮縣,玉里鎮,8810,27951,15259,12692
2008/5/1,花蓮縣,新城鄉,7133,20354,10648,9706
2008/5/1,花蓮縣,吉安鄉,27578,78861,40684,38177
2008/5/1,花蓮縣,壽豐鄉,6686,19261,10479,8782
2008/5/1,花蓮縣,光復鄉,4967,14570,7808,6762
2008/5/1,花蓮縣,豐濱鄉,1804,5276,2935,2341
2008/5/1,花蓮縣,瑞穗鄉,4563,13293,7218,6075
2008/5/1,花蓮縣,富里鄉,3905,11959,6610,5349
2008/5/1,花蓮縣,秀林鄉,4470,14937,7836,7101
2008/5/1,花蓮縣,萬榮鄉,2139,7079,3783,3296
2008/5/1,花蓮縣,卓溪鄉,1616,6489,3609,2880
2008/5/1,澎湖縣,馬公市,17975,54653,27836,26817
2008/5/1,澎湖縣,湖西鄉,4320,12850,6725,6125
2008/5/1,澎湖縣,白沙鄉,2953,9150,4839,4311
2008/5/1,澎湖縣,西嶼鄉,2675,8141,4229,3912
2008/5/1,澎湖縣,望安鄉,1713,4438,2386,2052
2008/5/1,澎湖縣,七美鄉,1117,3226,1707,1519
2008/5/1,基隆市,中正區,21720,57255,29545,27710
2008/5/1,基隆市,七堵區,19150,55172,28079,27093
2008/5/1,基隆市,暖暖區,14037,38342,19588,18754
2008/5/1,基隆市,仁愛區,19004,50422,25088,25334
2008/5/1,基隆市,中山區,18648,52062,26726,25336
2008/5/1,基隆市,安樂區,31017,85286,42548,42738
2008/5/1,基隆市,信義區,19417,51061,25713,25348
2008/5/1,新竹市,東區,63637,191497,94899,96598
2008/5/1,新竹市,北區,46782,140040,69866,70174
2008/5/1,新竹市,香山區,21097,70288,36055,34233
2008/5/1,臺中市,中區,8508,24080,11876,12204
2008/5/1,臺中市,東區,24999,73959,37563,36396
2008/5/1,臺中市,西區,41740,117245,56615,60630
2008/5/1,臺中市,南區,39581,110661,53973,56688
2008/5/1,臺中市,北區,53832,148018,72120,75898
2008/5/1,臺中市,西屯區,67926,199334,97365,101969
2008/5/1,臺中市,南屯區,49302,146911,71089,75822
2008/5/1,臺中市,北屯區,78971,240857,117497,123360
2008/5/1,嘉義市,東區,43722,128715,63062,65653
2008/5/1,嘉義市,西區,48176,144960,72223,72737
2008/5/1,臺南市,東區,68693,194223,94514,99709
2008/5/1,臺南市,南區,42001,127635,64273,63362
2008/5/1,臺南市,北區,45568,128958,64043,64915
2008/5/1,臺南市,安南區,51520,174905,89367,85538
2008/5/1,臺南市,安平區,21462,59710,28685,31025
2008/5/1,臺南市,中西區,29732,81276,40119,41157
2008/5/1,臺北市,松山區,76380,211424,100464,110960
2008/5/1,臺北市,信義區,84597,228708,111075,117633
2008/5/1,臺北市,大安區,114585,315708,149579,166129
2008/5/1,臺北市,中山區,87665,218524,103736,114788
2008/5/1,臺北市,中正區,60211,160082,77600,82482
2008/5/1,臺北市,大同區,45800,126090,62530,63560
2008/5/1,臺北市,萬華區,72403,191532,96474,95058
2008/5/1,臺北市,文山區,93799,262069,127762,134307
2008/5/1,臺北市,南港區,39646,113504,56381,57123
2008/5/1,臺北市,內湖區,91445,266078,129093,136985
2008/5/1,臺北市,士林區,97548,286926,140191,146735
2008/5/1,臺北市,北投區,86351,249870,121903,127967
2008/5/1,高雄市,鹽埕區,11254,28567,14474,14093
2008/5/1,高雄市,鼓山區,47363,123597,61305,62292
2008/5/1,高雄市,左營區,70385,186755,92797,93958
2008/5/1,高雄市,楠梓區,59091,169518,84599,84919
2008/5/1,高雄市,三民區,127515,356725,175807,180918
2008/5/1,高雄市,新興區,22760,57148,28060,29088
2008/5/1,高雄市,前金區,12374,29768,14629,15139
2008/5/1,高雄市,苓雅區,70169,187771,91921,95850
2008/5/1,高雄市,前鎮區,73574,200522,100585,99937
2008/5/1,高雄市,旗津區,10653,29813,15626,14187
2008/5/1,高雄市,小港區,59721,152472,77184,75288
2008/5/1,金門縣,金城鎮,10056,28483,15056,13427
2008/5/1,金門縣,金湖鎮,6585,18488,9874,8614
2008/5/1,金門縣,金沙鎮,4965,13268,6971,6297
2008/5/1,金門縣,金寧鄉,5547,15171,8234,6937
2008/5/1,金門縣,烈嶼鄉,2325,7234,3827,3407
2008/5/1,金門縣,烏坵鄉,134,434,225,209
2008/5/1,連江縣,南竿鄉,1080,5931,3448,2483
2008/5/1,連江縣,北竿鄉,376,1819,1067,752
2008/5/1,連江縣,莒光鄉,232,1186,700,486
2008/5/1,連江縣,東引鄉,248,1022,610,412
2008/6/1,總計,臺灣地區,7544629,22901096,11565856,11335240
2008/6/1,總計,臺灣省,6026782,18747588,9532603,9214985
2008/6/1,總計,新北市,1322485,3811043,1903837,1907206
2008/6/1,總計,宜蘭縣,148278,461082,235968,225114
2008/6/1,總計,桃園市,627325,1945581,985976,959605
2008/6/1,總計,新竹縣,149993,499372,258209,241163
2008/6/1,總計,苗栗縣,164705,559851,292214,267637
2008/6/1,總計,臺中市,446510,1553446,789992,763454
2008/6/1,總計,彰化縣,350439,1313003,676731,636272
2008/6/1,總計,南投縣,165444,532762,275588,257174
2008/6/1,總計,雲林縣,220904,725237,380590,344647
2008/6/1,總計,嘉義縣,170184,549265,287888,261377
2008/6/1,總計,臺南市,355793,1104491,566439,538052
2008/6/1,總計,高雄市,417235,1243026,639696,603330
2008/6/1,總計,屏東縣,268267,886786,458163,428623
2008/6/1,總計,臺東縣,78195,232663,122583,110080
2008/6/1,總計,花蓮縣,117707,342516,177715,164801
2008/6/1,總計,澎湖縣,30854,92602,47793,44809
2008/6/1,總計,基隆市,143150,389443,197159,192284
2008/6/1,總計,新竹市,131931,402368,201015,201353
2008/6/1,總計,臺中市,365884,1062244,518601,543643
2008/6/1,總計,嘉義市,92124,273789,135297,138492
2008/6/1,總計,臺南市,259375,767018,381149,385869
2008/6/1,總計,臺北市,951823,2630191,1276120,1354071
2008/6/1,總計,高雄市,566024,1523317,757133,766184
2008/6/1,總計,福建省,31582,93166,50054,43112
2008/6/1,總計,金門縣,29646,83225,44243,38982
2008/6/1,總計,連江縣,1936,9941,5811,4130
2008/6/1,新北市,板橋區,184966,549620,273586,276034
2008/6/1,新北市,三重區,131737,383277,192160,191117
2008/6/1,新北市,永和區,88241,236996,114244,122752
2008/6/1,新北市,中和區,147122,409175,203497,205678
2008/6/1,新北市,新莊區,130309,397025,197089,199936
2008/6/1,新北市,新店區,111089,290911,143460,147451
2008/6/1,新北市,土城區,78804,237578,119306,118272
2008/6/1,新北市,蘆洲區,61950,193213,96093,97120
2008/6/1,新北市,汐止區,74406,181543,90781,90762
2008/6/1,新北市,樹林區,53444,166736,84443,82293
2008/6/1,新北市,鶯歌區,26031,86113,43868,42245
2008/6/1,新北市,三峽區,31438,96488,49714,46774
2008/6/1,新北市,淡水區,50489,133474,65593,67881
2008/6/1,新北市,瑞芳區,15519,43246,22169,21077
2008/6/1,新北市,五股區,25726,77567,39498,38069
2008/6/1,新北市,泰山區,24896,75093,37981,37112
2008/6/1,新北市,林口區,23779,69977,34872,35105
2008/6/1,新北市,深坑區,8295,22623,11509,11114
2008/6/1,新北市,石碇區,3169,7851,4358,3493
2008/6/1,新北市,坪林區,2375,6529,3670,2859
2008/6/1,新北市,三芝區,8595,23566,12264,11302
2008/6/1,新北市,石門區,3693,11833,6294,5539
2008/6/1,新北市,八里區,11203,32845,16860,15985
2008/6/1,新北市,平溪區,2333,5551,3109,2442
2008/6/1,新北市,雙溪區,3797,9923,5368,4555
2008/6/1,新北市,貢寮區,4317,13897,7229,6668
2008/6/1,新北市,金山區,6476,22202,11323,10879
2008/6/1,新北市,萬里區,6633,20758,10706,10052
2008/6/1,新北市,烏來區,1653,5433,2793,2640
2008/6/1,宜蘭縣,宜蘭市,32152,96123,47550,48573
2008/6/1,宜蘭縣,羅東鎮,24268,74069,35649,38420
2008/6/1,宜蘭縣,蘇澳鎮,13231,43678,22542,21136
2008/6/1,宜蘭縣,頭城鎮,9353,31468,16339,15129
2008/6/1,宜蘭縣,礁溪鄉,11857,35925,18892,17033
2008/6/1,宜蘭縣,壯圍鄉,7796,25085,13276,11809
2008/6/1,宜蘭縣,員山鄉,10336,32335,17380,14955
2008/6/1,宜蘭縣,冬山鄉,16422,51456,26625,24831
2008/6/1,宜蘭縣,五結鄉,12293,38118,19893,18225
2008/6/1,宜蘭縣,三星鄉,7069,21202,11504,9698
2008/6/1,宜蘭縣,大同鄉,1787,5811,3210,2601
2008/6/1,宜蘭縣,南澳鄉,1714,5812,3108,2704
2008/6/1,桃園市,桃園區,134710,394613,193967,200646
2008/6/1,桃園市,中壢區,118189,360126,180834,179292
2008/6/1,桃園市,平鎮區,62441,204303,103326,100977
2008/6/1,桃園市,八德區,53760,172397,88414,83983
2008/6/1,桃園市,大溪區,27805,90718,46881,43837
2008/6/1,桃園市,楊梅區,44728,143997,73698,70299
2008/6/1,桃園市,蘆竹區,43913,133857,67535,66322
2008/6/1,桃園市,大園區,23946,79737,41587,38150
2008/6/1,桃園市,龜山區,46615,132579,67723,64856
2008/6/1,桃園市,龍潭區,34947,113177,57813,55364
2008/6/1,桃園市,新屋區,14496,49740,26566,23174
2008/6/1,桃園市,觀音區,18190,59896,31747,28149
2008/6/1,桃園市,復興區,3585,10441,5885,4556
2008/6/1,新竹縣,竹北市,40978,129072,65046,64026
2008/6/1,新竹縣,關西鎮,8909,32550,17380,15170
2008/6/1,新竹縣,新埔鎮,9982,36086,19163,16923
2008/6/1,新竹縣,竹東鎮,29141,96833,48981,47852
2008/6/1,新竹縣,湖口鄉,22269,74620,38248,36372
2008/6/1,新竹縣,橫山鄉,4199,14580,7951,6629
2008/6/1,新竹縣,新豐鄉,14786,52156,27084,25072
2008/6/1,新竹縣,芎林鄉,6003,20813,10962,9851
2008/6/1,新竹縣,寶山鄉,4478,13728,7406,6322
2008/6/1,新竹縣,北埔鄉,2995,10291,5579,4712
2008/6/1,新竹縣,峨眉鄉,2009,6129,3419,2710
2008/6/1,新竹縣,尖石鄉,2591,8142,4496,3646
2008/6/1,新竹縣,五峰鄉,1653,4372,2494,1878
2008/6/1,苗栗縣,苗栗市,28095,91161,46184,44977
2008/6/1,苗栗縣,苑裡鎮,13333,48957,25635,23322
2008/6/1,苗栗縣,通霄鎮,10963,38931,20783,18148
2008/6/1,苗栗縣,竹南鎮,22090,75757,38678,37079
2008/6/1,苗栗縣,頭份市,27678,95127,48699,46428
2008/6/1,苗栗縣,後龍鎮,11420,40288,21389,18899
2008/6/1,苗栗縣,卓蘭鎮,5772,18381,9747,8634
2008/6/1,苗栗縣,大湖鄉,5161,16086,8668,7418
2008/6/1,苗栗縣,公館鄉,9703,34731,18244,16487
2008/6/1,苗栗縣,銅鑼鄉,5846,19768,10544,9224
2008/6/1,苗栗縣,南庄鄉,3843,11291,6276,5015
2008/6/1,苗栗縣,頭屋鄉,3443,11817,6258,5559
2008/6/1,苗栗縣,三義鄉,5114,17669,9367,8302
2008/6/1,苗栗縣,西湖鄉,2585,7926,4412,3514
2008/6/1,苗栗縣,造橋鄉,3866,13760,7288,6472
2008/6/1,苗栗縣,三灣鄉,2311,7435,4054,3381
2008/6/1,苗栗縣,獅潭鄉,1636,5094,2868,2226
2008/6/1,苗栗縣,泰安鄉,1846,5672,3120,2552
2008/6/1,臺中市,豐原區,47524,165090,82186,82904
2008/6/1,臺中市,大里區,58633,193626,96392,97234
2008/6/1,臺中市,太平區,52543,171725,86523,85202
2008/6/1,臺中市,東勢區,16554,54493,28386,26107
2008/6/1,臺中市,大甲區,20960,79323,40267,39056
2008/6/1,臺中市,清水區,23996,85875,44423,41452
2008/6/1,臺中市,沙鹿區,21816,79098,40375,38723
2008/6/1,臺中市,梧棲區,15335,54445,27687,26758
2008/6/1,臺中市,后里區,14239,54432,28177,26255
2008/6/1,臺中市,神岡區,16978,64021,33072,30949
2008/6/1,臺中市,潭子區,30585,97772,49073,48699
2008/6/1,臺中市,大雅區,25179,88430,44790,43640
2008/6/1,臺中市,新社區,7157,25807,13659,12148
2008/6/1,臺中市,石岡區,4679,16125,8412,7713
2008/6/1,臺中市,外埔區,8384,31778,16416,15362
2008/6/1,臺中市,大安區,5121,20614,10854,9760
2008/6/1,臺中市,烏日區,19321,67739,34477,33262
2008/6/1,臺中市,大肚區,15264,55923,28810,27113
2008/6/1,臺中市,龍井區,19494,72086,36953,35133
2008/6/1,臺中市,霧峰區,18281,64293,33128,31165
2008/6/1,臺中市,和平區,4467,10751,5932,4819
2008/6/1,彰化縣,彰化市,69168,236473,118414,118059
2008/6/1,彰化縣,鹿港鎮,21353,85281,43818,41463
2008/6/1,彰化縣,和美鎮,23026,89138,45848,43290
2008/6/1,彰化縣,北斗鎮,9536,33589,17112,16477
2008/6/1,彰化縣,員林市,35326,126251,63780,62471
2008/6/1,彰化縣,溪湖鎮,14571,56615,29081,27534
2008/6/1,彰化縣,田中鎮,12185,44926,23620,21306
2008/6/1,彰化縣,二林鎮,13892,54905,28373,26532
2008/6/1,彰化縣,線西鄉,3941,17018,8784,8234
2008/6/1,彰化縣,伸港鄉,8566,35764,18455,17309
2008/6/1,彰化縣,福興鄉,11554,48843,25605,23238
2008/6/1,彰化縣,秀水鄉,9265,38926,20170,18756
2008/6/1,彰化縣,花壇鄉,12346,46089,23830,22259
2008/6/1,彰化縣,芬園鄉,6766,25102,13361,11741
2008/6/1,彰化縣,大村鄉,9828,36410,19053,17357
2008/6/1,彰化縣,埔鹽鄉,8515,34620,18220,16400
2008/6/1,彰化縣,埔心鄉,9593,35490,18431,17059
2008/6/1,彰化縣,永靖鄉,10057,39571,20614,18957
2008/6/1,彰化縣,社頭鄉,11952,45323,23389,21934
2008/6/1,彰化縣,二水鄉,5199,16968,8984,7984
2008/6/1,彰化縣,田尾鄉,7471,28991,15126,13865
2008/6/1,彰化縣,埤頭鄉,8254,32049,16822,15227
2008/6/1,彰化縣,芳苑鄉,9821,36809,19542,17267
2008/6/1,彰化縣,大城鄉,5278,19139,10459,8680
2008/6/1,彰化縣,竹塘鄉,4483,16690,8854,7836
2008/6/1,彰化縣,溪州鄉,8493,32023,16986,15037
2008/6/1,南投縣,南投市,32312,105569,53344,52225
2008/6/1,南投縣,埔里鎮,27627,86416,43802,42614
2008/6/1,南投縣,草屯鎮,29792,100082,50747,49335
2008/6/1,南投縣,竹山鎮,18187,59089,30614,28475
2008/6/1,南投縣,集集鎮,4138,12026,6330,5696
2008/6/1,南投縣,名間鄉,11758,41610,21958,19652
2008/6/1,南投縣,鹿谷鄉,6370,19439,10384,9055
2008/6/1,南投縣,中寮鄉,5467,16486,8985,7501
2008/6/1,南投縣,魚池鄉,5679,17309,9206,8103
2008/6/1,南投縣,國姓鄉,7077,21301,11716,9585
2008/6/1,南投縣,水里鄉,7133,20769,10944,9825
2008/6/1,南投縣,信義鄉,5034,17200,9366,7834
2008/6/1,南投縣,仁愛鄉,4870,15466,8192,7274
2008/6/1,雲林縣,斗六市,32980,105886,53589,52297
2008/6/1,雲林縣,斗南鎮,14778,47727,24306,23421
2008/6/1,雲林縣,虎尾鎮,21320,69638,35588,34050
2008/6/1,雲林縣,西螺鎮,13678,49334,25039,24295
2008/6/1,雲林縣,土庫鎮,8444,31032,16275,14757
2008/6/1,雲林縣,北港鎮,14869,44244,23095,21149
2008/6/1,雲林縣,古坑鄉,10343,35098,18644,16454
2008/6/1,雲林縣,大埤鄉,6452,21759,11599,10160
2008/6/1,雲林縣,莿桐鄉,8721,30708,16107,14601
2008/6/1,雲林縣,林內鄉,5559,20325,10711,9614
2008/6/1,雲林縣,二崙鄉,8598,30399,16383,14016
2008/6/1,雲林縣,崙背鄉,8151,28056,14894,13162
2008/6/1,雲林縣,麥寮鄉,11452,33631,17922,15709
2008/6/1,雲林縣,東勢鄉,5609,17479,9520,7959
2008/6/1,雲林縣,褒忠鄉,4185,14696,7886,6810
2008/6/1,雲林縣,臺西鄉,8583,27370,14740,12630
2008/6/1,雲林縣,元長鄉,9121,29501,16147,13354
2008/6/1,雲林縣,四湖鄉,8877,27611,15170,12441
2008/6/1,雲林縣,口湖鄉,9400,31111,16681,14430
2008/6/1,雲林縣,水林鄉,9784,29632,16294,13338
2008/6/1,嘉義縣,太保市,10545,35796,18591,17205
2008/6/1,嘉義縣,朴子市,13741,44351,22770,21581
2008/6/1,嘉義縣,布袋鎮,9921,31082,16055,15027
2008/6/1,嘉義縣,大林鎮,10919,34219,17674,16545
2008/6/1,嘉義縣,民雄鄉,21766,72688,37504,35184
2008/6/1,嘉義縣,溪口鄉,5261,16726,8944,7782
2008/6/1,嘉義縣,新港鄉,10096,35270,18625,16645
2008/6/1,嘉義縣,六腳鄉,8976,27043,14359,12684
2008/6/1,嘉義縣,東石鄉,9156,28349,15148,13201
2008/6/1,嘉義縣,義竹鄉,7317,21723,11337,10386
2008/6/1,嘉義縣,鹿草鄉,5577,17450,9381,8069
2008/6/1,嘉義縣,水上鄉,17153,53245,27724,25521
2008/6/1,嘉義縣,中埔鄉,14625,47793,25067,22726
2008/6/1,嘉義縣,竹崎鄉,11107,39387,21024,18363
2008/6/1,嘉義縣,梅山鄉,6391,22252,11803,10449
2008/6/1,嘉義縣,番路鄉,3800,11651,6371,5280
2008/6/1,嘉義縣,大埔鄉,1885,4082,2202,1880
2008/6/1,嘉義縣,阿里山鄉,1948,6158,3309,2849
2008/6/1,臺南市,新營區,26278,79012,39683,39329
2008/6/1,臺南市,永康區,71009,211668,105854,105814
2008/6/1,臺南市,鹽水區,9681,27695,14448,13247
2008/6/1,臺南市,白河區,10741,32067,16974,15093
2008/6/1,臺南市,麻豆區,14401,46306,23746,22560
2008/6/1,臺南市,佳里區,18521,59261,29620,29641
2008/6/1,臺南市,新化區,13185,44517,22886,21631
2008/6/1,臺南市,善化區,13763,42857,21833,21024
2008/6/1,臺南市,學甲區,9201,28456,14649,13807
2008/6/1,臺南市,柳營區,7588,23117,12110,11007
2008/6/1,臺南市,後壁區,8504,26338,13772,12566
2008/6/1,臺南市,東山區,8054,23644,12694,10950
2008/6/1,臺南市,下營區,8907,26656,13846,12810
2008/6/1,臺南市,六甲區,7432,24344,12685,11659
2008/6/1,臺南市,官田區,7473,22495,11615,10880
2008/6/1,臺南市,大內區,4010,11250,6018,5232
2008/6/1,臺南市,西港區,7602,25489,13047,12442
2008/6/1,臺南市,七股區,7766,25323,13271,12052
2008/6/1,臺南市,將軍區,7269,21878,11202,10676
2008/6/1,臺南市,北門區,4165,12491,6421,6070
2008/6/1,臺南市,新市區,10466,35380,17841,17539
2008/6/1,臺南市,安定區,8828,30068,15622,14446
2008/6/1,臺南市,山上區,2693,8066,4265,3801
2008/6/1,臺南市,玉井區,5008,15757,8220,7537
2008/6/1,臺南市,楠西區,3593,10969,5838,5131
2008/6/1,臺南市,南化區,2813,8949,4915,4034
2008/6/1,臺南市,左鎮區,1937,5598,3115,2483
2008/6/1,臺南市,仁德區,23267,67942,35146,32796
2008/6/1,臺南市,歸仁區,19609,65681,33545,32136
2008/6/1,臺南市,關廟區,10462,36801,19149,17652
2008/6/1,臺南市,龍崎區,1567,4416,2409,2007
2008/6/1,高雄市,鳳山區,122087,338968,169737,169231
2008/6/1,高雄市,岡山區,32053,96416,48753,47663
2008/6/1,高雄市,旗山區,13547,41031,21485,19546
2008/6/1,高雄市,美濃區,13675,43919,23032,20887
2008/6/1,高雄市,林園區,23403,71203,36763,34440
2008/6/1,高雄市,大寮區,36719,109056,57034,52022
2008/6/1,高雄市,大樹區,12853,44697,23209,21488
2008/6/1,高雄市,仁武區,23555,68428,35437,32991
2008/6/1,高雄市,大社區,11308,32744,16915,15829
2008/6/1,高雄市,鳥松區,15656,41430,21133,20297
2008/6/1,高雄市,橋頭區,12219,36462,18834,17628
2008/6/1,高雄市,燕巢區,9658,31185,16706,14479
2008/6/1,高雄市,田寮區,3564,8476,4736,3740
2008/6/1,高雄市,阿蓮區,8921,30846,15609,15237
2008/6/1,高雄市,路竹區,15482,54393,27857,26536
2008/6/1,高雄市,湖內區,9131,28592,14804,13788
2008/6/1,高雄市,茄萣區,9949,31871,16723,15148
2008/6/1,高雄市,永安區,5661,14158,7294,6864
2008/6/1,高雄市,彌陀區,6406,20710,10859,9851
2008/6/1,高雄市,梓官區,11555,37095,19471,17624
2008/6/1,高雄市,六龜區,5680,15576,8473,7103
2008/6/1,高雄市,甲仙區,2562,8161,4398,3763
2008/6/1,高雄市,杉林區,3987,11248,6182,5066
2008/6/1,高雄市,內門區,4977,16373,8965,7408
2008/6/1,高雄市,茂林區,525,1750,897,853
2008/6/1,高雄市,桃源區,1230,4769,2560,2209
2008/6/1,高雄市,那瑪夏區,872,3469,1830,1639
2008/6/1,屏東縣,屏東市,71168,215697,108051,107646
2008/6/1,屏東縣,潮州鎮,17635,56876,28753,28123
2008/6/1,屏東縣,東港鎮,14744,50536,25789,24747
2008/6/1,屏東縣,恆春鎮,10348,31209,16167,15042
2008/6/1,屏東縣,萬丹鄉,13835,54520,28291,26229
2008/6/1,屏東縣,長治鄉,9526,30964,16283,14681
2008/6/1,屏東縣,麟洛鄉,3458,11623,6038,5585
2008/6/1,屏東縣,九如鄉,6417,23180,12079,11101
2008/6/1,屏東縣,里港鄉,7777,26454,13593,12861
2008/6/1,屏東縣,鹽埔鄉,7514,27628,14423,13205
2008/6/1,屏東縣,高樹鄉,9519,27346,14647,12699
2008/6/1,屏東縣,萬巒鄉,6296,22544,11914,10630
2008/6/1,屏東縣,內埔鄉,17280,59302,31015,28287
2008/6/1,屏東縣,竹田鄉,5368,18459,9848,8611
2008/6/1,屏東縣,新埤鄉,3300,10943,5808,5135
2008/6/1,屏東縣,枋寮鄉,8268,27294,14512,12782
2008/6/1,屏東縣,新園鄉,10869,39229,20320,18909
2008/6/1,屏東縣,崁頂鄉,3982,17020,8798,8222
2008/6/1,屏東縣,林邊鄉,6186,21179,10989,10190
2008/6/1,屏東縣,南州鄉,3578,12032,6190,5842
2008/6/1,屏東縣,佳冬鄉,6608,21696,11357,10339
2008/6/1,屏東縣,琉球鄉,3775,12587,6974,5613
2008/6/1,屏東縣,車城鄉,3389,10018,5410,4608
2008/6/1,屏東縣,滿州鄉,2984,8564,4716,3848
2008/6/1,屏東縣,枋山鄉,2102,6202,3332,2870
2008/6/1,屏東縣,三地門鄉,2028,7218,3708,3510
2008/6/1,屏東縣,霧臺鄉,861,2708,1451,1257
2008/6/1,屏東縣,瑪家鄉,1806,6430,3355,3075
2008/6/1,屏東縣,泰武鄉,1100,4885,2604,2281
2008/6/1,屏東縣,來義鄉,2063,7692,3982,3710
2008/6/1,屏東縣,春日鄉,1277,4953,2595,2358
2008/6/1,屏東縣,獅子鄉,1425,4938,2630,2308
2008/6/1,屏東縣,牡丹鄉,1781,4860,2541,2319
2008/6/1,臺東縣,臺東市,37104,110028,56097,53931
2008/6/1,臺東縣,成功鎮,5319,16287,8736,7551
2008/6/1,臺東縣,關山鎮,3207,9971,5269,4702
2008/6/1,臺東縣,卑南鄉,6413,18318,10025,8293
2008/6/1,臺東縣,大武鄉,2443,7008,3679,3329
2008/6/1,臺東縣,太麻里鄉,4499,12180,6551,5629
2008/6/1,臺東縣,東河鄉,3440,9595,5338,4257
2008/6/1,臺東縣,長濱鄉,2856,8750,4987,3763
2008/6/1,臺東縣,鹿野鄉,3082,8807,4775,4032
2008/6/1,臺東縣,池上鄉,3197,9435,5041,4394
2008/6/1,臺東縣,綠島鄉,924,3143,1689,1454
2008/6/1,臺東縣,延平鄉,1055,3599,2017,1582
2008/6/1,臺東縣,海端鄉,1071,4532,2459,2073
2008/6/1,臺東縣,達仁鄉,1394,3708,2063,1645
2008/6/1,臺東縣,金峰鄉,974,3323,1753,1570
2008/6/1,臺東縣,蘭嶼鄉,1217,3979,2104,1875
2008/6/1,花蓮縣,花蓮市,39583,110334,54405,55929
2008/6/1,花蓮縣,鳳林鎮,4389,12380,6588,5792
2008/6/1,花蓮縣,玉里鎮,8813,27890,15210,12680
2008/6/1,花蓮縣,新城鄉,7132,20347,10650,9697
2008/6/1,花蓮縣,吉安鄉,27651,78869,40685,38184
2008/6/1,花蓮縣,壽豐鄉,6680,19200,10438,8762
2008/6/1,花蓮縣,光復鄉,4963,14546,7799,6747
2008/6/1,花蓮縣,豐濱鄉,1804,5250,2926,2324
2008/6/1,花蓮縣,瑞穗鄉,4558,13269,7201,6068
2008/6/1,花蓮縣,富里鄉,3906,11937,6592,5345
2008/6/1,花蓮縣,秀林鄉,4474,14945,7837,7108
2008/6/1,花蓮縣,萬榮鄉,2137,7072,3780,3292
2008/6/1,花蓮縣,卓溪鄉,1617,6477,3604,2873
2008/6/1,澎湖縣,馬公市,18047,54773,27894,26879
2008/6/1,澎湖縣,湖西鄉,4340,12861,6736,6125
2008/6/1,澎湖縣,白沙鄉,2958,9144,4835,4309
2008/6/1,澎湖縣,西嶼鄉,2678,8153,4230,3923
2008/6/1,澎湖縣,望安鄉,1710,4424,2379,2045
2008/6/1,澎湖縣,七美鄉,1121,3247,1719,1528
2008/6/1,基隆市,中正區,21707,57138,29474,27664
2008/6/1,基隆市,七堵區,19165,55163,28069,27094
2008/6/1,基隆市,暖暖區,14039,38318,19568,18750
2008/6/1,基隆市,仁愛區,19078,50530,25104,25426
2008/6/1,基隆市,中山區,18654,51982,26660,25322
2008/6/1,基隆市,安樂區,31047,85233,42556,42677
2008/6/1,基隆市,信義區,19460,51079,25728,25351
2008/6/1,新竹市,東區,63833,191688,94932,96756
2008/6/1,新竹市,北區,46928,140255,69991,70264
2008/6/1,新竹市,香山區,21170,70425,36092,34333
2008/6/1,臺中市,中區,8537,24129,11887,12242
2008/6/1,臺中市,東區,25054,74047,37589,36458
2008/6/1,臺中市,西區,41806,117347,56671,60676
2008/6/1,臺中市,南區,39718,110779,54045,56734
2008/6/1,臺中市,北區,53928,148035,72147,75888
2008/6/1,臺中市,西屯區,68290,199903,97592,102311
2008/6/1,臺中市,南屯區,49469,147182,71210,75972
2008/6/1,臺中市,北屯區,79082,240822,117460,123362
2008/6/1,嘉義市,東區,43791,128692,63054,65638
2008/6/1,嘉義市,西區,48333,145097,72243,72854
2008/6/1,臺南市,東區,68784,194307,94553,99754
2008/6/1,臺南市,南區,42025,127510,64217,63293
2008/6/1,臺南市,北區,45726,129131,64126,65005
2008/6/1,臺南市,安南區,51599,175040,89451,85589
2008/6/1,臺南市,安平區,21522,59862,28748,31114
2008/6/1,臺南市,中西區,29719,81168,40054,41114
2008/6/1,臺北市,松山區,76550,211534,100495,111039
2008/6/1,臺北市,信義區,84668,228577,110974,117603
2008/6/1,臺北市,大安區,114687,315587,149467,166120
2008/6/1,臺北市,中山區,87779,218530,103661,114869
2008/6/1,臺北市,中正區,60328,160141,77596,82545
2008/6/1,臺北市,大同區,45861,126078,62480,63598
2008/6/1,臺北市,萬華區,72484,191354,96361,94993
2008/6/1,臺北市,文山區,93871,261842,127646,134196
2008/6/1,臺北市,南港區,39740,113548,56361,57187
2008/6/1,臺北市,內湖區,91639,266132,129036,137096
2008/6/1,臺北市,士林區,97671,286947,140153,146794
2008/6/1,臺北市,北投區,86545,249921,121890,128031
2008/6/1,高雄市,鹽埕區,11245,28511,14447,14064
2008/6/1,高雄市,鼓山區,47509,123805,61380,62425
2008/6/1,高雄市,左營區,70561,187066,92894,94172
2008/6/1,高雄市,楠梓區,59232,169704,84673,85031
2008/6/1,高雄市,三民區,127733,356732,175808,180924
2008/6/1,高雄市,新興區,22784,57107,28038,29069
2008/6/1,高雄市,前金區,12397,29772,14639,15133
2008/6/1,高雄市,苓雅區,70243,187600,91778,95822
2008/6/1,高雄市,前鎮區,73774,200665,100672,99993
2008/6/1,高雄市,旗津區,10656,29789,15593,14196
2008/6/1,高雄市,小港區,59890,152566,77211,75355
2008/6/1,金門縣,金城鎮,10076,28536,15087,13449
2008/6/1,金門縣,金湖鎮,6585,18515,9888,8627
2008/6/1,金門縣,金沙鎮,4966,13294,6978,6316
2008/6/1,金門縣,金寧鄉,5552,15191,8235,6956
2008/6/1,金門縣,烈嶼鄉,2333,7258,3832,3426
2008/6/1,金門縣,烏坵鄉,134,431,223,208
2008/6/1,連江縣,南竿鄉,1078,5916,3436,2480
2008/6/1,連江縣,北竿鄉,377,1817,1066,751
2008/6/1,連江縣,莒光鄉,232,1190,700,490
2008/6/1,連江縣,東引鄉,249,1018,609,409
2008/7/1,總計,臺灣地區,7559855,22907614,11567417,11340197
2008/7/1,總計,臺灣省,6039539,18755266,9535128,9220138
2008/7/1,總計,新北市,1325925,3814784,1905382,1909402
2008/7/1,總計,宜蘭縣,148570,461126,235927,225199
2008/7/1,總計,桃園市,629223,1948004,986996,961008
2008/7/1,總計,新竹縣,150478,500025,258533,241492
2008/7/1,總計,苗栗縣,165094,559914,292250,267664
2008/7/1,總計,臺中市,447298,1554266,790331,763935
2008/7/1,總計,彰化縣,350933,1312737,676555,636182
2008/7/1,總計,南投縣,165701,532615,275465,257150
2008/7/1,總計,雲林縣,221485,724994,380439,344555
2008/7/1,總計,嘉義縣,170433,549002,287728,261274
2008/7/1,總計,臺南市,356353,1104386,566291,538095
2008/7/1,總計,高雄市,417905,1243000,639544,603456
2008/7/1,總計,屏東縣,268513,886514,457971,428543
2008/7/1,總計,臺東縣,78287,232452,122487,109965
2008/7/1,總計,花蓮縣,117899,342400,177676,164724
2008/7/1,總計,澎湖縣,30937,92769,47875,44894
2008/7/1,總計,基隆市,143351,389213,197057,192156
2008/7/1,總計,新竹市,132260,402695,201157,201538
2008/7/1,總計,臺中市,366560,1062937,518826,544111
2008/7/1,總計,嘉義市,92386,273967,135381,138586
2008/7/1,總計,臺南市,259948,767466,381257,386209
2008/7/1,總計,臺北市,953188,2628699,1275162,1353537
2008/7/1,總計,高雄市,567128,1523649,757127,766522
2008/7/1,總計,福建省,31645,93213,50020,43193
2008/7/1,總計,金門縣,29710,83329,44249,39080
2008/7/1,總計,連江縣,1935,9884,5771,4113
2008/7/1,新北市,板橋區,185435,550016,273712,276304
2008/7/1,新北市,三重區,132089,383526,192306,191220
2008/7/1,新北市,永和區,88289,236987,114209,122778
2008/7/1,新北市,中和區,147461,409252,203499,205753
2008/7/1,新北市,新莊區,130542,397299,197192,200107
2008/7/1,新北市,新店區,111324,291125,143546,147579
2008/7/1,新北市,土城區,78993,237741,119343,118398
2008/7/1,新北市,蘆洲區,62108,193411,96182,97229
2008/7/1,新北市,汐止區,74537,181816,90919,90897
2008/7/1,新北市,樹林區,53718,167079,84578,82501
2008/7/1,新北市,鶯歌區,26076,86134,43867,42267
2008/7/1,新北市,三峽區,31620,96785,49866,46919
2008/7/1,新北市,淡水區,50687,133793,65697,68096
2008/7/1,新北市,瑞芳區,15525,43165,22117,21048
2008/7/1,新北市,五股區,25761,77562,39501,38061
2008/7/1,新北市,泰山區,25022,75221,38048,37173
2008/7/1,新北市,林口區,24095,70603,35190,35413
2008/7/1,新北市,深坑區,8321,22690,11541,11149
2008/7/1,新北市,石碇區,3176,7863,4368,3495
2008/7/1,新北市,坪林區,2375,6530,3668,2862
2008/7/1,新北市,三芝區,8611,23566,12259,11307
2008/7/1,新北市,石門區,3697,11833,6304,5529
2008/7/1,新北市,八里區,11229,32912,16886,16026
2008/7/1,新北市,平溪區,2329,5544,3107,2437
2008/7/1,新北市,雙溪區,3806,9916,5360,4556
2008/7/1,新北市,貢寮區,4314,13893,7235,6658
2008/7/1,新北市,金山區,6491,22223,11326,10897
2008/7/1,新北市,萬里區,6642,20837,10752,10085
2008/7/1,新北市,烏來區,1652,5462,2804,2658
2008/7/1,宜蘭縣,宜蘭市,32195,96084,47527,48557
2008/7/1,宜蘭縣,羅東鎮,24307,74087,35650,38437
2008/7/1,宜蘭縣,蘇澳鎮,13272,43724,22553,21171
2008/7/1,宜蘭縣,頭城鎮,9371,31444,16323,15121
2008/7/1,宜蘭縣,礁溪鄉,11883,35919,18900,17019
2008/7/1,宜蘭縣,壯圍鄉,7818,25069,13258,11811
2008/7/1,宜蘭縣,員山鄉,10370,32285,17356,14929
2008/7/1,宜蘭縣,冬山鄉,16455,51513,26656,24857
2008/7/1,宜蘭縣,五結鄉,12319,38176,19895,18281
2008/7/1,宜蘭縣,三星鄉,7079,21209,11503,9706
2008/7/1,宜蘭縣,大同鄉,1787,5804,3209,2595
2008/7/1,宜蘭縣,南澳鄉,1714,5812,3097,2715
2008/7/1,桃園市,桃園區,135027,395104,194193,200911
2008/7/1,桃園市,中壢區,118536,360569,180993,179576
2008/7/1,桃園市,平鎮區,62628,204440,103343,101097
2008/7/1,桃園市,八德區,53899,172587,88491,84096
2008/7/1,桃園市,大溪區,27885,90747,46904,43843
2008/7/1,桃園市,楊梅區,44858,144297,73825,70472
2008/7/1,桃園市,蘆竹區,44130,134275,67723,66552
2008/7/1,桃園市,大園區,24163,79849,41647,38202
2008/7/1,桃園市,龜山區,46724,132767,67812,64955
2008/7/1,桃園市,龍潭區,35039,113264,57852,55412
2008/7/1,桃園市,新屋區,14512,49726,26571,23155
2008/7/1,桃園市,觀音區,18234,59958,31774,28184
2008/7/1,桃園市,復興區,3588,10421,5868,4553
2008/7/1,新竹縣,竹北市,41244,129609,65329,64280
2008/7/1,新竹縣,關西鎮,8926,32548,17383,15165
2008/7/1,新竹縣,新埔鎮,10002,36098,19162,16936
2008/7/1,新竹縣,竹東鎮,29215,96876,48985,47891
2008/7/1,新竹縣,湖口鄉,22334,74705,38291,36414
2008/7/1,新竹縣,橫山鄉,4208,14602,7949,6653
2008/7/1,新竹縣,新豐鄉,14803,52182,27103,25079
2008/7/1,新竹縣,芎林鄉,6026,20809,10961,9848
2008/7/1,新竹縣,寶山鄉,4467,13707,7399,6308
2008/7/1,新竹縣,北埔鄉,2998,10278,5568,4710
2008/7/1,新竹縣,峨眉鄉,2011,6099,3400,2699
2008/7/1,新竹縣,尖石鄉,2588,8138,4501,3637
2008/7/1,新竹縣,五峰鄉,1656,4374,2502,1872
2008/7/1,苗栗縣,苗栗市,28143,91149,46176,44973
2008/7/1,苗栗縣,苑裡鎮,13346,48952,25626,23326
2008/7/1,苗栗縣,通霄鎮,10986,38911,20770,18141
2008/7/1,苗栗縣,竹南鎮,22176,75871,38737,37134
2008/7/1,苗栗縣,頭份市,27787,95266,48787,46479
2008/7/1,苗栗縣,後龍鎮,11425,40253,21368,18885
2008/7/1,苗栗縣,卓蘭鎮,5784,18374,9742,8632
2008/7/1,苗栗縣,大湖鄉,5178,16098,8679,7419
2008/7/1,苗栗縣,公館鄉,9728,34720,18245,16475
2008/7/1,苗栗縣,銅鑼鄉,5854,19731,10523,9208
2008/7/1,苗栗縣,南庄鄉,3853,11295,6275,5020
2008/7/1,苗栗縣,頭屋鄉,3449,11792,6243,5549
2008/7/1,苗栗縣,三義鄉,5120,17678,9371,8307
2008/7/1,苗栗縣,西湖鄉,2590,7918,4403,3515
2008/7/1,苗栗縣,造橋鄉,3874,13748,7287,6461
2008/7/1,苗栗縣,三灣鄉,2315,7411,4041,3370
2008/7/1,苗栗縣,獅潭鄉,1639,5079,2862,2217
2008/7/1,苗栗縣,泰安鄉,1847,5668,3115,2553
2008/7/1,臺中市,豐原區,47637,165144,82192,82952
2008/7/1,臺中市,大里區,58715,193779,96449,97330
2008/7/1,臺中市,太平區,52610,171817,86557,85260
2008/7/1,臺中市,東勢區,16573,54450,28360,26090
2008/7/1,臺中市,大甲區,20986,79249,40221,39028
2008/7/1,臺中市,清水區,24044,85853,44422,41431
2008/7/1,臺中市,沙鹿區,21892,79181,40416,38765
2008/7/1,臺中市,梧棲區,15374,54525,27732,26793
2008/7/1,臺中市,后里區,14252,54459,28188,26271
2008/7/1,臺中市,神岡區,16994,64023,33075,30948
2008/7/1,臺中市,潭子區,30687,97952,49180,48772
2008/7/1,臺中市,大雅區,25212,88530,44830,43700
2008/7/1,臺中市,新社區,7161,25769,13648,12121
2008/7/1,臺中市,石岡區,4687,16131,8409,7722
2008/7/1,臺中市,外埔區,8408,31834,16438,15396
2008/7/1,臺中市,大安區,5123,20609,10858,9751
2008/7/1,臺中市,烏日區,19362,67808,34491,33317
2008/7/1,臺中市,大肚區,15303,56004,28841,27163
2008/7/1,臺中市,龍井區,19511,72134,36970,35164
2008/7/1,臺中市,霧峰區,18299,64248,33114,31134
2008/7/1,臺中市,和平區,4468,10767,5940,4827
2008/7/1,彰化縣,彰化市,69315,236538,118448,118090
2008/7/1,彰化縣,鹿港鎮,21360,85258,43799,41459
2008/7/1,彰化縣,和美鎮,23073,89162,45865,43297
2008/7/1,彰化縣,北斗鎮,9548,33607,17119,16488
2008/7/1,彰化縣,員林市,35353,126153,63717,62436
2008/7/1,彰化縣,溪湖鎮,14577,56603,29066,27537
2008/7/1,彰化縣,田中鎮,12202,44901,23609,21292
2008/7/1,彰化縣,二林鎮,13908,54885,28360,26525
2008/7/1,彰化縣,線西鄉,3938,17015,8783,8232
2008/7/1,彰化縣,伸港鄉,8585,35771,18448,17323
2008/7/1,彰化縣,福興鄉,11582,48878,25620,23258
2008/7/1,彰化縣,秀水鄉,9296,38951,20189,18762
2008/7/1,彰化縣,花壇鄉,12367,46080,23826,22254
2008/7/1,彰化縣,芬園鄉,6782,25096,13356,11740
2008/7/1,彰化縣,大村鄉,9833,36385,19032,17353
2008/7/1,彰化縣,埔鹽鄉,8527,34590,18198,16392
2008/7/1,彰化縣,埔心鄉,9604,35508,18443,17065
2008/7/1,彰化縣,永靖鄉,10068,39581,20616,18965
2008/7/1,彰化縣,社頭鄉,11965,45312,23383,21929
2008/7/1,彰化縣,二水鄉,5214,16956,8976,7980
2008/7/1,彰化縣,田尾鄉,7480,28965,15116,13849
2008/7/1,彰化縣,埤頭鄉,8273,31991,16794,15197
2008/7/1,彰化縣,芳苑鄉,9828,36781,19525,17256
2008/7/1,彰化縣,大城鄉,5277,19109,10449,8660
2008/7/1,彰化縣,竹塘鄉,4478,16675,8848,7827
2008/7/1,彰化縣,溪州鄉,8500,31986,16970,15016
2008/7/1,南投縣,南投市,32343,105523,53316,52207
2008/7/1,南投縣,埔里鎮,27672,86409,43796,42613
2008/7/1,南投縣,草屯鎮,29866,100127,50763,49364
2008/7/1,南投縣,竹山鎮,18235,59053,30577,28476
2008/7/1,南投縣,集集鎮,4148,12022,6332,5690
2008/7/1,南投縣,名間鄉,11764,41583,21946,19637
2008/7/1,南投縣,鹿谷鄉,6390,19445,10389,9056
2008/7/1,南投縣,中寮鄉,5478,16479,8981,7498
2008/7/1,南投縣,魚池鄉,5679,17308,9202,8106
2008/7/1,南投縣,國姓鄉,7087,21277,11697,9580
2008/7/1,南投縣,水里鄉,7133,20716,10919,9797
2008/7/1,南投縣,信義鄉,5035,17206,9365,7841
2008/7/1,南投縣,仁愛鄉,4871,15467,8182,7285
2008/7/1,雲林縣,斗六市,33069,105999,53648,52351
2008/7/1,雲林縣,斗南鎮,14782,47692,24281,23411
2008/7/1,雲林縣,虎尾鎮,21354,69657,35575,34082
2008/7/1,雲林縣,西螺鎮,13686,49253,25033,24220
2008/7/1,雲林縣,土庫鎮,8468,31013,16262,14751
2008/7/1,雲林縣,北港鎮,14876,44215,23061,21154
2008/7/1,雲林縣,古坑鄉,10351,35093,18638,16455
2008/7/1,雲林縣,大埤鄉,6465,21753,11604,10149
2008/7/1,雲林縣,莿桐鄉,8740,30705,16108,14597
2008/7/1,雲林縣,林內鄉,5568,20304,10692,9612
2008/7/1,雲林縣,二崙鄉,8605,30405,16372,14033
2008/7/1,雲林縣,崙背鄉,8163,28049,14898,13151
2008/7/1,雲林縣,麥寮鄉,11481,33667,17946,15721
2008/7/1,雲林縣,東勢鄉,5619,17460,9510,7950
2008/7/1,雲林縣,褒忠鄉,4195,14676,7870,6806
2008/7/1,雲林縣,臺西鄉,8594,27299,14711,12588
2008/7/1,雲林縣,元長鄉,9138,29464,16126,13338
2008/7/1,雲林縣,四湖鄉,8895,27593,15160,12433
2008/7/1,雲林縣,口湖鄉,9403,31050,16649,14401
2008/7/1,雲林縣,水林鄉,10033,29647,16295,13352
2008/7/1,嘉義縣,太保市,10563,35774,18594,17180
2008/7/1,嘉義縣,朴子市,13776,44320,22742,21578
2008/7/1,嘉義縣,布袋鎮,9921,31050,16040,15010
2008/7/1,嘉義縣,大林鎮,10945,34214,17669,16545
2008/7/1,嘉義縣,民雄鄉,21789,72662,37494,35168
2008/7/1,嘉義縣,溪口鄉,5265,16709,8940,7769
2008/7/1,嘉義縣,新港鄉,10106,35250,18613,16637
2008/7/1,嘉義縣,六腳鄉,8980,27037,14356,12681
2008/7/1,嘉義縣,東石鄉,9172,28365,15156,13209
2008/7/1,嘉義縣,義竹鄉,7338,21708,11317,10391
2008/7/1,嘉義縣,鹿草鄉,5588,17425,9366,8059
2008/7/1,嘉義縣,水上鄉,17169,53223,27698,25525
2008/7/1,嘉義縣,中埔鄉,14645,47786,25061,22725
2008/7/1,嘉義縣,竹崎鄉,11118,39359,21005,18354
2008/7/1,嘉義縣,梅山鄉,6412,22237,11794,10443
2008/7/1,嘉義縣,番路鄉,3806,11617,6361,5256
2008/7/1,嘉義縣,大埔鄉,1888,4105,2209,1896
2008/7/1,嘉義縣,阿里山鄉,1952,6161,3313,2848
2008/7/1,臺南市,新營區,26305,78906,39607,39299
2008/7/1,臺南市,永康區,71151,211788,105885,105903
2008/7/1,臺南市,鹽水區,9696,27687,14444,13243
2008/7/1,臺南市,白河區,10751,32048,16953,15095
2008/7/1,臺南市,麻豆區,14430,46282,23739,22543
2008/7/1,臺南市,佳里區,18548,59281,29621,29660
2008/7/1,臺南市,新化區,13204,44511,22888,21623
2008/7/1,臺南市,善化區,13784,42905,21849,21056
2008/7/1,臺南市,學甲區,9208,28447,14644,13803
2008/7/1,臺南市,柳營區,7599,23092,12102,10990
2008/7/1,臺南市,後壁區,8515,26316,13761,12555
2008/7/1,臺南市,東山區,8065,23624,12669,10955
2008/7/1,臺南市,下營區,8906,26657,13842,12815
2008/7/1,臺南市,六甲區,7443,24332,12679,11653
2008/7/1,臺南市,官田區,7479,22513,11612,10901
2008/7/1,臺南市,大內區,4013,11241,6021,5220
2008/7/1,臺南市,西港區,7609,25497,13051,12446
2008/7/1,臺南市,七股區,7770,25274,13250,12024
2008/7/1,臺南市,將軍區,7269,21861,11195,10666
2008/7/1,臺南市,北門區,4175,12483,6418,6065
2008/7/1,臺南市,新市區,10480,35396,17844,17552
2008/7/1,臺南市,安定區,8843,30055,15611,14444
2008/7/1,臺南市,山上區,2699,8057,4264,3793
2008/7/1,臺南市,玉井區,5010,15731,8196,7535
2008/7/1,臺南市,楠西區,3593,10952,5831,5121
2008/7/1,臺南市,南化區,2811,8950,4923,4027
2008/7/1,臺南市,左鎮區,1941,5587,3109,2478
2008/7/1,臺南市,仁德區,23368,68038,35185,32853
2008/7/1,臺南市,歸仁區,19642,65660,33542,32118
2008/7/1,臺南市,關廟區,10476,36789,19144,17645
2008/7/1,臺南市,龍崎區,1570,4426,2412,2014
2008/7/1,高雄市,鳳山區,122290,339178,169843,169335
2008/7/1,高雄市,岡山區,32110,96458,48759,47699
2008/7/1,高雄市,旗山區,13545,40985,21444,19541
2008/7/1,高雄市,美濃區,13706,43869,23002,20867
2008/7/1,高雄市,林園區,23423,71150,36734,34416
2008/7/1,高雄市,大寮區,36774,109119,57046,52073
2008/7/1,高雄市,大樹區,12863,44629,23168,21461
2008/7/1,高雄市,仁武區,23612,68482,35457,33025
2008/7/1,高雄市,大社區,11339,32756,16917,15839
2008/7/1,高雄市,鳥松區,15711,41440,21145,20295
2008/7/1,高雄市,橋頭區,12230,36471,18833,17638
2008/7/1,高雄市,燕巢區,9678,31177,16705,14472
2008/7/1,高雄市,田寮區,3570,8496,4736,3760
2008/7/1,高雄市,阿蓮區,8932,30826,15595,15231
2008/7/1,高雄市,路竹區,15498,54353,27821,26532
2008/7/1,高雄市,湖內區,9151,28579,14800,13779
2008/7/1,高雄市,茄萣區,9954,31849,16707,15142
2008/7/1,高雄市,永安區,5668,14143,7281,6862
2008/7/1,高雄市,彌陀區,6417,20700,10844,9856
2008/7/1,高雄市,梓官區,11586,37075,19450,17625
2008/7/1,高雄市,六龜區,5684,15556,8456,7100
2008/7/1,高雄市,甲仙區,2565,8150,4390,3760
2008/7/1,高雄市,杉林區,3991,11229,6172,5057
2008/7/1,高雄市,內門區,4978,16348,8957,7391
2008/7/1,高雄市,茂林區,527,1760,900,860
2008/7/1,高雄市,桃源區,1228,4750,2551,2199
2008/7/1,高雄市,那瑪夏區,875,3472,1831,1641
2008/7/1,屏東縣,屏東市,71262,215643,108022,107621
2008/7/1,屏東縣,潮州鎮,17656,56858,28748,28110
2008/7/1,屏東縣,東港鎮,14782,50559,25796,24763
2008/7/1,屏東縣,恆春鎮,10362,31183,16159,15024
2008/7/1,屏東縣,萬丹鄉,13856,54506,28279,26227
2008/7/1,屏東縣,長治鄉,9530,31003,16288,14715
2008/7/1,屏東縣,麟洛鄉,3460,11619,6037,5582
2008/7/1,屏東縣,九如鄉,6413,23166,12078,11088
2008/7/1,屏東縣,里港鄉,7775,26408,13566,12842
2008/7/1,屏東縣,鹽埔鄉,7522,27591,14405,13186
2008/7/1,屏東縣,高樹鄉,9513,27317,14627,12690
2008/7/1,屏東縣,萬巒鄉,6293,22551,11917,10634
2008/7/1,屏東縣,內埔鄉,17310,59286,31004,28282
2008/7/1,屏東縣,竹田鄉,5372,18466,9855,8611
2008/7/1,屏東縣,新埤鄉,3301,10918,5798,5120
2008/7/1,屏東縣,枋寮鄉,8267,27252,14482,12770
2008/7/1,屏東縣,新園鄉,10879,39237,20312,18925
2008/7/1,屏東縣,崁頂鄉,3988,17053,8799,8254
2008/7/1,屏東縣,林邊鄉,6185,21154,10979,10175
2008/7/1,屏東縣,南州鄉,3575,12042,6192,5850
2008/7/1,屏東縣,佳冬鄉,6604,21679,11347,10332
2008/7/1,屏東縣,琉球鄉,3777,12567,6962,5605
2008/7/1,屏東縣,車城鄉,3394,10000,5389,4611
2008/7/1,屏東縣,滿州鄉,2982,8577,4728,3849
2008/7/1,屏東縣,枋山鄉,2100,6187,3324,2863
2008/7/1,屏東縣,三地門鄉,2029,7224,3716,3508
2008/7/1,屏東縣,霧臺鄉,866,2709,1451,1258
2008/7/1,屏東縣,瑪家鄉,1803,6436,3362,3074
2008/7/1,屏東縣,泰武鄉,1104,4892,2611,2281
2008/7/1,屏東縣,來義鄉,2066,7686,3980,3706
2008/7/1,屏東縣,春日鄉,1278,4949,2591,2358
2008/7/1,屏東縣,獅子鄉,1429,4936,2628,2308
2008/7/1,屏東縣,牡丹鄉,1780,4860,2539,2321
2008/7/1,臺東縣,臺東市,37142,109978,56092,53886
2008/7/1,臺東縣,成功鎮,5336,16295,8729,7566
2008/7/1,臺東縣,關山鎮,3203,9947,5257,4690
2008/7/1,臺東縣,卑南鄉,6418,18306,10013,8293
2008/7/1,臺東縣,大武鄉,2443,6998,3677,3321
2008/7/1,臺東縣,太麻里鄉,4499,12157,6536,5621
2008/7/1,臺東縣,東河鄉,3453,9583,5332,4251
2008/7/1,臺東縣,長濱鄉,2860,8726,4979,3747
2008/7/1,臺東縣,鹿野鄉,3081,8763,4754,4009
2008/7/1,臺東縣,池上鄉,3200,9411,5023,4388
2008/7/1,臺東縣,綠島鄉,933,3157,1693,1464
2008/7/1,臺東縣,延平鄉,1059,3597,2013,1584
2008/7/1,臺東縣,海端鄉,1074,4541,2474,2067
2008/7/1,臺東縣,達仁鄉,1396,3710,2065,1645
2008/7/1,臺東縣,金峰鄉,972,3313,1749,1564
2008/7/1,臺東縣,蘭嶼鄉,1218,3970,2101,1869
2008/7/1,花蓮縣,花蓮市,39655,110362,54416,55946
2008/7/1,花蓮縣,鳳林鎮,4397,12351,6576,5775
2008/7/1,花蓮縣,玉里鎮,8820,27859,15186,12673
2008/7/1,花蓮縣,新城鄉,7124,20312,10636,9676
2008/7/1,花蓮縣,吉安鄉,27716,78881,40694,38187
2008/7/1,花蓮縣,壽豐鄉,6703,19199,10429,8770
2008/7/1,花蓮縣,光復鄉,4971,14537,7799,6738
2008/7/1,花蓮縣,豐濱鄉,1805,5246,2922,2324
2008/7/1,花蓮縣,瑞穗鄉,4573,13244,7197,6047
2008/7/1,花蓮縣,富里鄉,3914,11933,6600,5333
2008/7/1,花蓮縣,秀林鄉,4470,14937,7838,7099
2008/7/1,花蓮縣,萬榮鄉,2135,7056,3778,3278
2008/7/1,花蓮縣,卓溪鄉,1616,6483,3605,2878
2008/7/1,澎湖縣,馬公市,18103,54833,27936,26897
2008/7/1,澎湖縣,湖西鄉,4350,12882,6750,6132
2008/7/1,澎湖縣,白沙鄉,2966,9170,4845,4325
2008/7/1,澎湖縣,西嶼鄉,2681,8173,4236,3937
2008/7/1,澎湖縣,望安鄉,1710,4441,2384,2057
2008/7/1,澎湖縣,七美鄉,1127,3270,1724,1546
2008/7/1,基隆市,中正區,21715,57054,29439,27615
2008/7/1,基隆市,七堵區,19196,55161,28079,27082
2008/7/1,基隆市,暖暖區,14060,38292,19554,18738
2008/7/1,基隆市,仁愛區,19167,50590,25120,25470
2008/7/1,基隆市,中山區,18643,51869,26595,25274
2008/7/1,基隆市,安樂區,31089,85208,42570,42638
2008/7/1,基隆市,信義區,19481,51039,25700,25339
2008/7/1,新竹市,東區,63922,191646,94928,96718
2008/7/1,新竹市,北區,47070,140499,70095,70404
2008/7/1,新竹市,香山區,21268,70550,36134,34416
2008/7/1,臺中市,中區,8556,24149,11912,12237
2008/7/1,臺中市,東區,25079,74004,37547,36457
2008/7/1,臺中市,西區,41864,117384,56674,60710
2008/7/1,臺中市,南區,39814,110900,54115,56785
2008/7/1,臺中市,北區,53968,147955,72072,75883
2008/7/1,臺中市,西屯區,68566,200386,97811,102575
2008/7/1,臺中市,南屯區,49561,147283,71253,76030
2008/7/1,臺中市,北屯區,79152,240876,117442,123434
2008/7/1,嘉義市,東區,43900,128743,63070,65673
2008/7/1,嘉義市,西區,48486,145224,72311,72913
2008/7/1,臺南市,東區,68953,194376,94563,99813
2008/7/1,臺南市,南區,42066,127487,64201,63286
2008/7/1,臺南市,北區,45869,129310,64182,65128
2008/7/1,臺南市,安南區,51718,175216,89488,85728
2008/7/1,臺南市,安平區,21639,60087,28853,31234
2008/7/1,臺南市,中西區,29703,80990,39970,41020
2008/7/1,臺北市,松山區,76636,211304,100362,110942
2008/7/1,臺北市,信義區,84729,228405,110879,117526
2008/7/1,臺北市,大安區,114772,315226,149270,165956
2008/7/1,臺北市,中山區,87958,218565,103615,114950
2008/7/1,臺北市,中正區,60421,159931,77508,82423
2008/7/1,臺北市,大同區,45858,125781,62317,63464
2008/7/1,臺北市,萬華區,72562,191129,96256,94873
2008/7/1,臺北市,文山區,94016,261842,127640,134202
2008/7/1,臺北市,南港區,39834,113580,56392,57188
2008/7/1,臺北市,內湖區,91864,266212,129018,137194
2008/7/1,臺北市,士林區,97802,286742,139988,146754
2008/7/1,臺北市,北投區,86736,249982,121917,128065
2008/7/1,高雄市,鹽埕區,11254,28427,14414,14013
2008/7/1,高雄市,鼓山區,47713,124027,61463,62564
2008/7/1,高雄市,左營區,70797,187387,93050,94337
2008/7/1,高雄市,楠梓區,59364,169868,84782,85086
2008/7/1,高雄市,三民區,127900,356628,175685,180943
2008/7/1,高雄市,新興區,22811,57070,28000,29070
2008/7/1,高雄市,前金區,12409,29744,14592,15152
2008/7/1,高雄市,苓雅區,70311,187414,91689,95725
2008/7/1,高雄市,前鎮區,73902,200635,100611,100024
2008/7/1,高雄市,旗津區,10650,29792,15592,14200
2008/7/1,高雄市,小港區,60017,152657,77249,75408
2008/7/1,金門縣,金城鎮,10095,28580,15099,13481
2008/7/1,金門縣,金湖鎮,6599,18526,9880,8646
2008/7/1,金門縣,金沙鎮,4978,13303,6979,6324
2008/7/1,金門縣,金寧鄉,5562,15200,8223,6977
2008/7/1,金門縣,烈嶼鄉,2341,7283,3842,3441
2008/7/1,金門縣,烏坵鄉,135,437,226,211
2008/7/1,連江縣,南竿鄉,1078,5883,3415,2468
2008/7/1,連江縣,北竿鄉,375,1804,1054,750
2008/7/1,連江縣,莒光鄉,232,1184,696,488
2008/7/1,連江縣,東引鄉,250,1013,606,407
2008/8/1,總計,臺灣地區,7576561,22911715,11567994,11343721
2008/8/1,總計,臺灣省,6053342,18761712,9537188,9224524
2008/8/1,總計,新北市,1329610,3818201,1906749,1911452
2008/8/1,總計,宜蘭縣,148929,461268,235993,225275
2008/8/1,總計,桃園市,631413,1950129,987975,962154
2008/8/1,總計,新竹縣,150987,500595,258789,241806
2008/8/1,總計,苗栗縣,165446,559904,292260,267644
2008/8/1,總計,臺中市,448075,1554993,790571,764422
2008/8/1,總計,彰化縣,351495,1312642,676395,636247
2008/8/1,總計,南投縣,165930,532422,275333,257089
2008/8/1,總計,雲林縣,222107,724638,380192,344446
2008/8/1,總計,嘉義縣,170720,548754,287541,261213
2008/8/1,總計,臺南市,356916,1104437,566192,538245
2008/8/1,總計,高雄市,418529,1242866,639458,603408
2008/8/1,總計,屏東縣,268860,886193,457724,428469
2008/8/1,總計,臺東縣,78438,232258,122378,109880
2008/8/1,總計,花蓮縣,118049,342003,177418,164585
2008/8/1,總計,澎湖縣,31051,92907,47938,44969
2008/8/1,總計,基隆市,143584,389134,197000,192134
2008/8/1,總計,新竹市,132666,403272,201439,201833
2008/8/1,總計,臺中市,367406,1063429,519114,544315
2008/8/1,總計,嘉義市,92636,274074,135437,138637
2008/8/1,總計,臺南市,260495,767593,381292,386301
2008/8/1,總計,臺北市,954817,2626114,1273790,1352324
2008/8/1,總計,高雄市,568402,1523889,757016,766873
2008/8/1,總計,福建省,31681,93352,50026,43326
2008/8/1,總計,金門縣,29742,83497,44283,39214
2008/8/1,總計,連江縣,1939,9855,5743,4112
2008/8/1,新北市,板橋區,185893,550117,273739,276378
2008/8/1,新北市,三重區,132436,383722,192351,191371
2008/8/1,新北市,永和區,88370,236855,114114,122741
2008/8/1,新北市,中和區,147909,409678,203662,206016
2008/8/1,新北市,新莊區,130813,397398,197197,200201
2008/8/1,新北市,新店區,111636,291322,143655,147667
2008/8/1,新北市,土城區,79133,237857,119390,118467
2008/8/1,新北市,蘆洲區,62241,193660,96275,97385
2008/8/1,新北市,汐止區,74781,182185,91057,91128
2008/8/1,新北市,樹林區,54035,167508,84795,82713
2008/8/1,新北市,鶯歌區,26136,86189,43907,42282
2008/8/1,新北市,三峽區,31770,96970,49946,47024
2008/8/1,新北市,淡水區,50924,134090,65812,68278
2008/8/1,新北市,瑞芳區,15524,43133,22093,21040
2008/8/1,新北市,五股區,25760,77548,39502,38046
2008/8/1,新北市,泰山區,25105,75277,38083,37194
2008/8/1,新北市,林口區,24412,71218,35470,35748
2008/8/1,新北市,深坑區,8349,22752,11560,11192
2008/8/1,新北市,石碇區,3175,7845,4362,3483
2008/8/1,新北市,坪林區,2375,6526,3659,2867
2008/8/1,新北市,三芝區,8613,23566,12269,11297
2008/8/1,新北市,石門區,3703,11862,6325,5537
2008/8/1,新北市,八里區,11258,33001,16925,16076
2008/8/1,新北市,平溪區,2333,5528,3101,2427
2008/8/1,新北市,雙溪區,3796,9897,5355,4542
2008/8/1,新北市,貢寮區,4317,13908,7242,6666
2008/8/1,新北市,金山區,6495,22244,11322,10922
2008/8/1,新北市,萬里區,6663,20864,10765,10099
2008/8/1,新北市,烏來區,1655,5481,2816,2665
2008/8/1,宜蘭縣,宜蘭市,32243,96022,47475,48547
2008/8/1,宜蘭縣,羅東鎮,24348,74081,35667,38414
2008/8/1,宜蘭縣,蘇澳鎮,13302,43819,22611,21208
2008/8/1,宜蘭縣,頭城鎮,9387,31436,16313,15123
2008/8/1,宜蘭縣,礁溪鄉,11952,35934,18906,17028
2008/8/1,宜蘭縣,壯圍鄉,7827,25076,13272,11804
2008/8/1,宜蘭縣,員山鄉,10400,32253,17343,14910
2008/8/1,宜蘭縣,冬山鄉,16488,51526,26656,24870
2008/8/1,宜蘭縣,五結鄉,12360,38230,19924,18306
2008/8/1,宜蘭縣,三星鄉,7115,21256,11520,9736
2008/8/1,宜蘭縣,大同鄉,1786,5798,3201,2597
2008/8/1,宜蘭縣,南澳鄉,1721,5837,3105,2732
2008/8/1,桃園市,桃園區,135399,395421,194377,201044
2008/8/1,桃園市,中壢區,118950,360980,181145,179835
2008/8/1,桃園市,平鎮區,62807,204532,103371,101161
2008/8/1,桃園市,八德區,54077,172792,88579,84213
2008/8/1,桃園市,大溪區,27984,90801,46933,43868
2008/8/1,桃園市,楊梅區,45032,144546,73958,70588
2008/8/1,桃園市,蘆竹區,44338,134550,67831,66719
2008/8/1,桃園市,大園區,24322,79923,41685,38238
2008/8/1,桃園市,龜山區,46937,133036,67939,65097
2008/8/1,桃園市,龍潭區,35151,113329,57882,55447
2008/8/1,桃園市,新屋區,14528,49704,26581,23123
2008/8/1,桃園市,觀音區,18294,60074,31824,28250
2008/8/1,桃園市,復興區,3594,10441,5870,4571
2008/8/1,新竹縣,竹北市,41510,130049,65516,64533
2008/8/1,新竹縣,關西鎮,8935,32534,17389,15145
2008/8/1,新竹縣,新埔鎮,10022,36115,19183,16932
2008/8/1,新竹縣,竹東鎮,29308,96921,49007,47914
2008/8/1,新竹縣,湖口鄉,22394,74787,38330,36457
2008/8/1,新竹縣,橫山鄉,4212,14587,7944,6643
2008/8/1,新竹縣,新豐鄉,14833,52188,27101,25087
2008/8/1,新竹縣,芎林鄉,6036,20805,10961,9844
2008/8/1,新竹縣,寶山鄉,4473,13723,7399,6324
2008/8/1,新竹縣,北埔鄉,3008,10268,5566,4702
2008/8/1,新竹縣,峨眉鄉,2011,6091,3394,2697
2008/8/1,新竹縣,尖石鄉,2593,8151,4502,3649
2008/8/1,新竹縣,五峰鄉,1652,4376,2497,1879
2008/8/1,苗栗縣,苗栗市,28195,91146,46171,44975
2008/8/1,苗栗縣,苑裡鎮,13374,48962,25633,23329
2008/8/1,苗栗縣,通霄鎮,11005,38883,20755,18128
2008/8/1,苗栗縣,竹南鎮,22269,75943,38761,37182
2008/8/1,苗栗縣,頭份市,27880,95318,48803,46515
2008/8/1,苗栗縣,後龍鎮,11441,40243,21362,18881
2008/8/1,苗栗縣,卓蘭鎮,5794,18372,9745,8627
2008/8/1,苗栗縣,大湖鄉,5183,16094,8690,7404
2008/8/1,苗栗縣,公館鄉,9745,34737,18278,16459
2008/8/1,苗栗縣,銅鑼鄉,5853,19699,10496,9203
2008/8/1,苗栗縣,南庄鄉,3856,11292,6274,5018
2008/8/1,苗栗縣,頭屋鄉,3448,11759,6231,5528
2008/8/1,苗栗縣,三義鄉,5130,17661,9368,8293
2008/8/1,苗栗縣,西湖鄉,2592,7915,4401,3514
2008/8/1,苗栗縣,造橋鄉,3881,13739,7286,6453
2008/8/1,苗栗縣,三灣鄉,2318,7406,4035,3371
2008/8/1,苗栗縣,獅潭鄉,1637,5071,2860,2211
2008/8/1,苗栗縣,泰安鄉,1845,5664,3111,2553
2008/8/1,臺中市,豐原區,47726,165180,82191,82989
2008/8/1,臺中市,大里區,58839,194017,96536,97481
2008/8/1,臺中市,太平區,52710,171967,86619,85348
2008/8/1,臺中市,東勢區,16583,54370,28310,26060
2008/8/1,臺中市,大甲區,21000,79117,40150,38967
2008/8/1,臺中市,清水區,24093,85808,44406,41402
2008/8/1,臺中市,沙鹿區,21963,79297,40454,38843
2008/8/1,臺中市,梧棲區,15390,54586,27763,26823
2008/8/1,臺中市,后里區,14283,54469,28201,26268
2008/8/1,臺中市,神岡區,17022,64026,33069,30957
2008/8/1,臺中市,潭子區,30726,97960,49176,48784
2008/8/1,臺中市,大雅區,25252,88636,44865,43771
2008/8/1,臺中市,新社區,7171,25775,13648,12127
2008/8/1,臺中市,石岡區,4700,16177,8439,7738
2008/8/1,臺中市,外埔區,8426,31878,16461,15417
2008/8/1,臺中市,大安區,5127,20610,10863,9747
2008/8/1,臺中市,烏日區,19382,67836,34510,33326
2008/8/1,臺中市,大肚區,15316,55992,28833,27159
2008/8/1,臺中市,龍井區,19561,72249,37026,35223
2008/8/1,臺中市,霧峰區,18339,64279,33123,31156
2008/8/1,臺中市,和平區,4466,10764,5928,4836
2008/8/1,彰化縣,彰化市,69409,236543,118422,118121
2008/8/1,彰化縣,鹿港鎮,21381,85228,43769,41459
2008/8/1,彰化縣,和美鎮,23142,89228,45902,43326
2008/8/1,彰化縣,北斗鎮,9572,33630,17130,16500
2008/8/1,彰化縣,員林市,35413,126122,63672,62450
2008/8/1,彰化縣,溪湖鎮,14615,56617,29073,27544
2008/8/1,彰化縣,田中鎮,12206,44834,23564,21270
2008/8/1,彰化縣,二林鎮,13934,54860,28350,26510
2008/8/1,彰化縣,線西鄉,3945,17007,8779,8228
2008/8/1,彰化縣,伸港鄉,8594,35759,18438,17321
2008/8/1,彰化縣,福興鄉,11610,48894,25627,23267
2008/8/1,彰化縣,秀水鄉,9313,38949,20191,18758
2008/8/1,彰化縣,花壇鄉,12394,46123,23845,22278
2008/8/1,彰化縣,芬園鄉,6791,25098,13360,11738
2008/8/1,彰化縣,大村鄉,9847,36370,19028,17342
2008/8/1,彰化縣,埔鹽鄉,8547,34591,18193,16398
2008/8/1,彰化縣,埔心鄉,9604,35485,18447,17038
2008/8/1,彰化縣,永靖鄉,10094,39620,20635,18985
2008/8/1,彰化縣,社頭鄉,11994,45295,23362,21933
2008/8/1,彰化縣,二水鄉,5221,16948,8974,7974
2008/8/1,彰化縣,田尾鄉,7493,28945,15101,13844
2008/8/1,彰化縣,埤頭鄉,8286,31998,16785,15213
2008/8/1,彰化縣,芳苑鄉,9832,36768,19518,17250
2008/8/1,彰化縣,大城鄉,5278,19106,10441,8665
2008/8/1,彰化縣,竹塘鄉,4478,16673,8846,7827
2008/8/1,彰化縣,溪州鄉,8502,31951,16943,15008
2008/8/1,南投縣,南投市,32375,105414,53248,52166
2008/8/1,南投縣,埔里鎮,27713,86378,43757,42621
2008/8/1,南投縣,草屯鎮,29911,100159,50776,49383
2008/8/1,南投縣,竹山鎮,18291,59040,30568,28472
2008/8/1,南投縣,集集鎮,4151,12033,6339,5694
2008/8/1,南投縣,名間鄉,11792,41610,21957,19653
2008/8/1,南投縣,鹿谷鄉,6393,19429,10384,9045
2008/8/1,南投縣,中寮鄉,5480,16476,8985,7491
2008/8/1,南投縣,魚池鄉,5686,17314,9213,8101
2008/8/1,南投縣,國姓鄉,7093,21249,11676,9573
2008/8/1,南投縣,水里鄉,7132,20682,10905,9777
2008/8/1,南投縣,信義鄉,5040,17190,9355,7835
2008/8/1,南投縣,仁愛鄉,4873,15448,8170,7278
2008/8/1,雲林縣,斗六市,33160,106059,53663,52396
2008/8/1,雲林縣,斗南鎮,14812,47664,24272,23392
2008/8/1,雲林縣,虎尾鎮,21422,69729,35597,34132
2008/8/1,雲林縣,西螺鎮,13689,49154,25006,24148
2008/8/1,雲林縣,土庫鎮,8480,31012,16256,14756
2008/8/1,雲林縣,北港鎮,14904,44174,23042,21132
2008/8/1,雲林縣,古坑鄉,10352,35024,18596,16428
2008/8/1,雲林縣,大埤鄉,6473,21724,11590,10134
2008/8/1,雲林縣,莿桐鄉,8753,30664,16083,14581
2008/8/1,雲林縣,林內鄉,5574,20284,10676,9608
2008/8/1,雲林縣,二崙鄉,8607,30361,16345,14016
2008/8/1,雲林縣,崙背鄉,8178,28025,14884,13141
2008/8/1,雲林縣,麥寮鄉,11513,33702,17960,15742
2008/8/1,雲林縣,東勢鄉,5639,17474,9516,7958
2008/8/1,雲林縣,褒忠鄉,4201,14656,7855,6801
2008/8/1,雲林縣,臺西鄉,8619,27241,14683,12558
2008/8/1,雲林縣,元長鄉,9143,29476,16124,13352
2008/8/1,雲林縣,四湖鄉,8901,27550,15131,12419
2008/8/1,雲林縣,口湖鄉,9432,31021,16627,14394
2008/8/1,雲林縣,水林鄉,10255,29644,16286,13358
2008/8/1,嘉義縣,太保市,10601,35815,18618,17197
2008/8/1,嘉義縣,朴子市,13800,44330,22737,21593
2008/8/1,嘉義縣,布袋鎮,9935,31014,16021,14993
2008/8/1,嘉義縣,大林鎮,10973,34183,17635,16548
2008/8/1,嘉義縣,民雄鄉,21815,72608,37447,35161
2008/8/1,嘉義縣,溪口鄉,5279,16705,8935,7770
2008/8/1,嘉義縣,新港鄉,10114,35237,18606,16631
2008/8/1,嘉義縣,六腳鄉,8991,26987,14334,12653
2008/8/1,嘉義縣,東石鄉,9175,28353,15148,13205
2008/8/1,嘉義縣,義竹鄉,7348,21701,11306,10395
2008/8/1,嘉義縣,鹿草鄉,5595,17411,9357,8054
2008/8/1,嘉義縣,水上鄉,17200,53192,27675,25517
2008/8/1,嘉義縣,中埔鄉,14684,47786,25060,22726
2008/8/1,嘉義縣,竹崎鄉,11130,39338,21001,18337
2008/8/1,嘉義縣,梅山鄉,6432,22199,11778,10421
2008/8/1,嘉義縣,番路鄉,3811,11613,6353,5260
2008/8/1,嘉義縣,大埔鄉,1884,4123,2219,1904
2008/8/1,嘉義縣,阿里山鄉,1953,6159,3311,2848
2008/8/1,臺南市,新營區,26339,78862,39581,39281
2008/8/1,臺南市,永康區,71248,211828,105878,105950
2008/8/1,臺南市,鹽水區,9702,27688,14432,13256
2008/8/1,臺南市,白河區,10769,32010,16924,15086
2008/8/1,臺南市,麻豆區,14462,46287,23748,22539
2008/8/1,臺南市,佳里區,18591,59283,29617,29666
2008/8/1,臺南市,新化區,13245,44542,22899,21643
2008/8/1,臺南市,善化區,13815,42987,21893,21094
2008/8/1,臺南市,學甲區,9210,28403,14603,13800
2008/8/1,臺南市,柳營區,7618,23093,12096,10997
2008/8/1,臺南市,後壁區,8543,26333,13758,12575
2008/8/1,臺南市,東山區,8074,23602,12655,10947
2008/8/1,臺南市,下營區,8908,26639,13830,12809
2008/8/1,臺南市,六甲區,7458,24302,12668,11634
2008/8/1,臺南市,官田區,7480,22518,11603,10915
2008/8/1,臺南市,大內區,4024,11247,6025,5222
2008/8/1,臺南市,西港區,7614,25477,13045,12432
2008/8/1,臺南市,七股區,7783,25269,13249,12020
2008/8/1,臺南市,將軍區,7275,21887,11205,10682
2008/8/1,臺南市,北門區,4183,12460,6412,6048
2008/8/1,臺南市,新市區,10500,35365,17834,17531
2008/8/1,臺南市,安定區,8864,30057,15605,14452
2008/8/1,臺南市,山上區,2704,8046,4259,3787
2008/8/1,臺南市,玉井區,5006,15730,8187,7543
2008/8/1,臺南市,楠西區,3599,10955,5830,5125
2008/8/1,臺南市,南化區,2808,8943,4924,4019
2008/8/1,臺南市,左鎮區,1949,5584,3110,2474
2008/8/1,臺南市,仁德區,23427,68151,35224,32927
2008/8/1,臺南市,歸仁區,19673,65661,33539,32122
2008/8/1,臺南市,關廟區,10473,36790,19138,17652
2008/8/1,臺南市,龍崎區,1572,4438,2421,2017
2008/8/1,高雄市,鳳山區,122499,339089,169809,169280
2008/8/1,高雄市,岡山區,32161,96499,48754,47745
2008/8/1,高雄市,旗山區,13565,40923,21410,19513
2008/8/1,高雄市,美濃區,13720,43830,22974,20856
2008/8/1,高雄市,林園區,23438,71115,36719,34396
2008/8/1,高雄市,大寮區,36837,109112,57059,52053
2008/8/1,高雄市,大樹區,12875,44635,23171,21464
2008/8/1,高雄市,仁武區,23681,68529,35488,33041
2008/8/1,高雄市,大社區,11344,32753,16917,15836
2008/8/1,高雄市,鳥松區,15744,41499,21167,20332
2008/8/1,高雄市,橋頭區,12255,36524,18845,17679
2008/8/1,高雄市,燕巢區,9710,31271,16754,14517
2008/8/1,高雄市,田寮區,3563,8487,4740,3747
2008/8/1,高雄市,阿蓮區,8941,30789,15579,15210
2008/8/1,高雄市,路竹區,15522,54365,27834,26531
2008/8/1,高雄市,湖內區,9167,28608,14821,13787
2008/8/1,高雄市,茄萣區,9955,31794,16676,15118
2008/8/1,高雄市,永安區,5664,14109,7268,6841
2008/8/1,高雄市,彌陀區,6424,20693,10837,9856
2008/8/1,高雄市,梓官區,11608,37036,19420,17616
2008/8/1,高雄市,六龜區,5681,15522,8439,7083
2008/8/1,高雄市,甲仙區,2562,8135,4380,3755
2008/8/1,高雄市,杉林區,4000,11237,6164,5073
2008/8/1,高雄市,內門區,4978,16333,8953,7380
2008/8/1,高雄市,茂林區,526,1760,903,857
2008/8/1,高雄市,桃源區,1230,4746,2545,2201
2008/8/1,高雄市,那瑪夏區,879,3473,1832,1641
2008/8/1,屏東縣,屏東市,71365,215573,107930,107643
2008/8/1,屏東縣,潮州鎮,17693,56873,28745,28128
2008/8/1,屏東縣,東港鎮,14794,50543,25785,24758
2008/8/1,屏東縣,恆春鎮,10366,31182,16155,15027
2008/8/1,屏東縣,萬丹鄉,13873,54516,28268,26248
2008/8/1,屏東縣,長治鄉,9545,30994,16292,14702
2008/8/1,屏東縣,麟洛鄉,3466,11613,6030,5583
2008/8/1,屏東縣,九如鄉,6419,23153,12067,11086
2008/8/1,屏東縣,里港鄉,7783,26408,13575,12833
2008/8/1,屏東縣,鹽埔鄉,7534,27569,14392,13177
2008/8/1,屏東縣,高樹鄉,9526,27326,14626,12700
2008/8/1,屏東縣,萬巒鄉,6305,22563,11927,10636
2008/8/1,屏東縣,內埔鄉,17340,59271,30989,28282
2008/8/1,屏東縣,竹田鄉,5387,18470,9860,8610
2008/8/1,屏東縣,新埤鄉,3294,10901,5790,5111
2008/8/1,屏東縣,枋寮鄉,8274,27240,14480,12760
2008/8/1,屏東縣,新園鄉,10894,39210,20300,18910
2008/8/1,屏東縣,崁頂鄉,3993,17029,8784,8245
2008/8/1,屏東縣,林邊鄉,6188,21120,10957,10163
2008/8/1,屏東縣,南州鄉,3577,12028,6188,5840
2008/8/1,屏東縣,佳冬鄉,6599,21652,11334,10318
2008/8/1,屏東縣,琉球鄉,3784,12566,6960,5606
2008/8/1,屏東縣,車城鄉,3399,9988,5390,4598
2008/8/1,屏東縣,滿州鄉,2982,8547,4708,3839
2008/8/1,屏東縣,枋山鄉,2104,6175,3316,2859
2008/8/1,屏東縣,三地門鄉,2031,7225,3715,3510
2008/8/1,屏東縣,霧臺鄉,868,2699,1447,1252
2008/8/1,屏東縣,瑪家鄉,1804,6427,3358,3069
2008/8/1,屏東縣,泰武鄉,1108,4900,2623,2277
2008/8/1,屏東縣,來義鄉,2068,7677,3978,3699
2008/8/1,屏東縣,春日鄉,1283,4952,2589,2363
2008/8/1,屏東縣,獅子鄉,1430,4941,2625,2316
2008/8/1,屏東縣,牡丹鄉,1784,4862,2541,2321
2008/8/1,臺東縣,臺東市,37217,109945,56058,53887
2008/8/1,臺東縣,成功鎮,5351,16282,8721,7561
2008/8/1,臺東縣,關山鎮,3207,9930,5249,4681
2008/8/1,臺東縣,卑南鄉,6418,18273,9989,8284
2008/8/1,臺東縣,大武鄉,2445,6970,3671,3299
2008/8/1,臺東縣,太麻里鄉,4496,12134,6526,5608
2008/8/1,臺東縣,東河鄉,3460,9549,5327,4222
2008/8/1,臺東縣,長濱鄉,2872,8695,4962,3733
2008/8/1,臺東縣,鹿野鄉,3089,8767,4763,4004
2008/8/1,臺東縣,池上鄉,3202,9403,5015,4388
2008/8/1,臺東縣,綠島鄉,938,3166,1700,1466
2008/8/1,臺東縣,延平鄉,1062,3589,2004,1585
2008/8/1,臺東縣,海端鄉,1078,4539,2474,2065
2008/8/1,臺東縣,達仁鄉,1397,3719,2067,1652
2008/8/1,臺東縣,金峰鄉,972,3310,1743,1567
2008/8/1,臺東縣,蘭嶼鄉,1234,3987,2109,1878
2008/8/1,花蓮縣,花蓮市,39707,110214,54309,55905
2008/8/1,花蓮縣,鳳林鎮,4405,12356,6586,5770
2008/8/1,花蓮縣,玉里鎮,8831,27802,15159,12643
2008/8/1,花蓮縣,新城鄉,7117,20289,10615,9674
2008/8/1,花蓮縣,吉安鄉,27780,78915,40698,38217
2008/8/1,花蓮縣,壽豐鄉,6715,19174,10411,8763
2008/8/1,花蓮縣,光復鄉,4972,14485,7775,6710
2008/8/1,花蓮縣,豐濱鄉,1806,5219,2910,2309
2008/8/1,花蓮縣,瑞穗鄉,4574,13235,7188,6047
2008/8/1,花蓮縣,富里鄉,3912,11911,6586,5325
2008/8/1,花蓮縣,秀林鄉,4479,14890,7821,7069
2008/8/1,花蓮縣,萬榮鄉,2131,7038,3766,3272
2008/8/1,花蓮縣,卓溪鄉,1620,6475,3594,2881
2008/8/1,澎湖縣,馬公市,18181,54939,27987,26952
2008/8/1,澎湖縣,湖西鄉,4366,12910,6771,6139
2008/8/1,澎湖縣,白沙鄉,2974,9163,4838,4325
2008/8/1,澎湖縣,西嶼鄉,2682,8165,4230,3935
2008/8/1,澎湖縣,望安鄉,1717,4446,2384,2062
2008/8/1,澎湖縣,七美鄉,1131,3284,1728,1556
2008/8/1,基隆市,中正區,21727,57006,29413,27593
2008/8/1,基隆市,七堵區,19221,55171,28071,27100
2008/8/1,基隆市,暖暖區,14093,38258,19521,18737
2008/8/1,基隆市,仁愛區,19218,50546,25104,25442
2008/8/1,基隆市,中山區,18657,51861,26601,25260
2008/8/1,基隆市,安樂區,31146,85234,42592,42642
2008/8/1,基隆市,信義區,19522,51058,25698,25360
2008/8/1,新竹市,東區,64086,191816,95000,96816
2008/8/1,新竹市,北區,47212,140797,70236,70561
2008/8/1,新竹市,香山區,21368,70659,36203,34456
2008/8/1,臺中市,中區,8541,24044,11856,12188
2008/8/1,臺中市,東區,25094,73906,37536,36370
2008/8/1,臺中市,西區,41965,117439,56687,60752
2008/8/1,臺中市,南區,39919,110960,54115,56845
2008/8/1,臺中市,北區,54048,147902,72033,75869
2008/8/1,臺中市,西屯區,68832,200692,97953,102739
2008/8/1,臺中市,南屯區,49668,147401,71357,76044
2008/8/1,臺中市,北屯區,79339,241085,117577,123508
2008/8/1,嘉義市,東區,44000,128781,63099,65682
2008/8/1,嘉義市,西區,48636,145293,72338,72955
2008/8/1,臺南市,東區,69097,194279,94531,99748
2008/8/1,臺南市,南區,42130,127530,64202,63328
2008/8/1,臺南市,北區,45998,129447,64240,65207
2008/8/1,臺南市,安南區,51842,175285,89515,85770
2008/8/1,臺南市,安平區,21724,60212,28922,31290
2008/8/1,臺南市,中西區,29704,80840,39882,40958
2008/8/1,臺北市,松山區,76673,210775,100094,110681
2008/8/1,臺北市,信義區,84817,228105,110680,117425
2008/8/1,臺北市,大安區,114965,314612,148958,165654
2008/8/1,臺北市,中山區,88212,218556,103635,114921
2008/8/1,臺北市,中正區,60472,159510,77297,82213
2008/8/1,臺北市,大同區,45866,125470,62151,63319
2008/8/1,臺北市,萬華區,72695,191178,96253,94925
2008/8/1,臺北市,文山區,94242,261712,127590,134122
2008/8/1,臺北市,南港區,39918,113482,56325,57157
2008/8/1,臺北市,內湖區,92164,266411,129114,137297
2008/8/1,臺北市,士林區,97942,286494,139903,146591
2008/8/1,臺北市,北投區,86851,249809,121790,128019
2008/8/1,高雄市,鹽埕區,11249,28322,14342,13980
2008/8/1,高雄市,鼓山區,47932,124286,61536,62750
2008/8/1,高雄市,左營區,71043,187719,93190,94529
2008/8/1,高雄市,楠梓區,59519,169985,84822,85163
2008/8/1,高雄市,三民區,128131,356448,175541,180907
2008/8/1,高雄市,新興區,22850,57014,27974,29040
2008/8/1,高雄市,前金區,12431,29731,14585,15146
2008/8/1,高雄市,苓雅區,70416,187319,91655,95664
2008/8/1,高雄市,前鎮區,74069,200688,100612,100076
2008/8/1,高雄市,旗津區,10654,29760,15560,14200
2008/8/1,高雄市,小港區,60108,152617,77199,75418
2008/8/1,金門縣,金城鎮,10098,28624,15105,13519
2008/8/1,金門縣,金湖鎮,6618,18565,9882,8683
2008/8/1,金門縣,金沙鎮,4976,13318,6983,6335
2008/8/1,金門縣,金寧鄉,5568,15252,8244,7008
2008/8/1,金門縣,烈嶼鄉,2347,7302,3844,3458
2008/8/1,金門縣,烏坵鄉,135,436,225,211
2008/8/1,連江縣,南竿鄉,1084,5868,3402,2466
2008/8/1,連江縣,北竿鄉,373,1785,1043,742
2008/8/1,連江縣,莒光鄉,233,1189,696,493
2008/8/1,連江縣,東引鄉,249,1013,602,411
2008/9/1,總計,臺灣地區,7598853,22914286,11567897,11346389
2008/9/1,總計,臺灣省,6070921,18767479,9539102,9228377
2008/9/1,總計,新北市,1335346,3821823,1908417,1913406
2008/9/1,總計,宜蘭縣,149245,461094,235913,225181
2008/9/1,總計,桃園市,633827,1952321,988831,963490
2008/9/1,總計,新竹縣,151763,501312,259127,242185
2008/9/1,總計,苗栗縣,165866,559959,292304,267655
2008/9/1,總計,臺中市,449096,1555418,790706,764712
2008/9/1,總計,彰化縣,352225,1312427,676223,636204
2008/9/1,總計,南投縣,166162,532074,275116,256958
2008/9/1,總計,雲林縣,222569,724334,380020,344314
2008/9/1,總計,嘉義縣,171005,548652,287469,261183
2008/9/1,總計,臺南市,357524,1104258,566005,538253
2008/9/1,總計,高雄市,419351,1242864,639363,603501
2008/9/1,總計,屏東縣,269221,885640,457356,428284
2008/9/1,總計,臺東縣,78594,232107,122258,109849
2008/9/1,總計,花蓮縣,118291,341843,177302,164541
2008/9/1,總計,澎湖縣,31141,92984,47963,45021
2008/9/1,總計,基隆市,144068,389087,196985,192102
2008/9/1,總計,新竹市,133185,403638,201654,201984
2008/9/1,總計,臺中市,368324,1063800,519282,544518
2008/9/1,總計,嘉義市,92935,274032,135414,138618
2008/9/1,總計,臺南市,261183,767812,381394,386418
2008/9/1,總計,臺北市,958008,2622933,1271922,1351011
2008/9/1,總計,高雄市,569924,1523874,756873,767001
2008/9/1,總計,福建省,31737,93451,50024,43427
2008/9/1,總計,金門縣,29785,83619,44299,39320
2008/9/1,總計,連江縣,1952,9832,5725,4107
2008/9/1,新北市,板橋區,186515,550008,273633,276375
2008/9/1,新北市,三重區,132914,384006,192484,191522
2008/9/1,新北市,永和區,88520,236558,114024,122534
2008/9/1,新北市,中和區,149103,410631,204096,206535
2008/9/1,新北市,新莊區,131189,397619,197296,200323
2008/9/1,新北市,新店區,112080,291472,143748,147724
2008/9/1,新北市,土城區,79300,237838,119399,118439
2008/9/1,新北市,蘆洲區,62430,193846,96336,97510
2008/9/1,新北市,汐止區,75109,182594,91270,91324
2008/9/1,新北市,樹林區,54463,167912,85004,82908
2008/9/1,新北市,鶯歌區,26206,86158,43897,42261
2008/9/1,新北市,三峽區,32020,97315,50105,47210
2008/9/1,新北市,淡水區,51258,134335,65886,68449
2008/9/1,新北市,瑞芳區,15543,43084,22076,21008
2008/9/1,新北市,五股區,25804,77560,39494,38066
2008/9/1,新北市,泰山區,25219,75454,38172,37282
2008/9/1,新北市,林口區,24780,71713,35727,35986
2008/9/1,新北市,深坑區,8376,22767,11578,11189
2008/9/1,新北市,石碇區,3181,7839,4358,3481
2008/9/1,新北市,坪林區,2370,6519,3656,2863
2008/9/1,新北市,三芝區,8646,23582,12257,11325
2008/9/1,新北市,石門區,3712,11909,6344,5565
2008/9/1,新北市,八里區,11310,33059,16949,16110
2008/9/1,新北市,平溪區,2336,5534,3100,2434
2008/9/1,新北市,雙溪區,3797,9874,5334,4540
2008/9/1,新北市,貢寮區,4328,13941,7257,6684
2008/9/1,新北市,金山區,6500,22256,11328,10928
2008/9/1,新北市,萬里區,6679,20911,10777,10134
2008/9/1,新北市,烏來區,1658,5529,2832,2697
2008/9/1,宜蘭縣,宜蘭市,32284,95893,47396,48497
2008/9/1,宜蘭縣,羅東鎮,24368,74006,35615,38391
2008/9/1,宜蘭縣,蘇澳鎮,13309,43746,22575,21171
2008/9/1,宜蘭縣,頭城鎮,9401,31405,16288,15117
2008/9/1,宜蘭縣,礁溪鄉,11966,35915,18896,17019
2008/9/1,宜蘭縣,壯圍鄉,7862,25104,13283,11821
2008/9/1,宜蘭縣,員山鄉,10441,32271,17355,14916
2008/9/1,宜蘭縣,冬山鄉,16534,51571,26701,24870
2008/9/1,宜蘭縣,五結鄉,12413,38288,19959,18329
2008/9/1,宜蘭縣,三星鄉,7162,21249,11534,9715
2008/9/1,宜蘭縣,大同鄉,1784,5801,3204,2597
2008/9/1,宜蘭縣,南澳鄉,1721,5845,3107,2738
2008/9/1,桃園市,桃園區,135915,395792,194499,201293
2008/9/1,桃園市,中壢區,119525,361412,181325,180087
2008/9/1,桃園市,平鎮區,63023,204678,103414,101264
2008/9/1,桃園市,八德區,54308,173038,88671,84367
2008/9/1,桃園市,大溪區,28060,90890,46984,43906
2008/9/1,桃園市,楊梅區,45189,144692,74001,70691
2008/9/1,桃園市,蘆竹區,44552,134878,67985,66893
2008/9/1,桃園市,大園區,24423,80013,41722,38291
2008/9/1,桃園市,龜山區,47072,133225,67983,65242
2008/9/1,桃園市,龍潭區,35266,113446,57943,55503
2008/9/1,桃園市,新屋區,14543,49666,26571,23095
2008/9/1,桃園市,觀音區,18340,60135,31858,28277
2008/9/1,桃園市,復興區,3611,10456,5875,4581
2008/9/1,新竹縣,竹北市,42005,130736,65875,64861
2008/9/1,新竹縣,關西鎮,8958,32507,17371,15136
2008/9/1,新竹縣,新埔鎮,10044,36083,19157,16926
2008/9/1,新竹縣,竹東鎮,29397,96941,49004,47937
2008/9/1,新竹縣,湖口鄉,22443,74837,38349,36488
2008/9/1,新竹縣,橫山鄉,4214,14562,7928,6634
2008/9/1,新竹縣,新豐鄉,14876,52237,27136,25101
2008/9/1,新竹縣,芎林鄉,6069,20810,10963,9847
2008/9/1,新竹縣,寶山鄉,4483,13698,7388,6310
2008/9/1,新竹縣,北埔鄉,3012,10270,5565,4705
2008/9/1,新竹縣,峨眉鄉,2009,6086,3387,2699
2008/9/1,新竹縣,尖石鄉,2598,8147,4499,3648
2008/9/1,新竹縣,五峰鄉,1655,4398,2505,1893
2008/9/1,苗栗縣,苗栗市,28268,91162,46169,44993
2008/9/1,苗栗縣,苑裡鎮,13407,48967,25642,23325
2008/9/1,苗栗縣,通霄鎮,11012,38835,20749,18086
2008/9/1,苗栗縣,竹南鎮,22407,76067,38817,37250
2008/9/1,苗栗縣,頭份市,27968,95413,48847,46566
2008/9/1,苗栗縣,後龍鎮,11449,40214,21336,18878
2008/9/1,苗栗縣,卓蘭鎮,5803,18353,9731,8622
2008/9/1,苗栗縣,大湖鄉,5196,16078,8688,7390
2008/9/1,苗栗縣,公館鄉,9759,34722,18274,16448
2008/9/1,苗栗縣,銅鑼鄉,5857,19670,10484,9186
2008/9/1,苗栗縣,南庄鄉,3853,11303,6276,5027
2008/9/1,苗栗縣,頭屋鄉,3455,11742,6226,5516
2008/9/1,苗栗縣,三義鄉,5126,17631,9362,8269
2008/9/1,苗栗縣,西湖鄉,2598,7904,4398,3506
2008/9/1,苗栗縣,造橋鄉,3887,13733,7287,6446
2008/9/1,苗栗縣,三灣鄉,2332,7430,4049,3381
2008/9/1,苗栗縣,獅潭鄉,1638,5061,2851,2210
2008/9/1,苗栗縣,泰安鄉,1851,5674,3118,2556
2008/9/1,臺中市,豐原區,47846,165199,82206,82993
2008/9/1,臺中市,大里區,58959,194103,96579,97524
2008/9/1,臺中市,太平區,52785,172042,86656,85386
2008/9/1,臺中市,東勢區,16623,54344,28290,26054
2008/9/1,臺中市,大甲區,21013,79026,40113,38913
2008/9/1,臺中市,清水區,24166,85834,44415,41419
2008/9/1,臺中市,沙鹿區,22069,79352,40477,38875
2008/9/1,臺中市,梧棲區,15438,54593,27780,26813
2008/9/1,臺中市,后里區,14301,54513,28194,26319
2008/9/1,臺中市,神岡區,17067,63999,33036,30963
2008/9/1,臺中市,潭子區,30832,98060,49199,48861
2008/9/1,臺中市,大雅區,25295,88654,44874,43780
2008/9/1,臺中市,新社區,7182,25767,13635,12132
2008/9/1,臺中市,石岡區,4710,16160,8435,7725
2008/9/1,臺中市,外埔區,8453,31904,16472,15432
2008/9/1,臺中市,大安區,5138,20595,10860,9735
2008/9/1,臺中市,烏日區,19435,67892,34521,33371
2008/9/1,臺中市,大肚區,15343,55975,28807,27168
2008/9/1,臺中市,龍井區,19613,72380,37100,35280
2008/9/1,臺中市,霧峰區,18369,64276,33141,31135
2008/9/1,臺中市,和平區,4459,10750,5916,4834
2008/9/1,彰化縣,彰化市,69555,236446,118344,118102
2008/9/1,彰化縣,鹿港鎮,21443,85266,43802,41464
2008/9/1,彰化縣,和美鎮,23196,89272,45902,43370
2008/9/1,彰化縣,北斗鎮,9593,33637,17123,16514
2008/9/1,彰化縣,員林市,35492,126037,63623,62414
2008/9/1,彰化縣,溪湖鎮,14643,56589,29047,27542
2008/9/1,彰化縣,田中鎮,12238,44842,23555,21287
2008/9/1,彰化縣,二林鎮,13959,54842,28343,26499
2008/9/1,彰化縣,線西鄉,3953,17002,8780,8222
2008/9/1,彰化縣,伸港鄉,8612,35772,18453,17319
2008/9/1,彰化縣,福興鄉,11630,48906,25626,23280
2008/9/1,彰化縣,秀水鄉,9340,38946,20193,18753
2008/9/1,彰化縣,花壇鄉,12443,46149,23867,22282
2008/9/1,彰化縣,芬園鄉,6793,25049,13336,11713
2008/9/1,彰化縣,大村鄉,9869,36374,19027,17347
2008/9/1,彰化縣,埔鹽鄉,8560,34602,18201,16401
2008/9/1,彰化縣,埔心鄉,9624,35465,18449,17016
2008/9/1,彰化縣,永靖鄉,10119,39626,20638,18988
2008/9/1,彰化縣,社頭鄉,12017,45279,23353,21926
2008/9/1,彰化縣,二水鄉,5224,16932,8963,7969
2008/9/1,彰化縣,田尾鄉,7509,28949,15120,13829
2008/9/1,彰化縣,埤頭鄉,8297,31978,16776,15202
2008/9/1,彰化縣,芳苑鄉,9843,36771,19509,17262
2008/9/1,彰化縣,大城鄉,5282,19080,10428,8652
2008/9/1,彰化縣,竹塘鄉,4489,16668,8835,7833
2008/9/1,彰化縣,溪州鄉,8502,31948,16930,15018
2008/9/1,南投縣,南投市,32440,105376,53205,52171
2008/9/1,南投縣,埔里鎮,27740,86303,43717,42586
2008/9/1,南投縣,草屯鎮,29962,100137,50779,49358
2008/9/1,南投縣,竹山鎮,18322,59015,30562,28453
2008/9/1,南投縣,集集鎮,4154,11995,6319,5676
2008/9/1,南投縣,名間鄉,11810,41570,21927,19643
2008/9/1,南投縣,鹿谷鄉,6397,19390,10355,9035
2008/9/1,南投縣,中寮鄉,5487,16443,8965,7478
2008/9/1,南投縣,魚池鄉,5693,17319,9211,8108
2008/9/1,南投縣,國姓鄉,7093,21220,11652,9568
2008/9/1,南投縣,水里鄉,7144,20675,10898,9777
2008/9/1,南投縣,信義鄉,5047,17186,9360,7826
2008/9/1,南投縣,仁愛鄉,4873,15445,8166,7279
2008/9/1,雲林縣,斗六市,33277,106094,53680,52414
2008/9/1,雲林縣,斗南鎮,14833,47634,24245,23389
2008/9/1,雲林縣,虎尾鎮,21489,69789,35613,34176
2008/9/1,雲林縣,西螺鎮,13705,49108,24988,24120
2008/9/1,雲林縣,土庫鎮,8492,30975,16253,14722
2008/9/1,雲林縣,北港鎮,14921,44125,23003,21122
2008/9/1,雲林縣,古坑鄉,10359,35006,18591,16415
2008/9/1,雲林縣,大埤鄉,6498,21696,11582,10114
2008/9/1,雲林縣,莿桐鄉,8777,30676,16102,14574
2008/9/1,雲林縣,林內鄉,5582,20282,10671,9611
2008/9/1,雲林縣,二崙鄉,8618,30330,16320,14010
2008/9/1,雲林縣,崙背鄉,8190,28032,14885,13147
2008/9/1,雲林縣,麥寮鄉,11541,33757,17990,15767
2008/9/1,雲林縣,東勢鄉,5647,17441,9504,7937
2008/9/1,雲林縣,褒忠鄉,4202,14616,7836,6780
2008/9/1,雲林縣,臺西鄉,8639,27189,14657,12532
2008/9/1,雲林縣,元長鄉,9155,29429,16101,13328
2008/9/1,雲林縣,四湖鄉,8918,27537,15118,12419
2008/9/1,雲林縣,口湖鄉,9450,31002,16611,14391
2008/9/1,雲林縣,水林鄉,10276,29616,16270,13346
2008/9/1,嘉義縣,太保市,10639,35829,18612,17217
2008/9/1,嘉義縣,朴子市,13834,44290,22721,21569
2008/9/1,嘉義縣,布袋鎮,9950,30954,15987,14967
2008/9/1,嘉義縣,大林鎮,10976,34144,17609,16535
2008/9/1,嘉義縣,民雄鄉,21867,72619,37465,35154
2008/9/1,嘉義縣,溪口鄉,5294,16712,8935,7777
2008/9/1,嘉義縣,新港鄉,10132,35211,18603,16608
2008/9/1,嘉義縣,六腳鄉,9002,26980,14336,12644
2008/9/1,嘉義縣,東石鄉,9177,28349,15138,13211
2008/9/1,嘉義縣,義竹鄉,7354,21679,11286,10393
2008/9/1,嘉義縣,鹿草鄉,5596,17429,9373,8056
2008/9/1,嘉義縣,水上鄉,17207,53169,27652,25517
2008/9/1,嘉義縣,中埔鄉,14723,47831,25092,22739
2008/9/1,嘉義縣,竹崎鄉,11153,39326,20971,18355
2008/9/1,嘉義縣,梅山鄉,6440,22184,11779,10405
2008/9/1,嘉義縣,番路鄉,3812,11643,6370,5273
2008/9/1,嘉義縣,大埔鄉,1891,4138,2220,1918
2008/9/1,嘉義縣,阿里山鄉,1958,6165,3320,2845
2008/9/1,臺南市,新營區,26394,78740,39515,39225
2008/9/1,臺南市,永康區,71447,212035,105978,106057
2008/9/1,臺南市,鹽水區,9706,27650,14415,13235
2008/9/1,臺南市,白河區,10776,31966,16882,15084
2008/9/1,臺南市,麻豆區,14499,46240,23719,22521
2008/9/1,臺南市,佳里區,18634,59310,29635,29675
2008/9/1,臺南市,新化區,13273,44536,22910,21626
2008/9/1,臺南市,善化區,13837,42995,21883,21112
2008/9/1,臺南市,學甲區,9208,28382,14589,13793
2008/9/1,臺南市,柳營區,7638,23109,12105,11004
2008/9/1,臺南市,後壁區,8557,26327,13756,12571
2008/9/1,臺南市,東山區,8081,23593,12644,10949
2008/9/1,臺南市,下營區,8917,26624,13825,12799
2008/9/1,臺南市,六甲區,7453,24259,12644,11615
2008/9/1,臺南市,官田區,7490,22527,11616,10911
2008/9/1,臺南市,大內區,4034,11247,6023,5224
2008/9/1,臺南市,西港區,7617,25440,13022,12418
2008/9/1,臺南市,七股區,7781,25227,13235,11992
2008/9/1,臺南市,將軍區,7281,21862,11193,10669
2008/9/1,臺南市,北門區,4187,12483,6411,6072
2008/9/1,臺南市,新市區,10522,35357,17816,17541
2008/9/1,臺南市,安定區,8886,30069,15618,14451
2008/9/1,臺南市,山上區,2701,8040,4253,3787
2008/9/1,臺南市,玉井區,5014,15733,8183,7550
2008/9/1,臺南市,楠西區,3590,10915,5813,5102
2008/9/1,臺南市,南化區,2807,8950,4920,4030
2008/9/1,臺南市,左鎮區,1949,5586,3118,2468
2008/9/1,臺南市,仁德區,23496,68192,35219,32973
2008/9/1,臺南市,歸仁區,19689,65664,33526,32138
2008/9/1,臺南市,關廟區,10483,36758,19118,17640
2008/9/1,臺南市,龍崎區,1577,4442,2421,2021
2008/9/1,高雄市,鳳山區,122819,339271,169898,169373
2008/9/1,高雄市,岡山區,32217,96501,48752,47749
2008/9/1,高雄市,旗山區,13582,40843,21377,19466
2008/9/1,高雄市,美濃區,13725,43798,22956,20842
2008/9/1,高雄市,林園區,23470,71081,36684,34397
2008/9/1,高雄市,大寮區,36927,109175,57087,52088
2008/9/1,高雄市,大樹區,12882,44625,23151,21474
2008/9/1,高雄市,仁武區,23798,68706,35568,33138
2008/9/1,高雄市,大社區,11361,32726,16903,15823
2008/9/1,高雄市,鳥松區,15811,41560,21206,20354
2008/9/1,高雄市,橋頭區,12267,36474,18818,17656
2008/9/1,高雄市,燕巢區,9727,31258,16740,14518
2008/9/1,高雄市,田寮區,3565,8462,4716,3746
2008/9/1,高雄市,阿蓮區,8941,30754,15545,15209
2008/9/1,高雄市,路竹區,15551,54346,27836,26510
2008/9/1,高雄市,湖內區,9184,28586,14800,13786
2008/9/1,高雄市,茄萣區,9950,31771,16663,15108
2008/9/1,高雄市,永安區,5664,14102,7257,6845
2008/9/1,高雄市,彌陀區,6433,20680,10830,9850
2008/9/1,高雄市,梓官區,11618,36992,19383,17609
2008/9/1,高雄市,六龜區,5679,15506,8435,7071
2008/9/1,高雄市,甲仙區,2556,8103,4361,3742
2008/9/1,高雄市,杉林區,4006,11228,6165,5063
2008/9/1,高雄市,內門區,4977,16338,8949,7389
2008/9/1,高雄市,茂林區,527,1763,908,855
2008/9/1,高雄市,桃源區,1232,4738,2544,2194
2008/9/1,高雄市,那瑪夏區,882,3477,1831,1646
2008/9/1,屏東縣,屏東市,71506,215409,107794,107615
2008/9/1,屏東縣,潮州鎮,17749,56847,28719,28128
2008/9/1,屏東縣,東港鎮,14828,50514,25750,24764
2008/9/1,屏東縣,恆春鎮,10371,31162,16139,15023
2008/9/1,屏東縣,萬丹鄉,13887,54499,28263,26236
2008/9/1,屏東縣,長治鄉,9552,30975,16288,14687
2008/9/1,屏東縣,麟洛鄉,3469,11587,6024,5563
2008/9/1,屏東縣,九如鄉,6421,23152,12071,11081
2008/9/1,屏東縣,里港鄉,7790,26392,13563,12829
2008/9/1,屏東縣,鹽埔鄉,7533,27563,14385,13178
2008/9/1,屏東縣,高樹鄉,9514,27277,14611,12666
2008/9/1,屏東縣,萬巒鄉,6303,22523,11903,10620
2008/9/1,屏東縣,內埔鄉,17368,59207,30946,28261
2008/9/1,屏東縣,竹田鄉,5389,18472,9864,8608
2008/9/1,屏東縣,新埤鄉,3299,10900,5781,5119
2008/9/1,屏東縣,枋寮鄉,8282,27224,14465,12759
2008/9/1,屏東縣,新園鄉,10908,39161,20282,18879
2008/9/1,屏東縣,崁頂鄉,4003,17101,8809,8292
2008/9/1,屏東縣,林邊鄉,6194,21080,10932,10148
2008/9/1,屏東縣,南州鄉,3578,12020,6190,5830
2008/9/1,屏東縣,佳冬鄉,6602,21651,11334,10317
2008/9/1,屏東縣,琉球鄉,3791,12561,6959,5602
2008/9/1,屏東縣,車城鄉,3403,9972,5384,4588
2008/9/1,屏東縣,滿州鄉,2983,8536,4705,3831
2008/9/1,屏東縣,枋山鄉,2102,6166,3316,2850
2008/9/1,屏東縣,三地門鄉,2031,7251,3730,3521
2008/9/1,屏東縣,霧臺鄉,871,2687,1437,1250
2008/9/1,屏東縣,瑪家鄉,1803,6431,3365,3066
2008/9/1,屏東縣,泰武鄉,1112,4896,2622,2274
2008/9/1,屏東縣,來義鄉,2075,7673,3978,3695
2008/9/1,屏東縣,春日鄉,1284,4942,2582,2360
2008/9/1,屏東縣,獅子鄉,1427,4949,2633,2316
2008/9/1,屏東縣,牡丹鄉,1793,4860,2532,2328
2008/9/1,臺東縣,臺東市,37298,109893,55991,53902
2008/9/1,臺東縣,成功鎮,5362,16236,8699,7537
2008/9/1,臺東縣,關山鎮,3195,9909,5237,4672
2008/9/1,臺東縣,卑南鄉,6430,18282,9995,8287
2008/9/1,臺東縣,大武鄉,2441,6942,3656,3286
2008/9/1,臺東縣,太麻里鄉,4498,12145,6530,5615
2008/9/1,臺東縣,東河鄉,3490,9562,5339,4223
2008/9/1,臺東縣,長濱鄉,2876,8644,4926,3718
2008/9/1,臺東縣,鹿野鄉,3092,8774,4769,4005
2008/9/1,臺東縣,池上鄉,3208,9400,5011,4389
2008/9/1,臺東縣,綠島鄉,940,3173,1709,1464
2008/9/1,臺東縣,延平鄉,1068,3579,1998,1581
2008/9/1,臺東縣,海端鄉,1082,4533,2474,2059
2008/9/1,臺東縣,達仁鄉,1399,3713,2062,1651
2008/9/1,臺東縣,金峰鄉,973,3311,1743,1568
2008/9/1,臺東縣,蘭嶼鄉,1242,4011,2119,1892
2008/9/1,花蓮縣,花蓮市,39810,110217,54306,55911
2008/9/1,花蓮縣,鳳林鎮,4414,12328,6570,5758
2008/9/1,花蓮縣,玉里鎮,8867,27785,15144,12641
2008/9/1,花蓮縣,新城鄉,7127,20298,10613,9685
2008/9/1,花蓮縣,吉安鄉,27843,78935,40700,38235
2008/9/1,花蓮縣,壽豐鄉,6724,19127,10377,8750
2008/9/1,花蓮縣,光復鄉,4972,14459,7763,6696
2008/9/1,花蓮縣,豐濱鄉,1804,5205,2905,2300
2008/9/1,花蓮縣,瑞穗鄉,4575,13206,7181,6025
2008/9/1,花蓮縣,富里鄉,3917,11888,6574,5314
2008/9/1,花蓮縣,秀林鄉,4482,14888,7813,7075
2008/9/1,花蓮縣,萬榮鄉,2129,7041,3768,3273
2008/9/1,花蓮縣,卓溪鄉,1627,6466,3588,2878
2008/9/1,澎湖縣,馬公市,18226,54951,27987,26964
2008/9/1,澎湖縣,湖西鄉,4385,12946,6782,6164
2008/9/1,澎湖縣,白沙鄉,2977,9177,4840,4337
2008/9/1,澎湖縣,西嶼鄉,2694,8164,4228,3936
2008/9/1,澎湖縣,望安鄉,1724,4462,2401,2061
2008/9/1,澎湖縣,七美鄉,1135,3284,1725,1559
2008/9/1,基隆市,中正區,21766,56956,29375,27581
2008/9/1,基隆市,七堵區,19316,55231,28105,27126
2008/9/1,基隆市,暖暖區,14152,38262,19506,18756
2008/9/1,基隆市,仁愛區,19306,50488,25098,25390
2008/9/1,基隆市,中山區,18703,51825,26572,25253
2008/9/1,基隆市,安樂區,31239,85181,42599,42582
2008/9/1,基隆市,信義區,19586,51144,25730,25414
2008/9/1,新竹市,東區,64282,191814,95052,96762
2008/9/1,新竹市,北區,47397,141040,70340,70700
2008/9/1,新竹市,香山區,21506,70784,36262,34522
2008/9/1,臺中市,中區,8534,23959,11808,12151
2008/9/1,臺中市,東區,25137,73929,37574,36355
2008/9/1,臺中市,西區,42034,117256,56600,60656
2008/9/1,臺中市,南區,40057,111148,54194,56954
2008/9/1,臺中市,北區,54151,147891,72002,75889
2008/9/1,臺中市,西屯區,69032,200835,98049,102786
2008/9/1,臺中市,南屯區,49854,147599,71459,76140
2008/9/1,臺中市,北屯區,79525,241183,117596,123587
2008/9/1,嘉義市,東區,44077,128557,62998,65559
2008/9/1,嘉義市,西區,48858,145475,72416,73059
2008/9/1,臺南市,東區,69225,194247,94530,99717
2008/9/1,臺南市,南區,42261,127501,64185,63316
2008/9/1,臺南市,北區,46147,129599,64298,65301
2008/9/1,臺南市,安南區,51968,175346,89537,85809
2008/9/1,臺南市,安平區,21855,60409,29015,31394
2008/9/1,臺南市,中西區,29727,80710,39829,40881
2008/9/1,臺北市,松山區,76730,210101,99743,110358
2008/9/1,臺北市,信義區,85059,227828,110509,117319
2008/9/1,臺北市,大安區,115238,313686,148397,165289
2008/9/1,臺北市,中山區,88677,218556,103626,114930
2008/9/1,臺北市,中正區,60642,159144,77099,82045
2008/9/1,臺北市,大同區,45956,125111,62018,63093
2008/9/1,臺北市,萬華區,72879,191035,96162,94873
2008/9/1,臺北市,文山區,94655,261641,127511,134130
2008/9/1,臺北市,南港區,40132,113575,56339,57236
2008/9/1,臺北市,內湖區,92679,266489,129136,137353
2008/9/1,臺北市,士林區,98211,286043,139702,146341
2008/9/1,臺北市,北投區,87150,249724,121680,128044
2008/9/1,高雄市,鹽埕區,11253,28273,14327,13946
2008/9/1,高雄市,鼓山區,48267,124681,61707,62974
2008/9/1,高雄市,左營區,71322,188069,93346,94723
2008/9/1,高雄市,楠梓區,59704,170157,84878,85279
2008/9/1,高雄市,三民區,128281,356031,175301,180730
2008/9/1,高雄市,新興區,22880,56923,27918,29005
2008/9/1,高雄市,前金區,12485,29724,14587,15137
2008/9/1,高雄市,苓雅區,70511,186985,91488,95497
2008/9/1,高雄市,前鎮區,74279,200571,100507,100064
2008/9/1,高雄市,旗津區,10677,29828,15577,14251
2008/9/1,高雄市,小港區,60265,152632,77237,75395
2008/9/1,金門縣,金城鎮,10113,28642,15109,13533
2008/9/1,金門縣,金湖鎮,6617,18571,9864,8707
2008/9/1,金門縣,金沙鎮,4988,13369,7005,6364
2008/9/1,金門縣,金寧鄉,5578,15273,8244,7029
2008/9/1,金門縣,烈嶼鄉,2354,7331,3853,3478
2008/9/1,金門縣,烏坵鄉,135,433,224,209
2008/9/1,連江縣,南竿鄉,1095,5855,3393,2462
2008/9/1,連江縣,北竿鄉,374,1775,1035,740
2008/9/1,連江縣,莒光鄉,233,1192,699,493
2008/9/1,連江縣,東引鄉,250,1010,598,412
2008/10/1,總計,臺灣地區,7606000,22922691,11570084,11352607
2008/10/1,總計,臺灣省,6077737,18775811,9541731,9234080
2008/10/1,總計,新北市,1336839,3825164,1909826,1915338
2008/10/1,總計,宜蘭縣,149351,461010,235878,225132
2008/10/1,總計,桃園市,634720,1954237,989631,964606
2008/10/1,總計,新竹縣,152137,502012,259428,242584
2008/10/1,總計,苗栗縣,166091,560167,292333,267834
2008/10/1,總計,臺中市,449764,1556176,791090,765086
2008/10/1,總計,彰化縣,352623,1312611,676213,636398
2008/10/1,總計,南投縣,166337,532034,275016,257018
2008/10/1,總計,雲林縣,222901,724311,379900,344411
2008/10/1,總計,嘉義縣,171184,548603,287400,261203
2008/10/1,總計,臺南市,357952,1104488,566003,538485
2008/10/1,總計,高雄市,419682,1243017,639290,603727
2008/10/1,總計,屏東縣,269327,885443,457194,428249
2008/10/1,總計,臺東縣,78661,232063,122208,109855
2008/10/1,總計,花蓮縣,118406,341792,177267,164525
2008/10/1,總計,澎湖縣,31204,93104,48039,45065
2008/10/1,總計,基隆市,144172,388976,196903,192073
2008/10/1,總計,新竹市,133386,404109,201827,202282
2008/10/1,總計,臺中市,368632,1064440,519449,544991
2008/10/1,總計,嘉義市,93018,274086,135437,138649
2008/10/1,總計,臺南市,261350,767968,381399,386569
2008/10/1,總計,臺北市,958065,2622539,1271456,1351083
2008/10/1,總計,高雄市,570198,1524341,756897,767444
2008/10/1,總計,福建省,31756,93566,50030,43536
2008/10/1,總計,金門縣,29804,83735,44316,39419
2008/10/1,總計,連江縣,1952,9831,5714,4117
2008/10/1,新北市,板橋區,186665,550204,273660,276544
2008/10/1,新北市,三重區,133060,384170,192589,191581
2008/10/1,新北市,永和區,88459,236546,113986,122560
2008/10/1,新北市,中和區,149289,411003,204271,206732
2008/10/1,新北市,新莊區,131299,397877,197405,200472
2008/10/1,新北市,新店區,112122,291871,143891,147980
2008/10/1,新北市,土城區,79377,238016,119477,118539
2008/10/1,新北市,蘆洲區,62518,194053,96435,97618
2008/10/1,新北市,汐止區,75208,182818,91338,91480
2008/10/1,新北市,樹林區,54578,168051,85094,82957
2008/10/1,新北市,鶯歌區,26239,86177,43909,42268
2008/10/1,新北市,三峽區,32132,97527,50205,47322
2008/10/1,新北市,淡水區,51393,134614,65976,68638
2008/10/1,新北市,瑞芳區,15545,43064,22078,20986
2008/10/1,新北市,五股區,25818,77537,39482,38055
2008/10/1,新北市,泰山區,25264,75614,38260,37354
2008/10/1,新北市,林口區,24941,72049,35901,36148
2008/10/1,新北市,深坑區,8373,22784,11583,11201
2008/10/1,新北市,石碇區,3180,7843,4365,3478
2008/10/1,新北市,坪林區,2370,6532,3666,2866
2008/10/1,新北市,三芝區,8639,23534,12226,11308
2008/10/1,新北市,石門區,3719,11943,6362,5581
2008/10/1,新北市,八里區,11327,33125,16979,16146
2008/10/1,新北市,平溪區,2338,5541,3097,2444
2008/10/1,新北市,雙溪區,3800,9876,5342,4534
2008/10/1,新北市,貢寮區,4326,13992,7275,6717
2008/10/1,新北市,金山區,6509,22291,11343,10948
2008/10/1,新北市,萬里區,6689,20962,10794,10168
2008/10/1,新北市,烏來區,1662,5550,2837,2713
2008/10/1,宜蘭縣,宜蘭市,32279,95902,47413,48489
2008/10/1,宜蘭縣,羅東鎮,24375,73938,35591,38347
2008/10/1,宜蘭縣,蘇澳鎮,13319,43707,22562,21145
2008/10/1,宜蘭縣,頭城鎮,9411,31358,16260,15098
2008/10/1,宜蘭縣,礁溪鄉,11980,35926,18901,17025
2008/10/1,宜蘭縣,壯圍鄉,7871,25077,13263,11814
2008/10/1,宜蘭縣,員山鄉,10454,32262,17353,14909
2008/10/1,宜蘭縣,冬山鄉,16554,51599,26708,24891
2008/10/1,宜蘭縣,五結鄉,12424,38334,19979,18355
2008/10/1,宜蘭縣,三星鄉,7172,21245,11537,9708
2008/10/1,宜蘭縣,大同鄉,1783,5803,3200,2603
2008/10/1,宜蘭縣,南澳鄉,1729,5859,3111,2748
2008/10/1,桃園市,桃園區,136002,396215,194745,201470
2008/10/1,桃園市,中壢區,119756,361729,181471,180258
2008/10/1,桃園市,平鎮區,63112,204775,103461,101314
2008/10/1,桃園市,八德區,54408,173107,88647,84460
2008/10/1,桃園市,大溪區,28103,90951,47011,43940
2008/10/1,桃園市,楊梅區,45278,144902,74094,70808
2008/10/1,桃園市,蘆竹區,44646,135135,68104,67031
2008/10/1,桃園市,大園區,24469,80152,41783,38369
2008/10/1,桃園市,龜山區,47104,133423,67993,65430
2008/10/1,桃園市,龍潭區,35308,113476,57960,55516
2008/10/1,桃園市,新屋區,14557,49681,26578,23103
2008/10/1,桃園市,觀音區,18365,60236,31899,28337
2008/10/1,桃園市,復興區,3612,10455,5885,4570
2008/10/1,新竹縣,竹北市,42183,131214,66113,65101
2008/10/1,新竹縣,關西鎮,8968,32487,17361,15126
2008/10/1,新竹縣,新埔鎮,10057,36083,19160,16923
2008/10/1,新竹縣,竹東鎮,29446,97025,49030,47995
2008/10/1,新竹縣,湖口鄉,22490,74940,38388,36552
2008/10/1,新竹縣,橫山鄉,4222,14578,7923,6655
2008/10/1,新竹縣,新豐鄉,14925,52279,27151,25128
2008/10/1,新竹縣,芎林鄉,6083,20823,10971,9852
2008/10/1,新竹縣,寶山鄉,4486,13691,7394,6297
2008/10/1,新竹縣,北埔鄉,3014,10267,5562,4705
2008/10/1,新竹縣,峨眉鄉,2006,6071,3371,2700
2008/10/1,新竹縣,尖石鄉,2599,8159,4506,3653
2008/10/1,新竹縣,五峰鄉,1658,4395,2498,1897
2008/10/1,苗栗縣,苗栗市,28289,91169,46147,45022
2008/10/1,苗栗縣,苑裡鎮,13433,49009,25672,23337
2008/10/1,苗栗縣,通霄鎮,11015,38821,20731,18090
2008/10/1,苗栗縣,竹南鎮,22470,76184,38852,37332
2008/10/1,苗栗縣,頭份市,28016,95505,48902,46603
2008/10/1,苗栗縣,後龍鎮,11454,40186,21297,18889
2008/10/1,苗栗縣,卓蘭鎮,5815,18386,9738,8648
2008/10/1,苗栗縣,大湖鄉,5187,16067,8687,7380
2008/10/1,苗栗縣,公館鄉,9772,34732,18282,16450
2008/10/1,苗栗縣,銅鑼鄉,5865,19658,10478,9180
2008/10/1,苗栗縣,南庄鄉,3856,11291,6266,5025
2008/10/1,苗栗縣,頭屋鄉,3456,11706,6214,5492
2008/10/1,苗栗縣,三義鄉,5129,17631,9357,8274
2008/10/1,苗栗縣,西湖鄉,2606,7904,4399,3505
2008/10/1,苗栗縣,造橋鄉,3897,13740,7292,6448
2008/10/1,苗栗縣,三灣鄉,2337,7425,4047,3378
2008/10/1,苗栗縣,獅潭鄉,1639,5047,2841,2206
2008/10/1,苗栗縣,泰安鄉,1855,5706,3131,2575
2008/10/1,臺中市,豐原區,47908,165242,82238,83004
2008/10/1,臺中市,大里區,59053,194228,96658,97570
2008/10/1,臺中市,太平區,52844,172085,86683,85402
2008/10/1,臺中市,東勢區,16626,54320,28268,26052
2008/10/1,臺中市,大甲區,21051,79015,40125,38890
2008/10/1,臺中市,清水區,24189,85808,44383,41425
2008/10/1,臺中市,沙鹿區,22125,79403,40494,38909
2008/10/1,臺中市,梧棲區,15481,54636,27815,26821
2008/10/1,臺中市,后里區,14331,54525,28208,26317
2008/10/1,臺中市,神岡區,17109,64084,33078,31006
2008/10/1,臺中市,潭子區,30881,98174,49252,48922
2008/10/1,臺中市,大雅區,25330,88749,44929,43820
2008/10/1,臺中市,新社區,7195,25793,13654,12139
2008/10/1,臺中市,石岡區,4725,16160,8441,7719
2008/10/1,臺中市,外埔區,8461,31917,16478,15439
2008/10/1,臺中市,大安區,5143,20594,10864,9730
2008/10/1,臺中市,烏日區,19465,67910,34520,33390
2008/10/1,臺中市,大肚區,15356,55943,28776,27167
2008/10/1,臺中市,龍井區,19652,72540,37174,35366
2008/10/1,臺中市,霧峰區,18378,64284,33131,31153
2008/10/1,臺中市,和平區,4461,10766,5921,4845
2008/10/1,彰化縣,彰化市,69629,236598,118399,118199
2008/10/1,彰化縣,鹿港鎮,21461,85287,43803,41484
2008/10/1,彰化縣,和美鎮,23225,89316,45930,43386
2008/10/1,彰化縣,北斗鎮,9608,33664,17131,16533
2008/10/1,彰化縣,員林市,35517,126023,63588,62435
2008/10/1,彰化縣,溪湖鎮,14668,56552,29008,27544
2008/10/1,彰化縣,田中鎮,12244,44789,23528,21261
2008/10/1,彰化縣,二林鎮,13986,54840,28351,26489
2008/10/1,彰化縣,線西鄉,3962,16998,8772,8226
2008/10/1,彰化縣,伸港鄉,8629,35759,18457,17302
2008/10/1,彰化縣,福興鄉,11635,48933,25628,23305
2008/10/1,彰化縣,秀水鄉,9363,38954,20202,18752
2008/10/1,彰化縣,花壇鄉,12465,46152,23866,22286
2008/10/1,彰化縣,芬園鄉,6795,25063,13325,11738
2008/10/1,彰化縣,大村鄉,9882,36389,19035,17354
2008/10/1,彰化縣,埔鹽鄉,8566,34608,18212,16396
2008/10/1,彰化縣,埔心鄉,9629,35459,18451,17008
2008/10/1,彰化縣,永靖鄉,10124,39614,20615,18999
2008/10/1,彰化縣,社頭鄉,12033,45259,23336,21923
2008/10/1,彰化縣,二水鄉,5228,16954,8970,7984
2008/10/1,彰化縣,田尾鄉,7502,28923,15115,13808
2008/10/1,彰化縣,埤頭鄉,8316,31993,16795,15198
2008/10/1,彰化縣,芳苑鄉,9852,36766,19514,17252
2008/10/1,彰化縣,大城鄉,5283,19075,10417,8658
2008/10/1,彰化縣,竹塘鄉,4500,16676,8832,7844
2008/10/1,彰化縣,溪州鄉,8521,31967,16933,15034
2008/10/1,南投縣,南投市,32456,105312,53170,52142
2008/10/1,南投縣,埔里鎮,27742,86302,43709,42593
2008/10/1,南投縣,草屯鎮,29993,100146,50776,49370
2008/10/1,南投縣,竹山鎮,18362,59040,30558,28482
2008/10/1,南投縣,集集鎮,4162,12012,6324,5688
2008/10/1,南投縣,名間鄉,11824,41572,21912,19660
2008/10/1,南投縣,鹿谷鄉,6413,19403,10351,9052
2008/10/1,南投縣,中寮鄉,5493,16435,8958,7477
2008/10/1,南投縣,魚池鄉,5705,17350,9227,8123
2008/10/1,南投縣,國姓鄉,7103,21216,11645,9571
2008/10/1,南投縣,水里鄉,7167,20638,10880,9758
2008/10/1,南投縣,信義鄉,5045,17174,9345,7829
2008/10/1,南投縣,仁愛鄉,4872,15434,8161,7273
2008/10/1,雲林縣,斗六市,33327,106117,53682,52435
2008/10/1,雲林縣,斗南鎮,14859,47636,24240,23396
2008/10/1,雲林縣,虎尾鎮,21530,69830,35630,34200
2008/10/1,雲林縣,西螺鎮,13725,49118,24983,24135
2008/10/1,雲林縣,土庫鎮,8508,30989,16253,14736
2008/10/1,雲林縣,北港鎮,14911,44031,22955,21076
2008/10/1,雲林縣,古坑鄉,10380,35000,18577,16423
2008/10/1,雲林縣,大埤鄉,6509,21699,11589,10110
2008/10/1,雲林縣,莿桐鄉,8804,30713,16116,14597
2008/10/1,雲林縣,林內鄉,5581,20275,10660,9615
2008/10/1,雲林縣,二崙鄉,8638,30315,16304,14011
2008/10/1,雲林縣,崙背鄉,8194,28015,14873,13142
2008/10/1,雲林縣,麥寮鄉,11579,33894,18037,15857
2008/10/1,雲林縣,東勢鄉,5654,17422,9498,7924
2008/10/1,雲林縣,褒忠鄉,4213,14621,7834,6787
2008/10/1,雲林縣,臺西鄉,8640,27118,14631,12487
2008/10/1,雲林縣,元長鄉,9173,29413,16081,13332
2008/10/1,雲林縣,四湖鄉,8910,27513,15104,12409
2008/10/1,雲林縣,口湖鄉,9482,31007,16602,14405
2008/10/1,雲林縣,水林鄉,10284,29585,16251,13334
2008/10/1,嘉義縣,太保市,10660,35872,18632,17240
2008/10/1,嘉義縣,朴子市,13837,44271,22700,21571
2008/10/1,嘉義縣,布袋鎮,9965,30907,15968,14939
2008/10/1,嘉義縣,大林鎮,10984,34133,17599,16534
2008/10/1,嘉義縣,民雄鄉,21893,72638,37464,35174
2008/10/1,嘉義縣,溪口鄉,5302,16684,8929,7755
2008/10/1,嘉義縣,新港鄉,10144,35217,18591,16626
2008/10/1,嘉義縣,六腳鄉,9020,27000,14349,12651
2008/10/1,嘉義縣,東石鄉,9186,28389,15154,13235
2008/10/1,嘉義縣,義竹鄉,7364,21658,11274,10384
2008/10/1,嘉義縣,鹿草鄉,5609,17428,9372,8056
2008/10/1,嘉義縣,水上鄉,17215,53160,27648,25512
2008/10/1,嘉義縣,中埔鄉,14732,47853,25093,22760
2008/10/1,嘉義縣,竹崎鄉,11143,39253,20931,18322
2008/10/1,嘉義縣,梅山鄉,6453,22192,11788,10404
2008/10/1,嘉義縣,番路鄉,3816,11622,6358,5264
2008/10/1,嘉義縣,大埔鄉,1895,4149,2223,1926
2008/10/1,嘉義縣,阿里山鄉,1966,6177,3327,2850
2008/10/1,臺南市,新營區,26430,78763,39511,39252
2008/10/1,臺南市,永康區,71574,212227,106050,106177
2008/10/1,臺南市,鹽水區,9706,27625,14393,13232
2008/10/1,臺南市,白河區,10789,31976,16893,15083
2008/10/1,臺南市,麻豆區,14498,46211,23696,22515
2008/10/1,臺南市,佳里區,18648,59343,29664,29679
2008/10/1,臺南市,新化區,13279,44516,22897,21619
2008/10/1,臺南市,善化區,13862,42981,21872,21109
2008/10/1,臺南市,學甲區,9213,28361,14556,13805
2008/10/1,臺南市,柳營區,7656,23130,12116,11014
2008/10/1,臺南市,後壁區,8560,26308,13752,12556
2008/10/1,臺南市,東山區,8090,23602,12643,10959
2008/10/1,臺南市,下營區,8934,26651,13835,12816
2008/10/1,臺南市,六甲區,7451,24249,12637,11612
2008/10/1,臺南市,官田區,7496,22537,11626,10911
2008/10/1,臺南市,大內區,4037,11250,6017,5233
2008/10/1,臺南市,西港區,7619,25411,13002,12409
2008/10/1,臺南市,七股區,7787,25225,13224,12001
2008/10/1,臺南市,將軍區,7289,21868,11180,10688
2008/10/1,臺南市,北門區,4194,12512,6426,6086
2008/10/1,臺南市,新市區,10523,35326,17809,17517
2008/10/1,臺南市,安定區,8905,30080,15624,14456
2008/10/1,臺南市,山上區,2703,8034,4251,3783
2008/10/1,臺南市,玉井區,5014,15701,8167,7534
2008/10/1,臺南市,楠西區,3596,10902,5805,5097
2008/10/1,臺南市,南化區,2812,8953,4916,4037
2008/10/1,臺南市,左鎮區,1954,5584,3114,2470
2008/10/1,臺南市,仁德區,23544,68265,35244,33021
2008/10/1,臺南市,歸仁區,19709,65690,33539,32151
2008/10/1,臺南市,關廟區,10499,36758,19117,17641
2008/10/1,臺南市,龍崎區,1581,4449,2427,2022
2008/10/1,高雄市,鳳山區,122836,339224,169895,169329
2008/10/1,高雄市,岡山區,32245,96562,48767,47795
2008/10/1,高雄市,旗山區,13585,40830,21354,19476
2008/10/1,高雄市,美濃區,13742,43785,22948,20837
2008/10/1,高雄市,林園區,23472,71042,36655,34387
2008/10/1,高雄市,大寮區,36994,109255,57108,52147
2008/10/1,高雄市,大樹區,12895,44636,23150,21486
2008/10/1,高雄市,仁武區,23832,68769,35592,33177
2008/10/1,高雄市,大社區,11372,32718,16894,15824
2008/10/1,高雄市,鳥松區,15839,41692,21274,20418
2008/10/1,高雄市,橋頭區,12268,36448,18811,17637
2008/10/1,高雄市,燕巢區,9739,31243,16712,14531
2008/10/1,高雄市,田寮區,3565,8456,4704,3752
2008/10/1,高雄市,阿蓮區,8952,30733,15534,15199
2008/10/1,高雄市,路竹區,15583,54358,27837,26521
2008/10/1,高雄市,湖內區,9184,28572,14785,13787
2008/10/1,高雄市,茄萣區,9961,31784,16667,15117
2008/10/1,高雄市,永安區,5675,14110,7254,6856
2008/10/1,高雄市,彌陀區,6448,20708,10833,9875
2008/10/1,高雄市,梓官區,11630,36976,19362,17614
2008/10/1,高雄市,六龜區,5681,15486,8425,7061
2008/10/1,高雄市,甲仙區,2557,8094,4355,3739
2008/10/1,高雄市,杉林區,4006,11224,6162,5062
2008/10/1,高雄市,內門區,4981,16329,8936,7393
2008/10/1,高雄市,茂林區,529,1771,908,863
2008/10/1,高雄市,桃源區,1233,4738,2544,2194
2008/10/1,高雄市,那瑪夏區,878,3474,1824,1650
2008/10/1,屏東縣,屏東市,71499,215239,107696,107543
2008/10/1,屏東縣,潮州鎮,17737,56791,28707,28084
2008/10/1,屏東縣,東港鎮,14857,50530,25743,24787
2008/10/1,屏東縣,恆春鎮,10379,31184,16145,15039
2008/10/1,屏東縣,萬丹鄉,13886,54488,28246,26242
2008/10/1,屏東縣,長治鄉,9537,30939,16270,14669
2008/10/1,屏東縣,麟洛鄉,3469,11592,6019,5573
2008/10/1,屏東縣,九如鄉,6430,23136,12067,11069
2008/10/1,屏東縣,里港鄉,7787,26373,13554,12819
2008/10/1,屏東縣,鹽埔鄉,7539,27575,14376,13199
2008/10/1,屏東縣,高樹鄉,9507,27297,14607,12690
2008/10/1,屏東縣,萬巒鄉,6302,22523,11904,10619
2008/10/1,屏東縣,內埔鄉,17391,59194,30949,28245
2008/10/1,屏東縣,竹田鄉,5393,18485,9871,8614
2008/10/1,屏東縣,新埤鄉,3301,10901,5776,5125
2008/10/1,屏東縣,枋寮鄉,8283,27154,14423,12731
2008/10/1,屏東縣,新園鄉,10918,39176,20305,18871
2008/10/1,屏東縣,崁頂鄉,4015,17149,8840,8309
2008/10/1,屏東縣,林邊鄉,6193,21076,10929,10147
2008/10/1,屏東縣,南州鄉,3581,12023,6193,5830
2008/10/1,屏東縣,佳冬鄉,6615,21666,11348,10318
2008/10/1,屏東縣,琉球鄉,3795,12558,6956,5602
2008/10/1,屏東縣,車城鄉,3413,9986,5384,4602
2008/10/1,屏東縣,滿州鄉,2988,8541,4701,3840
2008/10/1,屏東縣,枋山鄉,2097,6169,3316,2853
2008/10/1,屏東縣,三地門鄉,2036,7274,3738,3536
2008/10/1,屏東縣,霧臺鄉,872,2678,1432,1246
2008/10/1,屏東縣,瑪家鄉,1809,6425,3359,3066
2008/10/1,屏東縣,泰武鄉,1112,4905,2625,2280
2008/10/1,屏東縣,來義鄉,2078,7677,3981,3696
2008/10/1,屏東縣,春日鄉,1288,4945,2583,2362
2008/10/1,屏東縣,獅子鄉,1428,4949,2629,2320
2008/10/1,屏東縣,牡丹鄉,1792,4845,2522,2323
2008/10/1,臺東縣,臺東市,37331,109884,55968,53916
2008/10/1,臺東縣,成功鎮,5373,16212,8686,7526
2008/10/1,臺東縣,關山鎮,3191,9904,5231,4673
2008/10/1,臺東縣,卑南鄉,6435,18287,9986,8301
2008/10/1,臺東縣,大武鄉,2440,6935,3647,3288
2008/10/1,臺東縣,太麻里鄉,4496,12133,6539,5594
2008/10/1,臺東縣,東河鄉,3498,9552,5334,4218
2008/10/1,臺東縣,長濱鄉,2881,8628,4908,3720
2008/10/1,臺東縣,鹿野鄉,3085,8777,4765,4012
2008/10/1,臺東縣,池上鄉,3211,9395,5009,4386
2008/10/1,臺東縣,綠島鄉,937,3174,1714,1460
2008/10/1,臺東縣,延平鄉,1070,3578,1997,1581
2008/10/1,臺東縣,海端鄉,1083,4531,2476,2055
2008/10/1,臺東縣,達仁鄉,1405,3727,2073,1654
2008/10/1,臺東縣,金峰鄉,977,3306,1742,1564
2008/10/1,臺東縣,蘭嶼鄉,1248,4040,2133,1907
2008/10/1,花蓮縣,花蓮市,39849,110212,54293,55919
2008/10/1,花蓮縣,鳳林鎮,4405,12325,6561,5764
2008/10/1,花蓮縣,玉里鎮,8885,27767,15130,12637
2008/10/1,花蓮縣,新城鄉,7123,20311,10623,9688
2008/10/1,花蓮縣,吉安鄉,27904,78951,40735,38216
2008/10/1,花蓮縣,壽豐鄉,6714,19125,10374,8751
2008/10/1,花蓮縣,光復鄉,4973,14451,7757,6694
2008/10/1,花蓮縣,豐濱鄉,1808,5201,2905,2296
2008/10/1,花蓮縣,瑞穗鄉,4583,13224,7187,6037
2008/10/1,花蓮縣,富里鄉,3911,11853,6548,5305
2008/10/1,花蓮縣,秀林鄉,4487,14873,7798,7075
2008/10/1,花蓮縣,萬榮鄉,2133,7035,3763,3272
2008/10/1,花蓮縣,卓溪鄉,1631,6464,3593,2871
2008/10/1,澎湖縣,馬公市,18264,55013,28021,26992
2008/10/1,澎湖縣,湖西鄉,4396,12967,6794,6173
2008/10/1,澎湖縣,白沙鄉,2977,9190,4846,4344
2008/10/1,澎湖縣,西嶼鄉,2702,8164,4230,3934
2008/10/1,澎湖縣,望安鄉,1732,4485,2419,2066
2008/10/1,澎湖縣,七美鄉,1133,3285,1729,1556
2008/10/1,基隆市,中正區,21759,56911,29351,27560
2008/10/1,基隆市,七堵區,19343,55229,28100,27129
2008/10/1,基隆市,暖暖區,14159,38210,19490,18720
2008/10/1,基隆市,仁愛區,19330,50487,25106,25381
2008/10/1,基隆市,中山區,18713,51830,26579,25251
2008/10/1,基隆市,安樂區,31274,85186,42573,42613
2008/10/1,基隆市,信義區,19594,51123,25704,25419
2008/10/1,新竹市,東區,64356,192025,95122,96903
2008/10/1,新竹市,北區,47475,141208,70394,70814
2008/10/1,新竹市,香山區,21555,70876,36311,34565
2008/10/1,臺中市,中區,8507,23941,11796,12145
2008/10/1,臺中市,東區,25165,73904,37549,36355
2008/10/1,臺中市,西區,42038,117256,56569,60687
2008/10/1,臺中市,南區,40122,111307,54245,57062
2008/10/1,臺中市,北區,54119,147768,71945,75823
2008/10/1,臺中市,西屯區,69141,201011,98117,102894
2008/10/1,臺中市,南屯區,49950,147828,71533,76295
2008/10/1,臺中市,北屯區,79590,241425,117695,123730
2008/10/1,嘉義市,東區,44115,128573,62993,65580
2008/10/1,嘉義市,西區,48903,145513,72444,73069
2008/10/1,臺南市,東區,69242,194348,94520,99828
2008/10/1,臺南市,南區,42288,127489,64165,63324
2008/10/1,臺南市,北區,46190,129703,64344,65359
2008/10/1,臺南市,安南區,52017,175392,89565,85827
2008/10/1,臺南市,安平區,21877,60405,28994,31411
2008/10/1,臺南市,中西區,29736,80631,39811,40820
2008/10/1,臺北市,松山區,76683,210038,99706,110332
2008/10/1,臺北市,信義區,85035,227725,110455,117270
2008/10/1,臺北市,大安區,115169,313497,148263,165234
2008/10/1,臺北市,中山區,88709,218666,103673,114993
2008/10/1,臺北市,中正區,60660,159219,77090,82129
2008/10/1,臺北市,大同區,45959,124948,61908,63040
2008/10/1,臺北市,萬華區,72804,190639,95937,94702
2008/10/1,臺北市,文山區,94725,261755,127542,134213
2008/10/1,臺北市,南港區,40152,113611,56350,57261
2008/10/1,臺北市,內湖區,92731,266618,129171,137447
2008/10/1,臺北市,士林區,98232,286035,139683,146352
2008/10/1,臺北市,北投區,87206,249788,121678,128110
2008/10/1,高雄市,鹽埕區,11231,28181,14276,13905
2008/10/1,高雄市,鼓山區,48348,124938,61819,63119
2008/10/1,高雄市,左營區,71405,188304,93410,94894
2008/10/1,高雄市,楠梓區,59750,170281,84895,85386
2008/10/1,高雄市,三民區,128273,355942,175215,180727
2008/10/1,高雄市,新興區,22841,56843,27878,28965
2008/10/1,高雄市,前金區,12494,29721,14595,15126
2008/10/1,高雄市,苓雅區,70465,186945,91476,95469
2008/10/1,高雄市,前鎮區,74305,200566,100463,100103
2008/10/1,高雄市,旗津區,10708,29887,15593,14294
2008/10/1,高雄市,小港區,60378,152733,77277,75456
2008/10/1,金門縣,金城鎮,10101,28609,15081,13528
2008/10/1,金門縣,金湖鎮,6628,18542,9830,8712
2008/10/1,金門縣,金沙鎮,4992,13407,7025,6382
2008/10/1,金門縣,金寧鄉,5591,15406,8306,7100
2008/10/1,金門縣,烈嶼鄉,2357,7337,3849,3488
2008/10/1,金門縣,烏坵鄉,135,434,225,209
2008/10/1,連江縣,南竿鄉,1097,5855,3386,2469
2008/10/1,連江縣,北竿鄉,373,1778,1036,742
2008/10/1,連江縣,莒光鄉,231,1191,698,493
2008/10/1,連江縣,東引鄉,251,1007,594,413
2008/11/1,總計,臺灣地區,7619863,22933757,11573870,11359887
2008/11/1,總計,臺灣省,6090151,18786636,9545806,9240830
2008/11/1,總計,新北市,1339281,3829368,1911499,1917869
2008/11/1,總計,宜蘭縣,149652,461043,235904,225139
2008/11/1,總計,桃園市,636380,1956516,990632,965884
2008/11/1,總計,新竹縣,152595,502625,259725,242900
2008/11/1,總計,苗栗縣,166565,560397,292378,268019
2008/11/1,總計,臺中市,450917,1557301,791565,765736
2008/11/1,總計,彰化縣,353461,1312948,676304,636644
2008/11/1,總計,南投縣,166712,532059,275025,257034
2008/11/1,總計,雲林縣,223376,724238,379762,344476
2008/11/1,總計,嘉義縣,171529,548612,287344,261268
2008/11/1,總計,臺南市,358723,1104654,565994,538660
2008/11/1,總計,高雄市,420449,1243347,639342,604005
2008/11/1,總計,屏東縣,269721,885316,457089,428227
2008/11/1,總計,臺東縣,78781,232055,122156,109899
2008/11/1,總計,花蓮縣,118532,341709,177236,164473
2008/11/1,總計,澎湖縣,31291,93181,48063,45118
2008/11/1,總計,基隆市,144285,389035,196917,192118
2008/11/1,總計,新竹市,133752,404723,202114,202609
2008/11/1,總計,臺中市,369236,1065093,519820,545273
2008/11/1,總計,嘉義市,93178,274064,135418,138646
2008/11/1,總計,臺南市,261735,768352,381519,386833
2008/11/1,總計,臺北市,958604,2622125,1270978,1351147
2008/11/1,總計,高雄市,571108,1524996,757086,767910
2008/11/1,總計,福建省,31859,93915,50143,43772
2008/11/1,總計,金門縣,29902,84108,44456,39652
2008/11/1,總計,連江縣,1957,9807,5687,4120
2008/11/1,新北市,板橋區,186878,550538,273756,276782
2008/11/1,新北市,三重區,133312,384476,192699,191777
2008/11/1,新北市,永和區,88518,236578,113979,122599
2008/11/1,新北市,中和區,149529,411419,204447,206972
2008/11/1,新北市,新莊區,131513,398178,197478,200700
2008/11/1,新北市,新店區,112239,292220,143992,148228
2008/11/1,新北市,土城區,79478,238103,119535,118568
2008/11/1,新北市,蘆洲區,62648,194357,96553,97804
2008/11/1,新北市,汐止區,75380,183106,91416,91690
2008/11/1,新北市,樹林區,54754,168346,85258,83088
2008/11/1,新北市,鶯歌區,26302,86215,43912,42303
2008/11/1,新北市,三峽區,32259,97769,50305,47464
2008/11/1,新北市,淡水區,51575,134956,66142,68814
2008/11/1,新北市,瑞芳區,15574,43097,22105,20992
2008/11/1,新北市,五股區,25861,77666,39552,38114
2008/11/1,新北市,泰山區,25319,75774,38324,37450
2008/11/1,新北市,林口區,25137,72452,36090,36362
2008/11/1,新北市,深坑區,8384,22852,11613,11239
2008/11/1,新北市,石碇區,3184,7846,4376,3470
2008/11/1,新北市,坪林區,2379,6539,3668,2871
2008/11/1,新北市,三芝區,8639,23500,12215,11285
2008/11/1,新北市,石門區,3731,11959,6374,5585
2008/11/1,新北市,八里區,11328,33157,17004,16153
2008/11/1,新北市,平溪區,2335,5535,3088,2447
2008/11/1,新北市,雙溪區,3810,9872,5349,4523
2008/11/1,新北市,貢寮區,4327,13980,7266,6714
2008/11/1,新北市,金山區,6520,22300,11344,10956
2008/11/1,新北市,萬里區,6703,21003,10806,10197
2008/11/1,新北市,烏來區,1665,5575,2853,2722
2008/11/1,宜蘭縣,宜蘭市,32339,95912,47407,48505
2008/11/1,宜蘭縣,羅東鎮,24397,73821,35539,38282
2008/11/1,宜蘭縣,蘇澳鎮,13352,43718,22566,21152
2008/11/1,宜蘭縣,頭城鎮,9436,31328,16252,15076
2008/11/1,宜蘭縣,礁溪鄉,12020,35941,18909,17032
2008/11/1,宜蘭縣,壯圍鄉,7880,25075,13262,11813
2008/11/1,宜蘭縣,員山鄉,10474,32258,17350,14908
2008/11/1,宜蘭縣,冬山鄉,16598,51653,26752,24901
2008/11/1,宜蘭縣,五結鄉,12451,38407,20027,18380
2008/11/1,宜蘭縣,三星鄉,7190,21268,11544,9724
2008/11/1,宜蘭縣,大同鄉,1784,5810,3197,2613
2008/11/1,宜蘭縣,南澳鄉,1731,5852,3099,2753
2008/11/1,桃園市,桃園區,136286,396607,194919,201688
2008/11/1,桃園市,中壢區,120045,361857,181514,180343
2008/11/1,桃園市,平鎮區,63313,205058,103595,101463
2008/11/1,桃園市,八德區,54556,173309,88725,84584
2008/11/1,桃園市,大溪區,28161,91079,47072,44007
2008/11/1,桃園市,楊梅區,45415,145160,74188,70972
2008/11/1,桃園市,蘆竹區,44780,135429,68234,67195
2008/11/1,桃園市,大園區,24577,80281,41826,38455
2008/11/1,桃園市,龜山區,47236,133724,68141,65583
2008/11/1,桃園市,龍潭區,35398,113572,58020,55552
2008/11/1,桃園市,新屋區,14582,49713,26590,23123
2008/11/1,桃園市,觀音區,18418,60270,31919,28351
2008/11/1,桃園市,復興區,3613,10457,5889,4568
2008/11/1,新竹縣,竹北市,42365,131641,66319,65322
2008/11/1,新竹縣,關西鎮,8985,32460,17349,15111
2008/11/1,新竹縣,新埔鎮,10088,36117,19174,16943
2008/11/1,新竹縣,竹東鎮,29501,97051,49041,48010
2008/11/1,新竹縣,湖口鄉,22580,74980,38434,36546
2008/11/1,新竹縣,橫山鄉,4232,14577,7915,6662
2008/11/1,新竹縣,新豐鄉,14957,52320,27155,25165
2008/11/1,新竹縣,芎林鄉,6096,20878,10991,9887
2008/11/1,新竹縣,寶山鄉,4499,13703,7399,6304
2008/11/1,新竹縣,北埔鄉,3027,10264,5561,4703
2008/11/1,新竹縣,峨眉鄉,2006,6071,3368,2703
2008/11/1,新竹縣,尖石鄉,2598,8165,4513,3652
2008/11/1,新竹縣,五峰鄉,1661,4398,2506,1892
2008/11/1,苗栗縣,苗栗市,28345,91150,46107,45043
2008/11/1,苗栗縣,苑裡鎮,13484,49035,25685,23350
2008/11/1,苗栗縣,通霄鎮,11036,38814,20724,18090
2008/11/1,苗栗縣,竹南鎮,22571,76218,38869,37349
2008/11/1,苗栗縣,頭份市,28134,95677,48978,46699
2008/11/1,苗栗縣,後龍鎮,11461,40148,21280,18868
2008/11/1,苗栗縣,卓蘭鎮,5825,18379,9742,8637
2008/11/1,苗栗縣,大湖鄉,5197,16100,8694,7406
2008/11/1,苗栗縣,公館鄉,9805,34754,18296,16458
2008/11/1,苗栗縣,銅鑼鄉,5868,19652,10470,9182
2008/11/1,苗栗縣,南庄鄉,3859,11299,6261,5038
2008/11/1,苗栗縣,頭屋鄉,3459,11705,6211,5494
2008/11/1,苗栗縣,三義鄉,5153,17658,9357,8301
2008/11/1,苗栗縣,西湖鄉,2617,7921,4404,3517
2008/11/1,苗栗縣,造橋鄉,3906,13723,7290,6433
2008/11/1,苗栗縣,三灣鄉,2338,7416,4042,3374
2008/11/1,苗栗縣,獅潭鄉,1644,5048,2838,2210
2008/11/1,苗栗縣,泰安鄉,1863,5700,3130,2570
2008/11/1,臺中市,豐原區,47996,165232,82245,82987
2008/11/1,臺中市,大里區,59199,194401,96751,97650
2008/11/1,臺中市,太平區,52997,172323,86773,85550
2008/11/1,臺中市,東勢區,16652,54275,28248,26027
2008/11/1,臺中市,大甲區,21082,78947,40097,38850
2008/11/1,臺中市,清水區,24256,85805,44376,41429
2008/11/1,臺中市,沙鹿區,22212,79488,40505,38983
2008/11/1,臺中市,梧棲區,15543,54689,27849,26840
2008/11/1,臺中市,后里區,14390,54565,28215,26350
2008/11/1,臺中市,神岡區,17148,64173,33129,31044
2008/11/1,臺中市,潭子區,30991,98363,49318,49045
2008/11/1,臺中市,大雅區,25399,88816,44964,43852
2008/11/1,臺中市,新社區,7210,25812,13657,12155
2008/11/1,臺中市,石岡區,4738,16152,8427,7725
2008/11/1,臺中市,外埔區,8480,31958,16490,15468
2008/11/1,臺中市,大安區,5158,20606,10876,9730
2008/11/1,臺中市,烏日區,19501,67930,34526,33404
2008/11/1,臺中市,大肚區,15395,55956,28790,27166
2008/11/1,臺中市,龍井區,19717,72753,37288,35465
2008/11/1,臺中市,霧峰區,18388,64278,33113,31165
2008/11/1,臺中市,和平區,4465,10779,5928,4851
2008/11/1,彰化縣,彰化市,69756,236643,118383,118260
2008/11/1,彰化縣,鹿港鎮,21528,85281,43795,41486
2008/11/1,彰化縣,和美鎮,23303,89361,45960,43401
2008/11/1,彰化縣,北斗鎮,9626,33647,17118,16529
2008/11/1,彰化縣,員林市,35599,125959,63551,62408
2008/11/1,彰化縣,溪湖鎮,14712,56508,28971,27537
2008/11/1,彰化縣,田中鎮,12271,44785,23517,21268
2008/11/1,彰化縣,二林鎮,14009,54852,28349,26503
2008/11/1,彰化縣,線西鄉,3972,17026,8779,8247
2008/11/1,彰化縣,伸港鄉,8654,35800,18473,17327
2008/11/1,彰化縣,福興鄉,11685,49002,25680,23322
2008/11/1,彰化縣,秀水鄉,9397,38955,20205,18750
2008/11/1,彰化縣,花壇鄉,12509,46195,23884,22311
2008/11/1,彰化縣,芬園鄉,6792,25089,13323,11766
2008/11/1,彰化縣,大村鄉,9914,36459,19072,17387
2008/11/1,彰化縣,埔鹽鄉,8583,34646,18243,16403
2008/11/1,彰化縣,埔心鄉,9662,35497,18474,17023
2008/11/1,彰化縣,永靖鄉,10148,39625,20624,19001
2008/11/1,彰化縣,社頭鄉,12057,45259,23331,21928
2008/11/1,彰化縣,二水鄉,5230,16946,8965,7981
2008/11/1,彰化縣,田尾鄉,7519,28917,15118,13799
2008/11/1,彰化縣,埤頭鄉,8348,32004,16797,15207
2008/11/1,彰化縣,芳苑鄉,9860,36759,19509,17250
2008/11/1,彰化縣,大城鄉,5294,19092,10417,8675
2008/11/1,彰化縣,竹塘鄉,4497,16642,8812,7830
2008/11/1,彰化縣,溪州鄉,8536,31999,16954,15045
2008/11/1,南投縣,南投市,32561,105270,53142,52128
2008/11/1,南投縣,埔里鎮,27776,86252,43693,42559
2008/11/1,南投縣,草屯鎮,30071,100185,50806,49379
2008/11/1,南投縣,竹山鎮,18404,59046,30547,28499
2008/11/1,南投縣,集集鎮,4183,12050,6347,5703
2008/11/1,南投縣,名間鄉,11838,41606,21923,19683
2008/11/1,南投縣,鹿谷鄉,6430,19424,10364,9060
2008/11/1,南投縣,中寮鄉,5509,16444,8963,7481
2008/11/1,南投縣,魚池鄉,5713,17351,9226,8125
2008/11/1,南投縣,國姓鄉,7121,21209,11644,9565
2008/11/1,南投縣,水里鄉,7174,20614,10863,9751
2008/11/1,南投縣,信義鄉,5057,17162,9335,7827
2008/11/1,南投縣,仁愛鄉,4875,15446,8172,7274
2008/11/1,雲林縣,斗六市,33430,106198,53678,52520
2008/11/1,雲林縣,斗南鎮,14884,47588,24208,23380
2008/11/1,雲林縣,虎尾鎮,21585,69886,35654,34232
2008/11/1,雲林縣,西螺鎮,13750,49078,24974,24104
2008/11/1,雲林縣,土庫鎮,8522,30957,16233,14724
2008/11/1,雲林縣,北港鎮,14937,43932,22899,21033
2008/11/1,雲林縣,古坑鄉,10418,35000,18579,16421
2008/11/1,雲林縣,大埤鄉,6523,21722,11589,10133
2008/11/1,雲林縣,莿桐鄉,8824,30744,16140,14604
2008/11/1,雲林縣,林內鄉,5588,20212,10631,9581
2008/11/1,雲林縣,二崙鄉,8655,30308,16297,14011
2008/11/1,雲林縣,崙背鄉,8212,28003,14849,13154
2008/11/1,雲林縣,麥寮鄉,11612,34014,18086,15928
2008/11/1,雲林縣,東勢鄉,5660,17411,9495,7916
2008/11/1,雲林縣,褒忠鄉,4217,14626,7832,6794
2008/11/1,雲林縣,臺西鄉,8653,27038,14600,12438
2008/11/1,雲林縣,元長鄉,9184,29423,16084,13339
2008/11/1,雲林縣,四湖鄉,8926,27512,15082,12430
2008/11/1,雲林縣,口湖鄉,9507,31031,16620,14411
2008/11/1,雲林縣,水林鄉,10289,29555,16232,13323
2008/11/1,嘉義縣,太保市,10683,35878,18637,17241
2008/11/1,嘉義縣,朴子市,13890,44221,22659,21562
2008/11/1,嘉義縣,布袋鎮,9981,30897,15968,14929
2008/11/1,嘉義縣,大林鎮,11008,34107,17594,16513
2008/11/1,嘉義縣,民雄鄉,21944,72652,37456,35196
2008/11/1,嘉義縣,溪口鄉,5314,16698,8942,7756
2008/11/1,嘉義縣,新港鄉,10164,35164,18571,16593
2008/11/1,嘉義縣,六腳鄉,9048,27033,14359,12674
2008/11/1,嘉義縣,東石鄉,9209,28425,15167,13258
2008/11/1,嘉義縣,義竹鄉,7369,21674,11283,10391
2008/11/1,嘉義縣,鹿草鄉,5617,17423,9362,8061
2008/11/1,嘉義縣,水上鄉,17255,53189,27640,25549
2008/11/1,嘉義縣,中埔鄉,14747,47865,25090,22775
2008/11/1,嘉義縣,竹崎鄉,11151,39205,20913,18292
2008/11/1,嘉義縣,梅山鄉,6462,22203,11791,10412
2008/11/1,嘉義縣,番路鄉,3824,11624,6351,5273
2008/11/1,嘉義縣,大埔鄉,1899,4179,2236,1943
2008/11/1,嘉義縣,阿里山鄉,1964,6175,3325,2850
2008/11/1,臺南市,新營區,26481,78738,39500,39238
2008/11/1,臺南市,永康區,71726,212454,106133,106321
2008/11/1,臺南市,鹽水區,9733,27616,14386,13230
2008/11/1,臺南市,白河區,10808,31973,16880,15093
2008/11/1,臺南市,麻豆區,14531,46187,23683,22504
2008/11/1,臺南市,佳里區,18699,59351,29669,29682
2008/11/1,臺南市,新化區,13292,44491,22881,21610
2008/11/1,臺南市,善化區,13903,43024,21891,21133
2008/11/1,臺南市,學甲區,9233,28339,14549,13790
2008/11/1,臺南市,柳營區,7671,23140,12121,11019
2008/11/1,臺南市,後壁區,8589,26300,13747,12553
2008/11/1,臺南市,東山區,8106,23583,12617,10966
2008/11/1,臺南市,下營區,8941,26625,13826,12799
2008/11/1,臺南市,六甲區,7475,24232,12613,11619
2008/11/1,臺南市,官田區,7508,22523,11625,10898
2008/11/1,臺南市,大內區,4039,11221,5999,5222
2008/11/1,臺南市,西港區,7636,25423,13007,12416
2008/11/1,臺南市,七股區,7812,25150,13180,11970
2008/11/1,臺南市,將軍區,7294,21909,11200,10709
2008/11/1,臺南市,北門區,4206,12528,6437,6091
2008/11/1,臺南市,新市區,10544,35308,17794,17514
2008/11/1,臺南市,安定區,8928,30089,15627,14462
2008/11/1,臺南市,山上區,2703,8041,4254,3787
2008/11/1,臺南市,玉井區,5023,15698,8163,7535
2008/11/1,臺南市,楠西區,3591,10901,5807,5094
2008/11/1,臺南市,南化區,2818,8967,4924,4043
2008/11/1,臺南市,左鎮區,1952,5576,3106,2470
2008/11/1,臺南市,仁德區,23640,68372,35290,33082
2008/11/1,臺南市,歸仁區,19749,65713,33551,32162
2008/11/1,臺南市,關廟區,10507,36728,19109,17619
2008/11/1,臺南市,龍崎區,1585,4454,2425,2029
2008/11/1,高雄市,鳳山區,122967,339266,169919,169347
2008/11/1,高雄市,岡山區,32333,96636,48794,47842
2008/11/1,高雄市,旗山區,13604,40792,21333,19459
2008/11/1,高雄市,美濃區,13758,43764,22935,20829
2008/11/1,高雄市,林園區,23529,71011,36624,34387
2008/11/1,高雄市,大寮區,37101,109395,57149,52246
2008/11/1,高雄市,大樹區,12912,44598,23131,21467
2008/11/1,高雄市,仁武區,23896,68882,35629,33253
2008/11/1,高雄市,大社區,11396,32766,16906,15860
2008/11/1,高雄市,鳥松區,15850,41716,21293,20423
2008/11/1,高雄市,橋頭區,12304,36457,18805,17652
2008/11/1,高雄市,燕巢區,9761,31218,16689,14529
2008/11/1,高雄市,田寮區,3563,8453,4698,3755
2008/11/1,高雄市,阿蓮區,8981,30719,15533,15186
2008/11/1,高雄市,路竹區,15649,54389,27838,26551
2008/11/1,高雄市,湖內區,9213,28597,14803,13794
2008/11/1,高雄市,茄萣區,9969,31772,16674,15098
2008/11/1,高雄市,永安區,5684,14129,7264,6865
2008/11/1,高雄市,彌陀區,6461,20689,10815,9874
2008/11/1,高雄市,梓官區,11650,36981,19354,17627
2008/11/1,高雄市,六龜區,5672,15470,8415,7055
2008/11/1,高雄市,甲仙區,2561,8104,4362,3742
2008/11/1,高雄市,杉林區,4010,11208,6157,5051
2008/11/1,高雄市,內門區,4982,16332,8936,7396
2008/11/1,高雄市,茂林區,528,1771,908,863
2008/11/1,高雄市,桃源區,1237,4756,2551,2205
2008/11/1,高雄市,那瑪夏區,878,3476,1827,1649
2008/11/1,屏東縣,屏東市,71586,215212,107654,107558
2008/11/1,屏東縣,潮州鎮,17772,56786,28675,28111
2008/11/1,屏東縣,東港鎮,14863,50453,25697,24756
2008/11/1,屏東縣,恆春鎮,10421,31209,16159,15050
2008/11/1,屏東縣,萬丹鄉,13907,54509,28253,26256
2008/11/1,屏東縣,長治鄉,9551,30969,16290,14679
2008/11/1,屏東縣,麟洛鄉,3480,11610,6028,5582
2008/11/1,屏東縣,九如鄉,6451,23108,12060,11048
2008/11/1,屏東縣,里港鄉,7784,26338,13536,12802
2008/11/1,屏東縣,鹽埔鄉,7542,27575,14365,13210
2008/11/1,屏東縣,高樹鄉,9514,27313,14621,12692
2008/11/1,屏東縣,萬巒鄉,6314,22504,11896,10608
2008/11/1,屏東縣,內埔鄉,17420,59143,30936,28207
2008/11/1,屏東縣,竹田鄉,5394,18468,9861,8607
2008/11/1,屏東縣,新埤鄉,3301,10902,5778,5124
2008/11/1,屏東縣,枋寮鄉,8291,27139,14424,12715
2008/11/1,屏東縣,新園鄉,10936,39183,20313,18870
2008/11/1,屏東縣,崁頂鄉,4025,17119,8821,8298
2008/11/1,屏東縣,林邊鄉,6210,21095,10933,10162
2008/11/1,屏東縣,南州鄉,3588,12027,6202,5825
2008/11/1,屏東縣,佳冬鄉,6626,21669,11347,10322
2008/11/1,屏東縣,琉球鄉,3811,12559,6959,5600
2008/11/1,屏東縣,車城鄉,3419,9967,5375,4592
2008/11/1,屏東縣,滿州鄉,2988,8558,4710,3848
2008/11/1,屏東縣,枋山鄉,2098,6157,3306,2851
2008/11/1,屏東縣,三地門鄉,2038,7283,3744,3539
2008/11/1,屏東縣,霧臺鄉,875,2689,1439,1250
2008/11/1,屏東縣,瑪家鄉,1810,6426,3353,3073
2008/11/1,屏東縣,泰武鄉,1113,4910,2632,2278
2008/11/1,屏東縣,來義鄉,2082,7693,3985,3708
2008/11/1,屏東縣,春日鄉,1288,4931,2576,2355
2008/11/1,屏東縣,獅子鄉,1427,4953,2631,2322
2008/11/1,屏東縣,牡丹鄉,1796,4859,2530,2329
2008/11/1,臺東縣,臺東市,37400,109845,55938,53907
2008/11/1,臺東縣,成功鎮,5372,16222,8680,7542
2008/11/1,臺東縣,關山鎮,3191,9916,5232,4684
2008/11/1,臺東縣,卑南鄉,6446,18306,9989,8317
2008/11/1,臺東縣,大武鄉,2441,6917,3630,3287
2008/11/1,臺東縣,太麻里鄉,4511,12164,6547,5617
2008/11/1,臺東縣,東河鄉,3502,9545,5328,4217
2008/11/1,臺東縣,長濱鄉,2881,8620,4901,3719
2008/11/1,臺東縣,鹿野鄉,3089,8771,4764,4007
2008/11/1,臺東縣,池上鄉,3215,9385,5004,4381
2008/11/1,臺東縣,綠島鄉,943,3168,1714,1454
2008/11/1,臺東縣,延平鄉,1069,3576,1996,1580
2008/11/1,臺東縣,海端鄉,1082,4537,2477,2060
2008/11/1,臺東縣,達仁鄉,1406,3728,2073,1655
2008/11/1,臺東縣,金峰鄉,980,3323,1754,1569
2008/11/1,臺東縣,蘭嶼鄉,1253,4032,2129,1903
2008/11/1,花蓮縣,花蓮市,39888,110132,54246,55886
2008/11/1,花蓮縣,鳳林鎮,4408,12312,6557,5755
2008/11/1,花蓮縣,玉里鎮,8881,27725,15108,12617
2008/11/1,花蓮縣,新城鄉,7126,20315,10628,9687
2008/11/1,花蓮縣,吉安鄉,27985,79054,40788,38266
2008/11/1,花蓮縣,壽豐鄉,6712,19117,10370,8747
2008/11/1,花蓮縣,光復鄉,4977,14417,7738,6679
2008/11/1,花蓮縣,豐濱鄉,1805,5201,2905,2296
2008/11/1,花蓮縣,瑞穗鄉,4579,13213,7178,6035
2008/11/1,花蓮縣,富里鄉,3909,11844,6553,5291
2008/11/1,花蓮縣,秀林鄉,4492,14887,7814,7073
2008/11/1,花蓮縣,萬榮鄉,2134,7040,3761,3279
2008/11/1,花蓮縣,卓溪鄉,1636,6452,3590,2862
2008/11/1,澎湖縣,馬公市,18309,55036,28012,27024
2008/11/1,澎湖縣,湖西鄉,4411,12999,6810,6189
2008/11/1,澎湖縣,白沙鄉,2978,9195,4847,4348
2008/11/1,澎湖縣,西嶼鄉,2707,8166,4231,3935
2008/11/1,澎湖縣,望安鄉,1749,4505,2437,2068
2008/11/1,澎湖縣,七美鄉,1137,3280,1726,1554
2008/11/1,基隆市,中正區,21788,56817,29317,27500
2008/11/1,基隆市,七堵區,19371,55232,28109,27123
2008/11/1,基隆市,暖暖區,14145,38233,19508,18725
2008/11/1,基隆市,仁愛區,19318,50406,25062,25344
2008/11/1,基隆市,中山區,18736,51907,26622,25285
2008/11/1,基隆市,安樂區,31294,85181,42532,42649
2008/11/1,基隆市,信義區,19633,51259,25767,25492
2008/11/1,新竹市,東區,64476,192224,95190,97034
2008/11/1,新竹市,北區,47634,141473,70525,70948
2008/11/1,新竹市,香山區,21642,71026,36399,34627
2008/11/1,臺中市,中區,8501,23840,11758,12082
2008/11/1,臺中市,東區,25240,73985,37569,36416
2008/11/1,臺中市,西區,42077,117171,56546,60625
2008/11/1,臺中市,南區,40258,111621,54402,57219
2008/11/1,臺中市,北區,54152,147688,71941,75747
2008/11/1,臺中市,西屯區,69195,201045,98154,102891
2008/11/1,臺中市,南屯區,50058,148027,71632,76395
2008/11/1,臺中市,北屯區,79755,241716,117818,123898
2008/11/1,嘉義市,東區,44146,128499,62958,65541
2008/11/1,嘉義市,西區,49032,145565,72460,73105
2008/11/1,臺南市,東區,69277,194300,94487,99813
2008/11/1,臺南市,南區,42360,127513,64180,63333
2008/11/1,臺南市,北區,46311,129943,64438,65505
2008/11/1,臺南市,安南區,52128,175536,89605,85931
2008/11/1,臺南市,安平區,21916,60495,29027,31468
2008/11/1,臺南市,中西區,29743,80565,39782,40783
2008/11/1,臺北市,松山區,76688,209884,99617,110267
2008/11/1,臺北市,信義區,85076,227706,110413,117293
2008/11/1,臺北市,大安區,115258,313508,148223,165285
2008/11/1,臺北市,中山區,88763,218675,103621,115054
2008/11/1,臺北市,中正區,60727,159261,77086,82175
2008/11/1,臺北市,大同區,45938,124760,61788,62972
2008/11/1,臺北市,萬華區,72782,190374,95780,94594
2008/11/1,臺北市,文山區,94785,261825,127528,134297
2008/11/1,臺北市,南港區,40230,113713,56407,57306
2008/11/1,臺北市,內湖區,92795,266762,129241,137521
2008/11/1,臺北市,士林區,98284,285945,139671,146274
2008/11/1,臺北市,北投區,87278,249712,121603,128109
2008/11/1,高雄市,鹽埕區,11213,28106,14238,13868
2008/11/1,高雄市,鼓山區,48518,125348,62014,63334
2008/11/1,高雄市,左營區,71476,188503,93522,94981
2008/11/1,高雄市,楠梓區,59805,170352,84921,85431
2008/11/1,高雄市,三民區,128403,355948,175178,180770
2008/11/1,高雄市,新興區,22853,56736,27842,28894
2008/11/1,高雄市,前金區,12517,29724,14579,15145
2008/11/1,高雄市,苓雅區,70515,186790,91391,95399
2008/11/1,高雄市,前鎮區,74454,200670,100479,100191
2008/11/1,高雄市,旗津區,10732,29906,15594,14312
2008/11/1,高雄市,小港區,60622,152913,77328,75585
2008/11/1,金門縣,金城鎮,10144,28707,15119,13588
2008/11/1,金門縣,金湖鎮,6649,18612,9854,8758
2008/11/1,金門縣,金沙鎮,5003,13469,7052,6417
2008/11/1,金門縣,金寧鄉,5603,15482,8322,7160
2008/11/1,金門縣,烈嶼鄉,2368,7394,3878,3516
2008/11/1,金門縣,烏坵鄉,135,444,231,213
2008/11/1,連江縣,南竿鄉,1105,5851,3373,2478
2008/11/1,連江縣,北竿鄉,372,1762,1027,735
2008/11/1,連江縣,莒光鄉,231,1187,694,493
2008/11/1,連江縣,東引鄉,249,1007,593,414
2008/12/1,總計,臺灣地區,7623793,22942706,11576076,11366630
2008/12/1,總計,臺灣省,6094194,18794141,9547908,9246233
2008/12/1,總計,新北市,1340465,3833730,1913218,1920512
2008/12/1,總計,宜蘭縣,149839,460902,235855,225047
2008/12/1,總計,桃園市,637071,1958686,991492,967194
2008/12/1,總計,新竹縣,152886,503273,259977,243296
2008/12/1,總計,苗栗縣,166760,560397,292352,268045
2008/12/1,總計,臺中市,451237,1557944,791716,766228
2008/12/1,總計,彰化縣,353763,1312935,676162,636773
2008/12/1,總計,南投縣,166790,531753,274915,256838
2008/12/1,總計,雲林縣,223534,723674,379434,344240
2008/12/1,總計,嘉義縣,171645,548731,287360,261371
2008/12/1,總計,臺南市,358943,1104552,565834,538718
2008/12/1,總計,高雄市,420551,1243412,639236,604176
2008/12/1,總計,屏東縣,269755,884838,456802,428036
2008/12/1,總計,臺東縣,78693,231849,122041,109808
2008/12/1,總計,花蓮縣,118433,341433,177032,164401
2008/12/1,總計,澎湖縣,31468,93308,48092,45216
2008/12/1,總計,基隆市,144212,388979,196877,192102
2008/12/1,總計,新竹市,133957,405371,202389,202982
2008/12/1,總計,臺中市,369363,1066128,520274,545854
2008/12/1,總計,嘉義市,93138,273793,135283,138510
2008/12/1,總計,臺南市,261691,768453,381567,386886
2008/12/1,總計,臺北市,958433,2622923,1270948,1351975
2008/12/1,總計,高雄市,571166,1525642,757220,768422
2008/12/1,總計,福建省,31979,94325,50275,44050
2008/12/1,總計,金門縣,29999,84570,44625,39945
2008/12/1,總計,連江縣,1980,9755,5650,4105
2008/12/1,新北市,板橋區,186954,550767,273802,276965
2008/12/1,新北市,三重區,133411,384722,192798,191924
2008/12/1,新北市,永和區,88405,236598,113959,122639
2008/12/1,新北市,中和區,149621,412060,204647,207413
2008/12/1,新北市,新莊區,131529,398317,197486,200831
2008/12/1,新北市,新店區,112333,292693,144187,148506
2008/12/1,新北市,土城區,79480,238230,119607,118623
2008/12/1,新北市,蘆洲區,62693,194686,96709,97977
2008/12/1,新北市,汐止區,75460,183441,91558,91883
2008/12/1,新北市,樹林區,54894,168689,85417,83272
2008/12/1,新北市,鶯歌區,26317,86258,43931,42327
2008/12/1,新北市,三峽區,32414,97967,50402,47565
2008/12/1,新北市,淡水區,51768,135355,66323,69032
2008/12/1,新北市,瑞芳區,15591,43088,22101,20987
2008/12/1,新北市,五股區,25858,77754,39585,38169
2008/12/1,新北市,泰山區,25339,75830,38350,37480
2008/12/1,新北市,林口區,25349,72964,36354,36610
2008/12/1,新北市,深坑區,8372,22829,11606,11223
2008/12/1,新北市,石碇區,3188,7847,4382,3465
2008/12/1,新北市,坪林區,2379,6541,3666,2875
2008/12/1,新北市,三芝區,8642,23479,12197,11282
2008/12/1,新北市,石門區,3746,12023,6404,5619
2008/12/1,新北市,八里區,11349,33231,17041,16190
2008/12/1,新北市,平溪區,2327,5520,3078,2442
2008/12/1,新北市,雙溪區,3808,9877,5353,4524
2008/12/1,新北市,貢寮區,4324,13970,7261,6709
2008/12/1,新北市,金山區,6529,22306,11326,10980
2008/12/1,新北市,萬里區,6722,21085,10835,10250
2008/12/1,新北市,烏來區,1663,5603,2853,2750
2008/12/1,宜蘭縣,宜蘭市,32355,95874,47395,48479
2008/12/1,宜蘭縣,羅東鎮,24377,73722,35497,38225
2008/12/1,宜蘭縣,蘇澳鎮,13382,43665,22531,21134
2008/12/1,宜蘭縣,頭城鎮,9446,31300,16252,15048
2008/12/1,宜蘭縣,礁溪鄉,12119,35940,18909,17031
2008/12/1,宜蘭縣,壯圍鄉,7882,25072,13262,11810
2008/12/1,宜蘭縣,員山鄉,10479,32213,17319,14894
2008/12/1,宜蘭縣,冬山鄉,16634,51722,26797,24925
2008/12/1,宜蘭縣,五結鄉,12454,38469,20062,18407
2008/12/1,宜蘭縣,三星鄉,7198,21268,11535,9733
2008/12/1,宜蘭縣,大同鄉,1785,5815,3198,2617
2008/12/1,宜蘭縣,南澳鄉,1728,5842,3098,2744
2008/12/1,桃園市,桃園區,136386,397056,195120,201936
2008/12/1,桃園市,中壢區,120139,362129,181591,180538
2008/12/1,桃園市,平鎮區,63387,205266,103710,101556
2008/12/1,桃園市,八德區,54656,173585,88877,84708
2008/12/1,桃園市,大溪區,28197,91146,47084,44062
2008/12/1,桃園市,楊梅區,45470,145347,74257,71090
2008/12/1,桃園市,蘆竹區,44890,135768,68384,67384
2008/12/1,桃園市,大園區,24584,80274,41807,38467
2008/12/1,桃園市,龜山區,47295,133977,68209,65768
2008/12/1,桃園市,龍潭區,35419,113633,58034,55599
2008/12/1,桃園市,新屋區,14595,49683,26566,23117
2008/12/1,桃園市,觀音區,18444,60368,31957,28411
2008/12/1,桃園市,復興區,3609,10454,5896,4558
2008/12/1,新竹縣,竹北市,42576,132136,66558,65578
2008/12/1,新竹縣,關西鎮,8990,32451,17328,15123
2008/12/1,新竹縣,新埔鎮,10085,36085,19149,16936
2008/12/1,新竹縣,竹東鎮,29512,97086,49053,48033
2008/12/1,新竹縣,湖口鄉,22605,75066,38449,36617
2008/12/1,新竹縣,橫山鄉,4236,14590,7921,6669
2008/12/1,新竹縣,新豐鄉,14970,52334,27166,25168
2008/12/1,新竹縣,芎林鄉,6105,20879,10997,9882
2008/12/1,新竹縣,寶山鄉,4512,13748,7424,6324
2008/12/1,新竹縣,北埔鄉,3032,10262,5554,4708
2008/12/1,新竹縣,峨眉鄉,2007,6062,3358,2704
2008/12/1,新竹縣,尖石鄉,2595,8161,4510,3651
2008/12/1,新竹縣,五峰鄉,1661,4413,2510,1903
2008/12/1,苗栗縣,苗栗市,28361,91136,46086,45050
2008/12/1,苗栗縣,苑裡鎮,13497,49034,25680,23354
2008/12/1,苗栗縣,通霄鎮,11042,38773,20699,18074
2008/12/1,苗栗縣,竹南鎮,22627,76323,38923,37400
2008/12/1,苗栗縣,頭份市,28194,95687,48978,46709
2008/12/1,苗栗縣,後龍鎮,11469,40127,21265,18862
2008/12/1,苗栗縣,卓蘭鎮,5828,18391,9749,8642
2008/12/1,苗栗縣,大湖鄉,5213,16165,8721,7444
2008/12/1,苗栗縣,公館鄉,9815,34744,18301,16443
2008/12/1,苗栗縣,銅鑼鄉,5865,19597,10443,9154
2008/12/1,苗栗縣,南庄鄉,3867,11301,6264,5037
2008/12/1,苗栗縣,頭屋鄉,3466,11678,6198,5480
2008/12/1,苗栗縣,三義鄉,5155,17643,9349,8294
2008/12/1,苗栗縣,西湖鄉,2616,7924,4403,3521
2008/12/1,苗栗縣,造橋鄉,3904,13725,7290,6435
2008/12/1,苗栗縣,三灣鄉,2332,7400,4036,3364
2008/12/1,苗栗縣,獅潭鄉,1648,5048,2835,2213
2008/12/1,苗栗縣,泰安鄉,1861,5701,3132,2569
2008/12/1,臺中市,豐原區,48033,165238,82286,82952
2008/12/1,臺中市,大里區,59208,194550,96799,97751
2008/12/1,臺中市,太平區,52979,172363,86765,85598
2008/12/1,臺中市,東勢區,16663,54201,28200,26001
2008/12/1,臺中市,大甲區,21110,78917,40085,38832
2008/12/1,臺中市,清水區,24268,85770,44365,41405
2008/12/1,臺中市,沙鹿區,22276,79553,40540,39013
2008/12/1,臺中市,梧棲區,15556,54748,27870,26878
2008/12/1,臺中市,后里區,14404,54566,28203,26363
2008/12/1,臺中市,神岡區,17151,64159,33113,31046
2008/12/1,臺中市,潭子區,31026,98456,49342,49114
2008/12/1,臺中市,大雅區,25410,88864,44960,43904
2008/12/1,臺中市,新社區,7215,25819,13659,12160
2008/12/1,臺中市,石岡區,4746,16162,8432,7730
2008/12/1,臺中市,外埔區,8495,31986,16501,15485
2008/12/1,臺中市,大安區,5154,20605,10868,9737
2008/12/1,臺中市,烏日區,19520,67970,34529,33441
2008/12/1,臺中市,大肚區,15400,55945,28766,27179
2008/12/1,臺中市,龍井區,19768,73041,37410,35631
2008/12/1,臺中市,霧峰區,18386,64228,33081,31147
2008/12/1,臺中市,和平區,4469,10803,5942,4861
2008/12/1,彰化縣,彰化市,69787,236631,118345,118286
2008/12/1,彰化縣,鹿港鎮,21559,85340,43815,41525
2008/12/1,彰化縣,和美鎮,23330,89386,45961,43425
2008/12/1,彰化縣,北斗鎮,9632,33620,17100,16520
2008/12/1,彰化縣,員林市,35641,125962,63522,62440
2008/12/1,彰化縣,溪湖鎮,14714,56449,28941,27508
2008/12/1,彰化縣,田中鎮,12263,44769,23505,21264
2008/12/1,彰化縣,二林鎮,14016,54795,28313,26482
2008/12/1,彰化縣,線西鄉,3985,17030,8779,8251
2008/12/1,彰化縣,伸港鄉,8679,35825,18480,17345
2008/12/1,彰化縣,福興鄉,11687,49005,25679,23326
2008/12/1,彰化縣,秀水鄉,9402,38968,20224,18744
2008/12/1,彰化縣,花壇鄉,12534,46193,23899,22294
2008/12/1,彰化縣,芬園鄉,6791,25090,13318,11772
2008/12/1,彰化縣,大村鄉,9925,36501,19085,17416
2008/12/1,彰化縣,埔鹽鄉,8589,34667,18246,16421
2008/12/1,彰化縣,埔心鄉,9674,35498,18463,17035
2008/12/1,彰化縣,永靖鄉,10158,39595,20618,18977
2008/12/1,彰化縣,社頭鄉,12069,45231,23327,21904
2008/12/1,彰化縣,二水鄉,5235,16929,8953,7976
2008/12/1,彰化縣,田尾鄉,7535,28911,15110,13801
2008/12/1,彰化縣,埤頭鄉,8358,32015,16788,15227
2008/12/1,彰化縣,芳苑鄉,9862,36784,19523,17261
2008/12/1,彰化縣,大城鄉,5297,19094,10414,8680
2008/12/1,彰化縣,竹塘鄉,4497,16616,8796,7820
2008/12/1,彰化縣,溪州鄉,8544,32031,16958,15073
2008/12/1,南投縣,南投市,32556,105143,53077,52066
2008/12/1,南投縣,埔里鎮,27791,86189,43661,42528
2008/12/1,南投縣,草屯鎮,30095,100143,50806,49337
2008/12/1,南投縣,竹山鎮,18434,59003,30534,28469
2008/12/1,南投縣,集集鎮,4171,12055,6354,5701
2008/12/1,南投縣,名間鄉,11853,41589,21936,19653
2008/12/1,南投縣,鹿谷鄉,6445,19437,10361,9076
2008/12/1,南投縣,中寮鄉,5517,16445,8960,7485
2008/12/1,南投縣,魚池鄉,5715,17344,9218,8126
2008/12/1,南投縣,國姓鄉,7126,21195,11642,9553
2008/12/1,南投縣,水里鄉,7167,20593,10860,9733
2008/12/1,南投縣,信義鄉,5053,17166,9332,7834
2008/12/1,南投縣,仁愛鄉,4867,15451,8174,7277
2008/12/1,雲林縣,斗六市,33440,106226,53698,52528
2008/12/1,雲林縣,斗南鎮,14891,47585,24207,23378
2008/12/1,雲林縣,虎尾鎮,21598,69874,35658,34216
2008/12/1,雲林縣,西螺鎮,13751,48990,24948,24042
2008/12/1,雲林縣,土庫鎮,8530,30952,16218,14734
2008/12/1,雲林縣,北港鎮,14939,43781,22818,20963
2008/12/1,雲林縣,古坑鄉,10433,34976,18558,16418
2008/12/1,雲林縣,大埤鄉,6530,21702,11584,10118
2008/12/1,雲林縣,莿桐鄉,8828,30741,16140,14601
2008/12/1,雲林縣,林內鄉,5597,20144,10570,9574
2008/12/1,雲林縣,二崙鄉,8668,30289,16293,13996
2008/12/1,雲林縣,崙背鄉,8220,27976,14831,13145
2008/12/1,雲林縣,麥寮鄉,11631,34036,18085,15951
2008/12/1,雲林縣,東勢鄉,5655,17370,9475,7895
2008/12/1,雲林縣,褒忠鄉,4227,14624,7822,6802
2008/12/1,雲林縣,臺西鄉,8659,26986,14557,12429
2008/12/1,雲林縣,元長鄉,9189,29388,16069,13319
2008/12/1,雲林縣,四湖鄉,8934,27462,15055,12407
2008/12/1,雲林縣,口湖鄉,9510,31030,16612,14418
2008/12/1,雲林縣,水林鄉,10304,29542,16236,13306
2008/12/1,嘉義縣,太保市,10691,35896,18641,17255
2008/12/1,嘉義縣,朴子市,13924,44281,22698,21583
2008/12/1,嘉義縣,布袋鎮,9988,30888,15955,14933
2008/12/1,嘉義縣,大林鎮,10998,34101,17581,16520
2008/12/1,嘉義縣,民雄鄉,21985,72641,37458,35183
2008/12/1,嘉義縣,溪口鄉,5323,16695,8937,7758
2008/12/1,嘉義縣,新港鄉,10174,35149,18555,16594
2008/12/1,嘉義縣,六腳鄉,9053,27041,14358,12683
2008/12/1,嘉義縣,東石鄉,9203,28399,15153,13246
2008/12/1,嘉義縣,義竹鄉,7374,21671,11274,10397
2008/12/1,嘉義縣,鹿草鄉,5623,17429,9359,8070
2008/12/1,嘉義縣,水上鄉,17218,53130,27601,25529
2008/12/1,嘉義縣,中埔鄉,14759,47840,25074,22766
2008/12/1,嘉義縣,竹崎鄉,11127,39155,20900,18255
2008/12/1,嘉義縣,梅山鄉,6468,22184,11787,10397
2008/12/1,嘉義縣,番路鄉,3820,11619,6348,5271
2008/12/1,嘉義縣,大埔鄉,1950,4434,2359,2075
2008/12/1,嘉義縣,阿里山鄉,1967,6178,3322,2856
2008/12/1,臺南市,新營區,26480,78715,39500,39215
2008/12/1,臺南市,永康區,71736,212540,106168,106372
2008/12/1,臺南市,鹽水區,9729,27585,14372,13213
2008/12/1,臺南市,白河區,10803,31926,16850,15076
2008/12/1,臺南市,麻豆區,14528,46164,23669,22495
2008/12/1,臺南市,佳里區,18732,59329,29654,29675
2008/12/1,臺南市,新化區,13312,44469,22872,21597
2008/12/1,臺南市,善化區,13936,43021,21894,21127
2008/12/1,臺南市,學甲區,9251,28313,14532,13781
2008/12/1,臺南市,柳營區,7679,23147,12130,11017
2008/12/1,臺南市,後壁區,8582,26294,13741,12553
2008/12/1,臺南市,東山區,8098,23532,12586,10946
2008/12/1,臺南市,下營區,8951,26612,13819,12793
2008/12/1,臺南市,六甲區,7477,24211,12595,11616
2008/12/1,臺南市,官田區,7504,22529,11625,10904
2008/12/1,臺南市,大內區,4035,11205,5987,5218
2008/12/1,臺南市,西港區,7632,25415,13002,12413
2008/12/1,臺南市,七股區,7812,25115,13157,11958
2008/12/1,臺南市,將軍區,7309,21935,11203,10732
2008/12/1,臺南市,北門區,4208,12529,6431,6098
2008/12/1,臺南市,新市區,10541,35307,17787,17520
2008/12/1,臺南市,安定區,8938,30111,15643,14468
2008/12/1,臺南市,山上區,2705,8036,4249,3787
2008/12/1,臺南市,玉井區,5028,15696,8158,7538
2008/12/1,臺南市,楠西區,3589,10871,5789,5082
2008/12/1,臺南市,南化區,2824,8980,4922,4058
2008/12/1,臺南市,左鎮區,1954,5576,3107,2469
2008/12/1,臺南市,仁德區,23684,68481,35322,33159
2008/12/1,臺南市,歸仁區,19783,65729,33558,32171
2008/12/1,臺南市,關廟區,10511,36715,19082,17633
2008/12/1,臺南市,龍崎區,1592,4464,2430,2034
2008/12/1,高雄市,鳳山區,122935,339240,169876,169364
2008/12/1,高雄市,岡山區,32346,96731,48844,47887
2008/12/1,高雄市,旗山區,13578,40720,21297,19423
2008/12/1,高雄市,美濃區,13752,43710,22893,20817
2008/12/1,高雄市,林園區,23535,70979,36597,34382
2008/12/1,高雄市,大寮區,37145,109449,57170,52279
2008/12/1,高雄市,大樹區,12911,44585,23120,21465
2008/12/1,高雄市,仁武區,23915,68995,35662,33333
2008/12/1,高雄市,大社區,11409,32843,16949,15894
2008/12/1,高雄市,鳥松區,15860,41730,21288,20442
2008/12/1,高雄市,橋頭區,12289,36439,18775,17664
2008/12/1,高雄市,燕巢區,9767,31220,16695,14525
2008/12/1,高雄市,田寮區,3556,8441,4686,3755
2008/12/1,高雄市,阿蓮區,8984,30698,15524,15174
2008/12/1,高雄市,路竹區,15663,54369,27822,26547
2008/12/1,高雄市,湖內區,9217,28634,14816,13818
2008/12/1,高雄市,茄萣區,10002,31762,16665,15097
2008/12/1,高雄市,永安區,5696,14134,7257,6877
2008/12/1,高雄市,彌陀區,6470,20714,10832,9882
2008/12/1,高雄市,梓官區,11661,36976,19364,17612
2008/12/1,高雄市,六龜區,5669,15455,8403,7052
2008/12/1,高雄市,甲仙區,2559,8102,4358,3744
2008/12/1,高雄市,杉林區,4011,11186,6149,5037
2008/12/1,高雄市,內門區,4979,16308,8923,7385
2008/12/1,高雄市,茂林區,529,1776,912,864
2008/12/1,高雄市,桃源區,1234,4747,2542,2205
2008/12/1,高雄市,那瑪夏區,879,3469,1817,1652
2008/12/1,屏東縣,屏東市,71517,214987,107553,107434
2008/12/1,屏東縣,潮州鎮,17790,56781,28668,28113
2008/12/1,屏東縣,東港鎮,14864,50360,25642,24718
2008/12/1,屏東縣,恆春鎮,10430,31143,16117,15026
2008/12/1,屏東縣,萬丹鄉,13906,54521,28254,26267
2008/12/1,屏東縣,長治鄉,9552,30994,16304,14690
2008/12/1,屏東縣,麟洛鄉,3483,11619,6031,5588
2008/12/1,屏東縣,九如鄉,6457,23092,12045,11047
2008/12/1,屏東縣,里港鄉,7788,26317,13522,12795
2008/12/1,屏東縣,鹽埔鄉,7552,27576,14368,13208
2008/12/1,屏東縣,高樹鄉,9520,27325,14626,12699
2008/12/1,屏東縣,萬巒鄉,6309,22457,11878,10579
2008/12/1,屏東縣,內埔鄉,17433,59105,30917,28188
2008/12/1,屏東縣,竹田鄉,5403,18487,9869,8618
2008/12/1,屏東縣,新埤鄉,3293,10904,5779,5125
2008/12/1,屏東縣,枋寮鄉,8290,27137,14417,12720
2008/12/1,屏東縣,新園鄉,10946,39188,20309,18879
2008/12/1,屏東縣,崁頂鄉,4028,17042,8784,8258
2008/12/1,屏東縣,林邊鄉,6227,21101,10937,10164
2008/12/1,屏東縣,南州鄉,3588,12016,6197,5819
2008/12/1,屏東縣,佳冬鄉,6629,21711,11366,10345
2008/12/1,屏東縣,琉球鄉,3814,12550,6956,5594
2008/12/1,屏東縣,車城鄉,3432,9954,5365,4589
2008/12/1,屏東縣,滿州鄉,2990,8541,4698,3843
2008/12/1,屏東縣,枋山鄉,2094,6156,3296,2860
2008/12/1,屏東縣,三地門鄉,2039,7306,3750,3556
2008/12/1,屏東縣,霧臺鄉,873,2684,1437,1247
2008/12/1,屏東縣,瑪家鄉,1805,6430,3357,3073
2008/12/1,屏東縣,泰武鄉,1114,4919,2631,2288
2008/12/1,屏東縣,來義鄉,2083,7694,3985,3709
2008/12/1,屏東縣,春日鄉,1287,4927,2574,2353
2008/12/1,屏東縣,獅子鄉,1428,4949,2633,2316
2008/12/1,屏東縣,牡丹鄉,1791,4865,2537,2328
2008/12/1,臺東縣,臺東市,37374,109839,55940,53899
2008/12/1,臺東縣,成功鎮,5362,16189,8663,7526
2008/12/1,臺東縣,關山鎮,3187,9880,5219,4661
2008/12/1,臺東縣,卑南鄉,6440,18324,9996,8328
2008/12/1,臺東縣,大武鄉,2435,6890,3616,3274
2008/12/1,臺東縣,太麻里鄉,4493,12136,6530,5606
2008/12/1,臺東縣,東河鄉,3491,9532,5318,4214
2008/12/1,臺東縣,長濱鄉,2879,8611,4894,3717
2008/12/1,臺東縣,鹿野鄉,3089,8747,4751,3996
2008/12/1,臺東縣,池上鄉,3211,9366,4999,4367
2008/12/1,臺東縣,綠島鄉,938,3156,1700,1456
2008/12/1,臺東縣,延平鄉,1067,3566,1991,1575
2008/12/1,臺東縣,海端鄉,1081,4537,2478,2059
2008/12/1,臺東縣,達仁鄉,1409,3722,2069,1653
2008/12/1,臺東縣,金峰鄉,981,3329,1752,1577
2008/12/1,臺東縣,蘭嶼鄉,1256,4025,2125,1900
2008/12/1,花蓮縣,花蓮市,39801,110035,54232,55803
2008/12/1,花蓮縣,鳳林鎮,4412,12308,6556,5752
2008/12/1,花蓮縣,玉里鎮,8882,27685,15079,12606
2008/12/1,花蓮縣,新城鄉,7135,20322,10624,9698
2008/12/1,花蓮縣,吉安鄉,27968,79048,40734,38314
2008/12/1,花蓮縣,壽豐鄉,6718,19111,10362,8749
2008/12/1,花蓮縣,光復鄉,4965,14388,7713,6675
2008/12/1,花蓮縣,豐濱鄉,1804,5174,2891,2283
2008/12/1,花蓮縣,瑞穗鄉,4563,13163,7148,6015
2008/12/1,花蓮縣,富里鄉,3910,11811,6536,5275
2008/12/1,花蓮縣,秀林鄉,4501,14904,7817,7087
2008/12/1,花蓮縣,萬榮鄉,2136,7027,3745,3282
2008/12/1,花蓮縣,卓溪鄉,1638,6457,3595,2862
2008/12/1,澎湖縣,馬公市,18438,55126,28034,27092
2008/12/1,澎湖縣,湖西鄉,4430,13017,6814,6203
2008/12/1,澎湖縣,白沙鄉,2987,9202,4849,4353
2008/12/1,澎湖縣,西嶼鄉,2715,8177,4233,3944
2008/12/1,澎湖縣,望安鄉,1755,4502,2434,2068
2008/12/1,澎湖縣,七美鄉,1143,3284,1728,1556
2008/12/1,基隆市,中正區,21796,56803,29313,27490
2008/12/1,基隆市,七堵區,19380,55199,28099,27100
2008/12/1,基隆市,暖暖區,14105,38210,19514,18696
2008/12/1,基隆市,仁愛區,19299,50340,25020,25320
2008/12/1,基隆市,中山區,18740,51908,26615,25293
2008/12/1,基隆市,安樂區,31258,85117,42483,42634
2008/12/1,基隆市,信義區,19634,51402,25833,25569
2008/12/1,新竹市,東區,64512,192396,95269,97127
2008/12/1,新竹市,北區,47743,141823,70684,71139
2008/12/1,新竹市,香山區,21702,71152,36436,34716
2008/12/1,臺中市,中區,8462,23603,11654,11949
2008/12/1,臺中市,東區,25279,74072,37593,36479
2008/12/1,臺中市,西區,42102,117325,56594,60731
2008/12/1,臺中市,南區,40268,111878,54527,57351
2008/12/1,臺中市,北區,54133,147721,71998,75723
2008/12/1,臺中市,西屯區,69223,201333,98276,103057
2008/12/1,臺中市,南屯區,50082,148206,71675,76531
2008/12/1,臺中市,北屯區,79814,241990,117957,124033
2008/12/1,嘉義市,東區,44096,128284,62851,65433
2008/12/1,嘉義市,西區,49042,145509,72432,73077
2008/12/1,臺南市,東區,69198,194234,94436,99798
2008/12/1,臺南市,南區,42340,127390,64104,63286
2008/12/1,臺南市,北區,46339,130094,64519,65575
2008/12/1,臺南市,安南區,52200,175630,89671,85959
2008/12/1,臺南市,安平區,21929,60613,29085,31528
2008/12/1,臺南市,中西區,29685,80492,39752,40740
2008/12/1,臺北市,松山區,76678,210097,99694,110403
2008/12/1,臺北市,信義區,84968,227770,110435,117335
2008/12/1,臺北市,大安區,115237,313848,148315,165533
2008/12/1,臺北市,中山區,88774,218841,103630,115211
2008/12/1,臺北市,中正區,60723,159337,77129,82208
2008/12/1,臺北市,大同區,45935,124653,61723,62930
2008/12/1,臺北市,萬華區,72747,190361,95729,94632
2008/12/1,臺北市,文山區,94743,261719,127422,134297
2008/12/1,臺北市,南港區,40244,113672,56354,57318
2008/12/1,臺北市,內湖區,92788,266808,129257,137551
2008/12/1,臺北市,士林區,98339,286065,139660,146405
2008/12/1,臺北市,北投區,87257,249752,121600,128152
2008/12/1,高雄市,鹽埕區,11179,28067,14210,13857
2008/12/1,高雄市,鼓山區,48617,125641,62153,63488
2008/12/1,高雄市,左營區,71498,188671,93602,95069
2008/12/1,高雄市,楠梓區,59772,170416,84921,85495
2008/12/1,高雄市,三民區,128379,355927,175126,180801
2008/12/1,高雄市,新興區,22820,56704,27803,28901
2008/12/1,高雄市,前金區,12539,29774,14609,15165
2008/12/1,高雄市,苓雅區,70493,186765,91351,95414
2008/12/1,高雄市,前鎮區,74404,200614,100399,100215
2008/12/1,高雄市,旗津區,10756,29940,15612,14328
2008/12/1,高雄市,小港區,60709,153123,77434,75689
2008/12/1,金門縣,金城鎮,10167,28840,15154,13686
2008/12/1,金門縣,金湖鎮,6673,18720,9895,8825
2008/12/1,金門縣,金沙鎮,5014,13514,7057,6457
2008/12/1,金門縣,金寧鄉,5626,15588,8377,7211
2008/12/1,金門縣,烈嶼鄉,2383,7451,3907,3544
2008/12/1,金門縣,烏坵鄉,136,457,235,222
2008/12/1,連江縣,南竿鄉,1120,5798,3336,2462
2008/12/1,連江縣,北竿鄉,376,1762,1026,736
2008/12/1,連江縣,莒光鄉,231,1183,690,493
2008/12/1,連江縣,東引鄉,253,1012,598,414
2009/1/1,總計,臺灣地區,7625844,22951586,11576977,11374609
2009/1/1,總計,臺灣省,6096657,18803500,9549519,9253981
2009/1/1,總計,新北市,1340934,3837077,1914241,1922836
2009/1/1,總計,宜蘭縣,149840,461013,235863,225150
2009/1/1,總計,桃園市,637446,1960336,991949,968387
2009/1/1,總計,新竹縣,153027,503655,260060,243595
2009/1/1,總計,苗栗縣,166860,560616,292360,268256
2009/1/1,總計,臺中市,451396,1558611,791854,766757
2009/1/1,總計,彰化縣,353933,1313143,676117,637026
2009/1/1,總計,南投縣,166850,531810,274868,256942
2009/1/1,總計,雲林縣,223685,723700,379331,344369
2009/1/1,總計,嘉義縣,171794,548801,287329,261472
2009/1/1,總計,臺南市,359127,1104810,565763,539047
2009/1/1,總計,高雄市,420690,1243870,639251,604619
2009/1/1,總計,屏東縣,269762,884852,456673,428179
2009/1/1,總計,臺東縣,78693,231863,122013,109850
2009/1/1,總計,花蓮縣,118448,341504,177002,164502
2009/1/1,總計,澎湖縣,31538,93446,48138,45308
2009/1/1,總計,基隆市,144181,389067,196840,192227
2009/1/1,總計,新竹市,134085,405931,202537,203394
2009/1/1,總計,臺中市,369510,1066843,520423,546420
2009/1/1,總計,嘉義市,93167,273813,135249,138564
2009/1/1,總計,臺南市,261691,768739,381658,387081
2009/1/1,總計,臺北市,957954,2622090,1270259,1351831
2009/1/1,總計,高雄市,571233,1525996,757199,768797
2009/1/1,總計,福建省,32026,94591,50376,44215
2009/1/1,總計,金門縣,30028,84841,44732,40109
2009/1/1,總計,連江縣,1998,9750,5644,4106
2009/1/1,新北市,板橋區,186962,551044,273876,277168
2009/1/1,新北市,三重區,133510,385166,192927,192239
2009/1/1,新北市,永和區,88362,236684,113951,122733
2009/1/1,新北市,中和區,149687,412429,204777,207652
2009/1/1,新北市,新莊區,131607,398616,197554,201062
2009/1/1,新北市,新店區,112255,292851,144265,148586
2009/1/1,新北市,土城區,79464,238387,119655,118732
2009/1/1,新北市,蘆洲區,62698,194813,96740,98073
2009/1/1,新北市,汐止區,75473,183664,91639,92025
2009/1/1,新北市,樹林區,54950,168934,85501,83433
2009/1/1,新北市,鶯歌區,26348,86257,43921,42336
2009/1/1,新北市,三峽區,32441,98132,50460,47672
2009/1/1,新北市,淡水區,51874,135614,66436,69178
2009/1/1,新北市,瑞芳區,15581,43069,22084,20985
2009/1/1,新北市,五股區,25862,77886,39636,38250
2009/1/1,新北市,泰山區,25343,75892,38351,37541
2009/1/1,新北市,林口區,25466,73252,36477,36775
2009/1/1,新北市,深坑區,8365,22838,11608,11230
2009/1/1,新北市,石碇區,3187,7847,4381,3466
2009/1/1,新北市,坪林區,2384,6540,3666,2874
2009/1/1,新北市,三芝區,8649,23478,12181,11297
2009/1/1,新北市,石門區,3751,12037,6406,5631
2009/1/1,新北市,八里區,11335,33264,17049,16215
2009/1/1,新北市,平溪區,2332,5523,3073,2450
2009/1/1,新北市,雙溪區,3808,9863,5345,4518
2009/1/1,新北市,貢寮區,4324,13958,7249,6709
2009/1/1,新北市,金山區,6527,22301,11316,10985
2009/1/1,新北市,萬里區,6725,21128,10857,10271
2009/1/1,新北市,烏來區,1664,5610,2860,2750
2009/1/1,宜蘭縣,宜蘭市,32352,95915,47395,48520
2009/1/1,宜蘭縣,羅東鎮,24375,73690,35481,38209
2009/1/1,宜蘭縣,蘇澳鎮,13380,43652,22513,21139
2009/1/1,宜蘭縣,頭城鎮,9438,31270,16226,15044
2009/1/1,宜蘭縣,礁溪鄉,12105,35953,18919,17034
2009/1/1,宜蘭縣,壯圍鄉,7879,25058,13250,11808
2009/1/1,宜蘭縣,員山鄉,10486,32252,17327,14925
2009/1/1,宜蘭縣,冬山鄉,16635,51748,26812,24936
2009/1/1,宜蘭縣,五結鄉,12464,38517,20086,18431
2009/1/1,宜蘭縣,三星鄉,7211,21277,11539,9738
2009/1/1,宜蘭縣,大同鄉,1788,5832,3207,2625
2009/1/1,宜蘭縣,南澳鄉,1727,5849,3108,2741
2009/1/1,桃園市,桃園區,136416,397347,195240,202107
2009/1/1,桃園市,中壢區,120143,362322,181638,180684
2009/1/1,桃園市,平鎮區,63416,205371,103719,101652
2009/1/1,桃園市,八德區,54689,173822,88942,84880
2009/1/1,桃園市,大溪區,28209,91182,47077,44105
2009/1/1,桃園市,楊梅區,45551,145636,74372,71264
2009/1/1,桃園市,蘆竹區,44953,136019,68466,67553
2009/1/1,桃園市,大園區,24605,80285,41774,38511
2009/1/1,桃園市,龜山區,47327,134104,68246,65858
2009/1/1,桃園市,龍潭區,35464,113704,58051,55653
2009/1/1,桃園市,新屋區,14605,49702,26568,23134
2009/1/1,桃園市,觀音區,18454,60392,31966,28426
2009/1/1,桃園市,復興區,3614,10450,5890,4560
2009/1/1,新竹縣,竹北市,42642,132343,66655,65688
2009/1/1,新竹縣,關西鎮,8998,32456,17333,15123
2009/1/1,新竹縣,新埔鎮,10098,36106,19151,16955
2009/1/1,新竹縣,竹東鎮,29540,97163,49065,48098
2009/1/1,新竹縣,湖口鄉,22629,75155,38469,36686
2009/1/1,新竹縣,橫山鄉,4241,14583,7909,6674
2009/1/1,新竹縣,新豐鄉,14964,52326,27151,25175
2009/1/1,新竹縣,芎林鄉,6104,20858,10977,9881
2009/1/1,新竹縣,寶山鄉,4513,13759,7423,6336
2009/1/1,新竹縣,北埔鄉,3038,10267,5554,4713
2009/1/1,新竹縣,峨眉鄉,2005,6075,3364,2711
2009/1/1,新竹縣,尖石鄉,2597,8148,4502,3646
2009/1/1,新竹縣,五峰鄉,1658,4416,2507,1909
2009/1/1,苗栗縣,苗栗市,28377,91156,46095,45061
2009/1/1,苗栗縣,苑裡鎮,13507,49074,25687,23387
2009/1/1,苗栗縣,通霄鎮,11057,38783,20707,18076
2009/1/1,苗栗縣,竹南鎮,22658,76358,38932,37426
2009/1/1,苗栗縣,頭份市,28203,95786,49009,46777
2009/1/1,苗栗縣,後龍鎮,11473,40084,21242,18842
2009/1/1,苗栗縣,卓蘭鎮,5829,18411,9758,8653
2009/1/1,苗栗縣,大湖鄉,5213,16166,8717,7449
2009/1/1,苗栗縣,公館鄉,9821,34752,18293,16459
2009/1/1,苗栗縣,銅鑼鄉,5870,19615,10441,9174
2009/1/1,苗栗縣,南庄鄉,3872,11314,6269,5045
2009/1/1,苗栗縣,頭屋鄉,3467,11685,6195,5490
2009/1/1,苗栗縣,三義鄉,5155,17633,9345,8288
2009/1/1,苗栗縣,西湖鄉,2622,7941,4407,3534
2009/1/1,苗栗縣,造橋鄉,3895,13705,7275,6430
2009/1/1,苗栗縣,三灣鄉,2331,7411,4033,3378
2009/1/1,苗栗縣,獅潭鄉,1648,5042,2829,2213
2009/1/1,苗栗縣,泰安鄉,1862,5700,3126,2574
2009/1/1,臺中市,豐原區,48069,165327,82317,83010
2009/1/1,臺中市,大里區,59250,194751,96874,97877
2009/1/1,臺中市,太平區,52969,172433,86805,85628
2009/1/1,臺中市,東勢區,16666,54193,28189,26004
2009/1/1,臺中市,大甲區,21102,78873,40057,38816
2009/1/1,臺中市,清水區,24276,85795,44382,41413
2009/1/1,臺中市,沙鹿區,22292,79662,40570,39092
2009/1/1,臺中市,梧棲區,15577,54768,27870,26898
2009/1/1,臺中市,后里區,14402,54544,28177,26367
2009/1/1,臺中市,神岡區,17169,64182,33131,31051
2009/1/1,臺中市,潭子區,31024,98471,49330,49141
2009/1/1,臺中市,大雅區,25414,88900,44958,43942
2009/1/1,臺中市,新社區,7213,25836,13656,12180
2009/1/1,臺中市,石岡區,4743,16159,8430,7729
2009/1/1,臺中市,外埔區,8512,32011,16513,15498
2009/1/1,臺中市,大安區,5161,20639,10884,9755
2009/1/1,臺中市,烏日區,19536,68016,34542,33474
2009/1/1,臺中市,大肚區,15408,56000,28788,27212
2009/1/1,臺中市,龍井區,19785,73062,37397,35665
2009/1/1,臺中市,霧峰區,18363,64188,33051,31137
2009/1/1,臺中市,和平區,4465,10801,5933,4868
2009/1/1,彰化縣,彰化市,69792,236729,118391,118338
2009/1/1,彰化縣,鹿港鎮,21576,85358,43828,41530
2009/1/1,彰化縣,和美鎮,23351,89450,45989,43461
2009/1/1,彰化縣,北斗鎮,9633,33610,17088,16522
2009/1/1,彰化縣,員林市,35645,125931,63497,62434
2009/1/1,彰化縣,溪湖鎮,14716,56424,28926,27498
2009/1/1,彰化縣,田中鎮,12274,44781,23511,21270
2009/1/1,彰化縣,二林鎮,14027,54839,28307,26532
2009/1/1,彰化縣,線西鄉,3991,17033,8779,8254
2009/1/1,彰化縣,伸港鄉,8684,35836,18473,17363
2009/1/1,彰化縣,福興鄉,11699,49052,25711,23341
2009/1/1,彰化縣,秀水鄉,9404,38981,20225,18756
2009/1/1,彰化縣,花壇鄉,12551,46188,23880,22308
2009/1/1,彰化縣,芬園鄉,6786,25087,13313,11774
2009/1/1,彰化縣,大村鄉,9936,36491,19073,17418
2009/1/1,彰化縣,埔鹽鄉,8596,34677,18248,16429
2009/1/1,彰化縣,埔心鄉,9685,35505,18449,17056
2009/1/1,彰化縣,永靖鄉,10164,39580,20601,18979
2009/1/1,彰化縣,社頭鄉,12077,45227,23321,21906
2009/1/1,彰化縣,二水鄉,5233,16909,8942,7967
2009/1/1,彰化縣,田尾鄉,7541,28924,15105,13819
2009/1/1,彰化縣,埤頭鄉,8360,32027,16787,15240
2009/1/1,彰化縣,芳苑鄉,9859,36761,19516,17245
2009/1/1,彰化縣,大城鄉,5298,19098,10409,8689
2009/1/1,彰化縣,竹塘鄉,4501,16612,8796,7816
2009/1/1,彰化縣,溪州鄉,8554,32033,16952,15081
2009/1/1,南投縣,南投市,32573,105140,53054,52086
2009/1/1,南投縣,埔里鎮,27806,86173,43642,42531
2009/1/1,南投縣,草屯鎮,30094,100213,50836,49377
2009/1/1,南投縣,竹山鎮,18437,58995,30518,28477
2009/1/1,南投縣,集集鎮,4171,12046,6341,5705
2009/1/1,南投縣,名間鄉,11854,41605,21936,19669
2009/1/1,南投縣,鹿谷鄉,6449,19417,10357,9060
2009/1/1,南投縣,中寮鄉,5522,16438,8956,7482
2009/1/1,南投縣,魚池鄉,5722,17351,9213,8138
2009/1/1,南投縣,國姓鄉,7127,21201,11646,9555
2009/1/1,南投縣,水里鄉,7160,20584,10851,9733
2009/1/1,南投縣,信義鄉,5064,17173,9344,7829
2009/1/1,南投縣,仁愛鄉,4871,15474,8174,7300
2009/1/1,雲林縣,斗六市,33444,106281,53704,52577
2009/1/1,雲林縣,斗南鎮,14906,47624,24223,23401
2009/1/1,雲林縣,虎尾鎮,21622,69895,35667,34228
2009/1/1,雲林縣,西螺鎮,13746,48941,24934,24007
2009/1/1,雲林縣,土庫鎮,8533,30940,16205,14735
2009/1/1,雲林縣,北港鎮,14932,43753,22797,20956
2009/1/1,雲林縣,古坑鄉,10442,34964,18545,16419
2009/1/1,雲林縣,大埤鄉,6530,21679,11570,10109
2009/1/1,雲林縣,莿桐鄉,8833,30757,16151,14606
2009/1/1,雲林縣,林內鄉,5596,20105,10533,9572
2009/1/1,雲林縣,二崙鄉,8674,30281,16282,13999
2009/1/1,雲林縣,崙背鄉,8221,27963,14816,13147
2009/1/1,雲林縣,麥寮鄉,11690,34276,18172,16104
2009/1/1,雲林縣,東勢鄉,5662,17333,9462,7871
2009/1/1,雲林縣,褒忠鄉,4230,14617,7818,6799
2009/1/1,雲林縣,臺西鄉,8653,26897,14508,12389
2009/1/1,雲林縣,元長鄉,9201,29373,16060,13313
2009/1/1,雲林縣,四湖鄉,8945,27464,15055,12409
2009/1/1,雲林縣,口湖鄉,9515,30998,16595,14403
2009/1/1,雲林縣,水林鄉,10310,29559,16234,13325
2009/1/1,嘉義縣,太保市,10698,35891,18621,17270
2009/1/1,嘉義縣,朴子市,13949,44294,22705,21589
2009/1/1,嘉義縣,布袋鎮,9998,30889,15959,14930
2009/1/1,嘉義縣,大林鎮,11006,34108,17583,16525
2009/1/1,嘉義縣,民雄鄉,22037,72711,37477,35234
2009/1/1,嘉義縣,溪口鄉,5328,16684,8926,7758
2009/1/1,嘉義縣,新港鄉,10179,35155,18552,16603
2009/1/1,嘉義縣,六腳鄉,9059,27040,14353,12687
2009/1/1,嘉義縣,東石鄉,9216,28419,15161,13258
2009/1/1,嘉義縣,義竹鄉,7383,21673,11270,10403
2009/1/1,嘉義縣,鹿草鄉,5624,17415,9352,8063
2009/1/1,嘉義縣,水上鄉,17207,53094,27591,25503
2009/1/1,嘉義縣,中埔鄉,14781,47881,25086,22795
2009/1/1,嘉義縣,竹崎鄉,11120,39156,20893,18263
2009/1/1,嘉義縣,梅山鄉,6469,22165,11776,10389
2009/1/1,嘉義縣,番路鄉,3821,11618,6344,5274
2009/1/1,嘉義縣,大埔鄉,1948,4430,2359,2071
2009/1/1,嘉義縣,阿里山鄉,1971,6178,3321,2857
2009/1/1,臺南市,新營區,26487,78704,39501,39203
2009/1/1,臺南市,永康區,71763,212747,106213,106534
2009/1/1,臺南市,鹽水區,9730,27578,14364,13214
2009/1/1,臺南市,白河區,10816,31938,16843,15095
2009/1/1,臺南市,麻豆區,14523,46136,23639,22497
2009/1/1,臺南市,佳里區,18752,59328,29649,29679
2009/1/1,臺南市,新化區,13323,44495,22877,21618
2009/1/1,臺南市,善化區,13960,43050,21897,21153
2009/1/1,臺南市,學甲區,9261,28302,14528,13774
2009/1/1,臺南市,柳營區,7690,23145,12123,11022
2009/1/1,臺南市,後壁區,8582,26282,13729,12553
2009/1/1,臺南市,東山區,8098,23522,12574,10948
2009/1/1,臺南市,下營區,8952,26613,13816,12797
2009/1/1,臺南市,六甲區,7486,24223,12610,11613
2009/1/1,臺南市,官田區,7506,22526,11620,10906
2009/1/1,臺南市,大內區,4037,11193,5972,5221
2009/1/1,臺南市,西港區,7638,25411,12993,12418
2009/1/1,臺南市,七股區,7811,25119,13150,11969
2009/1/1,臺南市,將軍區,7312,21994,11226,10768
2009/1/1,臺南市,北門區,4213,12528,6433,6095
2009/1/1,臺南市,新市區,10538,35254,17770,17484
2009/1/1,臺南市,安定區,8937,30081,15629,14452
2009/1/1,臺南市,山上區,2702,8041,4244,3797
2009/1/1,臺南市,玉井區,5032,15694,8152,7542
2009/1/1,臺南市,楠西區,3587,10864,5781,5083
2009/1/1,臺南市,南化區,2832,8985,4925,4060
2009/1/1,臺南市,左鎮區,1953,5579,3106,2473
2009/1/1,臺南市,仁德區,23717,68536,35328,33208
2009/1/1,臺南市,歸仁區,19783,65764,33563,32201
2009/1/1,臺南市,關廟區,10512,36697,19071,17626
2009/1/1,臺南市,龍崎區,1594,4481,2437,2044
2009/1/1,高雄市,鳳山區,122919,339293,169853,169440
2009/1/1,高雄市,岡山區,32348,96779,48865,47914
2009/1/1,高雄市,旗山區,13585,40727,21292,19435
2009/1/1,高雄市,美濃區,13762,43733,22876,20857
2009/1/1,高雄市,林園區,23537,70961,36578,34383
2009/1/1,高雄市,大寮區,37209,109676,57267,52409
2009/1/1,高雄市,大樹區,12919,44584,23108,21476
2009/1/1,高雄市,仁武區,23952,69057,35688,33369
2009/1/1,高雄市,大社區,11406,32866,16951,15915
2009/1/1,高雄市,鳥松區,15877,41771,21302,20469
2009/1/1,高雄市,橋頭區,12283,36434,18756,17678
2009/1/1,高雄市,燕巢區,9768,31222,16690,14532
2009/1/1,高雄市,田寮區,3560,8439,4684,3755
2009/1/1,高雄市,阿蓮區,8995,30714,15529,15185
2009/1/1,高雄市,路竹區,15682,54374,27815,26559
2009/1/1,高雄市,湖內區,9200,28610,14800,13810
2009/1/1,高雄市,茄萣區,10007,31767,16655,15112
2009/1/1,高雄市,永安區,5697,14138,7261,6877
2009/1/1,高雄市,彌陀區,6469,20732,10837,9895
2009/1/1,高雄市,梓官區,11659,36961,19357,17604
2009/1/1,高雄市,六龜區,5669,15442,8391,7051
2009/1/1,高雄市,甲仙區,2557,8096,4354,3742
2009/1/1,高雄市,杉林區,4009,11189,6148,5041
2009/1/1,高雄市,內門區,4982,16300,8915,7385
2009/1/1,高雄市,茂林區,529,1781,916,865
2009/1/1,高雄市,桃源區,1233,4754,2545,2209
2009/1/1,高雄市,那瑪夏區,877,3470,1818,1652
2009/1/1,屏東縣,屏東市,71507,215090,107571,107519
2009/1/1,屏東縣,潮州鎮,17791,56724,28643,28081
2009/1/1,屏東縣,東港鎮,14862,50342,25628,24714
2009/1/1,屏東縣,恆春鎮,10436,31130,16109,15021
2009/1/1,屏東縣,萬丹鄉,13898,54495,28248,26247
2009/1/1,屏東縣,長治鄉,9550,30969,16274,14695
2009/1/1,屏東縣,麟洛鄉,3486,11620,6032,5588
2009/1/1,屏東縣,九如鄉,6458,23075,12035,11040
2009/1/1,屏東縣,里港鄉,7793,26332,13528,12804
2009/1/1,屏東縣,鹽埔鄉,7550,27570,14359,13211
2009/1/1,屏東縣,高樹鄉,9514,27319,14614,12705
2009/1/1,屏東縣,萬巒鄉,6308,22449,11865,10584
2009/1/1,屏東縣,內埔鄉,17437,59142,30919,28223
2009/1/1,屏東縣,竹田鄉,5404,18510,9883,8627
2009/1/1,屏東縣,新埤鄉,3290,10909,5773,5136
2009/1/1,屏東縣,枋寮鄉,8296,27151,14417,12734
2009/1/1,屏東縣,新園鄉,10942,39178,20284,18894
2009/1/1,屏東縣,崁頂鄉,4032,17057,8792,8265
2009/1/1,屏東縣,林邊鄉,6230,21101,10938,10163
2009/1/1,屏東縣,南州鄉,3594,12002,6194,5808
2009/1/1,屏東縣,佳冬鄉,6626,21732,11370,10362
2009/1/1,屏東縣,琉球鄉,3815,12550,6954,5596
2009/1/1,屏東縣,車城鄉,3435,9944,5364,4580
2009/1/1,屏東縣,滿州鄉,2992,8533,4689,3844
2009/1/1,屏東縣,枋山鄉,2093,6171,3304,2867
2009/1/1,屏東縣,三地門鄉,2041,7318,3756,3562
2009/1/1,屏東縣,霧臺鄉,873,2676,1435,1241
2009/1/1,屏東縣,瑪家鄉,1801,6421,3351,3070
2009/1/1,屏東縣,泰武鄉,1114,4915,2625,2290
2009/1/1,屏東縣,來義鄉,2083,7700,3987,3713
2009/1/1,屏東縣,春日鄉,1289,4933,2575,2358
2009/1/1,屏東縣,獅子鄉,1429,4931,2616,2315
2009/1/1,屏東縣,牡丹鄉,1793,4863,2541,2322
2009/1/1,臺東縣,臺東市,37368,109851,55929,53922
2009/1/1,臺東縣,成功鎮,5364,16171,8659,7512
2009/1/1,臺東縣,關山鎮,3187,9874,5210,4664
2009/1/1,臺東縣,卑南鄉,6443,18339,9989,8350
2009/1/1,臺東縣,大武鄉,2434,6896,3614,3282
2009/1/1,臺東縣,太麻里鄉,4492,12134,6530,5604
2009/1/1,臺東縣,東河鄉,3488,9525,5314,4211
2009/1/1,臺東縣,長濱鄉,2882,8599,4891,3708
2009/1/1,臺東縣,鹿野鄉,3092,8767,4762,4005
2009/1/1,臺東縣,池上鄉,3209,9352,4992,4360
2009/1/1,臺東縣,綠島鄉,938,3155,1701,1454
2009/1/1,臺東縣,延平鄉,1070,3562,1992,1570
2009/1/1,臺東縣,海端鄉,1080,4547,2478,2069
2009/1/1,臺東縣,達仁鄉,1408,3723,2071,1652
2009/1/1,臺東縣,金峰鄉,982,3340,1756,1584
2009/1/1,臺東縣,蘭嶼鄉,1256,4028,2125,1903
2009/1/1,花蓮縣,花蓮市,39792,110041,54231,55810
2009/1/1,花蓮縣,鳳林鎮,4418,12314,6556,5758
2009/1/1,花蓮縣,玉里鎮,8889,27673,15073,12600
2009/1/1,花蓮縣,新城鄉,7155,20368,10634,9734
2009/1/1,花蓮縣,吉安鄉,27976,79109,40737,38372
2009/1/1,花蓮縣,壽豐鄉,6724,19119,10361,8758
2009/1/1,花蓮縣,光復鄉,4956,14379,7704,6675
2009/1/1,花蓮縣,豐濱鄉,1803,5171,2888,2283
2009/1/1,花蓮縣,瑞穗鄉,4558,13135,7125,6010
2009/1/1,花蓮縣,富里鄉,3910,11813,6527,5286
2009/1/1,花蓮縣,秀林鄉,4499,14890,7812,7078
2009/1/1,花蓮縣,萬榮鄉,2132,7029,3747,3282
2009/1/1,花蓮縣,卓溪鄉,1636,6463,3607,2856
2009/1/1,澎湖縣,馬公市,18484,55195,28051,27144
2009/1/1,澎湖縣,湖西鄉,4434,13050,6828,6222
2009/1/1,澎湖縣,白沙鄉,2998,9208,4849,4359
2009/1/1,澎湖縣,西嶼鄉,2719,8195,4243,3952
2009/1/1,澎湖縣,望安鄉,1756,4502,2432,2070
2009/1/1,澎湖縣,七美鄉,1147,3296,1735,1561
2009/1/1,基隆市,中正區,21772,56762,29281,27481
2009/1/1,基隆市,七堵區,19390,55229,28090,27139
2009/1/1,基隆市,暖暖區,14091,38210,19503,18707
2009/1/1,基隆市,仁愛區,19321,50405,25047,25358
2009/1/1,基隆市,中山區,18727,51915,26605,25310
2009/1/1,基隆市,安樂區,31242,85104,42482,42622
2009/1/1,基隆市,信義區,19638,51442,25832,25610
2009/1/1,新竹市,東區,64574,192664,95368,97296
2009/1/1,新竹市,北區,47790,142036,70724,71312
2009/1/1,新竹市,香山區,21721,71231,36445,34786
2009/1/1,臺中市,中區,8462,23569,11617,11952
2009/1/1,臺中市,東區,25279,74109,37589,36520
2009/1/1,臺中市,西區,42107,117364,56581,60783
2009/1/1,臺中市,南區,40275,111931,54546,57385
2009/1/1,臺中市,北區,54119,147679,71955,75724
2009/1/1,臺中市,西屯區,69251,201456,98313,103143
2009/1/1,臺中市,南屯區,50125,148461,71766,76695
2009/1/1,臺中市,北屯區,79892,242274,118056,124218
2009/1/1,嘉義市,東區,44101,128280,62826,65454
2009/1/1,嘉義市,西區,49066,145533,72423,73110
2009/1/1,臺南市,東區,69220,194273,94456,99817
2009/1/1,臺南市,南區,42331,127437,64114,63323
2009/1/1,臺南市,北區,46306,130163,64539,65624
2009/1/1,臺南市,安南區,52235,175734,89730,86004
2009/1/1,臺南市,安平區,21912,60628,29079,31549
2009/1/1,臺南市,中西區,29687,80504,39740,40764
2009/1/1,臺北市,松山區,76598,209944,99615,110329
2009/1/1,臺北市,信義區,84929,227686,110357,117329
2009/1/1,臺北市,大安區,115072,313451,148111,165340
2009/1/1,臺北市,中山區,88703,218744,103550,115194
2009/1/1,臺北市,中正區,60681,159257,77051,82206
2009/1/1,臺北市,大同區,45981,124724,61743,62981
2009/1/1,臺北市,萬華區,72721,190432,95711,94721
2009/1/1,臺北市,文山區,94720,261728,127384,134344
2009/1/1,臺北市,南港區,40226,113657,56338,57319
2009/1/1,臺北市,內湖區,92788,266857,129263,137594
2009/1/1,臺北市,士林區,98267,285914,139575,146339
2009/1/1,臺北市,北投區,87268,249696,121561,128135
2009/1/1,高雄市,鹽埕區,11158,28018,14183,13835
2009/1/1,高雄市,鼓山區,48666,125790,62216,63574
2009/1/1,高雄市,左營區,71523,188866,93654,95212
2009/1/1,高雄市,楠梓區,59801,170540,84980,85560
2009/1/1,高雄市,三民區,128327,355933,175045,180888
2009/1/1,高雄市,新興區,22815,56673,27781,28892
2009/1/1,高雄市,前金區,12532,29789,14616,15173
2009/1/1,高雄市,苓雅區,70465,186673,91317,95356
2009/1/1,高雄市,前鎮區,74391,200628,100392,100236
2009/1/1,高雄市,旗津區,10763,29924,15587,14337
2009/1/1,高雄市,小港區,60792,153162,77428,75734
2009/1/1,金門縣,金城鎮,10163,28894,15156,13738
2009/1/1,金門縣,金湖鎮,6675,18794,9919,8875
2009/1/1,金門縣,金沙鎮,5018,13537,7068,6469
2009/1/1,金門縣,金寧鄉,5648,15687,8439,7248
2009/1/1,金門縣,烈嶼鄉,2388,7469,3913,3556
2009/1/1,金門縣,烏坵鄉,136,460,237,223
2009/1/1,連江縣,南竿鄉,1130,5801,3342,2459
2009/1/1,連江縣,北竿鄉,381,1762,1021,741
2009/1/1,連江縣,莒光鄉,233,1174,682,492
2009/1/1,連江縣,東引鄉,254,1013,599,414
2009/2/1,總計,臺灣地區,7637866,22954084,11575401,11378683
2009/2/1,總計,臺灣省,6107153,18807683,9549312,9258371
2009/2/1,總計,新北市,1343503,3840405,1915320,1925085
2009/2/1,總計,宜蘭縣,149960,460742,235666,225076
2009/2/1,總計,桃園市,638810,1961825,992487,969338
2009/2/1,總計,新竹縣,153535,504169,260240,243929
2009/2/1,總計,苗栗縣,167158,560548,292270,268278
2009/2/1,總計,臺中市,452221,1558862,791838,767024
2009/2/1,總計,彰化縣,354467,1312975,675891,637084
2009/2/1,總計,南投縣,167110,531733,274724,257009
2009/2/1,總計,雲林縣,224085,723449,379114,344335
2009/2/1,總計,嘉義縣,172018,548352,287062,261290
2009/2/1,總計,臺南市,359672,1104335,565423,538912
2009/2/1,總計,高雄市,421139,1243665,639068,604597
2009/2/1,總計,屏東縣,270154,884484,456353,428131
2009/2/1,總計,臺東縣,78741,231794,121894,109900
2009/2/1,總計,花蓮縣,118605,341263,176856,164407
2009/2/1,總計,澎湖縣,31690,93701,48275,45426
2009/2/1,總計,基隆市,144298,388787,196675,192112
2009/2/1,總計,新竹市,134469,406471,202748,203723
2009/2/1,總計,臺中市,370066,1067366,520560,546806
2009/2/1,總計,嘉義市,93297,273866,135228,138638
2009/2/1,總計,臺南市,262155,768891,381620,387271
2009/2/1,總計,臺北市,958573,2620273,1269131,1351142
2009/2/1,總計,高雄市,572140,1526128,756958,769170
2009/2/1,總計,福建省,32226,95323,50660,44663
2009/2/1,總計,金門縣,30219,85555,45001,40554
2009/2/1,總計,連江縣,2007,9768,5659,4109
2009/2/1,新北市,板橋區,187147,551122,273849,277273
2009/2/1,新北市,三重區,133773,385450,192979,192471
2009/2/1,新北市,永和區,88502,236888,114004,122884
2009/2/1,新北市,中和區,150028,412785,204967,207818
2009/2/1,新北市,新莊區,131852,398860,197611,201249
2009/2/1,新北市,新店區,112377,292826,144182,148644
2009/2/1,新北市,土城區,79564,238417,119658,118759
2009/2/1,新北市,蘆洲區,62838,194958,96811,98147
2009/2/1,新北市,汐止區,75568,183938,91749,92189
2009/2/1,新北市,樹林區,55138,169282,85667,83615
2009/2/1,新北市,鶯歌區,26367,86282,43915,42367
2009/2/1,新北市,三峽區,32482,98311,50544,47767
2009/2/1,新北市,淡水區,52085,135946,66554,69392
2009/2/1,新北市,瑞芳區,15597,43060,22068,20992
2009/2/1,新北市,五股區,25878,77926,39647,38279
2009/2/1,新北市,泰山區,25397,76015,38399,37616
2009/2/1,新北市,林口區,25749,73851,36753,37098
2009/2/1,新北市,深坑區,8371,22835,11581,11254
2009/2/1,新北市,石碇區,3206,7865,4388,3477
2009/2/1,新北市,坪林區,2388,6543,3666,2877
2009/2/1,新北市,三芝區,8657,23435,12154,11281
2009/2/1,新北市,石門區,3767,12089,6426,5663
2009/2/1,新北市,八里區,11368,33317,17071,16246
2009/2/1,新北市,平溪區,2332,5513,3066,2447
2009/2/1,新北市,雙溪區,3810,9844,5331,4513
2009/2/1,新北市,貢寮區,4325,13930,7229,6701
2009/2/1,新北市,金山區,6526,22334,11325,11009
2009/2/1,新北市,萬里區,6741,21153,10860,10293
2009/2/1,新北市,烏來區,1670,5630,2866,2764
2009/2/1,宜蘭縣,宜蘭市,32361,95869,47367,48502
2009/2/1,宜蘭縣,羅東鎮,24403,73644,35455,38189
2009/2/1,宜蘭縣,蘇澳鎮,13371,43548,22447,21101
2009/2/1,宜蘭縣,頭城鎮,9445,31208,16193,15015
2009/2/1,宜蘭縣,礁溪鄉,12075,35879,18866,17013
2009/2/1,宜蘭縣,壯圍鄉,7898,25062,13242,11820
2009/2/1,宜蘭縣,員山鄉,10501,32273,17327,14946
2009/2/1,宜蘭縣,冬山鄉,16678,51773,26811,24962
2009/2/1,宜蘭縣,五結鄉,12503,38529,20099,18430
2009/2/1,宜蘭縣,三星鄉,7211,21254,11532,9722
2009/2/1,宜蘭縣,大同鄉,1785,5852,3219,2633
2009/2/1,宜蘭縣,南澳鄉,1729,5851,3108,2743
2009/2/1,桃園市,桃園區,136652,397529,195307,202222
2009/2/1,桃園市,中壢區,120407,362499,181704,180795
2009/2/1,桃園市,平鎮區,63542,205468,103726,101742
2009/2/1,桃園市,八德區,54785,173870,88940,84930
2009/2/1,桃園市,大溪區,28241,91158,47068,44090
2009/2/1,桃園市,楊梅區,45689,145896,74472,71424
2009/2/1,桃園市,蘆竹區,45108,136362,68607,67755
2009/2/1,桃園市,大園區,24658,80401,41831,38570
2009/2/1,桃園市,龜山區,47431,134276,68307,65969
2009/2/1,桃園市,龍潭區,35546,113806,58088,55718
2009/2/1,桃園市,新屋區,14644,49688,26557,23131
2009/2/1,桃園市,觀音區,18497,60454,32007,28447
2009/2/1,桃園市,復興區,3610,10418,5873,4545
2009/2/1,新竹縣,竹北市,42893,132783,66860,65923
2009/2/1,新竹縣,關西鎮,9009,32455,17320,15135
2009/2/1,新竹縣,新埔鎮,10119,36074,19128,16946
2009/2/1,新竹縣,竹東鎮,29611,97124,49033,48091
2009/2/1,新竹縣,湖口鄉,22692,75201,38481,36720
2009/2/1,新竹縣,橫山鄉,4248,14587,7911,6676
2009/2/1,新竹縣,新豐鄉,15013,52357,27159,25198
2009/2/1,新竹縣,芎林鄉,6113,20861,10982,9879
2009/2/1,新竹縣,寶山鄉,4520,13796,7429,6367
2009/2/1,新竹縣,北埔鄉,3045,10274,5555,4719
2009/2/1,新竹縣,峨眉鄉,2010,6074,3371,2703
2009/2/1,新竹縣,尖石鄉,2601,8176,4514,3662
2009/2/1,新竹縣,五峰鄉,1661,4407,2497,1910
2009/2/1,苗栗縣,苗栗市,28400,91109,46050,45059
2009/2/1,苗栗縣,苑裡鎮,13531,49035,25679,23356
2009/2/1,苗栗縣,通霄鎮,11078,38769,20693,18076
2009/2/1,苗栗縣,竹南鎮,22705,76446,38988,37458
2009/2/1,苗栗縣,頭份市,28274,95768,48994,46774
2009/2/1,苗栗縣,後龍鎮,11488,40042,21203,18839
2009/2/1,苗栗縣,卓蘭鎮,5839,18421,9760,8661
2009/2/1,苗栗縣,大湖鄉,5227,16175,8723,7452
2009/2/1,苗栗縣,公館鄉,9847,34775,18307,16468
2009/2/1,苗栗縣,銅鑼鄉,5873,19621,10443,9178
2009/2/1,苗栗縣,南庄鄉,3883,11295,6251,5044
2009/2/1,苗栗縣,頭屋鄉,3473,11672,6185,5487
2009/2/1,苗栗縣,三義鄉,5160,17637,9347,8290
2009/2/1,苗栗縣,西湖鄉,2627,7946,4404,3542
2009/2/1,苗栗縣,造橋鄉,3897,13692,7268,6424
2009/2/1,苗栗縣,三灣鄉,2336,7414,4030,3384
2009/2/1,苗栗縣,獅潭鄉,1646,5032,2828,2204
2009/2/1,苗栗縣,泰安鄉,1874,5699,3117,2582
2009/2/1,臺中市,豐原區,48144,165333,82335,82998
2009/2/1,臺中市,大里區,59414,194960,96967,97993
2009/2/1,臺中市,太平區,53028,172329,86714,85615
2009/2/1,臺中市,東勢區,16681,54124,28164,25960
2009/2/1,臺中市,大甲區,21147,78962,40099,38863
2009/2/1,臺中市,清水區,24300,85777,44361,41416
2009/2/1,臺中市,沙鹿區,22358,79754,40631,39123
2009/2/1,臺中市,梧棲區,15591,54809,27879,26930
2009/2/1,臺中市,后里區,14437,54535,28156,26379
2009/2/1,臺中市,神岡區,17208,64137,33111,31026
2009/2/1,臺中市,潭子區,31110,98631,49391,49240
2009/2/1,臺中市,大雅區,25489,89020,45010,44010
2009/2/1,臺中市,新社區,7216,25835,13639,12196
2009/2/1,臺中市,石岡區,4743,16150,8425,7725
2009/2/1,臺中市,外埔區,8542,32011,16509,15502
2009/2/1,臺中市,大安區,5153,20560,10839,9721
2009/2/1,臺中市,烏日區,19576,68043,34538,33505
2009/2/1,臺中市,大肚區,15427,56001,28774,27227
2009/2/1,臺中市,龍井區,19821,72955,37350,35605
2009/2/1,臺中市,霧峰區,18363,64121,33008,31113
2009/2/1,臺中市,和平區,4473,10815,5938,4877
2009/2/1,彰化縣,彰化市,69847,236762,118386,118376
2009/2/1,彰化縣,鹿港鎮,21613,85356,43809,41547
2009/2/1,彰化縣,和美鎮,23395,89472,45987,43485
2009/2/1,彰化縣,北斗鎮,9645,33596,17091,16505
2009/2/1,彰化縣,員林市,35697,126046,63539,62507
2009/2/1,彰化縣,溪湖鎮,14744,56449,28922,27527
2009/2/1,彰化縣,田中鎮,12302,44818,23520,21298
2009/2/1,彰化縣,二林鎮,14041,54816,28283,26533
2009/2/1,彰化縣,線西鄉,4000,17027,8778,8249
2009/2/1,彰化縣,伸港鄉,8692,35825,18477,17348
2009/2/1,彰化縣,福興鄉,11711,49045,25720,23325
2009/2/1,彰化縣,秀水鄉,9423,38983,20226,18757
2009/2/1,彰化縣,花壇鄉,12603,46205,23878,22327
2009/2/1,彰化縣,芬園鄉,6785,25079,13318,11761
2009/2/1,彰化縣,大村鄉,9962,36478,19067,17411
2009/2/1,彰化縣,埔鹽鄉,8600,34582,18179,16403
2009/2/1,彰化縣,埔心鄉,9718,35462,18438,17024
2009/2/1,彰化縣,永靖鄉,10192,39556,20578,18978
2009/2/1,彰化縣,社頭鄉,12083,45186,23296,21890
2009/2/1,彰化縣,二水鄉,5247,16895,8930,7965
2009/2/1,彰化縣,田尾鄉,7538,28897,15101,13796
2009/2/1,彰化縣,埤頭鄉,8368,31995,16767,15228
2009/2/1,彰化縣,芳苑鄉,9876,36708,19486,17222
2009/2/1,彰化縣,大城鄉,5309,19093,10405,8688
2009/2/1,彰化縣,竹塘鄉,4501,16616,8781,7835
2009/2/1,彰化縣,溪州鄉,8575,32028,16929,15099
2009/2/1,南投縣,南投市,32632,105138,53044,52094
2009/2/1,南投縣,埔里鎮,27828,86170,43601,42569
2009/2/1,南投縣,草屯鎮,30155,100237,50841,49396
2009/2/1,南投縣,竹山鎮,18458,58983,30515,28468
2009/2/1,南投縣,集集鎮,4182,12053,6341,5712
2009/2/1,南投縣,名間鄉,11871,41619,21937,19682
2009/2/1,南投縣,鹿谷鄉,6469,19398,10340,9058
2009/2/1,南投縣,中寮鄉,5526,16417,8948,7469
2009/2/1,南投縣,魚池鄉,5738,17346,9208,8138
2009/2/1,南投縣,國姓鄉,7138,21137,11602,9535
2009/2/1,南投縣,水里鄉,7159,20570,10832,9738
2009/2/1,南投縣,信義鄉,5075,17178,9336,7842
2009/2/1,南投縣,仁愛鄉,4879,15487,8179,7308
2009/2/1,雲林縣,斗六市,33511,106261,53684,52577
2009/2/1,雲林縣,斗南鎮,14930,47646,24233,23413
2009/2/1,雲林縣,虎尾鎮,21681,69985,35696,34289
2009/2/1,雲林縣,西螺鎮,13767,48981,24946,24035
2009/2/1,雲林縣,土庫鎮,8545,30914,16171,14743
2009/2/1,雲林縣,北港鎮,14942,43766,22808,20958
2009/2/1,雲林縣,古坑鄉,10453,34898,18524,16374
2009/2/1,雲林縣,大埤鄉,6545,21659,11561,10098
2009/2/1,雲林縣,莿桐鄉,8857,30740,16132,14608
2009/2/1,雲林縣,林內鄉,5601,20065,10508,9557
2009/2/1,雲林縣,二崙鄉,8679,30207,16247,13960
2009/2/1,雲林縣,崙背鄉,8226,27955,14788,13167
2009/2/1,雲林縣,麥寮鄉,11741,34316,18182,16134
2009/2/1,雲林縣,東勢鄉,5673,17309,9450,7859
2009/2/1,雲林縣,褒忠鄉,4233,14596,7819,6777
2009/2/1,雲林縣,臺西鄉,8679,26889,14509,12380
2009/2/1,雲林縣,元長鄉,9224,29363,16057,13306
2009/2/1,雲林縣,四湖鄉,8958,27420,15025,12395
2009/2/1,雲林縣,口湖鄉,9535,30961,16569,14392
2009/2/1,雲林縣,水林鄉,10305,29518,16205,13313
2009/2/1,嘉義縣,太保市,10725,35913,18634,17279
2009/2/1,嘉義縣,朴子市,13978,44316,22721,21595
2009/2/1,嘉義縣,布袋鎮,10009,30813,15911,14902
2009/2/1,嘉義縣,大林鎮,11021,34070,17554,16516
2009/2/1,嘉義縣,民雄鄉,22080,72719,37490,35229
2009/2/1,嘉義縣,溪口鄉,5331,16638,8899,7739
2009/2/1,嘉義縣,新港鄉,10186,35136,18533,16603
2009/2/1,嘉義縣,六腳鄉,9068,27008,14328,12680
2009/2/1,嘉義縣,東石鄉,9234,28387,15147,13240
2009/2/1,嘉義縣,義竹鄉,7397,21658,11269,10389
2009/2/1,嘉義縣,鹿草鄉,5633,17409,9343,8066
2009/2/1,嘉義縣,水上鄉,17187,52991,27534,25457
2009/2/1,嘉義縣,中埔鄉,14798,47785,25030,22755
2009/2/1,嘉義縣,竹崎鄉,11134,39124,20873,18251
2009/2/1,嘉義縣,梅山鄉,6485,22148,11764,10384
2009/2/1,嘉義縣,番路鄉,3825,11619,6344,5275
2009/2/1,嘉義縣,大埔鄉,1952,4448,2369,2079
2009/2/1,嘉義縣,阿里山鄉,1975,6170,3319,2851
2009/2/1,臺南市,新營區,26511,78655,39466,39189
2009/2/1,臺南市,永康區,71917,212844,106280,106564
2009/2/1,臺南市,鹽水區,9730,27550,14355,13195
2009/2/1,臺南市,白河區,10827,31916,16837,15079
2009/2/1,臺南市,麻豆區,14550,46161,23647,22514
2009/2/1,臺南市,佳里區,18793,59318,29620,29698
2009/2/1,臺南市,新化區,13336,44494,22859,21635
2009/2/1,臺南市,善化區,13990,43084,21899,21185
2009/2/1,臺南市,學甲區,9270,28269,14506,13763
2009/2/1,臺南市,柳營區,7694,23151,12120,11031
2009/2/1,臺南市,後壁區,8595,26244,13713,12531
2009/2/1,臺南市,東山區,8110,23499,12555,10944
2009/2/1,臺南市,下營區,8957,26603,13815,12788
2009/2/1,臺南市,六甲區,7493,24194,12581,11613
2009/2/1,臺南市,官田區,7514,22489,11597,10892
2009/2/1,臺南市,大內區,4043,11186,5965,5221
2009/2/1,臺南市,西港區,7641,25386,12975,12411
2009/2/1,臺南市,七股區,7813,25104,13123,11981
2009/2/1,臺南市,將軍區,7319,21962,11216,10746
2009/2/1,臺南市,北門區,4223,12544,6433,6111
2009/2/1,臺南市,新市區,10547,35212,17752,17460
2009/2/1,臺南市,安定區,8937,30029,15590,14439
2009/2/1,臺南市,山上區,2706,8050,4244,3806
2009/2/1,臺南市,玉井區,5042,15678,8144,7534
2009/2/1,臺南市,楠西區,3585,10869,5779,5090
2009/2/1,臺南市,南化區,2830,8969,4921,4048
2009/2/1,臺南市,左鎮區,1957,5600,3110,2490
2009/2/1,臺南市,仁德區,23770,68463,35300,33163
2009/2/1,臺南市,歸仁區,19844,65700,33537,32163
2009/2/1,臺南市,關廟區,10533,36633,19049,17584
2009/2/1,臺南市,龍崎區,1595,4479,2435,2044
2009/2/1,高雄市,鳳山區,123044,339353,169836,169517
2009/2/1,高雄市,岡山區,32372,96868,48897,47971
2009/2/1,高雄市,旗山區,13590,40711,21290,19421
2009/2/1,高雄市,美濃區,13780,43706,22863,20843
2009/2/1,高雄市,林園區,23576,70978,36592,34386
2009/2/1,高雄市,大寮區,37243,109569,57186,52383
2009/2/1,高雄市,大樹區,12946,44525,23082,21443
2009/2/1,高雄市,仁武區,23983,69108,35731,33377
2009/2/1,高雄市,大社區,11421,32888,16958,15930
2009/2/1,高雄市,鳥松區,15912,41822,21308,20514
2009/2/1,高雄市,橋頭區,12274,36374,18729,17645
2009/2/1,高雄市,燕巢區,9770,31192,16677,14515
2009/2/1,高雄市,田寮區,3558,8397,4668,3729
2009/2/1,高雄市,阿蓮區,9000,30728,15534,15194
2009/2/1,高雄市,路竹區,15679,54306,27803,26503
2009/2/1,高雄市,湖內區,9210,28617,14801,13816
2009/2/1,高雄市,茄萣區,10009,31742,16639,15103
2009/2/1,高雄市,永安區,5708,14147,7256,6891
2009/2/1,高雄市,彌陀區,6483,20704,10834,9870
2009/2/1,高雄市,梓官區,11693,36922,19326,17596
2009/2/1,高雄市,六龜區,5684,15440,8387,7053
2009/2/1,高雄市,甲仙區,2559,8076,4338,3738
2009/2/1,高雄市,杉林區,4015,11193,6142,5051
2009/2/1,高雄市,內門區,4985,16257,8899,7358
2009/2/1,高雄市,茂林區,530,1791,920,871
2009/2/1,高雄市,桃源區,1238,4768,2549,2219
2009/2/1,高雄市,那瑪夏區,877,3483,1823,1660
2009/2/1,屏東縣,屏東市,71602,215034,107478,107556
2009/2/1,屏東縣,潮州鎮,17820,56667,28601,28066
2009/2/1,屏東縣,東港鎮,14874,50368,25650,24718
2009/2/1,屏東縣,恆春鎮,10469,31162,16116,15046
2009/2/1,屏東縣,萬丹鄉,13932,54448,28222,26226
2009/2/1,屏東縣,長治鄉,9559,30894,16233,14661
2009/2/1,屏東縣,麟洛鄉,3495,11575,6020,5555
2009/2/1,屏東縣,九如鄉,6468,23058,12029,11029
2009/2/1,屏東縣,里港鄉,7787,26318,13514,12804
2009/2/1,屏東縣,鹽埔鄉,7549,27541,14354,13187
2009/2/1,屏東縣,高樹鄉,9517,27312,14595,12717
2009/2/1,屏東縣,萬巒鄉,6313,22445,11865,10580
2009/2/1,屏東縣,內埔鄉,17453,59122,30898,28224
2009/2/1,屏東縣,竹田鄉,5418,18512,9881,8631
2009/2/1,屏東縣,新埤鄉,3302,10913,5774,5139
2009/2/1,屏東縣,枋寮鄉,8313,27120,14391,12729
2009/2/1,屏東縣,新園鄉,10967,39138,20266,18872
2009/2/1,屏東縣,崁頂鄉,4041,17087,8801,8286
2009/2/1,屏東縣,林邊鄉,6232,21080,10913,10167
2009/2/1,屏東縣,南州鄉,3601,11977,6180,5797
2009/2/1,屏東縣,佳冬鄉,6632,21723,11364,10359
2009/2/1,屏東縣,琉球鄉,3818,12519,6942,5577
2009/2/1,屏東縣,車城鄉,3446,9945,5370,4575
2009/2/1,屏東縣,滿州鄉,3005,8566,4699,3867
2009/2/1,屏東縣,枋山鄉,2089,6177,3304,2873
2009/2/1,屏東縣,三地門鄉,2048,7321,3761,3560
2009/2/1,屏東縣,霧臺鄉,875,2677,1437,1240
2009/2/1,屏東縣,瑪家鄉,1805,6440,3359,3081
2009/2/1,屏東縣,泰武鄉,1118,4931,2623,2308
2009/2/1,屏東縣,來義鄉,2079,7694,3985,3709
2009/2/1,屏東縣,春日鄉,1292,4923,2569,2354
2009/2/1,屏東縣,獅子鄉,1434,4949,2629,2320
2009/2/1,屏東縣,牡丹鄉,1801,4848,2530,2318
2009/2/1,臺東縣,臺東市,37365,109805,55890,53915
2009/2/1,臺東縣,成功鎮,5365,16153,8646,7507
2009/2/1,臺東縣,關山鎮,3192,9891,5215,4676
2009/2/1,臺東縣,卑南鄉,6459,18399,10009,8390
2009/2/1,臺東縣,大武鄉,2437,6890,3607,3283
2009/2/1,臺東縣,太麻里鄉,4487,12116,6520,5596
2009/2/1,臺東縣,東河鄉,3484,9517,5296,4221
2009/2/1,臺東縣,長濱鄉,2890,8574,4871,3703
2009/2/1,臺東縣,鹿野鄉,3091,8747,4751,3996
2009/2/1,臺東縣,池上鄉,3218,9352,4991,4361
2009/2/1,臺東縣,綠島鄉,935,3148,1690,1458
2009/2/1,臺東縣,延平鄉,1069,3563,1987,1576
2009/2/1,臺東縣,海端鄉,1081,4527,2466,2061
2009/2/1,臺東縣,達仁鄉,1416,3719,2068,1651
2009/2/1,臺東縣,金峰鄉,984,3361,1764,1597
2009/2/1,臺東縣,蘭嶼鄉,1268,4032,2123,1909
2009/2/1,花蓮縣,花蓮市,39827,110045,54179,55866
2009/2/1,花蓮縣,鳳林鎮,4421,12300,6554,5746
2009/2/1,花蓮縣,玉里鎮,8886,27564,15007,12557
2009/2/1,花蓮縣,新城鄉,7173,20373,10643,9730
2009/2/1,花蓮縣,吉安鄉,28042,79106,40753,38353
2009/2/1,花蓮縣,壽豐鄉,6729,19078,10353,8725
2009/2/1,花蓮縣,光復鄉,4958,14341,7686,6655
2009/2/1,花蓮縣,豐濱鄉,1807,5162,2887,2275
2009/2/1,花蓮縣,瑞穗鄉,4569,13145,7132,6013
2009/2/1,花蓮縣,富里鄉,3917,11793,6511,5282
2009/2/1,花蓮縣,秀林鄉,4501,14875,7797,7078
2009/2/1,花蓮縣,萬榮鄉,2134,7017,3741,3276
2009/2/1,花蓮縣,卓溪鄉,1641,6464,3613,2851
2009/2/1,澎湖縣,馬公市,18578,55342,28128,27214
2009/2/1,澎湖縣,湖西鄉,4464,13093,6844,6249
2009/2/1,澎湖縣,白沙鄉,3002,9213,4856,4357
2009/2/1,澎湖縣,西嶼鄉,2726,8213,4262,3951
2009/2/1,澎湖縣,望安鄉,1762,4505,2433,2072
2009/2/1,澎湖縣,七美鄉,1158,3335,1752,1583
2009/2/1,基隆市,中正區,21770,56672,29207,27465
2009/2/1,基隆市,七堵區,19406,55169,28044,27125
2009/2/1,基隆市,暖暖區,14102,38208,19498,18710
2009/2/1,基隆市,仁愛區,19357,50432,25072,25360
2009/2/1,基隆市,中山區,18745,51844,26551,25293
2009/2/1,基隆市,安樂區,31261,85035,42468,42567
2009/2/1,基隆市,信義區,19657,51427,25835,25592
2009/2/1,新竹市,東區,64660,192779,95414,97365
2009/2/1,新竹市,北區,47969,142266,70766,71500
2009/2/1,新竹市,香山區,21840,71426,36568,34858
2009/2/1,臺中市,中區,8446,23559,11612,11947
2009/2/1,臺中市,東區,25304,74082,37596,36486
2009/2/1,臺中市,西區,42112,117279,56533,60746
2009/2/1,臺中市,南區,40351,111956,54553,57403
2009/2/1,臺中市,北區,54205,147807,71968,75839
2009/2/1,臺中市,西屯區,69370,201613,98339,103274
2009/2/1,臺中市,南屯區,50293,148760,71889,76871
2009/2/1,臺中市,北屯區,79985,242310,118070,124240
2009/2/1,嘉義市,東區,44140,128236,62785,65451
2009/2/1,嘉義市,西區,49157,145630,72443,73187
2009/2/1,臺南市,東區,69342,194281,94428,99853
2009/2/1,臺南市,南區,42374,127269,64003,63266
2009/2/1,臺南市,北區,46386,130300,64593,65707
2009/2/1,臺南市,安南區,52361,175945,89806,86139
2009/2/1,臺南市,安平區,21972,60596,29065,31531
2009/2/1,臺南市,中西區,29720,80500,39725,40775
2009/2/1,臺北市,松山區,76630,209792,99538,110254
2009/2/1,臺北市,信義區,84917,227404,110198,117206
2009/2/1,臺北市,大安區,115140,313197,147931,165266
2009/2/1,臺北市,中山區,88788,218660,103468,115192
2009/2/1,臺北市,中正區,60689,159222,77048,82174
2009/2/1,臺北市,大同區,45990,124556,61652,62904
2009/2/1,臺北市,萬華區,72758,190239,95565,94674
2009/2/1,臺北市,文山區,94797,261702,127346,134356
2009/2/1,臺北市,南港區,40266,113577,56283,57294
2009/2/1,臺北市,內湖區,92932,266932,129283,137649
2009/2/1,臺北市,士林區,98299,285560,139378,146182
2009/2/1,臺北市,北投區,87367,249432,121441,127991
2009/2/1,高雄市,鹽埕區,11166,27990,14155,13835
2009/2/1,高雄市,鼓山區,48886,126196,62404,63792
2009/2/1,高雄市,左營區,71637,188878,93600,95278
2009/2/1,高雄市,楠梓區,59879,170702,85034,85668
2009/2/1,高雄市,三民區,128499,355920,174947,180973
2009/2/1,高雄市,新興區,22832,56643,27748,28895
2009/2/1,高雄市,前金區,12528,29750,14607,15143
2009/2/1,高雄市,苓雅區,70496,186404,91179,95225
2009/2/1,高雄市,前鎮區,74552,200521,100292,100229
2009/2/1,高雄市,旗津區,10781,29915,15582,14333
2009/2/1,高雄市,小港區,60884,153209,77410,75799
2009/2/1,金門縣,金城鎮,10225,29132,15253,13879
2009/2/1,金門縣,金湖鎮,6715,18948,9969,8979
2009/2/1,金門縣,金沙鎮,5043,13622,7097,6525
2009/2/1,金門縣,金寧鄉,5700,15826,8490,7336
2009/2/1,金門縣,烈嶼鄉,2399,7565,3956,3609
2009/2/1,金門縣,烏坵鄉,137,462,236,226
2009/2/1,連江縣,南竿鄉,1132,5808,3346,2462
2009/2/1,連江縣,北竿鄉,382,1761,1021,740
2009/2/1,連江縣,莒光鄉,234,1170,679,491
2009/2/1,連江縣,東引鄉,259,1029,613,416
2009/3/1,總計,臺灣地區,7651434,22962525,11577710,11384815
2009/3/1,總計,臺灣省,6118602,18816011,9551918,9264093
2009/3/1,總計,新北市,1346619,3843790,1916819,1926971
2009/3/1,總計,宜蘭縣,150081,460908,235694,225214
2009/3/1,總計,桃園市,640216,1963546,993255,970291
2009/3/1,總計,新竹縣,154002,504768,260493,244275
2009/3/1,總計,苗栗縣,167481,560644,292208,268436
2009/3/1,總計,臺中市,452998,1559454,792070,767384
2009/3/1,總計,彰化縣,354947,1312981,675815,637166
2009/3/1,總計,南投縣,167371,531630,274575,257055
2009/3/1,總計,雲林縣,224348,723274,378890,344384
2009/3/1,總計,嘉義縣,172162,548039,286860,261179
2009/3/1,總計,臺南市,360106,1104289,565358,538931
2009/3/1,總計,高雄市,421733,1243456,638857,604599
2009/3/1,總計,屏東縣,270430,884067,456070,427997
2009/3/1,總計,臺東縣,78899,231893,121908,109985
2009/3/1,總計,花蓮縣,118719,341222,176790,164432
2009/3/1,總計,澎湖縣,31888,93973,48413,45560
2009/3/1,總計,基隆市,144550,388764,196607,192157
2009/3/1,總計,新竹市,134978,407319,203127,204192
2009/3/1,總計,臺中市,370963,1068537,521038,547499
2009/3/1,總計,嘉義市,93477,274068,135251,138817
2009/3/1,總計,臺南市,262634,769389,381820,387569
2009/3/1,總計,臺北市,959761,2619920,1268796,1351124
2009/3/1,總計,高雄市,573071,1526594,756996,769598
2009/3/1,總計,福建省,32379,96025,50951,45074
2009/3/1,總計,金門縣,30365,86264,45301,40963
2009/3/1,總計,連江縣,2014,9761,5650,4111
2009/3/1,新北市,板橋區,187601,551507,274007,277500
2009/3/1,新北市,三重區,134087,385768,193110,192658
2009/3/1,新北市,永和區,88673,237229,114128,123101
2009/3/1,新北市,中和區,150311,412784,204990,207794
2009/3/1,新北市,新莊區,132129,399270,197758,201512
2009/3/1,新北市,新店區,112511,292802,144221,148581
2009/3/1,新北市,土城區,79667,238434,119663,118771
2009/3/1,新北市,蘆洲區,63029,195231,96951,98280
2009/3/1,新北市,汐止區,75627,184060,91804,92256
2009/3/1,新北市,樹林區,55301,169552,85771,83781
2009/3/1,新北市,鶯歌區,26423,86292,43907,42385
2009/3/1,新北市,三峽區,32616,98593,50693,47900
2009/3/1,新北市,淡水區,52322,136251,66685,69566
2009/3/1,新北市,瑞芳區,15614,43000,22056,20944
2009/3/1,新北市,五股區,26052,78044,39729,38315
2009/3/1,新北市,泰山區,25409,76017,38392,37625
2009/3/1,新北市,林口區,25948,74270,36955,37315
2009/3/1,新北市,深坑區,8392,22876,11589,11287
2009/3/1,新北市,石碇區,3230,7918,4419,3499
2009/3/1,新北市,坪林區,2387,6544,3667,2877
2009/3/1,新北市,三芝區,8660,23435,12144,11291
2009/3/1,新北市,石門區,3796,12091,6422,5669
2009/3/1,新北市,八里區,11383,33336,17087,16249
2009/3/1,新北市,平溪區,2340,5522,3068,2454
2009/3/1,新北市,雙溪區,3807,9867,5330,4537
2009/3/1,新北市,貢寮區,4331,13942,7224,6718
2009/3/1,新北市,金山區,6538,22370,11334,11036
2009/3/1,新北市,萬里區,6760,21156,10849,10307
2009/3/1,新北市,烏來區,1675,5629,2866,2763
2009/3/1,宜蘭縣,宜蘭市,32371,95851,47334,48517
2009/3/1,宜蘭縣,羅東鎮,24424,73531,35412,38119
2009/3/1,宜蘭縣,蘇澳鎮,13370,43491,22417,21074
2009/3/1,宜蘭縣,頭城鎮,9457,31224,16184,15040
2009/3/1,宜蘭縣,礁溪鄉,12057,35895,18865,17030
2009/3/1,宜蘭縣,壯圍鄉,7905,25095,13264,11831
2009/3/1,宜蘭縣,員山鄉,10495,32291,17333,14958
2009/3/1,宜蘭縣,冬山鄉,16726,51971,26893,25078
2009/3/1,宜蘭縣,五結鄉,12524,38564,20108,18456
2009/3/1,宜蘭縣,三星鄉,7234,21283,11541,9742
2009/3/1,宜蘭縣,大同鄉,1789,5850,3226,2624
2009/3/1,宜蘭縣,南澳鄉,1729,5862,3117,2745
2009/3/1,桃園市,桃園區,136998,398051,195574,202477
2009/3/1,桃園市,中壢區,120681,362743,181853,180890
2009/3/1,桃園市,平鎮區,63647,205547,103726,101821
2009/3/1,桃園市,八德區,54931,173847,88915,84932
2009/3/1,桃園市,大溪區,28279,91212,47080,44132
2009/3/1,桃園市,楊梅區,45813,146207,74615,71592
2009/3/1,桃園市,蘆竹區,45219,136667,68749,67918
2009/3/1,桃園市,大園區,24727,80420,41844,38576
2009/3/1,桃園市,龜山區,47517,134469,68398,66071
2009/3/1,桃園市,龍潭區,35598,113841,58088,55753
2009/3/1,桃園市,新屋區,14670,49670,26527,23143
2009/3/1,桃園市,觀音區,18525,60459,32010,28449
2009/3/1,桃園市,復興區,3611,10413,5876,4537
2009/3/1,新竹縣,竹北市,43130,133294,67089,66205
2009/3/1,新竹縣,關西鎮,9042,32445,17316,15129
2009/3/1,新竹縣,新埔鎮,10140,36043,19113,16930
2009/3/1,新竹縣,竹東鎮,29677,97147,49029,48118
2009/3/1,新竹縣,湖口鄉,22723,75182,38484,36698
2009/3/1,新竹縣,橫山鄉,4264,14586,7902,6684
2009/3/1,新竹縣,新豐鄉,15054,52444,27190,25254
2009/3/1,新竹縣,芎林鄉,6127,20865,10985,9880
2009/3/1,新竹縣,寶山鄉,4520,13777,7425,6352
2009/3/1,新竹縣,北埔鄉,3048,10280,5556,4724
2009/3/1,新竹縣,峨眉鄉,2013,6082,3375,2707
2009/3/1,新竹縣,尖石鄉,2607,8186,4526,3660
2009/3/1,新竹縣,五峰鄉,1657,4437,2503,1934
2009/3/1,苗栗縣,苗栗市,28458,91066,46027,45039
2009/3/1,苗栗縣,苑裡鎮,13551,49003,25654,23349
2009/3/1,苗栗縣,通霄鎮,11091,38707,20665,18042
2009/3/1,苗栗縣,竹南鎮,22773,76550,39011,37539
2009/3/1,苗栗縣,頭份市,28341,95858,49015,46843
2009/3/1,苗栗縣,後龍鎮,11500,40026,21191,18835
2009/3/1,苗栗縣,卓蘭鎮,5848,18439,9765,8674
2009/3/1,苗栗縣,大湖鄉,5241,16213,8725,7488
2009/3/1,苗栗縣,公館鄉,9873,34793,18297,16496
2009/3/1,苗栗縣,銅鑼鄉,5884,19580,10417,9163
2009/3/1,苗栗縣,南庄鄉,3885,11285,6242,5043
2009/3/1,苗栗縣,頭屋鄉,3470,11689,6197,5492
2009/3/1,苗栗縣,三義鄉,5162,17636,9349,8287
2009/3/1,苗栗縣,西湖鄉,2637,7945,4398,3547
2009/3/1,苗栗縣,造橋鄉,3895,13680,7261,6419
2009/3/1,苗栗縣,三灣鄉,2341,7406,4034,3372
2009/3/1,苗栗縣,獅潭鄉,1651,5042,2831,2211
2009/3/1,苗栗縣,泰安鄉,1880,5726,3129,2597
2009/3/1,臺中市,豐原區,48251,165502,82407,83095
2009/3/1,臺中市,大里區,59555,195153,97059,98094
2009/3/1,臺中市,太平區,53105,172291,86695,85596
2009/3/1,臺中市,東勢區,16686,54071,28134,25937
2009/3/1,臺中市,大甲區,21186,79018,40146,38872
2009/3/1,臺中市,清水區,24301,85809,44360,41449
2009/3/1,臺中市,沙鹿區,22437,79894,40718,39176
2009/3/1,臺中市,梧棲區,15598,54829,27887,26942
2009/3/1,臺中市,后里區,14465,54482,28132,26350
2009/3/1,臺中市,神岡區,17242,64176,33125,31051
2009/3/1,臺中市,潭子區,31221,98757,49434,49323
2009/3/1,臺中市,大雅區,25537,89137,45055,44082
2009/3/1,臺中市,新社區,7223,25838,13635,12203
2009/3/1,臺中市,石岡區,4746,16153,8424,7729
2009/3/1,臺中市,外埔區,8553,31943,16470,15473
2009/3/1,臺中市,大安區,5162,20521,10824,9697
2009/3/1,臺中市,烏日區,19636,68068,34562,33506
2009/3/1,臺中市,大肚區,15435,55995,28762,27233
2009/3/1,臺中市,龍井區,19834,73021,37355,35666
2009/3/1,臺中市,霧峰區,18351,63980,32945,31035
2009/3/1,臺中市,和平區,4474,10816,5941,4875
2009/3/1,彰化縣,彰化市,69977,236794,118400,118394
2009/3/1,彰化縣,鹿港鎮,21617,85381,43811,41570
2009/3/1,彰化縣,和美鎮,23429,89484,45990,43494
2009/3/1,彰化縣,北斗鎮,9655,33596,17073,16523
2009/3/1,彰化縣,員林市,35781,126063,63566,62497
2009/3/1,彰化縣,溪湖鎮,14769,56487,28917,27570
2009/3/1,彰化縣,田中鎮,12306,44807,23514,21293
2009/3/1,彰化縣,二林鎮,14060,54801,28281,26520
2009/3/1,彰化縣,線西鄉,4005,17014,8771,8243
2009/3/1,彰化縣,伸港鄉,8715,35865,18500,17365
2009/3/1,彰化縣,福興鄉,11733,49098,25750,23348
2009/3/1,彰化縣,秀水鄉,9438,38963,20232,18731
2009/3/1,彰化縣,花壇鄉,12631,46191,23866,22325
2009/3/1,彰化縣,芬園鄉,6783,25033,13301,11732
2009/3/1,彰化縣,大村鄉,9952,36538,19089,17449
2009/3/1,彰化縣,埔鹽鄉,8609,34547,18153,16394
2009/3/1,彰化縣,埔心鄉,9705,35404,18409,16995
2009/3/1,彰化縣,永靖鄉,10194,39598,20585,19013
2009/3/1,彰化縣,社頭鄉,12098,45173,23282,21891
2009/3/1,彰化縣,二水鄉,5250,16879,8919,7960
2009/3/1,彰化縣,田尾鄉,7542,28864,15082,13782
2009/3/1,彰化縣,埤頭鄉,8385,32023,16792,15231
2009/3/1,彰化縣,芳苑鄉,9901,36649,19449,17200
2009/3/1,彰化縣,大城鄉,5318,19119,10399,8720
2009/3/1,彰化縣,竹塘鄉,4520,16631,8784,7847
2009/3/1,彰化縣,溪州鄉,8574,31979,16900,15079
2009/3/1,南投縣,南投市,32677,105120,53021,52099
2009/3/1,南投縣,埔里鎮,27844,86075,43543,42532
2009/3/1,南投縣,草屯鎮,30234,100325,50871,49454
2009/3/1,南投縣,竹山鎮,18503,58940,30487,28453
2009/3/1,南投縣,集集鎮,4192,12024,6323,5701
2009/3/1,南投縣,名間鄉,11883,41630,21941,19689
2009/3/1,南投縣,鹿谷鄉,6489,19375,10329,9046
2009/3/1,南投縣,中寮鄉,5529,16420,8939,7481
2009/3/1,南投縣,魚池鄉,5748,17360,9212,8148
2009/3/1,南投縣,國姓鄉,7142,21095,11575,9520
2009/3/1,南投縣,水里鄉,7163,20563,10822,9741
2009/3/1,南投縣,信義鄉,5085,17194,9334,7860
2009/3/1,南投縣,仁愛鄉,4882,15509,8178,7331
2009/3/1,雲林縣,斗六市,33568,106334,53730,52604
2009/3/1,雲林縣,斗南鎮,14928,47668,24228,23440
2009/3/1,雲林縣,虎尾鎮,21731,70033,35734,34299
2009/3/1,雲林縣,西螺鎮,13783,49032,24945,24087
2009/3/1,雲林縣,土庫鎮,8560,30879,16156,14723
2009/3/1,雲林縣,北港鎮,14945,43741,22781,20960
2009/3/1,雲林縣,古坑鄉,10463,34854,18496,16358
2009/3/1,雲林縣,大埤鄉,6549,21632,11546,10086
2009/3/1,雲林縣,莿桐鄉,8861,30740,16129,14611
2009/3/1,雲林縣,林內鄉,5612,20073,10506,9567
2009/3/1,雲林縣,二崙鄉,8692,30169,16221,13948
2009/3/1,雲林縣,崙背鄉,8222,27887,14745,13142
2009/3/1,雲林縣,麥寮鄉,11793,34398,18198,16200
2009/3/1,雲林縣,東勢鄉,5682,17267,9421,7846
2009/3/1,雲林縣,褒忠鄉,4229,14591,7814,6777
2009/3/1,雲林縣,臺西鄉,8691,26854,14492,12362
2009/3/1,雲林縣,元長鄉,9236,29332,16031,13301
2009/3/1,雲林縣,四湖鄉,8971,27358,14976,12382
2009/3/1,雲林縣,口湖鄉,9539,30928,16543,14385
2009/3/1,雲林縣,水林鄉,10293,29504,16198,13306
2009/3/1,嘉義縣,太保市,10745,35900,18612,17288
2009/3/1,嘉義縣,朴子市,14006,44329,22722,21607
2009/3/1,嘉義縣,布袋鎮,10016,30736,15863,14873
2009/3/1,嘉義縣,大林鎮,11020,34046,17525,16521
2009/3/1,嘉義縣,民雄鄉,22087,72715,37495,35220
2009/3/1,嘉義縣,溪口鄉,5339,16602,8882,7720
2009/3/1,嘉義縣,新港鄉,10193,35194,18568,16626
2009/3/1,嘉義縣,六腳鄉,9061,26984,14307,12677
2009/3/1,嘉義縣,東石鄉,9233,28317,15107,13210
2009/3/1,嘉義縣,義竹鄉,7407,21694,11275,10419
2009/3/1,嘉義縣,鹿草鄉,5645,17400,9341,8059
2009/3/1,嘉義縣,水上鄉,17171,52881,27491,25390
2009/3/1,嘉義縣,中埔鄉,14831,47791,25044,22747
2009/3/1,嘉義縣,竹崎鄉,11139,39090,20846,18244
2009/3/1,嘉義縣,梅山鄉,6499,22099,11741,10358
2009/3/1,嘉義縣,番路鄉,3836,11608,6342,5266
2009/3/1,嘉義縣,大埔鄉,1948,4467,2379,2088
2009/3/1,嘉義縣,阿里山鄉,1986,6186,3320,2866
2009/3/1,臺南市,新營區,26527,78677,39475,39202
2009/3/1,臺南市,永康區,72085,212938,106295,106643
2009/3/1,臺南市,鹽水區,9737,27511,14331,13180
2009/3/1,臺南市,白河區,10823,31953,16861,15092
2009/3/1,臺南市,麻豆區,14562,46153,23644,22509
2009/3/1,臺南市,佳里區,18819,59394,29642,29752
2009/3/1,臺南市,新化區,13352,44488,22845,21643
2009/3/1,臺南市,善化區,13993,43107,21901,21206
2009/3/1,臺南市,學甲區,9276,28234,14476,13758
2009/3/1,臺南市,柳營區,7695,23120,12105,11015
2009/3/1,臺南市,後壁區,8602,26242,13712,12530
2009/3/1,臺南市,東山區,8121,23465,12542,10923
2009/3/1,臺南市,下營區,8957,26585,13805,12780
2009/3/1,臺南市,六甲區,7495,24181,12583,11598
2009/3/1,臺南市,官田區,7510,22451,11564,10887
2009/3/1,臺南市,大內區,4048,11186,5960,5226
2009/3/1,臺南市,西港區,7656,25397,12981,12416
2009/3/1,臺南市,七股區,7830,25121,13141,11980
2009/3/1,臺南市,將軍區,7323,21913,11196,10717
2009/3/1,臺南市,北門區,4234,12557,6434,6123
2009/3/1,臺南市,新市區,10553,35164,17728,17436
2009/3/1,臺南市,安定區,8950,30025,15592,14433
2009/3/1,臺南市,山上區,2706,8055,4245,3810
2009/3/1,臺南市,玉井區,5055,15706,8162,7544
2009/3/1,臺南市,楠西區,3584,10864,5776,5088
2009/3/1,臺南市,南化區,2826,8973,4919,4054
2009/3/1,臺南市,左鎮區,1959,5619,3117,2502
2009/3/1,臺南市,仁德區,23792,68430,35311,33119
2009/3/1,臺南市,歸仁區,19900,65739,33577,32162
2009/3/1,臺南市,關廟區,10541,36561,19005,17556
2009/3/1,臺南市,龍崎區,1595,4480,2433,2047
2009/3/1,高雄市,鳳山區,123258,339360,169811,169549
2009/3/1,高雄市,岡山區,32408,96890,48897,47993
2009/3/1,高雄市,旗山區,13588,40726,21290,19436
2009/3/1,高雄市,美濃區,13806,43691,22854,20837
2009/3/1,高雄市,林園區,23592,70969,36577,34392
2009/3/1,高雄市,大寮區,37290,109483,57177,52306
2009/3/1,高雄市,大樹區,12948,44508,23066,21442
2009/3/1,高雄市,仁武區,24050,69156,35739,33417
2009/3/1,高雄市,大社區,11448,32882,16966,15916
2009/3/1,高雄市,鳥松區,15948,41813,21327,20486
2009/3/1,高雄市,橋頭區,12279,36356,18714,17642
2009/3/1,高雄市,燕巢區,9782,31152,16640,14512
2009/3/1,高雄市,田寮區,3562,8399,4671,3728
2009/3/1,高雄市,阿蓮區,9000,30758,15538,15220
2009/3/1,高雄市,路竹區,15714,54317,27803,26514
2009/3/1,高雄市,湖內區,9212,28606,14791,13815
2009/3/1,高雄市,茄萣區,10010,31708,16614,15094
2009/3/1,高雄市,永安區,5721,14132,7261,6871
2009/3/1,高雄市,彌陀區,6492,20706,10823,9883
2009/3/1,高雄市,梓官區,11704,36899,19296,17603
2009/3/1,高雄市,六龜區,5712,15430,8381,7049
2009/3/1,高雄市,甲仙區,2558,8037,4324,3713
2009/3/1,高雄市,杉林區,4014,11177,6130,5047
2009/3/1,高雄市,內門區,4990,16238,8877,7361
2009/3/1,高雄市,茂林區,530,1800,922,878
2009/3/1,高雄市,桃源區,1240,4779,2548,2231
2009/3/1,高雄市,那瑪夏區,877,3484,1820,1664
2009/3/1,屏東縣,屏東市,71692,214907,107438,107469
2009/3/1,屏東縣,潮州鎮,17840,56612,28576,28036
2009/3/1,屏東縣,東港鎮,14891,50408,25659,24749
2009/3/1,屏東縣,恆春鎮,10504,31151,16097,15054
2009/3/1,屏東縣,萬丹鄉,13928,54410,28221,26189
2009/3/1,屏東縣,長治鄉,9574,30918,16224,14694
2009/3/1,屏東縣,麟洛鄉,3500,11569,6016,5553
2009/3/1,屏東縣,九如鄉,6471,23057,12028,11029
2009/3/1,屏東縣,里港鄉,7800,26297,13494,12803
2009/3/1,屏東縣,鹽埔鄉,7561,27530,14350,13180
2009/3/1,屏東縣,高樹鄉,9528,27312,14594,12718
2009/3/1,屏東縣,萬巒鄉,6318,22430,11855,10575
2009/3/1,屏東縣,內埔鄉,17457,59091,30863,28228
2009/3/1,屏東縣,竹田鄉,5423,18497,9873,8624
2009/3/1,屏東縣,新埤鄉,3296,10914,5775,5139
2009/3/1,屏東縣,枋寮鄉,8315,27114,14392,12722
2009/3/1,屏東縣,新園鄉,10955,39065,20207,18858
2009/3/1,屏東縣,崁頂鄉,4048,17100,8795,8305
2009/3/1,屏東縣,林邊鄉,6233,21036,10894,10142
2009/3/1,屏東縣,南州鄉,3605,11971,6180,5791
2009/3/1,屏東縣,佳冬鄉,6637,21692,11350,10342
2009/3/1,屏東縣,琉球鄉,3829,12502,6937,5565
2009/3/1,屏東縣,車城鄉,3453,9973,5382,4591
2009/3/1,屏東縣,滿州鄉,3011,8578,4702,3876
2009/3/1,屏東縣,枋山鄉,2091,6168,3297,2871
2009/3/1,屏東縣,三地門鄉,2052,7306,3756,3550
2009/3/1,屏東縣,霧臺鄉,873,2662,1431,1231
2009/3/1,屏東縣,瑪家鄉,1808,6447,3355,3092
2009/3/1,屏東縣,泰武鄉,1121,4925,2618,2307
2009/3/1,屏東縣,來義鄉,2077,7698,3984,3714
2009/3/1,屏東縣,春日鄉,1298,4918,2568,2350
2009/3/1,屏東縣,獅子鄉,1436,4954,2624,2330
2009/3/1,屏東縣,牡丹鄉,1805,4855,2535,2320
2009/3/1,臺東縣,臺東市,37457,109815,55893,53922
2009/3/1,臺東縣,成功鎮,5360,16115,8623,7492
2009/3/1,臺東縣,關山鎮,3196,9918,5222,4696
2009/3/1,臺東縣,卑南鄉,6473,18391,10014,8377
2009/3/1,臺東縣,大武鄉,2454,6934,3623,3311
2009/3/1,臺東縣,太麻里鄉,4492,12113,6504,5609
2009/3/1,臺東縣,東河鄉,3497,9518,5292,4226
2009/3/1,臺東縣,長濱鄉,2895,8585,4873,3712
2009/3/1,臺東縣,鹿野鄉,3091,8727,4738,3989
2009/3/1,臺東縣,池上鄉,3219,9323,4976,4347
2009/3/1,臺東縣,綠島鄉,936,3157,1697,1460
2009/3/1,臺東縣,延平鄉,1070,3566,1985,1581
2009/3/1,臺東縣,海端鄉,1081,4520,2464,2056
2009/3/1,臺東縣,達仁鄉,1419,3764,2090,1674
2009/3/1,臺東縣,金峰鄉,984,3368,1769,1599
2009/3/1,臺東縣,蘭嶼鄉,1275,4079,2145,1934
2009/3/1,花蓮縣,花蓮市,39828,110003,54161,55842
2009/3/1,花蓮縣,鳳林鎮,4417,12302,6543,5759
2009/3/1,花蓮縣,玉里鎮,8903,27555,15012,12543
2009/3/1,花蓮縣,新城鄉,7185,20340,10619,9721
2009/3/1,花蓮縣,吉安鄉,28087,79162,40770,38392
2009/3/1,花蓮縣,壽豐鄉,6730,19052,10330,8722
2009/3/1,花蓮縣,光復鄉,4962,14349,7689,6660
2009/3/1,花蓮縣,豐濱鄉,1811,5157,2881,2276
2009/3/1,花蓮縣,瑞穗鄉,4572,13135,7125,6010
2009/3/1,花蓮縣,富里鄉,3928,11780,6503,5277
2009/3/1,花蓮縣,秀林鄉,4516,14932,7811,7121
2009/3/1,花蓮縣,萬榮鄉,2131,7001,3738,3263
2009/3/1,花蓮縣,卓溪鄉,1649,6454,3608,2846
2009/3/1,澎湖縣,馬公市,18697,55474,28195,27279
2009/3/1,澎湖縣,湖西鄉,4495,13145,6876,6269
2009/3/1,澎湖縣,白沙鄉,3017,9227,4857,4370
2009/3/1,澎湖縣,西嶼鄉,2738,8235,4280,3955
2009/3/1,澎湖縣,望安鄉,1774,4522,2434,2088
2009/3/1,澎湖縣,七美鄉,1167,3370,1771,1599
2009/3/1,基隆市,中正區,21801,56635,29170,27465
2009/3/1,基隆市,七堵區,19453,55186,28052,27134
2009/3/1,基隆市,暖暖區,14100,38184,19458,18726
2009/3/1,基隆市,仁愛區,19428,50475,25088,25387
2009/3/1,基隆市,中山區,18734,51755,26519,25236
2009/3/1,基隆市,安樂區,31322,85093,42472,42621
2009/3/1,基隆市,信義區,19712,51436,25848,25588
2009/3/1,新竹市,東區,64905,193242,95629,97613
2009/3/1,新竹市,北區,48165,142624,70929,71695
2009/3/1,新竹市,香山區,21908,71453,36569,34884
2009/3/1,臺中市,中區,8462,23558,11623,11935
2009/3/1,臺中市,東區,25323,74069,37587,36482
2009/3/1,臺中市,西區,42208,117388,56565,60823
2009/3/1,臺中市,南區,40448,111990,54536,57454
2009/3/1,臺中市,北區,54328,147932,72006,75926
2009/3/1,臺中市,西屯區,69581,201899,98451,103448
2009/3/1,臺中市,南屯區,50454,149081,72050,77031
2009/3/1,臺中市,北屯區,80159,242620,118220,124400
2009/3/1,嘉義市,東區,44223,128282,62753,65529
2009/3/1,嘉義市,西區,49254,145786,72498,73288
2009/3/1,臺南市,東區,69492,194436,94472,99964
2009/3/1,臺南市,南區,42393,127121,63928,63193
2009/3/1,臺南市,北區,46473,130538,64735,65803
2009/3/1,臺南市,安南區,52449,176015,89817,86198
2009/3/1,臺南市,安平區,22023,60701,29128,31573
2009/3/1,臺南市,中西區,29804,80578,39740,40838
2009/3/1,臺北市,松山區,76699,209903,99573,110330
2009/3/1,臺北市,信義區,84962,227232,110121,117111
2009/3/1,臺北市,大安區,115306,313371,148016,165355
2009/3/1,臺北市,中山區,88848,218551,103428,115123
2009/3/1,臺北市,中正區,60808,159464,77163,82301
2009/3/1,臺北市,大同區,46031,124466,61584,62882
2009/3/1,臺北市,萬華區,72790,190050,95458,94592
2009/3/1,臺北市,文山區,94883,261523,127251,134272
2009/3/1,臺北市,南港區,40310,113462,56226,57236
2009/3/1,臺北市,內湖區,93129,267120,129328,137792
2009/3/1,臺北市,士林區,98462,285459,139303,146156
2009/3/1,臺北市,北投區,87533,249319,121345,127974
2009/3/1,高雄市,鹽埕區,11185,28021,14186,13835
2009/3/1,高雄市,鼓山區,49061,126547,62516,64031
2009/3/1,高雄市,左營區,71718,188972,93621,95351
2009/3/1,高雄市,楠梓區,60001,170830,85107,85723
2009/3/1,高雄市,三民區,128677,355899,174912,180987
2009/3/1,高雄市,新興區,22842,56638,27732,28906
2009/3/1,高雄市,前金區,12509,29667,14547,15120
2009/3/1,高雄市,苓雅區,70610,186240,91097,95143
2009/3/1,高雄市,前鎮區,74696,200633,100292,100341
2009/3/1,高雄市,旗津區,10790,29864,15549,14315
2009/3/1,高雄市,小港區,60982,153283,77437,75846
2009/3/1,金門縣,金城鎮,10275,29359,15358,14001
2009/3/1,金門縣,金湖鎮,6736,19044,10008,9036
2009/3/1,金門縣,金沙鎮,5067,13746,7144,6602
2009/3/1,金門縣,金寧鄉,5732,15995,8565,7430
2009/3/1,金門縣,烈嶼鄉,2418,7658,3989,3669
2009/3/1,金門縣,烏坵鄉,137,462,237,225
2009/3/1,連江縣,南竿鄉,1136,5798,3338,2460
2009/3/1,連江縣,北竿鄉,383,1763,1019,744
2009/3/1,連江縣,莒光鄉,234,1174,685,489
2009/3/1,連江縣,東引鄉,261,1026,608,418
2009/4/1,總計,臺灣地區,7662576,22962112,11575568,11386544
2009/4/1,總計,臺灣省,6128239,18817428,9551144,9266284
2009/4/1,總計,新北市,1349025,3845345,1917283,1928062
2009/4/1,總計,宜蘭縣,150241,460899,235693,225206
2009/4/1,總計,桃園市,641394,1964197,993399,970798
2009/4/1,總計,新竹縣,154370,505182,260683,244499
2009/4/1,總計,苗栗縣,167742,560646,292176,268470
2009/4/1,總計,臺中市,453597,1559174,791848,767326
2009/4/1,總計,彰化縣,355367,1312433,675455,636978
2009/4/1,總計,南投縣,167608,531514,274464,257050
2009/4/1,總計,雲林縣,224613,722971,378665,344306
2009/4/1,總計,嘉義縣,172318,547702,286654,261048
2009/4/1,總計,臺南市,360502,1104009,565085,538924
2009/4/1,總計,高雄市,422289,1243306,638681,604625
2009/4/1,總計,屏東縣,270685,883662,455799,427863
2009/4/1,總計,臺東縣,79015,231953,121908,110045
2009/4/1,總計,花蓮縣,118825,341046,176633,164413
2009/4/1,總計,澎湖縣,32066,94259,48570,45689
2009/4/1,總計,基隆市,144705,388697,196527,192170
2009/4/1,總計,新竹市,135367,407760,203302,204458
2009/4/1,總計,臺中市,371728,1068951,521183,547768
2009/4/1,總計,嘉義市,93660,274212,135311,138901
2009/4/1,總計,臺南市,263122,769510,381825,387685
2009/4/1,總計,臺北市,960653,2618476,1267800,1350676
2009/4/1,總計,高雄市,573684,1526208,756624,769584
2009/4/1,總計,福建省,32570,97227,51498,45729
2009/4/1,總計,金門縣,30553,87456,45839,41617
2009/4/1,總計,連江縣,2017,9771,5659,4112
2009/4/1,新北市,板橋區,187894,551685,274030,277655
2009/4/1,新北市,三重區,134346,385718,193046,192672
2009/4/1,新北市,永和區,88744,237195,114108,123087
2009/4/1,新北市,中和區,150549,412799,204923,207876
2009/4/1,新北市,新莊區,132408,399424,197826,201598
2009/4/1,新北市,新店區,112588,292796,144178,148618
2009/4/1,新北市,土城區,79767,238309,119616,118693
2009/4/1,新北市,蘆洲區,63152,195446,97050,98396
2009/4/1,新北市,汐止區,75757,184123,91837,92286
2009/4/1,新北市,樹林區,55473,169703,85846,83857
2009/4/1,新北市,鶯歌區,26465,86307,43904,42403
2009/4/1,新北市,三峽區,32655,98674,50703,47971
2009/4/1,新北市,淡水區,52539,136527,66800,69727
2009/4/1,新北市,瑞芳區,15612,42973,22031,20942
2009/4/1,新北市,五股區,26151,78176,39819,38357
2009/4/1,新北市,泰山區,25424,76007,38386,37621
2009/4/1,新北市,林口區,26106,74608,37114,37494
2009/4/1,新北市,深坑區,8424,22955,11637,11318
2009/4/1,新北市,石碇區,3235,7933,4429,3504
2009/4/1,新北市,坪林區,2387,6541,3665,2876
2009/4/1,新北市,三芝區,8659,23442,12150,11292
2009/4/1,新北市,石門區,3808,12108,6426,5682
2009/4/1,新北市,八里區,11417,33385,17107,16278
2009/4/1,新北市,平溪區,2341,5531,3070,2461
2009/4/1,新北市,雙溪區,3814,9885,5333,4552
2009/4/1,新北市,貢寮區,4325,13903,7200,6703
2009/4/1,新北市,金山區,6543,22397,11335,11062
2009/4/1,新北市,萬里區,6767,21176,10854,10322
2009/4/1,新北市,烏來區,1675,5619,2860,2759
2009/4/1,宜蘭縣,宜蘭市,32412,95850,47334,48516
2009/4/1,宜蘭縣,羅東鎮,24446,73552,35432,38120
2009/4/1,宜蘭縣,蘇澳鎮,13377,43454,22388,21066
2009/4/1,宜蘭縣,頭城鎮,9472,31202,16175,15027
2009/4/1,宜蘭縣,礁溪鄉,12048,35878,18863,17015
2009/4/1,宜蘭縣,壯圍鄉,7908,25097,13261,11836
2009/4/1,宜蘭縣,員山鄉,10504,32301,17354,14947
2009/4/1,宜蘭縣,冬山鄉,16737,51961,26888,25073
2009/4/1,宜蘭縣,五結鄉,12544,38569,20098,18471
2009/4/1,宜蘭縣,三星鄉,7265,21282,11543,9739
2009/4/1,宜蘭縣,大同鄉,1791,5887,3236,2651
2009/4/1,宜蘭縣,南澳鄉,1737,5866,3121,2745
2009/4/1,桃園市,桃園區,137246,398279,195616,202663
2009/4/1,桃園市,中壢區,120890,362884,181901,180983
2009/4/1,桃園市,平鎮區,63770,205551,103703,101848
2009/4/1,桃園市,八德區,55004,173699,88853,84846
2009/4/1,桃園市,大溪區,28333,91306,47114,44192
2009/4/1,桃園市,楊梅區,45939,146397,74698,71699
2009/4/1,桃園市,蘆竹區,45333,136774,68790,67984
2009/4/1,桃園市,大園區,24809,80489,41862,38627
2009/4/1,桃園市,龜山區,47582,134539,68436,66103
2009/4/1,桃園市,龍潭區,35625,113819,58065,55754
2009/4/1,桃園市,新屋區,14701,49637,26506,23131
2009/4/1,桃園市,觀音區,18553,60443,31991,28452
2009/4/1,桃園市,復興區,3609,10380,5864,4516
2009/4/1,新竹縣,竹北市,43298,133605,67236,66369
2009/4/1,新竹縣,關西鎮,9058,32432,17307,15125
2009/4/1,新竹縣,新埔鎮,10153,36039,19113,16926
2009/4/1,新竹縣,竹東鎮,29732,97101,49008,48093
2009/4/1,新竹縣,湖口鄉,22753,75184,38479,36705
2009/4/1,新竹縣,橫山鄉,4285,14648,7925,6723
2009/4/1,新竹縣,新豐鄉,15083,52473,27204,25269
2009/4/1,新竹縣,芎林鄉,6145,20881,11004,9877
2009/4/1,新竹縣,寶山鄉,4527,13772,7414,6358
2009/4/1,新竹縣,北埔鄉,3044,10292,5564,4728
2009/4/1,新竹縣,峨眉鄉,2016,6092,3382,2710
2009/4/1,新竹縣,尖石鄉,2613,8185,4525,3660
2009/4/1,新竹縣,五峰鄉,1663,4478,2522,1956
2009/4/1,苗栗縣,苗栗市,28482,91044,46035,45009
2009/4/1,苗栗縣,苑裡鎮,13587,49031,25670,23361
2009/4/1,苗栗縣,通霄鎮,11093,38694,20649,18045
2009/4/1,苗栗縣,竹南鎮,22818,76628,39060,37568
2009/4/1,苗栗縣,頭份市,28374,95814,48970,46844
2009/4/1,苗栗縣,後龍鎮,11505,39997,21179,18818
2009/4/1,苗栗縣,卓蘭鎮,5856,18427,9754,8673
2009/4/1,苗栗縣,大湖鄉,5257,16226,8730,7496
2009/4/1,苗栗縣,公館鄉,9901,34791,18304,16487
2009/4/1,苗栗縣,銅鑼鄉,5898,19574,10408,9166
2009/4/1,苗栗縣,南庄鄉,3894,11264,6229,5035
2009/4/1,苗栗縣,頭屋鄉,3475,11687,6193,5494
2009/4/1,苗栗縣,三義鄉,5165,17617,9330,8287
2009/4/1,苗栗縣,西湖鄉,2641,7939,4399,3540
2009/4/1,苗栗縣,造橋鄉,3904,13705,7267,6438
2009/4/1,苗栗縣,三灣鄉,2354,7427,4040,3387
2009/4/1,苗栗縣,獅潭鄉,1654,5039,2826,2213
2009/4/1,苗栗縣,泰安鄉,1884,5742,3133,2609
2009/4/1,臺中市,豐原區,48309,165427,82362,83065
2009/4/1,臺中市,大里區,59631,195202,97074,98128
2009/4/1,臺中市,太平區,53175,172232,86635,85597
2009/4/1,臺中市,東勢區,16702,54039,28112,25927
2009/4/1,臺中市,大甲區,21200,78987,40129,38858
2009/4/1,臺中市,清水區,24330,85757,44333,41424
2009/4/1,臺中市,沙鹿區,22503,80022,40781,39241
2009/4/1,臺中市,梧棲區,15603,54804,27872,26932
2009/4/1,臺中市,后里區,14477,54455,28115,26340
2009/4/1,臺中市,神岡區,17265,64132,33112,31020
2009/4/1,臺中市,潭子區,31271,98830,49457,49373
2009/4/1,臺中市,大雅區,25560,89141,45057,44084
2009/4/1,臺中市,新社區,7238,25839,13629,12210
2009/4/1,臺中市,石岡區,4757,16143,8423,7720
2009/4/1,臺中市,外埔區,8572,31924,16458,15466
2009/4/1,臺中市,大安區,5164,20468,10798,9670
2009/4/1,臺中市,烏日區,19683,68071,34577,33494
2009/4/1,臺中市,大肚區,15437,55942,28726,27216
2009/4/1,臺中市,龍井區,19877,73043,37347,35696
2009/4/1,臺中市,霧峰區,18373,63919,32923,30996
2009/4/1,臺中市,和平區,4470,10797,5928,4869
2009/4/1,彰化縣,彰化市,70070,236781,118371,118410
2009/4/1,彰化縣,鹿港鎮,21664,85356,43801,41555
2009/4/1,彰化縣,和美鎮,23459,89447,45955,43492
2009/4/1,彰化縣,北斗鎮,9655,33585,17061,16524
2009/4/1,彰化縣,員林市,35865,126114,63588,62526
2009/4/1,彰化縣,溪湖鎮,14784,56490,28912,27578
2009/4/1,彰化縣,田中鎮,12299,44756,23475,21281
2009/4/1,彰化縣,二林鎮,14069,54711,28233,26478
2009/4/1,彰化縣,線西鄉,4006,17004,8763,8241
2009/4/1,彰化縣,伸港鄉,8726,35843,18498,17345
2009/4/1,彰化縣,福興鄉,11754,49092,25751,23341
2009/4/1,彰化縣,秀水鄉,9443,38978,20221,18757
2009/4/1,彰化縣,花壇鄉,12639,46175,23855,22320
2009/4/1,彰化縣,芬園鄉,6792,25006,13296,11710
2009/4/1,彰化縣,大村鄉,9956,36489,19059,17430
2009/4/1,彰化縣,埔鹽鄉,8625,34510,18138,16372
2009/4/1,彰化縣,埔心鄉,9706,35328,18369,16959
2009/4/1,彰化縣,永靖鄉,10210,39594,20571,19023
2009/4/1,彰化縣,社頭鄉,12111,45141,23268,21873
2009/4/1,彰化縣,二水鄉,5252,16860,8917,7943
2009/4/1,彰化縣,田尾鄉,7538,28833,15063,13770
2009/4/1,彰化縣,埤頭鄉,8402,32047,16796,15251
2009/4/1,彰化縣,芳苑鄉,9916,36600,19419,17181
2009/4/1,彰化縣,大城鄉,5323,19095,10387,8708
2009/4/1,彰化縣,竹塘鄉,4522,16652,8800,7852
2009/4/1,彰化縣,溪州鄉,8581,31946,16888,15058
2009/4/1,南投縣,南投市,32711,105070,53000,52070
2009/4/1,南投縣,埔里鎮,27867,86077,43518,42559
2009/4/1,南投縣,草屯鎮,30290,100323,50870,49453
2009/4/1,南投縣,竹山鎮,18528,58899,30471,28428
2009/4/1,南投縣,集集鎮,4209,12040,6334,5706
2009/4/1,南投縣,名間鄉,11895,41636,21936,19700
2009/4/1,南投縣,鹿谷鄉,6509,19354,10312,9042
2009/4/1,南投縣,中寮鄉,5541,16403,8928,7475
2009/4/1,南投縣,魚池鄉,5757,17356,9206,8150
2009/4/1,南投縣,國姓鄉,7157,21081,11563,9518
2009/4/1,南投縣,水里鄉,7168,20541,10800,9741
2009/4/1,南投縣,信義鄉,5090,17190,9330,7860
2009/4/1,南投縣,仁愛鄉,4886,15544,8196,7348
2009/4/1,雲林縣,斗六市,33598,106361,53739,52622
2009/4/1,雲林縣,斗南鎮,14955,47640,24218,23422
2009/4/1,雲林縣,虎尾鎮,21772,69982,35679,34303
2009/4/1,雲林縣,西螺鎮,13793,49057,24943,24114
2009/4/1,雲林縣,土庫鎮,8572,30869,16159,14710
2009/4/1,雲林縣,北港鎮,14963,43762,22801,20961
2009/4/1,雲林縣,古坑鄉,10474,34799,18465,16334
2009/4/1,雲林縣,大埤鄉,6558,21610,11536,10074
2009/4/1,雲林縣,莿桐鄉,8868,30736,16125,14611
2009/4/1,雲林縣,林內鄉,5624,20064,10494,9570
2009/4/1,雲林縣,二崙鄉,8689,30117,16205,13912
2009/4/1,雲林縣,崙背鄉,8235,27872,14731,13141
2009/4/1,雲林縣,麥寮鄉,11825,34474,18234,16240
2009/4/1,雲林縣,東勢鄉,5695,17257,9416,7841
2009/4/1,雲林縣,褒忠鄉,4235,14597,7806,6791
2009/4/1,雲林縣,臺西鄉,8701,26793,14461,12332
2009/4/1,雲林縣,元長鄉,9251,29296,16008,13288
2009/4/1,雲林縣,四湖鄉,8976,27331,14954,12377
2009/4/1,雲林縣,口湖鄉,9550,30894,16518,14376
2009/4/1,雲林縣,水林鄉,10279,29460,16173,13287
2009/4/1,嘉義縣,太保市,10755,35917,18624,17293
2009/4/1,嘉義縣,朴子市,14017,44357,22729,21628
2009/4/1,嘉義縣,布袋鎮,10026,30726,15849,14877
2009/4/1,嘉義縣,大林鎮,11022,34042,17532,16510
2009/4/1,嘉義縣,民雄鄉,22118,72705,37478,35227
2009/4/1,嘉義縣,溪口鄉,5343,16591,8878,7713
2009/4/1,嘉義縣,新港鄉,10208,35177,18559,16618
2009/4/1,嘉義縣,六腳鄉,9060,26957,14299,12658
2009/4/1,嘉義縣,東石鄉,9239,28261,15074,13187
2009/4/1,嘉義縣,義竹鄉,7416,21723,11284,10439
2009/4/1,嘉義縣,鹿草鄉,5645,17390,9340,8050
2009/4/1,嘉義縣,水上鄉,17167,52743,27409,25334
2009/4/1,嘉義縣,中埔鄉,14852,47697,24996,22701
2009/4/1,嘉義縣,竹崎鄉,11162,39080,20836,18244
2009/4/1,嘉義縣,梅山鄉,6506,22079,11731,10348
2009/4/1,嘉義縣,番路鄉,3837,11590,6324,5266
2009/4/1,嘉義縣,大埔鄉,1955,4481,2389,2092
2009/4/1,嘉義縣,阿里山鄉,1990,6186,3323,2863
2009/4/1,臺南市,新營區,26548,78690,39487,39203
2009/4/1,臺南市,永康區,72151,212924,106269,106655
2009/4/1,臺南市,鹽水區,9751,27477,14308,13169
2009/4/1,臺南市,白河區,10838,31927,16828,15099
2009/4/1,臺南市,麻豆區,14581,46124,23617,22507
2009/4/1,臺南市,佳里區,18851,59440,29668,29772
2009/4/1,臺南市,新化區,13387,44459,22833,21626
2009/4/1,臺南市,善化區,14020,43134,21910,21224
2009/4/1,臺南市,學甲區,9282,28195,14453,13742
2009/4/1,臺南市,柳營區,7703,23104,12094,11010
2009/4/1,臺南市,後壁區,8601,26212,13690,12522
2009/4/1,臺南市,東山區,8126,23436,12524,10912
2009/4/1,臺南市,下營區,8967,26558,13787,12771
2009/4/1,臺南市,六甲區,7499,24180,12577,11603
2009/4/1,臺南市,官田區,7530,22450,11552,10898
2009/4/1,臺南市,大內區,4049,11177,5962,5215
2009/4/1,臺南市,西港區,7662,25382,12977,12405
2009/4/1,臺南市,七股區,7834,25131,13145,11986
2009/4/1,臺南市,將軍區,7336,21904,11189,10715
2009/4/1,臺南市,北門區,4242,12560,6423,6137
2009/4/1,臺南市,新市區,10575,35115,17708,17407
2009/4/1,臺南市,安定區,8964,29990,15561,14429
2009/4/1,臺南市,山上區,2708,8065,4248,3817
2009/4/1,臺南市,玉井區,5055,15681,8149,7532
2009/4/1,臺南市,楠西區,3583,10853,5767,5086
2009/4/1,臺南市,南化區,2823,8980,4921,4059
2009/4/1,臺南市,左鎮區,1956,5638,3129,2509
2009/4/1,臺南市,仁德區,23838,68452,35300,33152
2009/4/1,臺南市,歸仁區,19921,65764,33586,32178
2009/4/1,臺南市,關廟區,10528,36526,18992,17534
2009/4/1,臺南市,龍崎區,1593,4481,2431,2050
2009/4/1,高雄市,鳳山區,123491,339543,169851,169692
2009/4/1,高雄市,岡山區,32456,96861,48885,47976
2009/4/1,高雄市,旗山區,13599,40722,21295,19427
2009/4/1,高雄市,美濃區,13836,43704,22857,20847
2009/4/1,高雄市,林園區,23606,70934,36559,34375
2009/4/1,高雄市,大寮區,37318,109314,57069,52245
2009/4/1,高雄市,大樹區,12959,44478,23040,21438
2009/4/1,高雄市,仁武區,24089,69224,35770,33454
2009/4/1,高雄市,大社區,11437,32832,16942,15890
2009/4/1,高雄市,鳥松區,15979,41793,21324,20469
2009/4/1,高雄市,橋頭區,12295,36355,18714,17641
2009/4/1,高雄市,燕巢區,9791,31134,16648,14486
2009/4/1,高雄市,田寮區,3560,8391,4656,3735
2009/4/1,高雄市,阿蓮區,9015,30764,15541,15223
2009/4/1,高雄市,路竹區,15748,54273,27776,26497
2009/4/1,高雄市,湖內區,9216,28621,14804,13817
2009/4/1,高雄市,茄萣區,10026,31701,16604,15097
2009/4/1,高雄市,永安區,5727,14137,7263,6874
2009/4/1,高雄市,彌陀區,6490,20696,10813,9883
2009/4/1,高雄市,梓官區,11712,36889,19275,17614
2009/4/1,高雄市,六龜區,5716,15418,8383,7035
2009/4/1,高雄市,甲仙區,2560,8041,4327,3714
2009/4/1,高雄市,杉林區,4014,11164,6109,5055
2009/4/1,高雄市,內門區,4993,16223,8871,7352
2009/4/1,高雄市,茂林區,535,1815,927,888
2009/4/1,高雄市,桃源區,1244,4780,2551,2229
2009/4/1,高雄市,那瑪夏區,877,3499,1827,1672
2009/4/1,屏東縣,屏東市,71785,214860,107410,107450
2009/4/1,屏東縣,潮州鎮,17846,56605,28566,28039
2009/4/1,屏東縣,東港鎮,14893,50387,25651,24736
2009/4/1,屏東縣,恆春鎮,10525,31165,16098,15067
2009/4/1,屏東縣,萬丹鄉,13952,54395,28208,26187
2009/4/1,屏東縣,長治鄉,9564,30876,16212,14664
2009/4/1,屏東縣,麟洛鄉,3509,11574,6018,5556
2009/4/1,屏東縣,九如鄉,6474,23056,12019,11037
2009/4/1,屏東縣,里港鄉,7803,26298,13485,12813
2009/4/1,屏東縣,鹽埔鄉,7570,27512,14333,13179
2009/4/1,屏東縣,高樹鄉,9531,27276,14584,12692
2009/4/1,屏東縣,萬巒鄉,6326,22424,11846,10578
2009/4/1,屏東縣,內埔鄉,17492,59030,30820,28210
2009/4/1,屏東縣,竹田鄉,5421,18442,9832,8610
2009/4/1,屏東縣,新埤鄉,3300,10910,5773,5137
2009/4/1,屏東縣,枋寮鄉,8314,27094,14367,12727
2009/4/1,屏東縣,新園鄉,10958,39032,20187,18845
2009/4/1,屏東縣,崁頂鄉,4050,17113,8791,8322
2009/4/1,屏東縣,林邊鄉,6237,21011,10889,10122
2009/4/1,屏東縣,南州鄉,3612,11953,6166,5787
2009/4/1,屏東縣,佳冬鄉,6642,21678,11339,10339
2009/4/1,屏東縣,琉球鄉,3837,12508,6941,5567
2009/4/1,屏東縣,車城鄉,3461,9964,5382,4582
2009/4/1,屏東縣,滿州鄉,3022,8579,4711,3868
2009/4/1,屏東縣,枋山鄉,2083,6181,3304,2877
2009/4/1,屏東縣,三地門鄉,2052,7303,3755,3548
2009/4/1,屏東縣,霧臺鄉,873,2674,1442,1232
2009/4/1,屏東縣,瑪家鄉,1810,6417,3342,3075
2009/4/1,屏東縣,泰武鄉,1122,4920,2621,2299
2009/4/1,屏東縣,來義鄉,2079,7703,3981,3722
2009/4/1,屏東縣,春日鄉,1299,4907,2561,2346
2009/4/1,屏東縣,獅子鄉,1439,4960,2627,2333
2009/4/1,屏東縣,牡丹鄉,1804,4855,2538,2317
2009/4/1,臺東縣,臺東市,37464,109731,55826,53905
2009/4/1,臺東縣,成功鎮,5373,16113,8622,7491
2009/4/1,臺東縣,關山鎮,3197,9901,5210,4691
2009/4/1,臺東縣,卑南鄉,6469,18352,9989,8363
2009/4/1,臺東縣,大武鄉,2471,6980,3642,3338
2009/4/1,臺東縣,太麻里鄉,4498,12099,6506,5593
2009/4/1,臺東縣,東河鄉,3508,9517,5290,4227
2009/4/1,臺東縣,長濱鄉,2902,8578,4872,3706
2009/4/1,臺東縣,鹿野鄉,3100,8740,4743,3997
2009/4/1,臺東縣,池上鄉,3218,9318,4964,4354
2009/4/1,臺東縣,綠島鄉,944,3166,1708,1458
2009/4/1,臺東縣,延平鄉,1072,3572,1991,1581
2009/4/1,臺東縣,海端鄉,1082,4525,2467,2058
2009/4/1,臺東縣,達仁鄉,1439,3825,2124,1701
2009/4/1,臺東縣,金峰鄉,984,3385,1774,1611
2009/4/1,臺東縣,蘭嶼鄉,1294,4151,2180,1971
2009/4/1,花蓮縣,花蓮市,39832,109907,54123,55784
2009/4/1,花蓮縣,鳳林鎮,4417,12247,6514,5733
2009/4/1,花蓮縣,玉里鎮,8917,27522,14992,12530
2009/4/1,花蓮縣,新城鄉,7199,20326,10612,9714
2009/4/1,花蓮縣,吉安鄉,28146,79254,40771,38483
2009/4/1,花蓮縣,壽豐鄉,6726,19009,10307,8702
2009/4/1,花蓮縣,光復鄉,4962,14337,7685,6652
2009/4/1,花蓮縣,豐濱鄉,1814,5149,2875,2274
2009/4/1,花蓮縣,瑞穗鄉,4576,13119,7107,6012
2009/4/1,花蓮縣,富里鄉,3930,11777,6498,5279
2009/4/1,花蓮縣,秀林鄉,4524,14946,7806,7140
2009/4/1,花蓮縣,萬榮鄉,2136,6988,3726,3262
2009/4/1,花蓮縣,卓溪鄉,1646,6465,3617,2848
2009/4/1,澎湖縣,馬公市,18793,55584,28231,27353
2009/4/1,澎湖縣,湖西鄉,4522,13175,6904,6271
2009/4/1,澎湖縣,白沙鄉,3038,9248,4870,4378
2009/4/1,澎湖縣,西嶼鄉,2747,8306,4321,3985
2009/4/1,澎湖縣,望安鄉,1790,4548,2454,2094
2009/4/1,澎湖縣,七美鄉,1176,3398,1790,1608
2009/4/1,基隆市,中正區,21814,56623,29169,27454
2009/4/1,基隆市,七堵區,19486,55213,28064,27149
2009/4/1,基隆市,暖暖區,14114,38201,19467,18734
2009/4/1,基隆市,仁愛區,19455,50484,25062,25422
2009/4/1,基隆市,中山區,18753,51710,26499,25211
2009/4/1,基隆市,安樂區,31362,85081,42447,42634
2009/4/1,基隆市,信義區,19721,51385,25819,25566
2009/4/1,新竹市,東區,65068,193503,95755,97748
2009/4/1,新竹市,北區,48331,142813,70981,71832
2009/4/1,新竹市,香山區,21968,71444,36566,34878
2009/4/1,臺中市,中區,8468,23542,11612,11930
2009/4/1,臺中市,東區,25365,74037,37581,36456
2009/4/1,臺中市,西區,42285,117474,56611,60863
2009/4/1,臺中市,南區,40528,112032,54538,57494
2009/4/1,臺中市,北區,54416,147940,71969,75971
2009/4/1,臺中市,西屯區,69757,202014,98481,103533
2009/4/1,臺中市,南屯區,50549,149189,72111,77078
2009/4/1,臺中市,北屯區,80360,242723,118280,124443
2009/4/1,嘉義市,東區,44305,128422,62820,65602
2009/4/1,嘉義市,西區,49355,145790,72491,73299
2009/4/1,臺南市,東區,69604,194421,94406,100015
2009/4/1,臺南市,南區,42421,127037,63897,63140
2009/4/1,臺南市,北區,46584,130656,64785,65871
2009/4/1,臺南市,安南區,52550,176021,89846,86175
2009/4/1,臺南市,安平區,22092,60792,29161,31631
2009/4/1,臺南市,中西區,29871,80583,39730,40853
2009/4/1,臺北市,松山區,76755,209762,99510,110252
2009/4/1,臺北市,信義區,84989,227020,109998,117022
2009/4/1,臺北市,大安區,115413,313219,147885,165334
2009/4/1,臺北市,中山區,89007,218527,103370,115157
2009/4/1,臺北市,中正區,60909,159507,77176,82331
2009/4/1,臺北市,大同區,46093,124362,61539,62823
2009/4/1,臺北市,萬華區,72797,189752,95323,94429
2009/4/1,臺北市,文山區,94957,261534,127194,134340
2009/4/1,臺北市,南港區,40363,113417,56194,57223
2009/4/1,臺北市,內湖區,93253,267012,129215,137797
2009/4/1,臺北市,士林區,98525,285178,139159,146019
2009/4/1,臺北市,北投區,87592,249186,121237,127949
2009/4/1,高雄市,鹽埕區,11167,28007,14170,13837
2009/4/1,高雄市,鼓山區,49214,126827,62633,64194
2009/4/1,高雄市,左營區,71799,189053,93607,95446
2009/4/1,高雄市,楠梓區,60107,170877,85104,85773
2009/4/1,高雄市,三民區,128744,355643,174795,180848
2009/4/1,高雄市,新興區,22852,56576,27684,28892
2009/4/1,高雄市,前金區,12516,29628,14523,15105
2009/4/1,高雄市,苓雅區,70679,186216,91066,95150
2009/4/1,高雄市,前鎮區,74778,200358,100132,100226
2009/4/1,高雄市,旗津區,10801,29828,15523,14305
2009/4/1,高雄市,小港區,61027,153195,77387,75808
2009/4/1,金門縣,金城鎮,10336,29763,15558,14205
2009/4/1,金門縣,金湖鎮,6776,19267,10097,9170
2009/4/1,金門縣,金沙鎮,5091,13927,7219,6708
2009/4/1,金門縣,金寧鄉,5781,16228,8679,7549
2009/4/1,金門縣,烈嶼鄉,2433,7811,4052,3759
2009/4/1,金門縣,烏坵鄉,136,460,234,226
2009/4/1,連江縣,南竿鄉,1137,5811,3348,2463
2009/4/1,連江縣,北竿鄉,384,1759,1018,741
2009/4/1,連江縣,莒光鄉,236,1171,682,489
2009/4/1,連江縣,東引鄉,260,1030,611,419
2009/5/1,總計,臺灣地區,7673518,22965114,11575144,11389970
2009/5/1,總計,臺灣省,6137750,18821228,9551467,9269761
2009/5/1,總計,新北市,1351841,3847554,1917995,1929559
2009/5/1,總計,宜蘭縣,150443,460837,235626,225211
2009/5/1,總計,桃園市,642719,1965313,993844,971469
2009/5/1,總計,新竹縣,154812,505855,261037,244818
2009/5/1,總計,苗栗縣,167973,560631,292099,268532
2009/5/1,總計,臺中市,454252,1559198,791821,767377
2009/5/1,總計,彰化縣,355801,1312239,675212,637027
2009/5/1,總計,南投縣,167739,531244,274266,256978
2009/5/1,總計,雲林縣,224887,723038,378634,344404
2009/5/1,總計,嘉義縣,172517,547594,286544,261050
2009/5/1,總計,臺南市,360906,1104038,564934,539104
2009/5/1,總計,高雄市,422685,1242867,638381,604486
2009/5/1,總計,屏東縣,270864,883384,455617,427767
2009/5/1,總計,臺東縣,79092,231930,121879,110051
2009/5/1,總計,花蓮縣,118934,341032,176567,164465
2009/5/1,總計,澎湖縣,32154,94576,48727,45849
2009/5/1,總計,基隆市,144862,388693,196536,192157
2009/5/1,總計,新竹市,135714,408047,203367,204680
2009/5/1,總計,臺中市,372265,1069354,521295,548059
2009/5/1,總計,嘉義市,93753,274088,135228,138860
2009/5/1,總計,臺南市,263537,769716,381858,387858
2009/5/1,總計,臺北市,961347,2617566,1267200,1350366
2009/5/1,總計,高雄市,574421,1526320,756477,769843
2009/5/1,總計,福建省,32684,97913,51796,46117
2009/5/1,總計,金門縣,30657,88134,46137,41997
2009/5/1,總計,連江縣,2027,9779,5659,4120
2009/5/1,新北市,板橋區,188283,551901,274046,277855
2009/5/1,新北市,三重區,134628,385867,193131,192736
2009/5/1,新北市,永和區,88782,237162,114091,123071
2009/5/1,新北市,中和區,150934,412979,204997,207982
2009/5/1,新北市,新莊區,132636,399625,197867,201758
2009/5/1,新北市,新店區,112709,292819,144135,148684
2009/5/1,新北市,土城區,79929,238289,119572,118717
2009/5/1,新北市,蘆洲區,63278,195552,97098,98454
2009/5/1,新北市,汐止區,75803,184311,91909,92402
2009/5/1,新北市,樹林區,55672,169927,85954,83973
2009/5/1,新北市,鶯歌區,26528,86363,43911,42452
2009/5/1,新北市,三峽區,32794,98897,50793,48104
2009/5/1,新北市,淡水區,52765,136864,66940,69924
2009/5/1,新北市,瑞芳區,15613,42920,21996,20924
2009/5/1,新北市,五股區,26263,78368,39915,38453
2009/5/1,新北市,泰山區,25454,75998,38378,37620
2009/5/1,新北市,林口區,26295,74871,37235,37636
2009/5/1,新北市,深坑區,8436,22957,11633,11324
2009/5/1,新北市,石碇區,3247,7955,4439,3516
2009/5/1,新北市,坪林區,2390,6551,3663,2888
2009/5/1,新北市,三芝區,8671,23440,12155,11285
2009/5/1,新北市,石門區,3821,12135,6429,5706
2009/5/1,新北市,八里區,11445,33370,17112,16258
2009/5/1,新北市,平溪區,2339,5510,3052,2458
2009/5/1,新北市,雙溪區,3810,9882,5326,4556
2009/5/1,新北市,貢寮區,4320,13873,7191,6682
2009/5/1,新北市,金山區,6547,22371,11318,11053
2009/5/1,新北市,萬里區,6774,21181,10850,10331
2009/5/1,新北市,烏來區,1675,5616,2859,2757
2009/5/1,宜蘭縣,宜蘭市,32471,95856,47331,48525
2009/5/1,宜蘭縣,羅東鎮,24483,73554,35413,38141
2009/5/1,宜蘭縣,蘇澳鎮,13393,43418,22369,21049
2009/5/1,宜蘭縣,頭城鎮,9478,31162,16158,15004
2009/5/1,宜蘭縣,礁溪鄉,12046,35868,18840,17028
2009/5/1,宜蘭縣,壯圍鄉,7906,25047,13246,11801
2009/5/1,宜蘭縣,員山鄉,10521,32307,17350,14957
2009/5/1,宜蘭縣,冬山鄉,16764,52018,26915,25103
2009/5/1,宜蘭縣,五結鄉,12575,38531,20083,18448
2009/5/1,宜蘭縣,三星鄉,7265,21284,11537,9747
2009/5/1,宜蘭縣,大同鄉,1794,5912,3257,2655
2009/5/1,宜蘭縣,南澳鄉,1747,5880,3127,2753
2009/5/1,桃園市,桃園區,137522,398466,195695,202771
2009/5/1,桃園市,中壢區,121129,362919,181938,180981
2009/5/1,桃園市,平鎮區,63910,205745,103799,101946
2009/5/1,桃園市,八德區,55147,173641,88794,84847
2009/5/1,桃園市,大溪區,28390,91419,47170,44249
2009/5/1,桃園市,楊梅區,46060,146605,74791,71814
2009/5/1,桃園市,蘆竹區,45433,136935,68845,68090
2009/5/1,桃園市,大園區,24864,80595,41928,38667
2009/5/1,桃園市,龜山區,47687,134667,68482,66185
2009/5/1,桃園市,龍潭區,35675,113840,58055,55785
2009/5/1,桃園市,新屋區,14720,49638,26496,23142
2009/5/1,桃園市,觀音區,18577,60458,31983,28475
2009/5/1,桃園市,復興區,3605,10385,5868,4517
2009/5/1,新竹縣,竹北市,43553,134167,67532,66635
2009/5/1,新竹縣,關西鎮,9070,32421,17295,15126
2009/5/1,新竹縣,新埔鎮,10169,36032,19098,16934
2009/5/1,新竹縣,竹東鎮,29767,97074,49002,48072
2009/5/1,新竹縣,湖口鄉,22810,75258,38521,36737
2009/5/1,新竹縣,橫山鄉,4303,14692,7947,6745
2009/5/1,新竹縣,新豐鄉,15105,52431,27173,25258
2009/5/1,新竹縣,芎林鄉,6152,20910,11020,9890
2009/5/1,新竹縣,寶山鄉,4532,13763,7424,6339
2009/5/1,新竹縣,北埔鄉,3051,10290,5562,4728
2009/5/1,新竹縣,峨眉鄉,2016,6090,3384,2706
2009/5/1,新竹縣,尖石鄉,2614,8204,4538,3666
2009/5/1,新竹縣,五峰鄉,1670,4523,2541,1982
2009/5/1,苗栗縣,苗栗市,28513,91028,46028,45000
2009/5/1,苗栗縣,苑裡鎮,13606,49000,25645,23355
2009/5/1,苗栗縣,通霄鎮,11096,38684,20642,18042
2009/5/1,苗栗縣,竹南鎮,22889,76664,39077,37587
2009/5/1,苗栗縣,頭份市,28407,95837,48958,46879
2009/5/1,苗栗縣,後龍鎮,11491,39936,21142,18794
2009/5/1,苗栗縣,卓蘭鎮,5859,18420,9750,8670
2009/5/1,苗栗縣,大湖鄉,5259,16216,8720,7496
2009/5/1,苗栗縣,公館鄉,9917,34818,18315,16503
2009/5/1,苗栗縣,銅鑼鄉,5915,19592,10416,9176
2009/5/1,苗栗縣,南庄鄉,3902,11299,6251,5048
2009/5/1,苗栗縣,頭屋鄉,3479,11661,6173,5488
2009/5/1,苗栗縣,三義鄉,5179,17607,9320,8287
2009/5/1,苗栗縣,西湖鄉,2646,7929,4394,3535
2009/5/1,苗栗縣,造橋鄉,3903,13720,7268,6452
2009/5/1,苗栗縣,三灣鄉,2364,7423,4036,3387
2009/5/1,苗栗縣,獅潭鄉,1657,5033,2821,2212
2009/5/1,苗栗縣,泰安鄉,1891,5764,3143,2621
2009/5/1,臺中市,豐原區,48341,165391,82334,83057
2009/5/1,臺中市,大里區,59754,195267,97102,98165
2009/5/1,臺中市,太平區,53222,172145,86587,85558
2009/5/1,臺中市,東勢區,16727,53989,28078,25911
2009/5/1,臺中市,大甲區,21222,78928,40112,38816
2009/5/1,臺中市,清水區,24335,85743,44315,41428
2009/5/1,臺中市,沙鹿區,22563,80086,40809,39277
2009/5/1,臺中市,梧棲區,15630,54831,27887,26944
2009/5/1,臺中市,后里區,14505,54460,28120,26340
2009/5/1,臺中市,神岡區,17284,64145,33135,31010
2009/5/1,臺中市,潭子區,31325,98904,49488,49416
2009/5/1,臺中市,大雅區,25600,89139,45026,44113
2009/5/1,臺中市,新社區,7254,25817,13619,12198
2009/5/1,臺中市,石岡區,4764,16152,8422,7730
2009/5/1,臺中市,外埔區,8582,31904,16445,15459
2009/5/1,臺中市,大安區,5167,20474,10803,9671
2009/5/1,臺中市,烏日區,19744,68148,34606,33542
2009/5/1,臺中市,大肚區,15455,55955,28743,27212
2009/5/1,臺中市,龍井區,19922,73065,37360,35705
2009/5/1,臺中市,霧峰區,18396,63888,32917,30971
2009/5/1,臺中市,和平區,4460,10767,5913,4854
2009/5/1,彰化縣,彰化市,70186,236900,118411,118489
2009/5/1,彰化縣,鹿港鎮,21693,85343,43788,41555
2009/5/1,彰化縣,和美鎮,23492,89433,45946,43487
2009/5/1,彰化縣,北斗鎮,9671,33611,17074,16537
2009/5/1,彰化縣,員林市,35922,126131,63579,62552
2009/5/1,彰化縣,溪湖鎮,14797,56465,28885,27580
2009/5/1,彰化縣,田中鎮,12312,44632,23364,21268
2009/5/1,彰化縣,二林鎮,14084,54685,28198,26487
2009/5/1,彰化縣,線西鄉,4017,17006,8759,8247
2009/5/1,彰化縣,伸港鄉,8738,35837,18498,17339
2009/5/1,彰化縣,福興鄉,11758,49107,25752,23355
2009/5/1,彰化縣,秀水鄉,9451,38975,20212,18763
2009/5/1,彰化縣,花壇鄉,12649,46183,23875,22308
2009/5/1,彰化縣,芬園鄉,6793,25009,13300,11709
2009/5/1,彰化縣,大村鄉,9976,36498,19060,17438
2009/5/1,彰化縣,埔鹽鄉,8629,34509,18145,16364
2009/5/1,彰化縣,埔心鄉,9736,35339,18371,16968
2009/5/1,彰化縣,永靖鄉,10223,39564,20541,19023
2009/5/1,彰化縣,社頭鄉,12123,45109,23257,21852
2009/5/1,彰化縣,二水鄉,5254,16829,8894,7935
2009/5/1,彰化縣,田尾鄉,7545,28813,15057,13756
2009/5/1,彰化縣,埤頭鄉,8416,32029,16772,15257
2009/5/1,彰化縣,芳苑鄉,9911,36592,19426,17166
2009/5/1,彰化縣,大城鄉,5324,19093,10390,8703
2009/5/1,彰化縣,竹塘鄉,4524,16663,8800,7863
2009/5/1,彰化縣,溪州鄉,8577,31884,16858,15026
2009/5/1,南投縣,南投市,32713,105036,52966,52070
2009/5/1,南投縣,埔里鎮,27904,86080,43496,42584
2009/5/1,南投縣,草屯鎮,30332,100296,50852,49444
2009/5/1,南投縣,竹山鎮,18537,58881,30476,28405
2009/5/1,南投縣,集集鎮,4219,12027,6327,5700
2009/5/1,南投縣,名間鄉,11899,41579,21894,19685
2009/5/1,南投縣,鹿谷鄉,6530,19330,10301,9029
2009/5/1,南投縣,中寮鄉,5549,16383,8923,7460
2009/5/1,南投縣,魚池鄉,5751,17327,9187,8140
2009/5/1,南投縣,國姓鄉,7159,21043,11529,9514
2009/5/1,南投縣,水里鄉,7176,20524,10799,9725
2009/5/1,南投縣,信義鄉,5087,17182,9320,7862
2009/5/1,南投縣,仁愛鄉,4883,15556,8196,7360
2009/5/1,雲林縣,斗六市,33670,106335,53725,52610
2009/5/1,雲林縣,斗南鎮,14969,47630,24206,23424
2009/5/1,雲林縣,虎尾鎮,21794,69962,35667,34295
2009/5/1,雲林縣,西螺鎮,13815,49054,24927,24127
2009/5/1,雲林縣,土庫鎮,8581,30864,16156,14708
2009/5/1,雲林縣,北港鎮,14960,43765,22806,20959
2009/5/1,雲林縣,古坑鄉,10482,34738,18443,16295
2009/5/1,雲林縣,大埤鄉,6563,21583,11525,10058
2009/5/1,雲林縣,莿桐鄉,8879,30708,16110,14598
2009/5/1,雲林縣,林內鄉,5642,20263,10599,9664
2009/5/1,雲林縣,二崙鄉,8690,30134,16200,13934
2009/5/1,雲林縣,崙背鄉,8242,27851,14727,13124
2009/5/1,雲林縣,麥寮鄉,11841,34539,18260,16279
2009/5/1,雲林縣,東勢鄉,5703,17241,9410,7831
2009/5/1,雲林縣,褒忠鄉,4245,14634,7814,6820
2009/5/1,雲林縣,臺西鄉,8716,26762,14440,12322
2009/5/1,雲林縣,元長鄉,9266,29325,16010,13315
2009/5/1,雲林縣,四湖鄉,8985,27330,14953,12377
2009/5/1,雲林縣,口湖鄉,9561,30866,16500,14366
2009/5/1,雲林縣,水林鄉,10283,29454,16156,13298
2009/5/1,嘉義縣,太保市,10781,35927,18623,17304
2009/5/1,嘉義縣,朴子市,14037,44383,22726,21657
2009/5/1,嘉義縣,布袋鎮,10032,30691,15814,14877
2009/5/1,嘉義縣,大林鎮,11043,33994,17512,16482
2009/5/1,嘉義縣,民雄鄉,22159,72678,37464,35214
2009/5/1,嘉義縣,溪口鄉,5351,16601,8881,7720
2009/5/1,嘉義縣,新港鄉,10211,35184,18561,16623
2009/5/1,嘉義縣,六腳鄉,9069,26939,14305,12634
2009/5/1,嘉義縣,東石鄉,9241,28215,15047,13168
2009/5/1,嘉義縣,義竹鄉,7431,21773,11300,10473
2009/5/1,嘉義縣,鹿草鄉,5647,17365,9329,8036
2009/5/1,嘉義縣,水上鄉,17171,52724,27394,25330
2009/5/1,嘉義縣,中埔鄉,14875,47724,25007,22717
2009/5/1,嘉義縣,竹崎鄉,11169,39055,20826,18229
2009/5/1,嘉義縣,梅山鄉,6515,22061,11711,10350
2009/5/1,嘉義縣,番路鄉,3841,11607,6333,5274
2009/5/1,嘉義縣,大埔鄉,1956,4493,2395,2098
2009/5/1,嘉義縣,阿里山鄉,1988,6180,3316,2864
2009/5/1,臺南市,新營區,26577,78738,39495,39243
2009/5/1,臺南市,永康區,72287,213057,106286,106771
2009/5/1,臺南市,鹽水區,9745,27450,14302,13148
2009/5/1,臺南市,白河區,10846,31912,16812,15100
2009/5/1,臺南市,麻豆區,14608,46145,23619,22526
2009/5/1,臺南市,佳里區,18859,59459,29672,29787
2009/5/1,臺南市,新化區,13388,44425,22812,21613
2009/5/1,臺南市,善化區,14047,43175,21925,21250
2009/5/1,臺南市,學甲區,9291,28199,14452,13747
2009/5/1,臺南市,柳營區,7705,23078,12073,11005
2009/5/1,臺南市,後壁區,8606,26184,13672,12512
2009/5/1,臺南市,東山區,8137,23432,12514,10918
2009/5/1,臺南市,下營區,8977,26531,13774,12757
2009/5/1,臺南市,六甲區,7506,24175,12567,11608
2009/5/1,臺南市,官田區,7538,22435,11552,10883
2009/5/1,臺南市,大內區,4056,11187,5955,5232
2009/5/1,臺南市,西港區,7664,25367,12966,12401
2009/5/1,臺南市,七股區,7837,25129,13143,11986
2009/5/1,臺南市,將軍區,7350,21871,11174,10697
2009/5/1,臺南市,北門區,4251,12572,6420,6152
2009/5/1,臺南市,新市區,10570,35061,17672,17389
2009/5/1,臺南市,安定區,8971,30032,15581,14451
2009/5/1,臺南市,山上區,2703,8055,4243,3812
2009/5/1,臺南市,玉井區,5055,15659,8133,7526
2009/5/1,臺南市,楠西區,3578,10850,5768,5082
2009/5/1,臺南市,南化區,2825,8984,4921,4063
2009/5/1,臺南市,左鎮區,1960,5650,3132,2518
2009/5/1,臺南市,仁德區,23876,68468,35297,33171
2009/5/1,臺南市,歸仁區,19954,65760,33597,32163
2009/5/1,臺南市,關廟區,10543,36521,18988,17533
2009/5/1,臺南市,龍崎區,1596,4477,2417,2060
2009/5/1,高雄市,鳳山區,123607,339376,169746,169630
2009/5/1,高雄市,岡山區,32487,96840,48869,47971
2009/5/1,高雄市,旗山區,13606,40679,21266,19413
2009/5/1,高雄市,美濃區,13859,43661,22815,20846
2009/5/1,高雄市,林園區,23621,70924,36562,34362
2009/5/1,高雄市,大寮區,37352,109283,57065,52218
2009/5/1,高雄市,大樹區,12952,44401,23004,21397
2009/5/1,高雄市,仁武區,24161,69313,35825,33488
2009/5/1,高雄市,大社區,11440,32818,16942,15876
2009/5/1,高雄市,鳥松區,16021,41831,21314,20517
2009/5/1,高雄市,橋頭區,12303,36319,18704,17615
2009/5/1,高雄市,燕巢區,9817,31138,16653,14485
2009/5/1,高雄市,田寮區,3558,8376,4640,3736
2009/5/1,高雄市,阿蓮區,9017,30742,15526,15216
2009/5/1,高雄市,路竹區,15747,54237,27758,26479
2009/5/1,高雄市,湖內區,9221,28615,14795,13820
2009/5/1,高雄市,茄萣區,10018,31701,16600,15101
2009/5/1,高雄市,永安區,5725,14134,7258,6876
2009/5/1,高雄市,彌陀區,6493,20672,10810,9862
2009/5/1,高雄市,梓官區,11731,36900,19270,17630
2009/5/1,高雄市,六龜區,5718,15418,8383,7035
2009/5/1,高雄市,甲仙區,2566,8028,4320,3708
2009/5/1,高雄市,杉林區,4011,11158,6101,5057
2009/5/1,高雄市,內門區,4994,16206,8854,7352
2009/5/1,高雄市,茂林區,537,1815,924,891
2009/5/1,高雄市,桃源區,1245,4773,2545,2228
2009/5/1,高雄市,那瑪夏區,878,3509,1832,1677
2009/5/1,屏東縣,屏東市,71786,214607,107296,107311
2009/5/1,屏東縣,潮州鎮,17863,56577,28564,28013
2009/5/1,屏東縣,東港鎮,14910,50411,25667,24744
2009/5/1,屏東縣,恆春鎮,10529,31160,16096,15064
2009/5/1,屏東縣,萬丹鄉,13969,54405,28211,26194
2009/5/1,屏東縣,長治鄉,9579,30900,16224,14676
2009/5/1,屏東縣,麟洛鄉,3511,11580,6014,5566
2009/5/1,屏東縣,九如鄉,6479,23047,12008,11039
2009/5/1,屏東縣,里港鄉,7804,26281,13475,12806
2009/5/1,屏東縣,鹽埔鄉,7590,27509,14331,13178
2009/5/1,屏東縣,高樹鄉,9534,27262,14570,12692
2009/5/1,屏東縣,萬巒鄉,6340,22429,11844,10585
2009/5/1,屏東縣,內埔鄉,17521,58975,30777,28198
2009/5/1,屏東縣,竹田鄉,5423,18435,9824,8611
2009/5/1,屏東縣,新埤鄉,3305,10924,5780,5144
2009/5/1,屏東縣,枋寮鄉,8319,27097,14365,12732
2009/5/1,屏東縣,新園鄉,10948,39010,20175,18835
2009/5/1,屏東縣,崁頂鄉,4051,17128,8796,8332
2009/5/1,屏東縣,林邊鄉,6241,20989,10871,10118
2009/5/1,屏東縣,南州鄉,3617,11953,6162,5791
2009/5/1,屏東縣,佳冬鄉,6642,21651,11322,10329
2009/5/1,屏東縣,琉球鄉,3843,12511,6941,5570
2009/5/1,屏東縣,車城鄉,3461,9964,5391,4573
2009/5/1,屏東縣,滿州鄉,3021,8594,4710,3884
2009/5/1,屏東縣,枋山鄉,2083,6200,3307,2893
2009/5/1,屏東縣,三地門鄉,2054,7319,3766,3553
2009/5/1,屏東縣,霧臺鄉,875,2693,1446,1247
2009/5/1,屏東縣,瑪家鄉,1812,6418,3347,3071
2009/5/1,屏東縣,泰武鄉,1125,4912,2617,2295
2009/5/1,屏東縣,來義鄉,2081,7710,3985,3725
2009/5/1,屏東縣,春日鄉,1299,4906,2560,2346
2009/5/1,屏東縣,獅子鄉,1440,4953,2629,2324
2009/5/1,屏東縣,牡丹鄉,1809,4874,2546,2328
2009/5/1,臺東縣,臺東市,37479,109715,55842,53873
2009/5/1,臺東縣,成功鎮,5375,16092,8606,7486
2009/5/1,臺東縣,關山鎮,3194,9870,5187,4683
2009/5/1,臺東縣,卑南鄉,6487,18338,9971,8367
2009/5/1,臺東縣,大武鄉,2483,7024,3657,3367
2009/5/1,臺東縣,太麻里鄉,4494,12066,6490,5576
2009/5/1,臺東縣,東河鄉,3505,9495,5278,4217
2009/5/1,臺東縣,長濱鄉,2894,8546,4856,3690
2009/5/1,臺東縣,鹿野鄉,3108,8725,4736,3989
2009/5/1,臺東縣,池上鄉,3222,9325,4964,4361
2009/5/1,臺東縣,綠島鄉,959,3199,1724,1475
2009/5/1,臺東縣,延平鄉,1076,3599,1998,1601
2009/5/1,臺東縣,海端鄉,1082,4516,2463,2053
2009/5/1,臺東縣,達仁鄉,1447,3869,2142,1727
2009/5/1,臺東縣,金峰鄉,988,3382,1773,1609
2009/5/1,臺東縣,蘭嶼鄉,1299,4169,2192,1977
2009/5/1,花蓮縣,花蓮市,39871,109979,54138,55841
2009/5/1,花蓮縣,鳳林鎮,4421,12243,6512,5731
2009/5/1,花蓮縣,玉里鎮,8910,27488,14969,12519
2009/5/1,花蓮縣,新城鄉,7205,20307,10608,9699
2009/5/1,花蓮縣,吉安鄉,28165,79222,40745,38477
2009/5/1,花蓮縣,壽豐鄉,6731,18987,10295,8692
2009/5/1,花蓮縣,光復鄉,4976,14364,7683,6681
2009/5/1,花蓮縣,豐濱鄉,1813,5142,2869,2273
2009/5/1,花蓮縣,瑞穗鄉,4585,13085,7085,6000
2009/5/1,花蓮縣,富里鄉,3938,11777,6505,5272
2009/5/1,花蓮縣,秀林鄉,4535,14958,7809,7149
2009/5/1,花蓮縣,萬榮鄉,2136,7004,3728,3276
2009/5/1,花蓮縣,卓溪鄉,1648,6476,3621,2855
2009/5/1,澎湖縣,馬公市,18832,55642,28271,27371
2009/5/1,澎湖縣,湖西鄉,4529,13210,6915,6295
2009/5/1,澎湖縣,白沙鄉,3052,9247,4869,4378
2009/5/1,澎湖縣,西嶼鄉,2762,8472,4405,4067
2009/5/1,澎湖縣,望安鄉,1795,4562,2460,2102
2009/5/1,澎湖縣,七美鄉,1184,3443,1807,1636
2009/5/1,基隆市,中正區,21856,56609,29157,27452
2009/5/1,基隆市,七堵區,19514,55250,28095,27155
2009/5/1,基隆市,暖暖區,14117,38187,19466,18721
2009/5/1,基隆市,仁愛區,19499,50518,25075,25443
2009/5/1,基隆市,中山區,18767,51671,26472,25199
2009/5/1,基隆市,安樂區,31398,85110,42475,42635
2009/5/1,基隆市,信義區,19711,51348,25796,25552
2009/5/1,新竹市,東區,65244,193686,95808,97878
2009/5/1,新竹市,北區,48415,142860,70977,71883
2009/5/1,新竹市,香山區,22055,71501,36582,34919
2009/5/1,臺中市,中區,8450,23496,11591,11905
2009/5/1,臺中市,東區,25370,74024,37581,36443
2009/5/1,臺中市,西區,42346,117499,56598,60901
2009/5/1,臺中市,南區,40614,112130,54579,57551
2009/5/1,臺中市,北區,54504,147935,71957,75978
2009/5/1,臺中市,西屯區,69882,202209,98552,103657
2009/5/1,臺中市,南屯區,50624,149256,72102,77154
2009/5/1,臺中市,北屯區,80475,242805,118335,124470
2009/5/1,嘉義市,東區,44358,128381,62792,65589
2009/5/1,嘉義市,西區,49395,145707,72436,73271
2009/5/1,臺南市,東區,69699,194471,94443,100028
2009/5/1,臺南市,南區,42463,126979,63846,63133
2009/5/1,臺南市,北區,46705,130773,64836,65937
2009/5/1,臺南市,安南區,52633,176080,89839,86241
2009/5/1,臺南市,安平區,22159,60879,29205,31674
2009/5/1,臺南市,中西區,29878,80534,39689,40845
2009/5/1,臺北市,松山區,76797,209765,99552,110213
2009/5/1,臺北市,信義區,84999,226705,109815,116890
2009/5/1,臺北市,大安區,115374,313128,147898,165230
2009/5/1,臺北市,中山區,89064,218336,103272,115064
2009/5/1,臺北市,中正區,60953,159515,77213,82302
2009/5/1,臺北市,大同區,46175,124403,61536,62867
2009/5/1,臺北市,萬華區,72782,189487,95131,94356
2009/5/1,臺北市,文山區,95019,261534,127170,134364
2009/5/1,臺北市,南港區,40417,113429,56181,57248
2009/5/1,臺北市,內湖區,93458,267148,129209,137939
2009/5/1,臺北市,士林區,98583,284978,139037,145941
2009/5/1,臺北市,北投區,87726,249138,121186,127952
2009/5/1,高雄市,鹽埕區,11160,27963,14127,13836
2009/5/1,高雄市,鼓山區,49336,127018,62699,64319
2009/5/1,高雄市,左營區,71865,189189,93627,95562
2009/5/1,高雄市,楠梓區,60176,170850,85072,85778
2009/5/1,高雄市,三民區,128949,355655,174772,180883
2009/5/1,高雄市,新興區,22828,56475,27625,28850
2009/5/1,高雄市,前金區,12517,29608,14520,15088
2009/5/1,高雄市,苓雅區,70725,186070,90967,95103
2009/5/1,高雄市,前鎮區,74893,200344,100120,100224
2009/5/1,高雄市,旗津區,10805,29846,15537,14309
2009/5/1,高雄市,小港區,61167,153302,77411,75891
2009/5/1,金門縣,金城鎮,10376,30025,15673,14352
2009/5/1,金門縣,金湖鎮,6801,19417,10158,9259
2009/5/1,金門縣,金沙鎮,5099,14002,7255,6747
2009/5/1,金門縣,金寧鄉,5799,16354,8735,7619
2009/5/1,金門縣,烈嶼鄉,2446,7873,4081,3792
2009/5/1,金門縣,烏坵鄉,136,463,235,228
2009/5/1,連江縣,南竿鄉,1147,5823,3354,2469
2009/5/1,連江縣,北竿鄉,383,1750,1013,737
2009/5/1,連江縣,莒光鄉,237,1172,682,490
2009/5/1,連江縣,東引鄉,260,1034,610,424
2009/6/1,總計,臺灣地區,7688014,22970076,11575534,11394542
2009/6/1,總計,臺灣省,6149880,18827136,9552813,9274323
2009/6/1,總計,新北市,1355076,3849492,1918662,1930830
2009/6/1,總計,宜蘭縣,150753,461461,235895,225566
2009/6/1,總計,桃園市,644525,1967038,994591,972447
2009/6/1,總計,新竹縣,155306,506546,261361,245185
2009/6/1,總計,苗栗縣,168240,560581,292041,268540
2009/6/1,總計,臺中市,455093,1559178,791714,767464
2009/6/1,總計,彰化縣,356344,1312165,675076,637089
2009/6/1,總計,南投縣,167989,531307,274216,257091
2009/6/1,總計,雲林縣,225184,723065,378542,344523
2009/6/1,總計,嘉義縣,172731,547550,286466,261084
2009/6/1,總計,臺南市,361442,1103789,564733,539056
2009/6/1,總計,高雄市,423280,1242652,638174,604478
2009/6/1,總計,屏東縣,271046,883075,455381,427694
2009/6/1,總計,臺東縣,79198,232071,121902,110169
2009/6/1,總計,花蓮縣,119080,340903,176456,164447
2009/6/1,總計,澎湖縣,32282,94886,48888,45998
2009/6/1,總計,基隆市,145149,388703,196505,192198
2009/6/1,總計,新竹市,136188,408466,203507,204959
2009/6/1,總計,臺中市,373118,1070145,521622,548523
2009/6/1,總計,嘉義市,93943,274171,135209,138962
2009/6/1,總計,臺南市,263913,769892,381872,388020
2009/6/1,總計,臺北市,962831,2616520,1266401,1350119
2009/6/1,總計,高雄市,575303,1526420,756320,770100
2009/6/1,總計,福建省,32924,99269,52389,46880
2009/6/1,總計,金門縣,30893,89471,46716,42755
2009/6/1,總計,連江縣,2031,9798,5673,4125
2009/6/1,新北市,板橋區,188695,551995,274109,277886
2009/6/1,新北市,三重區,135018,385999,193189,192810
2009/6/1,新北市,永和區,88931,237238,114133,123105
2009/6/1,新北市,中和區,151212,412842,204856,207986
2009/6/1,新北市,新莊區,132837,399606,197817,201789
2009/6/1,新北市,新店區,112863,292568,144050,148518
2009/6/1,新北市,土城區,80111,238327,119539,118788
2009/6/1,新北市,蘆洲區,63381,195566,97111,98455
2009/6/1,新北市,汐止區,75921,184401,91958,92443
2009/6/1,新北市,樹林區,55906,170355,86129,84226
2009/6/1,新北市,鶯歌區,26584,86327,43873,42454
2009/6/1,新北市,三峽區,32949,99155,50891,48264
2009/6/1,新北市,淡水區,53020,137319,67129,70190
2009/6/1,新北市,瑞芳區,15619,42860,21959,20901
2009/6/1,新北市,五股區,26415,78598,40027,38571
2009/6/1,新北市,泰山區,25514,76083,38425,37658
2009/6/1,新北市,林口區,26507,75279,37422,37857
2009/6/1,新北市,深坑區,8453,22986,11642,11344
2009/6/1,新北市,石碇區,3251,7968,4454,3514
2009/6/1,新北市,坪林區,2394,6559,3666,2893
2009/6/1,新北市,三芝區,8680,23423,12119,11304
2009/6/1,新北市,石門區,3835,12173,6455,5718
2009/6/1,新北市,八里區,11482,33415,17119,16296
2009/6/1,新北市,平溪區,2348,5506,3049,2457
2009/6/1,新北市,雙溪區,3802,9868,5321,4547
2009/6/1,新北市,貢寮區,4321,13853,7189,6664
2009/6/1,新北市,金山區,6546,22325,11288,11037
2009/6/1,新北市,萬里區,6801,21289,10889,10400
2009/6/1,新北市,烏來區,1680,5609,2854,2755
2009/6/1,宜蘭縣,宜蘭市,32575,96066,47470,48596
2009/6/1,宜蘭縣,羅東鎮,24417,72991,35133,37858
2009/6/1,宜蘭縣,蘇澳鎮,13401,43353,22316,21037
2009/6/1,宜蘭縣,頭城鎮,9485,31082,16127,14955
2009/6/1,宜蘭縣,礁溪鄉,12026,35668,18733,16935
2009/6/1,宜蘭縣,壯圍鄉,7916,24992,13212,11780
2009/6/1,宜蘭縣,員山鄉,10545,32256,17332,14924
2009/6/1,宜蘭縣,冬山鄉,16937,52330,27087,25243
2009/6/1,宜蘭縣,五結鄉,12558,38369,19997,18372
2009/6/1,宜蘭縣,三星鄉,7347,22542,12093,10449
2009/6/1,宜蘭縣,大同鄉,1791,5920,3261,2659
2009/6/1,宜蘭縣,南澳鄉,1755,5892,3134,2758
2009/6/1,桃園市,桃園區,137913,398808,195833,202975
2009/6/1,桃園市,中壢區,121462,363182,182008,181174
2009/6/1,桃園市,平鎮區,64119,205848,103864,101984
2009/6/1,桃園市,八德區,55354,173732,88826,84906
2009/6/1,桃園市,大溪區,28445,91536,47232,44304
2009/6/1,桃園市,楊梅區,46236,146840,74915,71925
2009/6/1,桃園市,蘆竹區,45537,137175,68940,68235
2009/6/1,桃園市,大園區,24952,80661,41980,38681
2009/6/1,桃園市,龜山區,47806,134841,68557,66284
2009/6/1,桃園市,龍潭區,35747,113950,58112,55838
2009/6/1,桃園市,新屋區,14737,49597,26479,23118
2009/6/1,桃園市,觀音區,18609,60465,31972,28493
2009/6/1,桃園市,復興區,3608,10403,5873,4530
2009/6/1,新竹縣,竹北市,43789,134685,67801,66884
2009/6/1,新竹縣,關西鎮,9094,32411,17280,15131
2009/6/1,新竹縣,新埔鎮,10181,35988,19068,16920
2009/6/1,新竹縣,竹東鎮,29817,97078,49003,48075
2009/6/1,新竹縣,湖口鄉,22873,75220,38511,36709
2009/6/1,新竹縣,橫山鄉,4317,14747,7970,6777
2009/6/1,新竹縣,新豐鄉,15137,52500,27189,25311
2009/6/1,新竹縣,芎林鄉,6174,20906,11024,9882
2009/6/1,新竹縣,寶山鄉,4536,13816,7451,6365
2009/6/1,新竹縣,北埔鄉,3055,10274,5555,4719
2009/6/1,新竹縣,峨眉鄉,2026,6125,3403,2722
2009/6/1,新竹縣,尖石鄉,2621,8231,4544,3687
2009/6/1,新竹縣,五峰鄉,1686,4565,2562,2003
2009/6/1,苗栗縣,苗栗市,28532,90979,45985,44994
2009/6/1,苗栗縣,苑裡鎮,13634,48991,25652,23339
2009/6/1,苗栗縣,通霄鎮,11124,38676,20627,18049
2009/6/1,苗栗縣,竹南鎮,22952,76765,39126,37639
2009/6/1,苗栗縣,頭份市,28467,95897,48982,46915
2009/6/1,苗栗縣,後龍鎮,11491,39884,21116,18768
2009/6/1,苗栗縣,卓蘭鎮,5871,18406,9743,8663
2009/6/1,苗栗縣,大湖鄉,5251,16159,8697,7462
2009/6/1,苗栗縣,公館鄉,9923,34800,18305,16495
2009/6/1,苗栗縣,銅鑼鄉,5919,19587,10401,9186
2009/6/1,苗栗縣,南庄鄉,3911,11293,6249,5044
2009/6/1,苗栗縣,頭屋鄉,3483,11657,6176,5481
2009/6/1,苗栗縣,三義鄉,5187,17605,9311,8294
2009/6/1,苗栗縣,西湖鄉,2648,7930,4392,3538
2009/6/1,苗栗縣,造橋鄉,3912,13702,7262,6440
2009/6/1,苗栗縣,三灣鄉,2369,7421,4030,3391
2009/6/1,苗栗縣,獅潭鄉,1658,5042,2826,2216
2009/6/1,苗栗縣,泰安鄉,1908,5787,3161,2626
2009/6/1,臺中市,豐原區,48439,165357,82293,83064
2009/6/1,臺中市,大里區,59905,195415,97142,98273
2009/6/1,臺中市,太平區,53339,172102,86566,85536
2009/6/1,臺中市,東勢區,16731,53918,28041,25877
2009/6/1,臺中市,大甲區,21254,78923,40110,38813
2009/6/1,臺中市,清水區,24362,85669,44259,41410
2009/6/1,臺中市,沙鹿區,22629,80129,40804,39325
2009/6/1,臺中市,梧棲區,15665,54835,27893,26942
2009/6/1,臺中市,后里區,14517,54476,28144,26332
2009/6/1,臺中市,神岡區,17294,64107,33123,30984
2009/6/1,臺中市,潭子區,31417,98989,49528,49461
2009/6/1,臺中市,大雅區,25649,89152,45014,44138
2009/6/1,臺中市,新社區,7255,25811,13610,12201
2009/6/1,臺中市,石岡區,4766,16133,8415,7718
2009/6/1,臺中市,外埔區,8597,31857,16425,15432
2009/6/1,臺中市,大安區,5168,20465,10792,9673
2009/6/1,臺中市,烏日區,19780,68154,34616,33538
2009/6/1,臺中市,大肚區,15468,55944,28740,27204
2009/6/1,臺中市,龍井區,19961,73131,37373,35758
2009/6/1,臺中市,霧峰區,18431,63856,32918,30938
2009/6/1,臺中市,和平區,4466,10755,5908,4847
2009/6/1,彰化縣,彰化市,70315,236948,118381,118567
2009/6/1,彰化縣,鹿港鎮,21742,85319,43784,41535
2009/6/1,彰化縣,和美鎮,23507,89440,45952,43488
2009/6/1,彰化縣,北斗鎮,9690,33614,17080,16534
2009/6/1,彰化縣,員林市,35989,126132,63584,62548
2009/6/1,彰化縣,溪湖鎮,14808,56393,28864,27529
2009/6/1,彰化縣,田中鎮,12333,44608,23351,21257
2009/6/1,彰化縣,二林鎮,14105,54647,28190,26457
2009/6/1,彰化縣,線西鄉,4020,17041,8768,8273
2009/6/1,彰化縣,伸港鄉,8764,35882,18518,17364
2009/6/1,彰化縣,福興鄉,11783,49106,25746,23360
2009/6/1,彰化縣,秀水鄉,9466,38952,20199,18753
2009/6/1,彰化縣,花壇鄉,12668,46215,23886,22329
2009/6/1,彰化縣,芬園鄉,6800,24996,13289,11707
2009/6/1,彰化縣,大村鄉,9987,36516,19064,17452
2009/6/1,彰化縣,埔鹽鄉,8642,34510,18133,16377
2009/6/1,彰化縣,埔心鄉,9750,35356,18369,16987
2009/6/1,彰化縣,永靖鄉,10238,39544,20538,19006
2009/6/1,彰化縣,社頭鄉,12136,45057,23226,21831
2009/6/1,彰化縣,二水鄉,5272,16799,8876,7923
2009/6/1,彰化縣,田尾鄉,7556,28829,15051,13778
2009/6/1,彰化縣,埤頭鄉,8419,32017,16773,15244
2009/6/1,彰化縣,芳苑鄉,9906,36547,19403,17144
2009/6/1,彰化縣,大城鄉,5330,19114,10393,8721
2009/6/1,彰化縣,竹塘鄉,4532,16674,8798,7876
2009/6/1,彰化縣,溪州鄉,8586,31909,16860,15049
2009/6/1,南投縣,南投市,32753,104988,52928,52060
2009/6/1,南投縣,埔里鎮,27940,86114,43517,42597
2009/6/1,南投縣,草屯鎮,30384,100402,50870,49532
2009/6/1,南投縣,竹山鎮,18577,58923,30488,28435
2009/6/1,南投縣,集集鎮,4237,12041,6333,5708
2009/6/1,南投縣,名間鄉,11921,41559,21873,19686
2009/6/1,南投縣,鹿谷鄉,6551,19323,10289,9034
2009/6/1,南投縣,中寮鄉,5559,16385,8925,7460
2009/6/1,南投縣,魚池鄉,5751,17314,9181,8133
2009/6/1,南投縣,國姓鄉,7161,21030,11525,9505
2009/6/1,南投縣,水里鄉,7188,20526,10811,9715
2009/6/1,南投縣,信義鄉,5085,17197,9318,7879
2009/6/1,南投縣,仁愛鄉,4882,15505,8158,7347
2009/6/1,雲林縣,斗六市,33744,106411,53777,52634
2009/6/1,雲林縣,斗南鎮,14977,47626,24204,23422
2009/6/1,雲林縣,虎尾鎮,21829,69955,35653,34302
2009/6/1,雲林縣,西螺鎮,13820,49091,24934,24157
2009/6/1,雲林縣,土庫鎮,8585,30852,16146,14706
2009/6/1,雲林縣,北港鎮,14969,43732,22806,20926
2009/6/1,雲林縣,古坑鄉,10501,34746,18428,16318
2009/6/1,雲林縣,大埤鄉,6571,21548,11507,10041
2009/6/1,雲林縣,莿桐鄉,8891,30659,16071,14588
2009/6/1,雲林縣,林內鄉,5658,20314,10625,9689
2009/6/1,雲林縣,二崙鄉,8693,30093,16174,13919
2009/6/1,雲林縣,崙背鄉,8241,27815,14698,13117
2009/6/1,雲林縣,麥寮鄉,11885,34696,18323,16373
2009/6/1,雲林縣,東勢鄉,5709,17238,9394,7844
2009/6/1,雲林縣,褒忠鄉,4246,14636,7809,6827
2009/6/1,雲林縣,臺西鄉,8717,26735,14426,12309
2009/6/1,雲林縣,元長鄉,9282,29347,16019,13328
2009/6/1,雲林縣,四湖鄉,8986,27310,14930,12380
2009/6/1,雲林縣,口湖鄉,9566,30792,16461,14331
2009/6/1,雲林縣,水林鄉,10314,29469,16157,13312
2009/6/1,嘉義縣,太保市,10806,35949,18636,17313
2009/6/1,嘉義縣,朴子市,14066,44307,22672,21635
2009/6/1,嘉義縣,布袋鎮,10049,30864,15897,14967
2009/6/1,嘉義縣,大林鎮,11055,33978,17513,16465
2009/6/1,嘉義縣,民雄鄉,22180,72638,37434,35204
2009/6/1,嘉義縣,溪口鄉,5354,16590,8870,7720
2009/6/1,嘉義縣,新港鄉,10218,35192,18573,16619
2009/6/1,嘉義縣,六腳鄉,9081,26887,14270,12617
2009/6/1,嘉義縣,東石鄉,9253,28085,14969,13116
2009/6/1,嘉義縣,義竹鄉,7451,21947,11386,10561
2009/6/1,嘉義縣,鹿草鄉,5647,17356,9325,8031
2009/6/1,嘉義縣,水上鄉,17168,52679,27355,25324
2009/6/1,嘉義縣,中埔鄉,14886,47673,24992,22681
2009/6/1,嘉義縣,竹崎鄉,11180,39032,20807,18225
2009/6/1,嘉義縣,梅山鄉,6526,22052,11706,10346
2009/6/1,嘉義縣,番路鄉,3854,11624,6334,5290
2009/6/1,嘉義縣,大埔鄉,1962,4516,2409,2107
2009/6/1,嘉義縣,阿里山鄉,1995,6181,3318,2863
2009/6/1,臺南市,新營區,26612,78648,39427,39221
2009/6/1,臺南市,永康區,72479,213180,106311,106869
2009/6/1,臺南市,鹽水區,9762,27424,14284,13140
2009/6/1,臺南市,白河區,10853,31887,16814,15073
2009/6/1,臺南市,麻豆區,14634,46158,23633,22525
2009/6/1,臺南市,佳里區,18882,59528,29703,29825
2009/6/1,臺南市,新化區,13410,44443,22830,21613
2009/6/1,臺南市,善化區,14078,43183,21934,21249
2009/6/1,臺南市,學甲區,9301,28183,14443,13740
2009/6/1,臺南市,柳營區,7707,23028,12043,10985
2009/6/1,臺南市,後壁區,8610,26180,13665,12515
2009/6/1,臺南市,東山區,8133,23407,12496,10911
2009/6/1,臺南市,下營區,8979,26486,13755,12731
2009/6/1,臺南市,六甲區,7524,24172,12565,11607
2009/6/1,臺南市,官田區,7541,22414,11537,10877
2009/6/1,臺南市,大內區,4054,11171,5948,5223
2009/6/1,臺南市,西港區,7670,25341,12955,12386
2009/6/1,臺南市,七股區,7843,25085,13125,11960
2009/6/1,臺南市,將軍區,7357,21857,11164,10693
2009/6/1,臺南市,北門區,4250,12558,6411,6147
2009/6/1,臺南市,新市區,10591,35049,17654,17395
2009/6/1,臺南市,安定區,8986,30026,15582,14444
2009/6/1,臺南市,山上區,2700,8022,4222,3800
2009/6/1,臺南市,玉井區,5052,15632,8115,7517
2009/6/1,臺南市,楠西區,3576,10836,5762,5074
2009/6/1,臺南市,南化區,2826,8997,4928,4069
2009/6/1,臺南市,左鎮區,1961,5664,3140,2524
2009/6/1,臺南市,仁德區,23915,68468,35309,33159
2009/6/1,臺南市,歸仁區,20000,65813,33602,32211
2009/6/1,臺南市,關廟區,10558,36483,18960,17523
2009/6/1,臺南市,龍崎區,1598,4466,2416,2050
2009/6/1,高雄市,鳳山區,123765,339395,169780,169615
2009/6/1,高雄市,岡山區,32506,96870,48873,47997
2009/6/1,高雄市,旗山區,13614,40620,21241,19379
2009/6/1,高雄市,美濃區,13862,43627,22780,20847
2009/6/1,高雄市,林園區,23652,70866,36543,34323
2009/6/1,高雄市,大寮區,37440,109293,57054,52239
2009/6/1,高雄市,大樹區,12949,44351,22977,21374
2009/6/1,高雄市,仁武區,24247,69387,35844,33543
2009/6/1,高雄市,大社區,11447,32801,16916,15885
2009/6/1,高雄市,鳥松區,16038,41874,21320,20554
2009/6/1,高雄市,橋頭區,12315,36301,18695,17606
2009/6/1,高雄市,燕巢區,9843,31130,16655,14475
2009/6/1,高雄市,田寮區,3559,8367,4635,3732
2009/6/1,高雄市,阿蓮區,9033,30737,15525,15212
2009/6/1,高雄市,路竹區,15764,54229,27756,26473
2009/6/1,高雄市,湖內區,9245,28590,14780,13810
2009/6/1,高雄市,茄萣區,10034,31672,16581,15091
2009/6/1,高雄市,永安區,5732,14155,7257,6898
2009/6/1,高雄市,彌陀區,6499,20653,10792,9861
2009/6/1,高雄市,梓官區,11765,36895,19256,17639
2009/6/1,高雄市,六龜區,5725,15403,8371,7032
2009/6/1,高雄市,甲仙區,2574,8012,4312,3700
2009/6/1,高雄市,杉林區,4012,11141,6097,5044
2009/6/1,高雄市,內門區,4993,16182,8834,7348
2009/6/1,高雄市,茂林區,535,1817,922,895
2009/6/1,高雄市,桃源區,1251,4761,2542,2219
2009/6/1,高雄市,那瑪夏區,881,3523,1836,1687
2009/6/1,屏東縣,屏東市,71821,214495,107235,107260
2009/6/1,屏東縣,潮州鎮,17880,56517,28532,27985
2009/6/1,屏東縣,東港鎮,14909,50432,25663,24769
2009/6/1,屏東縣,恆春鎮,10554,31146,16082,15064
2009/6/1,屏東縣,萬丹鄉,13981,54367,28193,26174
2009/6/1,屏東縣,長治鄉,9595,30892,16220,14672
2009/6/1,屏東縣,麟洛鄉,3512,11571,6008,5563
2009/6/1,屏東縣,九如鄉,6475,23054,12010,11044
2009/6/1,屏東縣,里港鄉,7802,26276,13474,12802
2009/6/1,屏東縣,鹽埔鄉,7590,27480,14313,13167
2009/6/1,屏東縣,高樹鄉,9539,27251,14569,12682
2009/6/1,屏東縣,萬巒鄉,6339,22440,11844,10596
2009/6/1,屏東縣,內埔鄉,17534,58893,30742,28151
2009/6/1,屏東縣,竹田鄉,5428,18451,9828,8623
2009/6/1,屏東縣,新埤鄉,3305,10931,5784,5147
2009/6/1,屏東縣,枋寮鄉,8325,27097,14359,12738
2009/6/1,屏東縣,新園鄉,10954,38967,20149,18818
2009/6/1,屏東縣,崁頂鄉,4055,17147,8795,8352
2009/6/1,屏東縣,林邊鄉,6245,20967,10867,10100
2009/6/1,屏東縣,南州鄉,3619,11926,6140,5786
2009/6/1,屏東縣,佳冬鄉,6648,21623,11307,10316
2009/6/1,屏東縣,琉球鄉,3847,12501,6943,5558
2009/6/1,屏東縣,車城鄉,3474,9982,5397,4585
2009/6/1,屏東縣,滿州鄉,3028,8616,4713,3903
2009/6/1,屏東縣,枋山鄉,2078,6178,3295,2883
2009/6/1,屏東縣,三地門鄉,2061,7364,3781,3583
2009/6/1,屏東縣,霧臺鄉,871,2708,1448,1260
2009/6/1,屏東縣,瑪家鄉,1813,6420,3349,3071
2009/6/1,屏東縣,泰武鄉,1126,4908,2618,2290
2009/6/1,屏東縣,來義鄉,2083,7718,3980,3738
2009/6/1,屏東縣,春日鄉,1300,4900,2560,2340
2009/6/1,屏東縣,獅子鄉,1439,4942,2622,2320
2009/6/1,屏東縣,牡丹鄉,1816,4915,2561,2354
2009/6/1,臺東縣,臺東市,37533,109726,55823,53903
2009/6/1,臺東縣,成功鎮,5376,16059,8579,7480
2009/6/1,臺東縣,關山鎮,3197,9874,5192,4682
2009/6/1,臺東縣,卑南鄉,6500,18410,10011,8399
2009/6/1,臺東縣,大武鄉,2489,7093,3692,3401
2009/6/1,臺東縣,太麻里鄉,4489,12052,6481,5571
2009/6/1,臺東縣,東河鄉,3510,9496,5271,4225
2009/6/1,臺東縣,長濱鄉,2897,8526,4848,3678
2009/6/1,臺東縣,鹿野鄉,3102,8700,4720,3980
2009/6/1,臺東縣,池上鄉,3221,9320,4964,4356
2009/6/1,臺東縣,綠島鄉,964,3217,1735,1482
2009/6/1,臺東縣,延平鄉,1078,3621,2007,1614
2009/6/1,臺東縣,海端鄉,1087,4515,2461,2054
2009/6/1,臺東縣,達仁鄉,1452,3888,2148,1740
2009/6/1,臺東縣,金峰鄉,995,3391,1776,1615
2009/6/1,臺東縣,蘭嶼鄉,1308,4183,2194,1989
2009/6/1,花蓮縣,花蓮市,39917,109950,54107,55843
2009/6/1,花蓮縣,鳳林鎮,4428,12225,6498,5727
2009/6/1,花蓮縣,玉里鎮,8901,27443,14947,12496
2009/6/1,花蓮縣,新城鄉,7216,20331,10618,9713
2009/6/1,花蓮縣,吉安鄉,28217,79226,40752,38474
2009/6/1,花蓮縣,壽豐鄉,6743,18985,10289,8696
2009/6/1,花蓮縣,光復鄉,4971,14335,7663,6672
2009/6/1,花蓮縣,豐濱鄉,1816,5138,2864,2274
2009/6/1,花蓮縣,瑞穗鄉,4592,13073,7076,5997
2009/6/1,花蓮縣,富里鄉,3952,11800,6505,5295
2009/6/1,花蓮縣,秀林鄉,4537,14946,7808,7138
2009/6/1,花蓮縣,萬榮鄉,2138,6995,3726,3269
2009/6/1,花蓮縣,卓溪鄉,1652,6456,3603,2853
2009/6/1,澎湖縣,馬公市,18904,55760,28304,27456
2009/6/1,澎湖縣,湖西鄉,4544,13265,6957,6308
2009/6/1,澎湖縣,白沙鄉,3058,9268,4882,4386
2009/6/1,澎湖縣,西嶼鄉,2767,8511,4417,4094
2009/6/1,澎湖縣,望安鄉,1809,4590,2489,2101
2009/6/1,澎湖縣,七美鄉,1200,3492,1839,1653
2009/6/1,基隆市,中正區,21896,56560,29134,27426
2009/6/1,基隆市,七堵區,19593,55300,28117,27183
2009/6/1,基隆市,暖暖區,14122,38166,19459,18707
2009/6/1,基隆市,仁愛區,19577,50645,25111,25534
2009/6/1,基隆市,中山區,18783,51634,26458,25176
2009/6/1,基隆市,安樂區,31459,85129,42463,42666
2009/6/1,基隆市,信義區,19719,51269,25763,25506
2009/6/1,新竹市,東區,65482,193902,95895,98007
2009/6/1,新竹市,北區,48595,143023,71016,72007
2009/6/1,新竹市,香山區,22111,71541,36596,34945
2009/6/1,臺中市,中區,8446,23485,11586,11899
2009/6/1,臺中市,東區,25353,73945,37518,36427
2009/6/1,臺中市,西區,42421,117561,56635,60926
2009/6/1,臺中市,南區,40700,112153,54577,57576
2009/6/1,臺中市,北區,54577,147900,71918,75982
2009/6/1,臺中市,西屯區,70187,202655,98743,103912
2009/6/1,臺中市,南屯區,50755,149486,72225,77261
2009/6/1,臺中市,北屯區,80679,242960,118420,124540
2009/6/1,嘉義市,東區,44446,128409,62755,65654
2009/6/1,嘉義市,西區,49497,145762,72454,73308
2009/6/1,臺南市,東區,69806,194506,94403,100103
2009/6/1,臺南市,南區,42511,126930,63823,63107
2009/6/1,臺南市,北區,46762,130814,64838,65976
2009/6/1,臺南市,安南區,52735,176227,89918,86309
2009/6/1,臺南市,安平區,22215,60999,29273,31726
2009/6/1,臺南市,中西區,29884,80416,39617,40799
2009/6/1,臺北市,松山區,76894,209635,99446,110189
2009/6/1,臺北市,信義區,85044,226300,109594,116706
2009/6/1,臺北市,大安區,115535,313050,147801,165249
2009/6/1,臺北市,中山區,89154,218193,103149,115044
2009/6/1,臺北市,中正區,61145,159709,77267,82442
2009/6/1,臺北市,大同區,46252,124287,61447,62840
2009/6/1,臺北市,萬華區,72862,189199,95009,94190
2009/6/1,臺北市,文山區,95152,261586,127191,134395
2009/6/1,臺北市,南港區,40473,113318,56123,57195
2009/6/1,臺北市,內湖區,93665,267256,129190,138066
2009/6/1,臺北市,士林區,98756,284965,139005,145960
2009/6/1,臺北市,北投區,87899,249022,121179,127843
2009/6/1,高雄市,鹽埕區,11160,27947,14132,13815
2009/6/1,高雄市,鼓山區,49571,127382,62817,64565
2009/6/1,高雄市,左營區,71984,189253,93654,95599
2009/6/1,高雄市,楠梓區,60273,170894,85070,85824
2009/6/1,高雄市,三民區,129125,355623,174738,180885
2009/6/1,高雄市,新興區,22845,56399,27576,28823
2009/6/1,高雄市,前金區,12491,29533,14473,15060
2009/6/1,高雄市,苓雅區,70759,185866,90802,95064
2009/6/1,高雄市,前鎮區,74993,200304,100109,100195
2009/6/1,高雄市,旗津區,10808,29858,15535,14323
2009/6/1,高雄市,小港區,61294,153361,77414,75947
2009/6/1,金門縣,金城鎮,10456,30475,15891,14584
2009/6/1,金門縣,金湖鎮,6864,19644,10268,9376
2009/6/1,金門縣,金沙鎮,5119,14174,7321,6853
2009/6/1,金門縣,金寧鄉,5848,16634,8834,7800
2009/6/1,金門縣,烈嶼鄉,2470,8071,4162,3909
2009/6/1,金門縣,烏坵鄉,136,473,240,233
2009/6/1,連江縣,南竿鄉,1156,5855,3382,2473
2009/6/1,連江縣,北竿鄉,381,1748,1007,741
2009/6/1,連江縣,莒光鄉,235,1160,673,487
2009/6/1,連江縣,東引鄉,259,1035,611,424
2009/7/1,總計,臺灣地區,7702244,22976799,11577066,11399733
2009/7/1,總計,臺灣省,6161866,18834593,9555045,9279548
2009/7/1,總計,新北市,1358813,3853180,1920105,1933075
2009/7/1,總計,宜蘭縣,150896,461268,235768,225500
2009/7/1,總計,桃園市,646086,1968574,995263,973311
2009/7/1,總計,新竹縣,155794,507329,261767,245562
2009/7/1,總計,苗栗縣,168636,560794,292082,268712
2009/7/1,總計,臺中市,455712,1559433,791749,767684
2009/7/1,總計,彰化縣,356821,1312031,674891,637140
2009/7/1,總計,南投縣,168154,531177,274083,257094
2009/7/1,總計,雲林縣,225594,723111,378511,344600
2009/7/1,總計,嘉義縣,172986,547642,286466,261176
2009/7/1,總計,臺南市,361959,1103761,564621,539140
2009/7/1,總計,高雄市,423892,1242493,638011,604482
2009/7/1,總計,屏東縣,271292,882921,455213,427708
2009/7/1,總計,臺東縣,79337,232277,122026,110251
2009/7/1,總計,花蓮縣,119256,340947,176450,164497
2009/7/1,總計,澎湖縣,32422,95156,49024,46132
2009/7/1,總計,基隆市,145423,388684,196430,192254
2009/7/1,總計,新竹市,136578,408869,203692,205177
2009/7/1,總計,臺中市,373791,1070657,521829,548828
2009/7/1,總計,嘉義市,94045,274127,135164,138963
2009/7/1,總計,臺南市,264379,770162,381900,388262
2009/7/1,總計,臺北市,963947,2615285,1265627,1349658
2009/7/1,總計,高雄市,576431,1526921,756394,770527
2009/7/1,總計,福建省,33130,100392,52872,47520
2009/7/1,總計,金門縣,31090,90531,47155,43376
2009/7/1,總計,連江縣,2040,9861,5717,4144
2009/7/1,新北市,板橋區,189044,552127,274114,278013
2009/7/1,新北市,三重區,135397,386267,193242,193025
2009/7/1,新北市,永和區,89067,237238,114173,123065
2009/7/1,新北市,中和區,151627,413139,204905,208234
2009/7/1,新北市,新莊區,133146,399854,197922,201932
2009/7/1,新北市,新店區,113074,292679,144053,148626
2009/7/1,新北市,土城區,80251,238243,119514,118729
2009/7/1,新北市,蘆洲區,63585,195815,97206,98609
2009/7/1,新北市,汐止區,76105,184789,92133,92656
2009/7/1,新北市,樹林區,56181,170702,86288,84414
2009/7/1,新北市,鶯歌區,26667,86409,43889,42520
2009/7/1,新北市,三峽區,33094,99397,51004,48393
2009/7/1,新北市,淡水區,53375,137786,67355,70431
2009/7/1,新北市,瑞芳區,15629,42853,21956,20897
2009/7/1,新北市,五股區,26467,78640,40039,38601
2009/7/1,新北市,泰山區,25590,76155,38454,37701
2009/7/1,新北市,林口區,26759,75799,37688,38111
2009/7/1,新北市,深坑區,8489,23054,11671,11383
2009/7/1,新北市,石碇區,3256,7965,4446,3519
2009/7/1,新北市,坪林區,2389,6554,3666,2888
2009/7/1,新北市,三芝區,8689,23410,12113,11297
2009/7/1,新北市,石門區,3848,12236,6482,5754
2009/7/1,新北市,八里區,11544,33504,17169,16335
2009/7/1,新北市,平溪區,2354,5497,3040,2457
2009/7/1,新北市,雙溪區,3811,9853,5317,4536
2009/7/1,新北市,貢寮區,4336,13879,7189,6690
2009/7/1,新北市,金山區,6549,22335,11289,11046
2009/7/1,新北市,萬里區,6812,21376,10925,10451
2009/7/1,新北市,烏來區,1678,5625,2863,2762
2009/7/1,宜蘭縣,宜蘭市,32594,95943,47386,48557
2009/7/1,宜蘭縣,羅東鎮,24505,73250,35235,38015
2009/7/1,宜蘭縣,蘇澳鎮,13414,43331,22305,21026
2009/7/1,宜蘭縣,頭城鎮,9499,31108,16129,14979
2009/7/1,宜蘭縣,礁溪鄉,12069,35819,18818,17001
2009/7/1,宜蘭縣,壯圍鄉,7946,25111,13273,11838
2009/7/1,宜蘭縣,員山鄉,10559,32318,17368,14950
2009/7/1,宜蘭縣,冬山鄉,16816,52070,26959,25111
2009/7/1,宜蘭縣,五結鄉,12607,38541,20074,18467
2009/7/1,宜蘭縣,三星鄉,7330,21968,11825,10143
2009/7/1,宜蘭縣,大同鄉,1798,5933,3266,2667
2009/7/1,宜蘭縣,南澳鄉,1759,5876,3130,2746
2009/7/1,桃園市,桃園區,138223,399150,195960,203190
2009/7/1,桃園市,中壢區,121759,363477,182149,181328
2009/7/1,桃園市,平鎮區,64243,205853,103848,102005
2009/7/1,桃園市,八德區,55549,173969,88948,85021
2009/7/1,桃園市,大溪區,28507,91602,47249,44353
2009/7/1,桃園市,楊梅區,46347,147040,74993,72047
2009/7/1,桃園市,蘆竹區,45691,137349,69031,68318
2009/7/1,桃園市,大園區,25021,80759,42025,38734
2009/7/1,桃園市,龜山區,47889,134880,68604,66276
2009/7/1,桃園市,龍潭區,35848,113991,58129,55862
2009/7/1,桃園市,新屋區,14756,49587,26473,23114
2009/7/1,桃園市,觀音區,18641,60499,31984,28515
2009/7/1,桃園市,復興區,3612,10418,5870,4548
2009/7/1,新竹縣,竹北市,44065,135316,68127,67189
2009/7/1,新竹縣,關西鎮,9117,32428,17292,15136
2009/7/1,新竹縣,新埔鎮,10206,36005,19080,16925
2009/7/1,新竹縣,竹東鎮,29874,97038,48989,48049
2009/7/1,新竹縣,湖口鄉,22903,75182,38508,36674
2009/7/1,新竹縣,橫山鄉,4324,14781,7984,6797
2009/7/1,新竹縣,新豐鄉,15175,52550,27208,25342
2009/7/1,新竹縣,芎林鄉,6196,20919,11026,9893
2009/7/1,新竹縣,寶山鄉,4536,13841,7463,6378
2009/7/1,新竹縣,北埔鄉,3056,10269,5558,4711
2009/7/1,新竹縣,峨眉鄉,2021,6127,3399,2728
2009/7/1,新竹縣,尖石鄉,2629,8283,4566,3717
2009/7/1,新竹縣,五峰鄉,1692,4590,2567,2023
2009/7/1,苗栗縣,苗栗市,28587,90928,45943,44985
2009/7/1,苗栗縣,苑裡鎮,13660,48989,25642,23347
2009/7/1,苗栗縣,通霄鎮,11152,38680,20616,18064
2009/7/1,苗栗縣,竹南鎮,23069,76920,39199,37721
2009/7/1,苗栗縣,頭份市,28524,95936,48986,46950
2009/7/1,苗栗縣,後龍鎮,11512,39860,21106,18754
2009/7/1,苗栗縣,卓蘭鎮,5881,18423,9751,8672
2009/7/1,苗栗縣,大湖鄉,5260,16167,8707,7460
2009/7/1,苗栗縣,公館鄉,9944,34781,18308,16473
2009/7/1,苗栗縣,銅鑼鄉,5928,19603,10403,9200
2009/7/1,苗栗縣,南庄鄉,3915,11280,6243,5037
2009/7/1,苗栗縣,頭屋鄉,3486,11668,6172,5496
2009/7/1,苗栗縣,三義鄉,5200,17627,9313,8314
2009/7/1,苗栗縣,西湖鄉,2647,7941,4392,3549
2009/7/1,苗栗縣,造橋鄉,3919,13693,7260,6433
2009/7/1,苗栗縣,三灣鄉,2373,7406,4020,3386
2009/7/1,苗栗縣,獅潭鄉,1666,5075,2847,2228
2009/7/1,苗栗縣,泰安鄉,1913,5817,3174,2643
2009/7/1,臺中市,豐原區,48495,165346,82259,83087
2009/7/1,臺中市,大里區,60006,195466,97180,98286
2009/7/1,臺中市,太平區,53384,172082,86537,85545
2009/7/1,臺中市,東勢區,16758,53871,28021,25850
2009/7/1,臺中市,大甲區,21277,78907,40086,38821
2009/7/1,臺中市,清水區,24390,85642,44243,41399
2009/7/1,臺中市,沙鹿區,22681,80176,40823,39353
2009/7/1,臺中市,梧棲區,15680,54891,27926,26965
2009/7/1,臺中市,后里區,14524,54437,28124,26313
2009/7/1,臺中市,神岡區,17313,64114,33117,30997
2009/7/1,臺中市,潭子區,31477,99023,49525,49498
2009/7/1,臺中市,大雅區,25680,89217,45045,44172
2009/7/1,臺中市,新社區,7254,25821,13612,12209
2009/7/1,臺中市,石岡區,4773,16145,8431,7714
2009/7/1,臺中市,外埔區,8617,31870,16431,15439
2009/7/1,臺中市,大安區,5168,20455,10798,9657
2009/7/1,臺中市,烏日區,19819,68156,34626,33530
2009/7/1,臺中市,大肚區,15495,55966,28734,27232
2009/7/1,臺中市,龍井區,20010,73301,37436,35865
2009/7/1,臺中市,霧峰區,18448,63829,32909,30920
2009/7/1,臺中市,和平區,4463,10718,5886,4832
2009/7/1,彰化縣,彰化市,70373,236893,118318,118575
2009/7/1,彰化縣,鹿港鎮,21760,85262,43757,41505
2009/7/1,彰化縣,和美鎮,23550,89492,45981,43511
2009/7/1,彰化縣,北斗鎮,9706,33633,17082,16551
2009/7/1,彰化縣,員林市,36041,126084,63532,62552
2009/7/1,彰化縣,溪湖鎮,14832,56413,28867,27546
2009/7/1,彰化縣,田中鎮,12352,44524,23246,21278
2009/7/1,彰化縣,二林鎮,14135,54604,28188,26416
2009/7/1,彰化縣,線西鄉,4028,17071,8784,8287
2009/7/1,彰化縣,伸港鄉,8793,35910,18523,17387
2009/7/1,彰化縣,福興鄉,11808,49146,25763,23383
2009/7/1,彰化縣,秀水鄉,9484,38966,20220,18746
2009/7/1,彰化縣,花壇鄉,12685,46210,23883,22327
2009/7/1,彰化縣,芬園鄉,6816,24999,13301,11698
2009/7/1,彰化縣,大村鄉,10002,36552,19076,17476
2009/7/1,彰化縣,埔鹽鄉,8652,34494,18121,16373
2009/7/1,彰化縣,埔心鄉,9748,35364,18369,16995
2009/7/1,彰化縣,永靖鄉,10251,39595,20563,19032
2009/7/1,彰化縣,社頭鄉,12149,45013,23217,21796
2009/7/1,彰化縣,二水鄉,5282,16784,8869,7915
2009/7/1,彰化縣,田尾鄉,7568,28834,15054,13780
2009/7/1,彰化縣,埤頭鄉,8436,31996,16756,15240
2009/7/1,彰化縣,芳苑鄉,9914,36526,19394,17132
2009/7/1,彰化縣,大城鄉,5337,19140,10405,8735
2009/7/1,彰化縣,竹塘鄉,4535,16677,8801,7876
2009/7/1,彰化縣,溪州鄉,8584,31849,16821,15028
2009/7/1,南投縣,南投市,32760,104945,52891,52054
2009/7/1,南投縣,埔里鎮,27950,86039,43471,42568
2009/7/1,南投縣,草屯鎮,30412,100371,50825,49546
2009/7/1,南投縣,竹山鎮,18628,58899,30470,28429
2009/7/1,南投縣,集集鎮,4245,12046,6339,5707
2009/7/1,南投縣,名間鄉,11940,41554,21878,19676
2009/7/1,南投縣,鹿谷鄉,6564,19314,10271,9043
2009/7/1,南投縣,中寮鄉,5570,16380,8917,7463
2009/7/1,南投縣,魚池鄉,5762,17328,9186,8142
2009/7/1,南投縣,國姓鄉,7159,21037,11534,9503
2009/7/1,南投縣,水里鄉,7191,20517,10802,9715
2009/7/1,南投縣,信義鄉,5087,17236,9336,7900
2009/7/1,南投縣,仁愛鄉,4886,15511,8163,7348
2009/7/1,雲林縣,斗六市,33830,106486,53805,52681
2009/7/1,雲林縣,斗南鎮,14985,47556,24171,23385
2009/7/1,雲林縣,虎尾鎮,21899,70042,35706,34336
2009/7/1,雲林縣,西螺鎮,13839,49053,24941,24112
2009/7/1,雲林縣,土庫鎮,8605,30790,16117,14673
2009/7/1,雲林縣,北港鎮,14992,43702,22790,20912
2009/7/1,雲林縣,古坑鄉,10513,34701,18393,16308
2009/7/1,雲林縣,大埤鄉,6574,21523,11496,10027
2009/7/1,雲林縣,莿桐鄉,8898,30656,16071,14585
2009/7/1,雲林縣,林內鄉,5677,20312,10625,9687
2009/7/1,雲林縣,二崙鄉,8705,30081,16164,13917
2009/7/1,雲林縣,崙背鄉,8251,27794,14675,13119
2009/7/1,雲林縣,麥寮鄉,11938,34890,18420,16470
2009/7/1,雲林縣,東勢鄉,5713,17241,9388,7853
2009/7/1,雲林縣,褒忠鄉,4251,14623,7796,6827
2009/7/1,雲林縣,臺西鄉,8728,26710,14412,12298
2009/7/1,雲林縣,元長鄉,9291,29365,16013,13352
2009/7/1,雲林縣,四湖鄉,8989,27276,14916,12360
2009/7/1,雲林縣,口湖鄉,9569,30772,16441,14331
2009/7/1,雲林縣,水林鄉,10347,29538,16171,13367
2009/7/1,嘉義縣,太保市,10850,36014,18661,17353
2009/7/1,嘉義縣,朴子市,14111,44349,22695,21654
2009/7/1,嘉義縣,布袋鎮,10055,30787,15840,14947
2009/7/1,嘉義縣,大林鎮,11067,33992,17514,16478
2009/7/1,嘉義縣,民雄鄉,22206,72652,37449,35203
2009/7/1,嘉義縣,溪口鄉,5360,16594,8872,7722
2009/7/1,嘉義縣,新港鄉,10247,35173,18568,16605
2009/7/1,嘉義縣,六腳鄉,9096,26899,14277,12622
2009/7/1,嘉義縣,東石鄉,9258,28131,14983,13148
2009/7/1,嘉義縣,義竹鄉,7445,21894,11353,10541
2009/7/1,嘉義縣,鹿草鄉,5657,17388,9330,8058
2009/7/1,嘉義縣,水上鄉,17180,52638,27332,25306
2009/7/1,嘉義縣,中埔鄉,14925,47726,25012,22714
2009/7/1,嘉義縣,竹崎鄉,11177,38972,20786,18186
2009/7/1,嘉義縣,梅山鄉,6529,22053,11712,10341
2009/7/1,嘉義縣,番路鄉,3857,11660,6349,5311
2009/7/1,嘉義縣,大埔鄉,1968,4540,2415,2125
2009/7/1,嘉義縣,阿里山鄉,1998,6180,3318,2862
2009/7/1,臺南市,新營區,26653,78521,39370,39151
2009/7/1,臺南市,永康區,72654,213375,106383,106992
2009/7/1,臺南市,鹽水區,9770,27406,14270,13136
2009/7/1,臺南市,白河區,10849,31872,16803,15069
2009/7/1,臺南市,麻豆區,14646,46163,23624,22539
2009/7/1,臺南市,佳里區,18899,59560,29718,29842
2009/7/1,臺南市,新化區,13423,44402,22793,21609
2009/7/1,臺南市,善化區,14120,43226,21952,21274
2009/7/1,臺南市,學甲區,9314,28217,14458,13759
2009/7/1,臺南市,柳營區,7707,23023,12036,10987
2009/7/1,臺南市,後壁區,8618,26166,13653,12513
2009/7/1,臺南市,東山區,8141,23386,12490,10896
2009/7/1,臺南市,下營區,8977,26463,13736,12727
2009/7/1,臺南市,六甲區,7530,24132,12547,11585
2009/7/1,臺南市,官田區,7541,22415,11533,10882
2009/7/1,臺南市,大內區,4052,11150,5928,5222
2009/7/1,臺南市,西港區,7681,25336,12955,12381
2009/7/1,臺南市,七股區,7837,25036,13102,11934
2009/7/1,臺南市,將軍區,7364,21842,11155,10687
2009/7/1,臺南市,北門區,4252,12539,6406,6133
2009/7/1,臺南市,新市區,10609,35044,17650,17394
2009/7/1,臺南市,安定區,9002,30060,15601,14459
2009/7/1,臺南市,山上區,2699,8007,4217,3790
2009/7/1,臺南市,玉井區,5056,15626,8107,7519
2009/7/1,臺南市,楠西區,3585,10836,5759,5077
2009/7/1,臺南市,南化區,2824,8997,4932,4065
2009/7/1,臺南市,左鎮區,1964,5664,3135,2529
2009/7/1,臺南市,仁德區,23950,68489,35324,33165
2009/7/1,臺南市,歸仁區,20071,65878,33619,32259
2009/7/1,臺南市,關廟區,10573,36473,18953,17520
2009/7/1,臺南市,龍崎區,1598,4457,2412,2045
2009/7/1,高雄市,鳳山區,124030,339428,169752,169676
2009/7/1,高雄市,岡山區,32561,96930,48909,48021
2009/7/1,高雄市,旗山區,13617,40573,21216,19357
2009/7/1,高雄市,美濃區,13864,43568,22765,20803
2009/7/1,高雄市,林園區,23678,70823,36515,34308
2009/7/1,高雄市,大寮區,37466,109232,56985,52247
2009/7/1,高雄市,大樹區,12955,44319,22973,21346
2009/7/1,高雄市,仁武區,24341,69515,35925,33590
2009/7/1,高雄市,大社區,11451,32795,16912,15883
2009/7/1,高雄市,鳥松區,16080,41904,21332,20572
2009/7/1,高雄市,橋頭區,12332,36296,18699,17597
2009/7/1,高雄市,燕巢區,9854,31120,16643,14477
2009/7/1,高雄市,田寮區,3556,8359,4632,3727
2009/7/1,高雄市,阿蓮區,9034,30699,15497,15202
2009/7/1,高雄市,路竹區,15790,54172,27720,26452
2009/7/1,高雄市,湖內區,9251,28638,14802,13836
2009/7/1,高雄市,茄萣區,10029,31634,16555,15079
2009/7/1,高雄市,永安區,5733,14163,7258,6905
2009/7/1,高雄市,彌陀區,6504,20660,10795,9865
2009/7/1,高雄市,梓官區,11783,36911,19255,17656
2009/7/1,高雄市,六龜區,5720,15373,8351,7022
2009/7/1,高雄市,甲仙區,2582,8010,4313,3697
2009/7/1,高雄市,杉林區,4021,11145,6098,5047
2009/7/1,高雄市,內門區,4995,16165,8825,7340
2009/7/1,高雄市,茂林區,534,1807,917,890
2009/7/1,高雄市,桃源區,1249,4743,2534,2209
2009/7/1,高雄市,那瑪夏區,882,3511,1833,1678
2009/7/1,屏東縣,屏東市,71881,214362,107168,107194
2009/7/1,屏東縣,潮州鎮,17871,56403,28476,27927
2009/7/1,屏東縣,東港鎮,14913,50392,25653,24739
2009/7/1,屏東縣,恆春鎮,10554,31107,16074,15033
2009/7/1,屏東縣,萬丹鄉,14005,54358,28171,26187
2009/7/1,屏東縣,長治鄉,9599,30912,16222,14690
2009/7/1,屏東縣,麟洛鄉,3524,11583,6015,5568
2009/7/1,屏東縣,九如鄉,6482,23060,12015,11045
2009/7/1,屏東縣,里港鄉,7812,26268,13472,12796
2009/7/1,屏東縣,鹽埔鄉,7597,27478,14308,13170
2009/7/1,屏東縣,高樹鄉,9534,27274,14566,12708
2009/7/1,屏東縣,萬巒鄉,6347,22430,11836,10594
2009/7/1,屏東縣,內埔鄉,17546,58847,30695,28152
2009/7/1,屏東縣,竹田鄉,5432,18469,9833,8636
2009/7/1,屏東縣,新埤鄉,3316,10937,5789,5148
2009/7/1,屏東縣,枋寮鄉,8332,27093,14349,12744
2009/7/1,屏東縣,新園鄉,10957,38906,20121,18785
2009/7/1,屏東縣,崁頂鄉,4069,17188,8820,8368
2009/7/1,屏東縣,林邊鄉,6243,20933,10850,10083
2009/7/1,屏東縣,南州鄉,3617,11917,6137,5780
2009/7/1,屏東縣,佳冬鄉,6651,21598,11283,10315
2009/7/1,屏東縣,琉球鄉,3863,12548,6955,5593
2009/7/1,屏東縣,車城鄉,3479,9973,5390,4583
2009/7/1,屏東縣,滿州鄉,3044,8664,4745,3919
2009/7/1,屏東縣,枋山鄉,2078,6183,3304,2879
2009/7/1,屏東縣,三地門鄉,2068,7431,3807,3624
2009/7/1,屏東縣,霧臺鄉,876,2748,1462,1286
2009/7/1,屏東縣,瑪家鄉,1817,6425,3358,3067
2009/7/1,屏東縣,泰武鄉,1131,4914,2613,2301
2009/7/1,屏東縣,來義鄉,2080,7725,3982,3743
2009/7/1,屏東縣,春日鄉,1305,4883,2552,2331
2009/7/1,屏東縣,獅子鄉,1441,4951,2620,2331
2009/7/1,屏東縣,牡丹鄉,1828,4961,2572,2389
2009/7/1,臺東縣,臺東市,37581,109716,55855,53861
2009/7/1,臺東縣,成功鎮,5385,16052,8584,7468
2009/7/1,臺東縣,關山鎮,3203,9868,5184,4684
2009/7/1,臺東縣,卑南鄉,6519,18419,10017,8402
2009/7/1,臺東縣,大武鄉,2494,7158,3710,3448
2009/7/1,臺東縣,太麻里鄉,4490,12043,6474,5569
2009/7/1,臺東縣,東河鄉,3523,9521,5280,4241
2009/7/1,臺東縣,長濱鄉,2902,8531,4848,3683
2009/7/1,臺東縣,鹿野鄉,3106,8702,4717,3985
2009/7/1,臺東縣,池上鄉,3226,9320,4963,4357
2009/7/1,臺東縣,綠島鄉,973,3259,1760,1499
2009/7/1,臺東縣,延平鄉,1075,3623,2011,1612
2009/7/1,臺東縣,海端鄉,1089,4518,2465,2053
2009/7/1,臺東縣,達仁鄉,1460,3942,2175,1767
2009/7/1,臺東縣,金峰鄉,998,3396,1783,1613
2009/7/1,臺東縣,蘭嶼鄉,1313,4209,2200,2009
2009/7/1,花蓮縣,花蓮市,39975,109952,54095,55857
2009/7/1,花蓮縣,鳳林鎮,4431,12214,6491,5723
2009/7/1,花蓮縣,玉里鎮,8906,27429,14935,12494
2009/7/1,花蓮縣,新城鄉,7208,20311,10608,9703
2009/7/1,花蓮縣,吉安鄉,28307,79304,40787,38517
2009/7/1,花蓮縣,壽豐鄉,6743,18964,10278,8686
2009/7/1,花蓮縣,光復鄉,4970,14309,7654,6655
2009/7/1,花蓮縣,豐濱鄉,1818,5138,2857,2281
2009/7/1,花蓮縣,瑞穗鄉,4610,13078,7076,6002
2009/7/1,花蓮縣,富里鄉,3953,11832,6524,5308
2009/7/1,花蓮縣,秀林鄉,4538,14941,7795,7146
2009/7/1,花蓮縣,萬榮鄉,2139,7003,3734,3269
2009/7/1,花蓮縣,卓溪鄉,1658,6472,3616,2856
2009/7/1,澎湖縣,馬公市,18960,55872,28359,27513
2009/7/1,澎湖縣,湖西鄉,4584,13354,6998,6356
2009/7/1,澎湖縣,白沙鄉,3071,9299,4899,4400
2009/7/1,澎湖縣,西嶼鄉,2777,8443,4379,4064
2009/7/1,澎湖縣,望安鄉,1822,4651,2531,2120
2009/7/1,澎湖縣,七美鄉,1208,3537,1858,1679
2009/7/1,基隆市,中正區,21935,56485,29089,27396
2009/7/1,基隆市,七堵區,19674,55355,28137,27218
2009/7/1,基隆市,暖暖區,14147,38141,19451,18690
2009/7/1,基隆市,仁愛區,19574,50565,25062,25503
2009/7/1,基隆市,中山區,18803,51599,26448,25151
2009/7/1,基隆市,安樂區,31522,85125,42441,42684
2009/7/1,基隆市,信義區,19768,51414,25802,25612
2009/7/1,新竹市,東區,65601,193896,95914,97982
2009/7/1,新竹市,北區,48797,143334,71136,72198
2009/7/1,新竹市,香山區,22180,71639,36642,34997
2009/7/1,臺中市,中區,8439,23417,11555,11862
2009/7/1,臺中市,東區,25379,73853,37482,36371
2009/7/1,臺中市,西區,42454,117601,56631,60970
2009/7/1,臺中市,南區,40745,112138,54595,57543
2009/7/1,臺中市,北區,54634,147892,71927,75965
2009/7/1,臺中市,西屯區,70326,202762,98779,103983
2009/7/1,臺中市,南屯區,50939,149779,72354,77425
2009/7/1,臺中市,北屯區,80875,243215,118506,124709
2009/7/1,嘉義市,東區,44478,128355,62715,65640
2009/7/1,嘉義市,西區,49567,145772,72449,73323
2009/7/1,臺南市,東區,69944,194617,94446,100171
2009/7/1,臺南市,南區,42531,126802,63761,63041
2009/7/1,臺南市,北區,46888,130924,64860,66064
2009/7/1,臺南市,安南區,52851,176386,89957,86429
2009/7/1,臺南市,安平區,22282,61117,29339,31778
2009/7/1,臺南市,中西區,29883,80316,39537,40779
2009/7/1,臺北市,松山區,76979,209330,99306,110024
2009/7/1,臺北市,信義區,85121,226118,109510,116608
2009/7/1,臺北市,大安區,115602,312916,147681,165235
2009/7/1,臺北市,中山區,89360,218340,103179,115161
2009/7/1,臺北市,中正區,61201,159584,77231,82353
2009/7/1,臺北市,大同區,46214,124070,61356,62714
2009/7/1,臺北市,萬華區,72877,188951,94845,94106
2009/7/1,臺北市,文山區,95279,261493,127113,134380
2009/7/1,臺北市,南港區,40542,113271,56106,57165
2009/7/1,臺北市,內湖區,93870,267401,129220,138181
2009/7/1,臺北市,士林區,98874,284814,138911,145903
2009/7/1,臺北市,北投區,88028,248997,121169,127828
2009/7/1,高雄市,鹽埕區,11145,27888,14091,13797
2009/7/1,高雄市,鼓山區,49818,127796,62985,64811
2009/7/1,高雄市,左營區,72113,189434,93726,95708
2009/7/1,高雄市,楠梓區,60411,171086,85165,85921
2009/7/1,高雄市,三民區,129309,355514,174634,180880
2009/7/1,高雄市,新興區,22843,56310,27530,28780
2009/7/1,高雄市,前金區,12506,29522,14461,15061
2009/7/1,高雄市,苓雅區,70876,185760,90738,95022
2009/7/1,高雄市,前鎮區,75098,200255,100047,100208
2009/7/1,高雄市,旗津區,10836,29873,15551,14322
2009/7/1,高雄市,小港區,61476,153483,77466,76017
2009/7/1,金門縣,金城鎮,10530,30754,16026,14728
2009/7/1,金門縣,金湖鎮,6903,19828,10345,9483
2009/7/1,金門縣,金沙鎮,5160,14430,7443,6987
2009/7/1,金門縣,金寧鄉,5881,16849,8892,7957
2009/7/1,金門縣,烈嶼鄉,2480,8189,4207,3982
2009/7/1,金門縣,烏坵鄉,136,481,242,239
2009/7/1,連江縣,南竿鄉,1163,5902,3412,2490
2009/7/1,連江縣,北竿鄉,382,1771,1022,749
2009/7/1,連江縣,莒光鄉,235,1158,673,485
2009/7/1,連江縣,東引鄉,260,1030,610,420
2009/8/1,總計,臺灣地區,7720603,22981004,11577190,11403814
2009/8/1,總計,臺灣省,6177022,18841559,9556841,9284718
2009/8/1,總計,新北市,1363367,3857840,1922057,1935783
2009/8/1,總計,宜蘭縣,151186,461251,235752,225499
2009/8/1,總計,桃園市,648189,1970358,995986,974372
2009/8/1,總計,新竹縣,156313,508157,262181,245976
2009/8/1,總計,苗栗縣,169022,560975,292124,268851
2009/8/1,總計,臺中市,456567,1559703,791840,767863
2009/8/1,總計,彰化縣,357342,1311761,674616,637145
2009/8/1,總計,南投縣,168420,530941,273906,257035
2009/8/1,總計,雲林縣,225891,722858,378374,344484
2009/8/1,總計,嘉義縣,173310,547525,286354,261171
2009/8/1,總計,臺南市,362968,1103909,564567,539342
2009/8/1,總計,高雄市,424541,1241902,637590,604312
2009/8/1,總計,屏東縣,272023,882601,454986,427615
2009/8/1,總計,臺東縣,79440,232290,122001,110289
2009/8/1,總計,花蓮縣,119462,341001,176439,164562
2009/8/1,總計,澎湖縣,32511,95292,49069,46223
2009/8/1,總計,基隆市,145693,388624,196328,192296
2009/8/1,總計,新竹市,137063,409365,203847,205518
2009/8/1,總計,臺中市,374481,1070792,521746,549046
2009/8/1,總計,嘉義市,94243,274051,135131,138920
2009/8/1,總計,臺南市,264990,770363,381947,388416
2009/8/1,總計,臺北市,965870,2612605,1264203,1348402
2009/8/1,總計,高雄市,577711,1526840,756146,770694
2009/8/1,總計,福建省,33273,101121,53152,47969
2009/8/1,總計,金門縣,31233,91261,47436,43825
2009/8/1,總計,連江縣,2040,9860,5716,4144
2009/8/1,新北市,板橋區,189493,552197,274097,278100
2009/8/1,新北市,三重區,135904,386783,193466,193317
2009/8/1,新北市,永和區,89146,236947,113989,122958
2009/8/1,新北市,中和區,152107,413444,205004,208440
2009/8/1,新北市,新莊區,133487,399986,198013,201973
2009/8/1,新北市,新店區,113417,293210,144292,148918
2009/8/1,新北市,土城區,80467,238322,119534,118788
2009/8/1,新北市,蘆洲區,63795,196148,97335,98813
2009/8/1,新北市,汐止區,76429,185269,92356,92913
2009/8/1,新北市,樹林區,56487,171135,86490,84645
2009/8/1,新北市,鶯歌區,26713,86479,43907,42572
2009/8/1,新北市,三峽區,33264,99669,51130,48539
2009/8/1,新北市,淡水區,53807,138410,67628,70782
2009/8/1,新北市,瑞芳區,15614,42814,21929,20885
2009/8/1,新北市,五股區,26552,78773,40117,38656
2009/8/1,新北市,泰山區,25662,76220,38463,37757
2009/8/1,新北市,林口區,27139,76480,38020,38460
2009/8/1,新北市,深坑區,8513,23078,11670,11408
2009/8/1,新北市,石碇區,3261,7961,4450,3511
2009/8/1,新北市,坪林區,2387,6557,3671,2886
2009/8/1,新北市,三芝區,8707,23410,12122,11288
2009/8/1,新北市,石門區,3856,12261,6487,5774
2009/8/1,新北市,八里區,11579,33614,17218,16396
2009/8/1,新北市,平溪區,2359,5487,3038,2449
2009/8/1,新北市,雙溪區,3810,9833,5311,4522
2009/8/1,新北市,貢寮區,4343,13900,7197,6703
2009/8/1,新北市,金山區,6560,22339,11288,11051
2009/8/1,新北市,萬里區,6831,21459,10958,10501
2009/8/1,新北市,烏來區,1678,5655,2877,2778
2009/8/1,宜蘭縣,宜蘭市,32661,95879,47334,48545
2009/8/1,宜蘭縣,羅東鎮,24557,73274,35258,38016
2009/8/1,宜蘭縣,蘇澳鎮,13413,43306,22290,21016
2009/8/1,宜蘭縣,頭城鎮,9521,31122,16133,14989
2009/8/1,宜蘭縣,礁溪鄉,12088,35800,18805,16995
2009/8/1,宜蘭縣,壯圍鄉,7968,25129,13279,11850
2009/8/1,宜蘭縣,員山鄉,10581,32318,17380,14938
2009/8/1,宜蘭縣,冬山鄉,16844,52102,26974,25128
2009/8/1,宜蘭縣,五結鄉,12637,38603,20100,18503
2009/8/1,宜蘭縣,三星鄉,7350,21886,11800,10086
2009/8/1,宜蘭縣,大同鄉,1800,5947,3262,2685
2009/8/1,宜蘭縣,南澳鄉,1766,5885,3137,2748
2009/8/1,桃園市,桃園區,138686,399541,196121,203420
2009/8/1,桃園市,中壢區,122175,363700,182244,181456
2009/8/1,桃園市,平鎮區,64512,206102,103963,102139
2009/8/1,桃園市,八德區,55776,174130,89037,85093
2009/8/1,桃園市,大溪區,28568,91616,47239,44377
2009/8/1,桃園市,楊梅區,46505,147207,75059,72148
2009/8/1,桃園市,蘆竹區,45848,137551,69121,68430
2009/8/1,桃園市,大園區,25108,80925,42108,38817
2009/8/1,桃園市,龜山區,48018,135025,68632,66393
2009/8/1,桃園市,龍潭區,35959,114048,58140,55908
2009/8/1,桃園市,新屋區,14753,49579,26481,23098
2009/8/1,桃園市,觀音區,18655,60470,31947,28523
2009/8/1,桃園市,復興區,3626,10464,5894,4570
2009/8/1,新竹縣,竹北市,44369,135955,68444,67511
2009/8/1,新竹縣,關西鎮,9140,32414,17279,15135
2009/8/1,新竹縣,新埔鎮,10228,36037,19077,16960
2009/8/1,新竹縣,竹東鎮,29943,97065,49033,48032
2009/8/1,新竹縣,湖口鄉,22943,75255,38542,36713
2009/8/1,新竹縣,橫山鄉,4331,14754,7965,6789
2009/8/1,新竹縣,新豐鄉,15202,52568,27232,25336
2009/8/1,新竹縣,芎林鄉,6199,20918,11029,9889
2009/8/1,新竹縣,寶山鄉,4549,13880,7485,6395
2009/8/1,新竹縣,北埔鄉,3059,10279,5556,4723
2009/8/1,新竹縣,峨眉鄉,2019,6134,3406,2728
2009/8/1,新竹縣,尖石鄉,2634,8283,4557,3726
2009/8/1,新竹縣,五峰鄉,1697,4615,2576,2039
2009/8/1,苗栗縣,苗栗市,28664,90908,45942,44966
2009/8/1,苗栗縣,苑裡鎮,13680,48962,25616,23346
2009/8/1,苗栗縣,通霄鎮,11171,38629,20592,18037
2009/8/1,苗栗縣,竹南鎮,23176,77051,39273,37778
2009/8/1,苗栗縣,頭份市,28621,96006,49012,46994
2009/8/1,苗栗縣,後龍鎮,11522,39870,21098,18772
2009/8/1,苗栗縣,卓蘭鎮,5886,18427,9746,8681
2009/8/1,苗栗縣,大湖鄉,5263,16180,8705,7475
2009/8/1,苗栗縣,公館鄉,9956,34778,18315,16463
2009/8/1,苗栗縣,銅鑼鄉,5923,19601,10390,9211
2009/8/1,苗栗縣,南庄鄉,3935,11306,6252,5054
2009/8/1,苗栗縣,頭屋鄉,3485,11677,6180,5497
2009/8/1,苗栗縣,三義鄉,5203,17639,9317,8322
2009/8/1,苗栗縣,西湖鄉,2651,7939,4387,3552
2009/8/1,苗栗縣,造橋鄉,3925,13707,7260,6447
2009/8/1,苗栗縣,三灣鄉,2376,7397,4018,3379
2009/8/1,苗栗縣,獅潭鄉,1668,5082,2845,2237
2009/8/1,苗栗縣,泰安鄉,1917,5816,3176,2640
2009/8/1,臺中市,豐原區,48573,165265,82219,83046
2009/8/1,臺中市,大里區,60118,195596,97268,98328
2009/8/1,臺中市,太平區,53500,172132,86549,85583
2009/8/1,臺中市,東勢區,16791,53818,27994,25824
2009/8/1,臺中市,大甲區,21301,78860,40066,38794
2009/8/1,臺中市,清水區,24429,85632,44226,41406
2009/8/1,臺中市,沙鹿區,22736,80210,40839,39371
2009/8/1,臺中市,梧棲區,15709,54960,27961,26999
2009/8/1,臺中市,后里區,14551,54399,28100,26299
2009/8/1,臺中市,神岡區,17350,64116,33117,30999
2009/8/1,臺中市,潭子區,31558,99115,49548,49567
2009/8/1,臺中市,大雅區,25707,89179,45036,44143
2009/8/1,臺中市,新社區,7258,25798,13600,12198
2009/8/1,臺中市,石岡區,4780,16145,8434,7711
2009/8/1,臺中市,外埔區,8639,31894,16438,15456
2009/8/1,臺中市,大安區,5169,20445,10788,9657
2009/8/1,臺中市,烏日區,19884,68230,34660,33570
2009/8/1,臺中市,大肚區,15530,55926,28719,27207
2009/8/1,臺中市,龍井區,20071,73436,37513,35923
2009/8/1,臺中市,霧峰區,18462,63820,32882,30938
2009/8/1,臺中市,和平區,4451,10727,5883,4844
2009/8/1,彰化縣,彰化市,70498,236860,118268,118592
2009/8/1,彰化縣,鹿港鎮,21806,85328,43773,41555
2009/8/1,彰化縣,和美鎮,23572,89532,46010,43522
2009/8/1,彰化縣,北斗鎮,9728,33658,17079,16579
2009/8/1,彰化縣,員林市,36088,126062,63512,62550
2009/8/1,彰化縣,溪湖鎮,14848,56358,28861,27497
2009/8/1,彰化縣,田中鎮,12391,44488,23234,21254
2009/8/1,彰化縣,二林鎮,14157,54577,28166,26411
2009/8/1,彰化縣,線西鄉,4032,17045,8770,8275
2009/8/1,彰化縣,伸港鄉,8813,35911,18520,17391
2009/8/1,彰化縣,福興鄉,11806,49086,25737,23349
2009/8/1,彰化縣,秀水鄉,9497,38979,20224,18755
2009/8/1,彰化縣,花壇鄉,12712,46209,23881,22328
2009/8/1,彰化縣,芬園鄉,6826,25010,13287,11723
2009/8/1,彰化縣,大村鄉,10024,36569,19080,17489
2009/8/1,彰化縣,埔鹽鄉,8656,34448,18094,16354
2009/8/1,彰化縣,埔心鄉,9754,35346,18350,16996
2009/8/1,彰化縣,永靖鄉,10269,39595,20567,19028
2009/8/1,彰化縣,社頭鄉,12169,45010,23216,21794
2009/8/1,彰化縣,二水鄉,5291,16768,8847,7921
2009/8/1,彰化縣,田尾鄉,7561,28798,15029,13769
2009/8/1,彰化縣,埤頭鄉,8446,31978,16741,15237
2009/8/1,彰化縣,芳苑鄉,9921,36513,19376,17137
2009/8/1,彰化縣,大城鄉,5341,19125,10398,8727
2009/8/1,彰化縣,竹塘鄉,4551,16672,8797,7875
2009/8/1,彰化縣,溪州鄉,8585,31836,16799,15037
2009/8/1,南投縣,南投市,32823,104917,52882,52035
2009/8/1,南投縣,埔里鎮,28005,86013,43466,42547
2009/8/1,南投縣,草屯鎮,30434,100272,50767,49505
2009/8/1,南投縣,竹山鎮,18668,58890,30460,28430
2009/8/1,南投縣,集集鎮,4255,12044,6337,5707
2009/8/1,南投縣,名間鄉,11949,41532,21852,19680
2009/8/1,南投縣,鹿谷鄉,6579,19291,10255,9036
2009/8/1,南投縣,中寮鄉,5581,16396,8921,7475
2009/8/1,南投縣,魚池鄉,5761,17315,9173,8142
2009/8/1,南投縣,國姓鄉,7174,21019,11522,9497
2009/8/1,南投縣,水里鄉,7206,20500,10787,9713
2009/8/1,南投縣,信義鄉,5093,17246,9341,7905
2009/8/1,南投縣,仁愛鄉,4892,15506,8143,7363
2009/8/1,雲林縣,斗六市,33896,106573,53826,52747
2009/8/1,雲林縣,斗南鎮,14989,47518,24166,23352
2009/8/1,雲林縣,虎尾鎮,21942,70065,35721,34344
2009/8/1,雲林縣,西螺鎮,13839,48995,24921,24074
2009/8/1,雲林縣,土庫鎮,8618,30775,16109,14666
2009/8/1,雲林縣,北港鎮,15020,43655,22762,20893
2009/8/1,雲林縣,古坑鄉,10517,34633,18360,16273
2009/8/1,雲林縣,大埤鄉,6582,21490,11483,10007
2009/8/1,雲林縣,莿桐鄉,8902,30635,16062,14573
2009/8/1,雲林縣,林內鄉,5693,20298,10623,9675
2009/8/1,雲林縣,二崙鄉,8717,30085,16166,13919
2009/8/1,雲林縣,崙背鄉,8261,27798,14676,13122
2009/8/1,雲林縣,麥寮鄉,11954,34940,18422,16518
2009/8/1,雲林縣,東勢鄉,5708,17208,9372,7836
2009/8/1,雲林縣,褒忠鄉,4261,14613,7792,6821
2009/8/1,雲林縣,臺西鄉,8746,26691,14402,12289
2009/8/1,雲林縣,元長鄉,9294,29365,16013,13352
2009/8/1,雲林縣,四湖鄉,9006,27242,14894,12348
2009/8/1,雲林縣,口湖鄉,9587,30750,16426,14324
2009/8/1,雲林縣,水林鄉,10359,29529,16178,13351
2009/8/1,嘉義縣,太保市,10893,36044,18672,17372
2009/8/1,嘉義縣,朴子市,14169,44342,22698,21644
2009/8/1,嘉義縣,布袋鎮,10075,30780,15845,14935
2009/8/1,嘉義縣,大林鎮,11078,33999,17514,16485
2009/8/1,嘉義縣,民雄鄉,22273,72713,37482,35231
2009/8/1,嘉義縣,溪口鄉,5362,16565,8854,7711
2009/8/1,嘉義縣,新港鄉,10241,35116,18543,16573
2009/8/1,嘉義縣,六腳鄉,9103,26889,14262,12627
2009/8/1,嘉義縣,東石鄉,9270,28142,14985,13157
2009/8/1,嘉義縣,義竹鄉,7444,21806,11303,10503
2009/8/1,嘉義縣,鹿草鄉,5662,17382,9321,8061
2009/8/1,嘉義縣,水上鄉,17214,52608,27300,25308
2009/8/1,嘉義縣,中埔鄉,14950,47782,25015,22767
2009/8/1,嘉義縣,竹崎鄉,11200,38931,20773,18158
2009/8/1,嘉義縣,梅山鄉,6545,22043,11704,10339
2009/8/1,嘉義縣,番路鄉,3861,11673,6351,5322
2009/8/1,嘉義縣,大埔鄉,1973,4539,2419,2120
2009/8/1,嘉義縣,阿里山鄉,1997,6171,3313,2858
2009/8/1,臺南市,新營區,26702,78449,39317,39132
2009/8/1,臺南市,永康區,72925,213712,106545,107167
2009/8/1,臺南市,鹽水區,9799,27386,14257,13129
2009/8/1,臺南市,白河區,10855,31852,16784,15068
2009/8/1,臺南市,麻豆區,14739,46174,23618,22556
2009/8/1,臺南市,佳里區,18953,59554,29721,29833
2009/8/1,臺南市,新化區,13468,44383,22782,21601
2009/8/1,臺南市,善化區,14179,43236,21945,21291
2009/8/1,臺南市,學甲區,9353,28197,14439,13758
2009/8/1,臺南市,柳營區,7702,22985,12017,10968
2009/8/1,臺南市,後壁區,8627,26169,13652,12517
2009/8/1,臺南市,東山區,8140,23384,12485,10899
2009/8/1,臺南市,下營區,8998,26447,13730,12717
2009/8/1,臺南市,六甲區,7538,24099,12547,11552
2009/8/1,臺南市,官田區,7556,22418,11526,10892
2009/8/1,臺南市,大內區,4055,11131,5920,5211
2009/8/1,臺南市,西港區,7697,25326,12940,12386
2009/8/1,臺南市,七股區,7870,25025,13101,11924
2009/8/1,臺南市,將軍區,7367,21824,11139,10685
2009/8/1,臺南市,北門區,4280,12548,6406,6142
2009/8/1,臺南市,新市區,10633,35046,17645,17401
2009/8/1,臺南市,安定區,9051,30080,15595,14485
2009/8/1,臺南市,山上區,2705,8015,4218,3797
2009/8/1,臺南市,玉井區,5056,15608,8100,7508
2009/8/1,臺南市,楠西區,3587,10821,5749,5072
2009/8/1,臺南市,南化區,2826,8999,4930,4069
2009/8/1,臺南市,左鎮區,1964,5659,3129,2530
2009/8/1,臺南市,仁德區,24066,68617,35377,33240
2009/8/1,臺南市,歸仁區,20100,65878,33615,32263
2009/8/1,臺南市,關廟區,10579,36425,18926,17499
2009/8/1,臺南市,龍崎區,1598,4462,2412,2050
2009/8/1,高雄市,鳳山區,124210,339522,169757,169765
2009/8/1,高雄市,岡山區,32625,96979,48899,48080
2009/8/1,高雄市,旗山區,13636,40543,21203,19340
2009/8/1,高雄市,美濃區,13877,43508,22741,20767
2009/8/1,高雄市,林園區,23705,70720,36466,34254
2009/8/1,高雄市,大寮區,37525,109271,56985,52286
2009/8/1,高雄市,大樹區,12955,44285,22961,21324
2009/8/1,高雄市,仁武區,24493,69696,36031,33665
2009/8/1,高雄市,大社區,11475,32833,16923,15910
2009/8/1,高雄市,鳥松區,16127,41924,21345,20579
2009/8/1,高雄市,橋頭區,12350,36311,18688,17623
2009/8/1,高雄市,燕巢區,9873,31079,16624,14455
2009/8/1,高雄市,田寮區,3557,8349,4626,3723
2009/8/1,高雄市,阿蓮區,9033,30648,15480,15168
2009/8/1,高雄市,路竹區,15802,54142,27693,26449
2009/8/1,高雄市,湖內區,9283,28616,14790,13826
2009/8/1,高雄市,茄萣區,10034,31587,16527,15060
2009/8/1,高雄市,永安區,5744,14170,7261,6909
2009/8/1,高雄市,彌陀區,6504,20628,10783,9845
2009/8/1,高雄市,梓官區,11795,36905,19251,17654
2009/8/1,高雄市,六龜區,5723,15309,8310,6999
2009/8/1,高雄市,甲仙區,2539,7606,4095,3511
2009/8/1,高雄市,杉林區,4025,11119,6077,5042
2009/8/1,高雄市,內門區,4998,16144,8812,7332
2009/8/1,高雄市,茂林區,533,1800,918,882
2009/8/1,高雄市,桃源區,1246,4747,2539,2208
2009/8/1,高雄市,那瑪夏區,874,3461,1805,1656
2009/8/1,屏東縣,屏東市,71980,214150,107072,107078
2009/8/1,屏東縣,潮州鎮,17882,56329,28421,27908
2009/8/1,屏東縣,東港鎮,14996,50396,25657,24739
2009/8/1,屏東縣,恆春鎮,10568,31123,16073,15050
2009/8/1,屏東縣,萬丹鄉,14030,54299,28136,26163
2009/8/1,屏東縣,長治鄉,9622,30916,16212,14704
2009/8/1,屏東縣,麟洛鄉,3528,11593,6024,5569
2009/8/1,屏東縣,九如鄉,6484,23049,12018,11031
2009/8/1,屏東縣,里港鄉,7817,26276,13479,12797
2009/8/1,屏東縣,鹽埔鄉,7606,27471,14306,13165
2009/8/1,屏東縣,高樹鄉,9532,27225,14551,12674
2009/8/1,屏東縣,萬巒鄉,6357,22396,11823,10573
2009/8/1,屏東縣,內埔鄉,17567,58796,30672,28124
2009/8/1,屏東縣,竹田鄉,5440,18440,9819,8621
2009/8/1,屏東縣,新埤鄉,3323,10925,5776,5149
2009/8/1,屏東縣,枋寮鄉,8343,27053,14325,12728
2009/8/1,屏東縣,新園鄉,11007,38917,20113,18804
2009/8/1,屏東縣,崁頂鄉,4073,17184,8804,8380
2009/8/1,屏東縣,林邊鄉,6377,20953,10848,10105
2009/8/1,屏東縣,南州鄉,3621,11911,6139,5772
2009/8/1,屏東縣,佳冬鄉,6728,21646,11302,10344
2009/8/1,屏東縣,琉球鄉,3875,12558,6961,5597
2009/8/1,屏東縣,車城鄉,3481,9982,5390,4592
2009/8/1,屏東縣,滿州鄉,3046,8649,4737,3912
2009/8/1,屏東縣,枋山鄉,2080,6170,3294,2876
2009/8/1,屏東縣,三地門鄉,2077,7469,3826,3643
2009/8/1,屏東縣,霧臺鄉,882,2780,1474,1306
2009/8/1,屏東縣,瑪家鄉,1818,6431,3369,3062
2009/8/1,屏東縣,泰武鄉,1190,4961,2631,2330
2009/8/1,屏東縣,來義鄉,2105,7771,4009,3762
2009/8/1,屏東縣,春日鄉,1307,4866,2546,2320
2009/8/1,屏東縣,獅子鄉,1442,4952,2613,2339
2009/8/1,屏東縣,牡丹鄉,1839,4964,2566,2398
2009/8/1,臺東縣,臺東市,37622,109640,55823,53817
2009/8/1,臺東縣,成功鎮,5392,16033,8571,7462
2009/8/1,臺東縣,關山鎮,3202,9870,5183,4687
2009/8/1,臺東縣,卑南鄉,6522,18392,9982,8410
2009/8/1,臺東縣,大武鄉,2510,7166,3717,3449
2009/8/1,臺東縣,太麻里鄉,4498,12046,6471,5575
2009/8/1,臺東縣,東河鄉,3529,9522,5277,4245
2009/8/1,臺東縣,長濱鄉,2905,8502,4839,3663
2009/8/1,臺東縣,鹿野鄉,3109,8692,4710,3982
2009/8/1,臺東縣,池上鄉,3226,9327,4966,4361
2009/8/1,臺東縣,綠島鄉,971,3271,1764,1507
2009/8/1,臺東縣,延平鄉,1073,3626,2016,1610
2009/8/1,臺東縣,海端鄉,1091,4536,2473,2063
2009/8/1,臺東縣,達仁鄉,1462,4010,2206,1804
2009/8/1,臺東縣,金峰鄉,1005,3426,1796,1630
2009/8/1,臺東縣,蘭嶼鄉,1323,4231,2207,2024
2009/8/1,花蓮縣,花蓮市,40047,109898,54062,55836
2009/8/1,花蓮縣,鳳林鎮,4442,12214,6486,5728
2009/8/1,花蓮縣,玉里鎮,8900,27389,14906,12483
2009/8/1,花蓮縣,新城鄉,7217,20279,10584,9695
2009/8/1,花蓮縣,吉安鄉,28365,79415,40847,38568
2009/8/1,花蓮縣,壽豐鄉,6759,18951,10264,8687
2009/8/1,花蓮縣,光復鄉,4983,14326,7658,6668
2009/8/1,花蓮縣,豐濱鄉,1818,5139,2851,2288
2009/8/1,花蓮縣,瑞穗鄉,4606,13082,7079,6003
2009/8/1,花蓮縣,富里鄉,3961,11844,6525,5319
2009/8/1,花蓮縣,秀林鄉,4559,15012,7832,7180
2009/8/1,花蓮縣,萬榮鄉,2146,6997,3737,3260
2009/8/1,花蓮縣,卓溪鄉,1659,6455,3608,2847
2009/8/1,澎湖縣,馬公市,19007,55906,28363,27543
2009/8/1,澎湖縣,湖西鄉,4592,13381,7015,6366
2009/8/1,澎湖縣,白沙鄉,3078,9323,4903,4420
2009/8/1,澎湖縣,西嶼鄉,2781,8443,4379,4064
2009/8/1,澎湖縣,望安鄉,1835,4673,2538,2135
2009/8/1,澎湖縣,七美鄉,1218,3566,1871,1695
2009/8/1,基隆市,中正區,21955,56421,29043,27378
2009/8/1,基隆市,七堵區,19736,55356,28135,27221
2009/8/1,基隆市,暖暖區,14171,38124,19442,18682
2009/8/1,基隆市,仁愛區,19598,50504,25011,25493
2009/8/1,基隆市,中山區,18836,51572,26420,25152
2009/8/1,基隆市,安樂區,31590,85156,42454,42702
2009/8/1,基隆市,信義區,19807,51491,25823,25668
2009/8/1,新竹市,東區,65799,193990,95933,98057
2009/8/1,新竹市,北區,49001,143577,71205,72372
2009/8/1,新竹市,香山區,22263,71798,36709,35089
2009/8/1,臺中市,中區,8432,23340,11519,11821
2009/8/1,臺中市,東區,25418,73857,37442,36415
2009/8/1,臺中市,西區,42476,117379,56540,60839
2009/8/1,臺中市,南區,40868,112276,54641,57635
2009/8/1,臺中市,北區,54686,147761,71819,75942
2009/8/1,臺中市,西屯區,70482,202878,98814,104064
2009/8/1,臺中市,南屯區,51096,149988,72429,77559
2009/8/1,臺中市,北屯區,81023,243313,118542,124771
2009/8/1,嘉義市,東區,44541,128230,62672,65558
2009/8/1,嘉義市,西區,49702,145821,72459,73362
2009/8/1,臺南市,東區,70083,194604,94411,100193
2009/8/1,臺南市,南區,42593,126715,63718,62997
2009/8/1,臺南市,北區,47040,131063,64929,66134
2009/8/1,臺南市,安南區,53009,176478,89986,86492
2009/8/1,臺南市,安平區,22383,61323,29453,31870
2009/8/1,臺南市,中西區,29882,80180,39450,40730
2009/8/1,臺北市,松山區,77006,208894,99098,109796
2009/8/1,臺北市,信義區,85246,225872,109338,116534
2009/8/1,臺北市,大安區,115772,312312,147358,164954
2009/8/1,臺北市,中山區,89664,218438,103271,115167
2009/8/1,臺北市,中正區,61256,159251,77071,82180
2009/8/1,臺北市,大同區,46201,123815,61238,62577
2009/8/1,臺北市,萬華區,73009,188832,94797,94035
2009/8/1,臺北市,文山區,95519,261261,126945,134316
2009/8/1,臺北市,南港區,40691,113264,56079,57185
2009/8/1,臺北市,內湖區,94244,267544,129271,138273
2009/8/1,臺北市,士林區,99086,284441,138697,145744
2009/8/1,臺北市,北投區,88176,248681,121040,127641
2009/8/1,高雄市,鹽埕區,11127,27806,14025,13781
2009/8/1,高雄市,鼓山區,50082,128121,63112,65009
2009/8/1,高雄市,左營區,72238,189445,93709,95736
2009/8/1,高雄市,楠梓區,60553,171204,85213,85991
2009/8/1,高雄市,三民區,129583,355456,174524,180932
2009/8/1,高雄市,新興區,22862,56194,27479,28715
2009/8/1,高雄市,前金區,12516,29440,14425,15015
2009/8/1,高雄市,苓雅區,70980,185550,90635,94915
2009/8/1,高雄市,前鎮區,75281,200175,99980,100195
2009/8/1,高雄市,旗津區,10847,29883,15560,14323
2009/8/1,高雄市,小港區,61642,153566,77484,76082
2009/8/1,金門縣,金城鎮,10568,30977,16103,14874
2009/8/1,金門縣,金湖鎮,6937,20001,10414,9587
2009/8/1,金門縣,金沙鎮,5183,14561,7496,7065
2009/8/1,金門縣,金寧鄉,5910,16954,8927,8027
2009/8/1,金門縣,烈嶼鄉,2499,8284,4251,4033
2009/8/1,金門縣,烏坵鄉,136,484,245,239
2009/8/1,連江縣,南竿鄉,1165,5912,3415,2497
2009/8/1,連江縣,北竿鄉,381,1765,1021,744
2009/8/1,連江縣,莒光鄉,235,1151,672,479
2009/8/1,連江縣,東引鄉,259,1032,608,424
2009/9/1,總計,臺灣地區,7744138,22984669,11576779,11407890
2009/9/1,總計,臺灣省,6196241,18849276,9558799,9290477
2009/9/1,總計,新北市,1369577,3862640,1923934,1938706
2009/9/1,總計,宜蘭縣,151519,461203,235690,225513
2009/9/1,總計,桃園市,650886,1972635,996898,975737
2009/9/1,總計,新竹縣,156979,508883,262539,246344
2009/9/1,總計,苗栗縣,169464,561097,292138,268959
2009/9/1,總計,臺中市,457468,1560064,791902,768162
2009/9/1,總計,彰化縣,358019,1311529,674474,637055
2009/9/1,總計,南投縣,168647,530755,273753,257002
2009/9/1,總計,雲林縣,226252,722607,378180,344427
2009/9/1,總計,嘉義縣,173661,547185,286085,261100
2009/9/1,總計,臺南市,363983,1104068,564538,539530
2009/9/1,總計,高雄市,425403,1241920,637544,604376
2009/9/1,總計,屏東縣,273301,882511,454829,427682
2009/9/1,總計,臺東縣,79554,232235,121945,110290
2009/9/1,總計,花蓮縣,119701,340875,176323,164552
2009/9/1,總計,澎湖縣,32658,95445,49112,46333
2009/9/1,總計,基隆市,146109,388476,196209,192267
2009/9/1,總計,新竹市,137682,409911,204058,205853
2009/9/1,總計,臺中市,375302,1071117,521831,549286
2009/9/1,總計,嘉義市,94411,273876,135030,138846
2009/9/1,總計,臺南市,265665,770244,381787,388457
2009/9/1,總計,臺北市,968748,2608596,1262113,1346483
2009/9/1,總計,高雄市,579149,1526797,755867,770930
2009/9/1,總計,福建省,33389,101772,53437,48335
2009/9/1,總計,金門縣,31348,91890,47707,44183
2009/9/1,總計,連江縣,2041,9882,5730,4152
2009/9/1,新北市,板橋區,190156,552235,274084,278151
2009/9/1,新北市,三重區,136616,387422,193716,193706
2009/9/1,新北市,永和區,89276,236591,113794,122797
2009/9/1,新北市,中和區,152839,413881,205150,208731
2009/9/1,新北市,新莊區,133803,400124,198059,202065
2009/9/1,新北市,新店區,114012,293578,144391,149187
2009/9/1,新北市,土城區,80750,238515,119580,118935
2009/9/1,新北市,蘆洲區,64033,196414,97490,98924
2009/9/1,新北市,汐止區,76911,185943,92617,93326
2009/9/1,新北市,樹林區,56865,171517,86639,84878
2009/9/1,新北市,鶯歌區,26763,86510,43919,42591
2009/9/1,新北市,三峽區,33524,100021,51297,48724
2009/9/1,新北市,淡水區,54385,139073,67906,71167
2009/9/1,新北市,瑞芳區,15627,42752,21912,20840
2009/9/1,新北市,五股區,26637,78899,40187,38712
2009/9/1,新北市,泰山區,25771,76287,38496,37791
2009/9/1,新北市,林口區,27587,77097,38321,38776
2009/9/1,新北市,深坑區,8538,23077,11664,11413
2009/9/1,新北市,石碇區,3260,7962,4450,3512
2009/9/1,新北市,坪林區,2392,6558,3677,2881
2009/9/1,新北市,三芝區,8721,23409,12129,11280
2009/9/1,新北市,石門區,3862,12281,6491,5790
2009/9/1,新北市,八里區,11648,33727,17249,16478
2009/9/1,新北市,平溪區,2361,5483,3038,2445
2009/9/1,新北市,雙溪區,3812,9829,5317,4512
2009/9/1,新北市,貢寮區,4345,13906,7194,6712
2009/9/1,新北市,金山區,6555,22331,11278,11053
2009/9/1,新北市,萬里區,6843,21518,10987,10531
2009/9/1,新北市,烏來區,1685,5700,2902,2798
2009/9/1,宜蘭縣,宜蘭市,32750,95863,47321,48542
2009/9/1,宜蘭縣,羅東鎮,24593,73180,35217,37963
2009/9/1,宜蘭縣,蘇澳鎮,13428,43283,22271,21012
2009/9/1,宜蘭縣,頭城鎮,9550,31124,16138,14986
2009/9/1,宜蘭縣,礁溪鄉,12126,35824,18804,17020
2009/9/1,宜蘭縣,壯圍鄉,7981,25134,13272,11862
2009/9/1,宜蘭縣,員山鄉,10609,32324,17378,14946
2009/9/1,宜蘭縣,冬山鄉,16885,52167,26988,25179
2009/9/1,宜蘭縣,五結鄉,12668,38620,20113,18507
2009/9/1,宜蘭縣,三星鄉,7359,21797,11764,10033
2009/9/1,宜蘭縣,大同鄉,1806,5967,3272,2695
2009/9/1,宜蘭縣,南澳鄉,1764,5920,3152,2768
2009/9/1,桃園市,桃園區,139207,399855,196238,203617
2009/9/1,桃園市,中壢區,122654,364007,182383,181624
2009/9/1,桃園市,平鎮區,64752,206242,104039,102203
2009/9/1,桃園市,八德區,56140,174512,89144,85368
2009/9/1,桃園市,大溪區,28694,91667,47260,44407
2009/9/1,桃園市,楊梅區,46649,147350,75105,72245
2009/9/1,桃園市,蘆竹區,46143,138007,69343,68664
2009/9/1,桃園市,大園區,25289,81043,42181,38862
2009/9/1,桃園市,龜山區,48184,135221,68709,66512
2009/9/1,桃園市,龍潭區,36048,114053,58105,55948
2009/9/1,桃園市,新屋區,14777,49549,26467,23082
2009/9/1,桃園市,觀音區,18707,60618,32019,28599
2009/9/1,桃園市,復興區,3642,10511,5905,4606
2009/9/1,新竹縣,竹北市,44745,136605,68778,67827
2009/9/1,新竹縣,關西鎮,9157,32410,17270,15140
2009/9/1,新竹縣,新埔鎮,10241,36008,19058,16950
2009/9/1,新竹縣,竹東鎮,30056,97086,49031,48055
2009/9/1,新竹縣,湖口鄉,22990,75280,38562,36718
2009/9/1,新竹縣,橫山鄉,4348,14769,7978,6791
2009/9/1,新竹縣,新豐鄉,15243,52603,27236,25367
2009/9/1,新竹縣,芎林鄉,6210,20885,11021,9864
2009/9/1,新竹縣,寶山鄉,4564,13915,7511,6404
2009/9/1,新竹縣,北埔鄉,3069,10259,5552,4707
2009/9/1,新竹縣,峨眉鄉,2016,6132,3400,2732
2009/9/1,新竹縣,尖石鄉,2642,8306,4568,3738
2009/9/1,新竹縣,五峰鄉,1698,4625,2574,2051
2009/9/1,苗栗縣,苗栗市,28730,90847,45908,44939
2009/9/1,苗栗縣,苑裡鎮,13705,48981,25625,23356
2009/9/1,苗栗縣,通霄鎮,11196,38608,20582,18026
2009/9/1,苗栗縣,竹南鎮,23291,77139,39305,37834
2009/9/1,苗栗縣,頭份市,28708,96066,49017,47049
2009/9/1,苗栗縣,後龍鎮,11529,39815,21070,18745
2009/9/1,苗栗縣,卓蘭鎮,5889,18451,9769,8682
2009/9/1,苗栗縣,大湖鄉,5274,16181,8700,7481
2009/9/1,苗栗縣,公館鄉,9996,34813,18319,16494
2009/9/1,苗栗縣,銅鑼鄉,5934,19595,10389,9206
2009/9/1,苗栗縣,南庄鄉,3949,11315,6262,5053
2009/9/1,苗栗縣,頭屋鄉,3491,11681,6178,5503
2009/9/1,苗栗縣,三義鄉,5207,17646,9316,8330
2009/9/1,苗栗縣,西湖鄉,2656,7942,4395,3547
2009/9/1,苗栗縣,造橋鄉,3934,13707,7266,6441
2009/9/1,苗栗縣,三灣鄉,2381,7390,4014,3376
2009/9/1,苗栗縣,獅潭鄉,1672,5074,2835,2239
2009/9/1,苗栗縣,泰安鄉,1922,5846,3188,2658
2009/9/1,臺中市,豐原區,48660,165169,82188,82981
2009/9/1,臺中市,大里區,60190,195574,97254,98320
2009/9/1,臺中市,太平區,53592,172151,86552,85599
2009/9/1,臺中市,東勢區,16805,53787,27967,25820
2009/9/1,臺中市,大甲區,21329,78736,39986,38750
2009/9/1,臺中市,清水區,24481,85706,44254,41452
2009/9/1,臺中市,沙鹿區,22821,80331,40902,39429
2009/9/1,臺中市,梧棲區,15717,54903,27940,26963
2009/9/1,臺中市,后里區,14602,54435,28095,26340
2009/9/1,臺中市,神岡區,17374,64089,33108,30981
2009/9/1,臺中市,潭子區,31665,99316,49635,49681
2009/9/1,臺中市,大雅區,25734,89202,45039,44163
2009/9/1,臺中市,新社區,7265,25794,13588,12206
2009/9/1,臺中市,石岡區,4799,16137,8427,7710
2009/9/1,臺中市,外埔區,8663,31923,16449,15474
2009/9/1,臺中市,大安區,5177,20441,10787,9654
2009/9/1,臺中市,烏日區,19942,68309,34692,33617
2009/9/1,臺中市,大肚區,15580,55932,28719,27213
2009/9/1,臺中市,龍井區,20132,73515,37535,35980
2009/9/1,臺中市,霧峰區,18484,63895,32911,30984
2009/9/1,臺中市,和平區,4456,10719,5874,4845
2009/9/1,彰化縣,彰化市,70661,236852,118256,118596
2009/9/1,彰化縣,鹿港鎮,21850,85305,43777,41528
2009/9/1,彰化縣,和美鎮,23632,89530,46007,43523
2009/9/1,彰化縣,北斗鎮,9749,33633,17069,16564
2009/9/1,彰化縣,員林市,36184,125960,63457,62503
2009/9/1,彰化縣,溪湖鎮,14880,56277,28806,27471
2009/9/1,彰化縣,田中鎮,12419,44449,23204,21245
2009/9/1,彰化縣,二林鎮,14170,54545,28151,26394
2009/9/1,彰化縣,線西鄉,4044,17047,8773,8274
2009/9/1,彰化縣,伸港鄉,8821,35921,18527,17394
2009/9/1,彰化縣,福興鄉,11834,49095,25736,23359
2009/9/1,彰化縣,秀水鄉,9508,38946,20203,18743
2009/9/1,彰化縣,花壇鄉,12738,46249,23897,22352
2009/9/1,彰化縣,芬園鄉,6827,24990,13278,11712
2009/9/1,彰化縣,大村鄉,10046,36598,19101,17497
2009/9/1,彰化縣,埔鹽鄉,8670,34497,18122,16375
2009/9/1,彰化縣,埔心鄉,9774,35361,18347,17014
2009/9/1,彰化縣,永靖鄉,10285,39584,20544,19040
2009/9/1,彰化縣,社頭鄉,12177,44988,23210,21778
2009/9/1,彰化縣,二水鄉,5298,16757,8843,7914
2009/9/1,彰化縣,田尾鄉,7576,28833,15043,13790
2009/9/1,彰化縣,埤頭鄉,8453,31976,16748,15228
2009/9/1,彰化縣,芳苑鄉,9929,36534,19398,17136
2009/9/1,彰化縣,大城鄉,5344,19125,10402,8723
2009/9/1,彰化縣,竹塘鄉,4545,16650,8776,7874
2009/9/1,彰化縣,溪州鄉,8605,31827,16799,15028
2009/9/1,南投縣,南投市,32858,104810,52814,51996
2009/9/1,南投縣,埔里鎮,28018,85901,43404,42497
2009/9/1,南投縣,草屯鎮,30482,100249,50745,49504
2009/9/1,南投縣,竹山鎮,18710,58870,30433,28437
2009/9/1,南投縣,集集鎮,4262,12052,6350,5702
2009/9/1,南投縣,名間鄉,11962,41524,21838,19686
2009/9/1,南投縣,鹿谷鄉,6594,19327,10279,9048
2009/9/1,南投縣,中寮鄉,5592,16403,8922,7481
2009/9/1,南投縣,魚池鄉,5764,17315,9165,8150
2009/9/1,南投縣,國姓鄉,7177,21006,11510,9496
2009/9/1,南投縣,水里鄉,7212,20453,10759,9694
2009/9/1,南投縣,信義鄉,5120,17272,9355,7917
2009/9/1,南投縣,仁愛鄉,4896,15573,8179,7394
2009/9/1,雲林縣,斗六市,33955,106559,53795,52764
2009/9/1,雲林縣,斗南鎮,15024,47508,24164,23344
2009/9/1,雲林縣,虎尾鎮,22006,70076,35719,34357
2009/9/1,雲林縣,西螺鎮,13851,48981,24920,24061
2009/9/1,雲林縣,土庫鎮,8618,30723,16096,14627
2009/9/1,雲林縣,北港鎮,15051,43632,22754,20878
2009/9/1,雲林縣,古坑鄉,10545,34625,18352,16273
2009/9/1,雲林縣,大埤鄉,6586,21479,11482,9997
2009/9/1,雲林縣,莿桐鄉,8914,30635,16066,14569
2009/9/1,雲林縣,林內鄉,5704,20267,10608,9659
2009/9/1,雲林縣,二崙鄉,8717,30061,16145,13916
2009/9/1,雲林縣,崙背鄉,8262,27794,14678,13116
2009/9/1,雲林縣,麥寮鄉,11983,34969,18418,16551
2009/9/1,雲林縣,東勢鄉,5709,17199,9360,7839
2009/9/1,雲林縣,褒忠鄉,4263,14610,7790,6820
2009/9/1,雲林縣,臺西鄉,8753,26651,14376,12275
2009/9/1,雲林縣,元長鄉,9312,29327,15985,13342
2009/9/1,雲林縣,四湖鄉,9027,27252,14897,12355
2009/9/1,雲林縣,口湖鄉,9596,30745,16415,14330
2009/9/1,雲林縣,水林鄉,10376,29514,16160,13354
2009/9/1,嘉義縣,太保市,10919,36070,18683,17387
2009/9/1,嘉義縣,朴子市,14214,44273,22650,21623
2009/9/1,嘉義縣,布袋鎮,10100,30770,15834,14936
2009/9/1,嘉義縣,大林鎮,11097,34003,17505,16498
2009/9/1,嘉義縣,民雄鄉,22324,72694,37442,35252
2009/9/1,嘉義縣,溪口鄉,5369,16550,8832,7718
2009/9/1,嘉義縣,新港鄉,10253,35060,18517,16543
2009/9/1,嘉義縣,六腳鄉,9118,26857,14252,12605
2009/9/1,嘉義縣,東石鄉,9307,28175,15000,13175
2009/9/1,嘉義縣,義竹鄉,7453,21717,11252,10465
2009/9/1,嘉義縣,鹿草鄉,5675,17373,9316,8057
2009/9/1,嘉義縣,水上鄉,17237,52567,27268,25299
2009/9/1,嘉義縣,中埔鄉,14983,47756,25010,22746
2009/9/1,嘉義縣,竹崎鄉,11203,38906,20760,18146
2009/9/1,嘉義縣,梅山鄉,6565,22039,11694,10345
2009/9/1,嘉義縣,番路鄉,3859,11662,6343,5319
2009/9/1,嘉義縣,大埔鄉,1974,4545,2417,2128
2009/9/1,嘉義縣,阿里山鄉,2011,6168,3310,2858
2009/9/1,臺南市,新營區,26760,78368,39228,39140
2009/9/1,臺南市,永康區,73172,214033,106697,107336
2009/9/1,臺南市,鹽水區,9819,27364,14251,13113
2009/9/1,臺南市,白河區,10864,31838,16769,15069
2009/9/1,臺南市,麻豆區,14801,46139,23591,22548
2009/9/1,臺南市,佳里區,19008,59478,29670,29808
2009/9/1,臺南市,新化區,13500,44384,22793,21591
2009/9/1,臺南市,善化區,14220,43282,21954,21328
2009/9/1,臺南市,學甲區,9401,28169,14426,13743
2009/9/1,臺南市,柳營區,7716,22978,12026,10952
2009/9/1,臺南市,後壁區,8648,26183,13660,12523
2009/9/1,臺南市,東山區,8150,23371,12474,10897
2009/9/1,臺南市,下營區,9028,26462,13731,12731
2009/9/1,臺南市,六甲區,7549,24048,12518,11530
2009/9/1,臺南市,官田區,7574,22418,11519,10899
2009/9/1,臺南市,大內區,4060,11121,5914,5207
2009/9/1,臺南市,西港區,7710,25328,12942,12386
2009/9/1,臺南市,七股區,7896,25005,13090,11915
2009/9/1,臺南市,將軍區,7382,21830,11144,10686
2009/9/1,臺南市,北門區,4311,12554,6407,6147
2009/9/1,臺南市,新市區,10649,35036,17641,17395
2009/9/1,臺南市,安定區,9086,30109,15605,14504
2009/9/1,臺南市,山上區,2708,8005,4216,3789
2009/9/1,臺南市,玉井區,5070,15616,8104,7512
2009/9/1,臺南市,楠西區,3597,10808,5745,5063
2009/9/1,臺南市,南化區,2816,9015,4935,4080
2009/9/1,臺南市,左鎮區,1968,5647,3126,2521
2009/9/1,臺南市,仁德區,24184,68753,35443,33310
2009/9/1,臺南市,歸仁區,20144,65882,33604,32278
2009/9/1,臺南市,關廟區,10594,36389,18905,17484
2009/9/1,臺南市,龍崎區,1598,4455,2410,2045
2009/9/1,高雄市,鳳山區,124440,339543,169761,169782
2009/9/1,高雄市,岡山區,32686,96977,48888,48089
2009/9/1,高雄市,旗山區,13663,40467,21164,19303
2009/9/1,高雄市,美濃區,13887,43451,22708,20743
2009/9/1,高雄市,林園區,23746,70714,36443,34271
2009/9/1,高雄市,大寮區,37598,109278,56956,52322
2009/9/1,高雄市,大樹區,12965,44256,22965,21291
2009/9/1,高雄市,仁武區,24642,69836,36125,33711
2009/9/1,高雄市,大社區,11512,32871,16948,15923
2009/9/1,高雄市,鳥松區,16168,41969,21367,20602
2009/9/1,高雄市,橋頭區,12355,36261,18646,17615
2009/9/1,高雄市,燕巢區,9888,31080,16628,14452
2009/9/1,高雄市,田寮區,3563,8335,4623,3712
2009/9/1,高雄市,阿蓮區,9037,30604,15453,15151
2009/9/1,高雄市,路竹區,15822,54131,27685,26446
2009/9/1,高雄市,湖內區,9332,28651,14806,13845
2009/9/1,高雄市,茄萣區,10050,31607,16535,15072
2009/9/1,高雄市,永安區,5747,14170,7254,6916
2009/9/1,高雄市,彌陀區,6508,20619,10775,9844
2009/9/1,高雄市,梓官區,11812,36882,19239,17643
2009/9/1,高雄市,六龜區,5761,15364,8333,7031
2009/9/1,高雄市,甲仙區,2547,7587,4091,3496
2009/9/1,高雄市,杉林區,4025,11097,6062,5035
2009/9/1,高雄市,內門區,5001,16136,8810,7326
2009/9/1,高雄市,茂林區,532,1835,935,900
2009/9/1,高雄市,桃源區,1244,4748,2541,2207
2009/9/1,高雄市,那瑪夏區,872,3451,1803,1648
2009/9/1,屏東縣,屏東市,72045,213856,106885,106971
2009/9/1,屏東縣,潮州鎮,17923,56199,28347,27852
2009/9/1,屏東縣,東港鎮,15189,50275,25591,24684
2009/9/1,屏東縣,恆春鎮,10593,31130,16061,15069
2009/9/1,屏東縣,萬丹鄉,14078,54309,28132,26177
2009/9/1,屏東縣,長治鄉,9629,30915,16209,14706
2009/9/1,屏東縣,麟洛鄉,3531,11575,6009,5566
2009/9/1,屏東縣,九如鄉,6486,23020,12000,11020
2009/9/1,屏東縣,里港鄉,7813,26268,13473,12795
2009/9/1,屏東縣,鹽埔鄉,7612,27441,14288,13153
2009/9/1,屏東縣,高樹鄉,9549,27195,14533,12662
2009/9/1,屏東縣,萬巒鄉,6368,22339,11784,10555
2009/9/1,屏東縣,內埔鄉,17580,58759,30643,28116
2009/9/1,屏東縣,竹田鄉,5453,18457,9825,8632
2009/9/1,屏東縣,新埤鄉,3327,10919,5769,5150
2009/9/1,屏東縣,枋寮鄉,8360,27030,14312,12718
2009/9/1,屏東縣,新園鄉,11125,39015,20162,18853
2009/9/1,屏東縣,崁頂鄉,4084,17241,8853,8388
2009/9/1,屏東縣,林邊鄉,6711,21073,10904,10169
2009/9/1,屏東縣,南州鄉,3640,11925,6140,5785
2009/9/1,屏東縣,佳冬鄉,6864,21690,11334,10356
2009/9/1,屏東縣,琉球鄉,3894,12548,6956,5592
2009/9/1,屏東縣,車城鄉,3480,9948,5373,4575
2009/9/1,屏東縣,滿州鄉,3049,8649,4740,3909
2009/9/1,屏東縣,枋山鄉,2081,6180,3301,2879
2009/9/1,屏東縣,三地門鄉,2106,7531,3863,3668
2009/9/1,屏東縣,霧臺鄉,920,2883,1533,1350
2009/9/1,屏東縣,瑪家鄉,1849,6480,3392,3088
2009/9/1,屏東縣,泰武鄉,1223,5031,2667,2364
2009/9/1,屏東縣,來義鄉,2130,7838,4030,3808
2009/9/1,屏東縣,春日鄉,1313,4869,2544,2325
2009/9/1,屏東縣,獅子鄉,1447,4953,2604,2349
2009/9/1,屏東縣,牡丹鄉,1849,4970,2572,2398
2009/9/1,臺東縣,臺東市,37657,109573,55774,53799
2009/9/1,臺東縣,成功鎮,5390,15999,8548,7451
2009/9/1,臺東縣,關山鎮,3201,9880,5186,4694
2009/9/1,臺東縣,卑南鄉,6531,18391,9974,8417
2009/9/1,臺東縣,大武鄉,2528,7168,3722,3446
2009/9/1,臺東縣,太麻里鄉,4508,12067,6472,5595
2009/9/1,臺東縣,東河鄉,3531,9513,5276,4237
2009/9/1,臺東縣,長濱鄉,2911,8475,4822,3653
2009/9/1,臺東縣,鹿野鄉,3114,8687,4707,3980
2009/9/1,臺東縣,池上鄉,3224,9319,4965,4354
2009/9/1,臺東縣,綠島鄉,974,3278,1768,1510
2009/9/1,臺東縣,延平鄉,1075,3622,2015,1607
2009/9/1,臺東縣,海端鄉,1091,4528,2468,2060
2009/9/1,臺東縣,達仁鄉,1474,4043,2223,1820
2009/9/1,臺東縣,金峰鄉,1012,3440,1808,1632
2009/9/1,臺東縣,蘭嶼鄉,1333,4252,2217,2035
2009/9/1,花蓮縣,花蓮市,40174,109910,54040,55870
2009/9/1,花蓮縣,鳳林鎮,4440,12175,6471,5704
2009/9/1,花蓮縣,玉里鎮,8919,27357,14882,12475
2009/9/1,花蓮縣,新城鄉,7232,20271,10575,9696
2009/9/1,花蓮縣,吉安鄉,28430,79441,40862,38579
2009/9/1,花蓮縣,壽豐鄉,6761,18926,10246,8680
2009/9/1,花蓮縣,光復鄉,4979,14274,7628,6646
2009/9/1,花蓮縣,豐濱鄉,1816,5122,2838,2284
2009/9/1,花蓮縣,瑞穗鄉,4609,13068,7069,5999
2009/9/1,花蓮縣,富里鄉,3970,11843,6521,5322
2009/9/1,花蓮縣,秀林鄉,4573,15066,7858,7208
2009/9/1,花蓮縣,萬榮鄉,2138,6989,3734,3255
2009/9/1,花蓮縣,卓溪鄉,1660,6433,3599,2834
2009/9/1,澎湖縣,馬公市,19104,55977,28381,27596
2009/9/1,澎湖縣,湖西鄉,4606,13421,7027,6394
2009/9/1,澎湖縣,白沙鄉,3087,9352,4904,4448
2009/9/1,澎湖縣,西嶼鄉,2794,8457,4390,4067
2009/9/1,澎湖縣,望安鄉,1843,4692,2544,2148
2009/9/1,澎湖縣,七美鄉,1224,3546,1866,1680
2009/9/1,基隆市,中正區,22052,56413,29021,27392
2009/9/1,基隆市,七堵區,19812,55378,28135,27243
2009/9/1,基隆市,暖暖區,14192,38153,19455,18698
2009/9/1,基隆市,仁愛區,19658,50485,24983,25502
2009/9/1,基隆市,中山區,18870,51515,26377,25138
2009/9/1,基隆市,安樂區,31660,84993,42367,42626
2009/9/1,基隆市,信義區,19865,51539,25871,25668
2009/9/1,新竹市,東區,66077,194188,96019,98169
2009/9/1,新竹市,北區,49265,143891,71311,72580
2009/9/1,新竹市,香山區,22340,71832,36728,35104
2009/9/1,臺中市,中區,8434,23310,11496,11814
2009/9/1,臺中市,東區,25474,73870,37424,36446
2009/9/1,臺中市,西區,42604,117420,56557,60863
2009/9/1,臺中市,南區,40977,112284,54654,57630
2009/9/1,臺中市,北區,54725,147533,71684,75849
2009/9/1,臺中市,西屯區,70653,203097,98892,104205
2009/9/1,臺中市,南屯區,51228,150132,72522,77610
2009/9/1,臺中市,北屯區,81207,243471,118602,124869
2009/9/1,嘉義市,東區,44564,127987,62563,65424
2009/9/1,嘉義市,西區,49847,145889,72467,73422
2009/9/1,臺南市,東區,70182,194424,94259,100165
2009/9/1,臺南市,南區,42663,126610,63646,62964
2009/9/1,臺南市,北區,47208,131085,64940,66145
2009/9/1,臺南市,安南區,53224,176643,90053,86590
2009/9/1,臺南市,安平區,22502,61447,29528,31919
2009/9/1,臺南市,中西區,29886,80035,39361,40674
2009/9/1,臺北市,松山區,77139,208237,98813,109424
2009/9/1,臺北市,信義區,85477,225608,109218,116390
2009/9/1,臺北市,大安區,116033,311378,146902,164476
2009/9/1,臺北市,中山區,90124,218330,103174,115156
2009/9/1,臺北市,中正區,61411,158829,76837,81992
2009/9/1,臺北市,大同區,46301,123562,61098,62464
2009/9/1,臺北市,萬華區,73142,188608,94655,93953
2009/9/1,臺北市,文山區,95826,261030,126767,134263
2009/9/1,臺北市,南港區,40937,113327,56112,57215
2009/9/1,臺北市,內湖區,94689,267518,129262,138256
2009/9/1,臺北市,士林區,99334,283881,138406,145475
2009/9/1,臺北市,北投區,88335,248288,120869,127419
2009/9/1,高雄市,鹽埕區,11128,27749,13991,13758
2009/9/1,高雄市,鼓山區,50422,128599,63300,65299
2009/9/1,高雄市,左營區,72398,189617,93740,95877
2009/9/1,高雄市,楠梓區,60750,171403,85290,86113
2009/9/1,高雄市,三民區,129876,355248,174360,180888
2009/9/1,高雄市,新興區,22883,55982,27372,28610
2009/9/1,高雄市,前金區,12537,29346,14385,14961
2009/9/1,高雄市,苓雅區,71064,185210,90440,94770
2009/9/1,高雄市,前鎮區,75452,200128,99929,100199
2009/9/1,高雄市,旗津區,10868,29901,15578,14323
2009/9/1,高雄市,小港區,61771,153614,77482,76132
2009/9/1,金門縣,金城鎮,10599,31117,16163,14954
2009/9/1,金門縣,金湖鎮,6965,20122,10471,9651
2009/9/1,金門縣,金沙鎮,5196,14619,7531,7088
2009/9/1,金門縣,金寧鄉,5943,17206,9019,8187
2009/9/1,金門縣,烈嶼鄉,2509,8342,4278,4064
2009/9/1,金門縣,烏坵鄉,136,484,245,239
2009/9/1,連江縣,南竿鄉,1166,5930,3427,2503
2009/9/1,連江縣,北竿鄉,380,1760,1019,741
2009/9/1,連江縣,莒光鄉,235,1151,673,478
2009/9/1,連江縣,東引鄉,260,1041,611,430
2009/10/1,總計,臺灣地區,7751539,22995557,11578475,11417082
2009/10/1,總計,臺灣省,6203350,18860229,9561378,9298851
2009/10/1,總計,新北市,1370994,3866378,1925197,1941181
2009/10/1,總計,宜蘭縣,151623,461345,235737,225608
2009/10/1,總計,桃園市,651738,1974758,997540,977218
2009/10/1,總計,新竹縣,157199,509453,262727,246726
2009/10/1,總計,苗栗縣,169667,561315,292180,269135
2009/10/1,總計,臺中市,457991,1560637,792022,768615
2009/10/1,總計,彰化縣,358293,1311971,674605,637366
2009/10/1,總計,南投縣,168807,530769,273687,257082
2009/10/1,總計,雲林縣,226525,722831,378145,344686
2009/10/1,總計,嘉義縣,173810,547267,286064,261203
2009/10/1,總計,臺南市,364469,1104320,564566,539754
2009/10/1,總計,高雄市,425818,1242328,637530,604798
2009/10/1,總計,屏東縣,274088,882575,454716,427859
2009/10/1,總計,臺東縣,79662,232290,121897,110393
2009/10/1,總計,花蓮縣,119790,340910,176264,164646
2009/10/1,總計,澎湖縣,32895,95751,49268,46483
2009/10/1,總計,基隆市,146127,388542,196121,192421
2009/10/1,總計,新竹市,137936,410399,204229,206170
2009/10/1,總計,臺中市,375681,1071946,522088,549858
2009/10/1,總計,嘉義市,94398,273861,134982,138879
2009/10/1,總計,臺南市,265839,770583,381813,388770
2009/10/1,總計,臺北市,968739,2608186,1261386,1346800
2009/10/1,總計,高雄市,579450,1527142,755711,771431
2009/10/1,總計,福建省,33496,102492,53777,48715
2009/10/1,總計,金門縣,31452,92602,48045,44557
2009/10/1,總計,連江縣,2044,9890,5732,4158
2009/10/1,新北市,板橋區,190222,552384,274068,278316
2009/10/1,新北市,三重區,136753,387695,193827,193868
2009/10/1,新北市,永和區,89281,236700,113845,122855
2009/10/1,新北市,中和區,152955,414182,205216,208966
2009/10/1,新北市,新莊區,133865,400396,198161,202235
2009/10/1,新北市,新店區,114064,293985,144533,149452
2009/10/1,新北市,土城區,80774,238526,119544,118982
2009/10/1,新北市,蘆洲區,64113,196712,97595,99117
2009/10/1,新北市,汐止區,77015,186250,92724,93526
2009/10/1,新北市,樹林區,56969,171794,86783,85011
2009/10/1,新北市,鶯歌區,26810,86632,43949,42683
2009/10/1,新北市,三峽區,33616,100195,51359,48836
2009/10/1,新北市,淡水區,54546,139415,68052,71363
2009/10/1,新北市,瑞芳區,15653,42752,21915,20837
2009/10/1,新北市,五股區,26687,78958,40215,38743
2009/10/1,新北市,泰山區,25789,76377,38505,37872
2009/10/1,新北市,林口區,27735,77525,38520,39005
2009/10/1,新北市,深坑區,8548,23051,11645,11406
2009/10/1,新北市,石碇區,3261,7960,4444,3516
2009/10/1,新北市,坪林區,2395,6551,3672,2879
2009/10/1,新北市,三芝區,8724,23398,12117,11281
2009/10/1,新北市,石門區,3881,12315,6512,5803
2009/10/1,新北市,八里區,11696,33781,17252,16529
2009/10/1,新北市,平溪區,2366,5484,3044,2440
2009/10/1,新北市,雙溪區,3818,9832,5316,4516
2009/10/1,新北市,貢寮區,4347,13907,7188,6719
2009/10/1,新北市,金山區,6563,22356,11284,11072
2009/10/1,新北市,萬里區,6858,21543,11001,10542
2009/10/1,新北市,烏來區,1690,5722,2911,2811
2009/10/1,宜蘭縣,宜蘭市,32778,95877,47328,48549
2009/10/1,宜蘭縣,羅東鎮,24577,73105,35180,37925
2009/10/1,宜蘭縣,蘇澳鎮,13427,43279,22269,21010
2009/10/1,宜蘭縣,頭城鎮,9553,31137,16138,14999
2009/10/1,宜蘭縣,礁溪鄉,12137,35854,18816,17038
2009/10/1,宜蘭縣,壯圍鄉,7987,25120,13264,11856
2009/10/1,宜蘭縣,員山鄉,10617,32358,17390,14968
2009/10/1,宜蘭縣,冬山鄉,16902,52255,27032,25223
2009/10/1,宜蘭縣,五結鄉,12713,38697,20155,18542
2009/10/1,宜蘭縣,三星鄉,7360,21768,11737,10031
2009/10/1,宜蘭縣,大同鄉,1805,5973,3276,2697
2009/10/1,宜蘭縣,南澳鄉,1767,5922,3152,2770
2009/10/1,桃園市,桃園區,139378,400322,196392,203930
2009/10/1,桃園市,中壢區,122838,364464,182533,181931
2009/10/1,桃園市,平鎮區,64824,206319,104042,102277
2009/10/1,桃園市,八德區,56178,174645,89160,85485
2009/10/1,桃園市,大溪區,28704,91761,47282,44479
2009/10/1,桃園市,楊梅區,46741,147629,75197,72432
2009/10/1,桃園市,蘆竹區,46184,138180,69409,68771
2009/10/1,桃園市,大園區,25400,81149,42213,38936
2009/10/1,桃園市,龜山區,48249,135435,68785,66650
2009/10/1,桃園市,龍潭區,36077,114074,58093,55981
2009/10/1,桃園市,新屋區,14787,49583,26474,23109
2009/10/1,桃園市,觀音區,18735,60678,32050,28628
2009/10/1,桃園市,復興區,3643,10519,5910,4609
2009/10/1,新竹縣,竹北市,44837,136948,68928,68020
2009/10/1,新竹縣,關西鎮,9163,32411,17267,15144
2009/10/1,新竹縣,新埔鎮,10251,36018,19059,16959
2009/10/1,新竹縣,竹東鎮,30069,97079,49006,48073
2009/10/1,新竹縣,湖口鄉,23031,75393,38601,36792
2009/10/1,新竹縣,橫山鄉,4352,14767,7970,6797
2009/10/1,新竹縣,新豐鄉,15260,52638,27241,25397
2009/10/1,新竹縣,芎林鄉,6228,20915,11034,9881
2009/10/1,新竹縣,寶山鄉,4569,13926,7507,6419
2009/10/1,新竹縣,北埔鄉,3069,10275,5562,4713
2009/10/1,新竹縣,峨眉鄉,2017,6131,3403,2728
2009/10/1,新竹縣,尖石鄉,2650,8315,4571,3744
2009/10/1,新竹縣,五峰鄉,1703,4637,2578,2059
2009/10/1,苗栗縣,苗栗市,28754,90896,45901,44995
2009/10/1,苗栗縣,苑裡鎮,13727,48985,25630,23355
2009/10/1,苗栗縣,通霄鎮,11207,38584,20562,18022
2009/10/1,苗栗縣,竹南鎮,23337,77196,39335,37861
2009/10/1,苗栗縣,頭份市,28747,96117,49025,47092
2009/10/1,苗栗縣,後龍鎮,11534,39775,21051,18724
2009/10/1,苗栗縣,卓蘭鎮,5886,18465,9777,8688
2009/10/1,苗栗縣,大湖鄉,5283,16199,8707,7492
2009/10/1,苗栗縣,公館鄉,10003,34799,18313,16486
2009/10/1,苗栗縣,銅鑼鄉,5948,19613,10397,9216
2009/10/1,苗栗縣,南庄鄉,3953,11320,6263,5057
2009/10/1,苗栗縣,頭屋鄉,3493,11692,6185,5507
2009/10/1,苗栗縣,三義鄉,5221,17674,9325,8349
2009/10/1,苗栗縣,西湖鄉,2657,7945,4394,3551
2009/10/1,苗栗縣,造橋鄉,3937,13725,7269,6456
2009/10/1,苗栗縣,三灣鄉,2380,7404,4020,3384
2009/10/1,苗栗縣,獅潭鄉,1674,5069,2832,2237
2009/10/1,苗栗縣,泰安鄉,1926,5857,3194,2663
2009/10/1,臺中市,豐原區,48681,165199,82162,83037
2009/10/1,臺中市,大里區,60266,195666,97291,98375
2009/10/1,臺中市,太平區,53645,172217,86574,85643
2009/10/1,臺中市,東勢區,16819,53746,27926,25820
2009/10/1,臺中市,大甲區,21335,78723,39986,38737
2009/10/1,臺中市,清水區,24525,85734,44267,41467
2009/10/1,臺中市,沙鹿區,22863,80409,40942,39467
2009/10/1,臺中市,梧棲區,15740,54951,27956,26995
2009/10/1,臺中市,后里區,14621,54431,28082,26349
2009/10/1,臺中市,神岡區,17388,64074,33099,30975
2009/10/1,臺中市,潭子區,31704,99420,49689,49731
2009/10/1,臺中市,大雅區,25766,89265,45066,44199
2009/10/1,臺中市,新社區,7276,25770,13570,12200
2009/10/1,臺中市,石岡區,4803,16133,8424,7709
2009/10/1,臺中市,外埔區,8682,31960,16468,15492
2009/10/1,臺中市,大安區,5184,20455,10789,9666
2009/10/1,臺中市,烏日區,19978,68317,34679,33638
2009/10/1,臺中市,大肚區,15594,55957,28719,27238
2009/10/1,臺中市,龍井區,20158,73598,37557,36041
2009/10/1,臺中市,霧峰區,18504,63868,32901,30967
2009/10/1,臺中市,和平區,4459,10744,5875,4869
2009/10/1,彰化縣,彰化市,70741,237048,118319,118729
2009/10/1,彰化縣,鹿港鎮,21867,85317,43789,41528
2009/10/1,彰化縣,和美鎮,23661,89567,46034,43533
2009/10/1,彰化縣,北斗鎮,9753,33622,17055,16567
2009/10/1,彰化縣,員林市,36199,125883,63433,62450
2009/10/1,彰化縣,溪湖鎮,14891,56270,28802,27468
2009/10/1,彰化縣,田中鎮,12427,44477,23207,21270
2009/10/1,彰化縣,二林鎮,14176,54526,28136,26390
2009/10/1,彰化縣,線西鄉,4045,17067,8780,8287
2009/10/1,彰化縣,伸港鄉,8831,35947,18529,17418
2009/10/1,彰化縣,福興鄉,11844,49131,25744,23387
2009/10/1,彰化縣,秀水鄉,9523,38981,20220,18761
2009/10/1,彰化縣,花壇鄉,12746,46216,23875,22341
2009/10/1,彰化縣,芬園鄉,6829,24995,13271,11724
2009/10/1,彰化縣,大村鄉,10061,36627,19111,17516
2009/10/1,彰化縣,埔鹽鄉,8676,34511,18124,16387
2009/10/1,彰化縣,埔心鄉,9784,35387,18365,17022
2009/10/1,彰化縣,永靖鄉,10293,39593,20539,19054
2009/10/1,彰化縣,社頭鄉,12178,44996,23212,21784
2009/10/1,彰化縣,二水鄉,5298,16751,8839,7912
2009/10/1,彰化縣,田尾鄉,7579,28854,15050,13804
2009/10/1,彰化縣,埤頭鄉,8456,31976,16749,15227
2009/10/1,彰化縣,芳苑鄉,9925,36569,19427,17142
2009/10/1,彰化縣,大城鄉,5347,19119,10395,8724
2009/10/1,彰化縣,竹塘鄉,4549,16684,8788,7896
2009/10/1,彰化縣,溪州鄉,8614,31857,16812,15045
2009/10/1,南投縣,南投市,32867,104721,52754,51967
2009/10/1,南投縣,埔里鎮,28034,85848,43368,42480
2009/10/1,南投縣,草屯鎮,30514,100252,50743,49509
2009/10/1,南投縣,竹山鎮,18732,58855,30414,28441
2009/10/1,南投縣,集集鎮,4267,12050,6351,5699
2009/10/1,南投縣,名間鄉,11971,41564,21860,19704
2009/10/1,南投縣,鹿谷鄉,6611,19356,10290,9066
2009/10/1,南投縣,中寮鄉,5603,16411,8923,7488
2009/10/1,南投縣,魚池鄉,5767,17344,9173,8171
2009/10/1,南投縣,國姓鄉,7188,20993,11503,9490
2009/10/1,南投縣,水里鄉,7215,20461,10750,9711
2009/10/1,南投縣,信義鄉,5137,17313,9373,7940
2009/10/1,南投縣,仁愛鄉,4901,15601,8185,7416
2009/10/1,雲林縣,斗六市,34018,106619,53790,52829
2009/10/1,雲林縣,斗南鎮,15040,47508,24155,23353
2009/10/1,雲林縣,虎尾鎮,22055,70138,35746,34392
2009/10/1,雲林縣,西螺鎮,13860,48989,24933,24056
2009/10/1,雲林縣,土庫鎮,8625,30742,16103,14639
2009/10/1,雲林縣,北港鎮,15073,43596,22710,20886
2009/10/1,雲林縣,古坑鄉,10560,34641,18350,16291
2009/10/1,雲林縣,大埤鄉,6604,21488,11483,10005
2009/10/1,雲林縣,莿桐鄉,8908,30667,16073,14594
2009/10/1,雲林縣,林內鄉,5702,20183,10568,9615
2009/10/1,雲林縣,二崙鄉,8718,30055,16138,13917
2009/10/1,雲林縣,崙背鄉,8256,27777,14667,13110
2009/10/1,雲林縣,麥寮鄉,12008,35059,18462,16597
2009/10/1,雲林縣,東勢鄉,5710,17195,9356,7839
2009/10/1,雲林縣,褒忠鄉,4266,14606,7785,6821
2009/10/1,雲林縣,臺西鄉,8763,26609,14345,12264
2009/10/1,雲林縣,元長鄉,9327,29372,15999,13373
2009/10/1,雲林縣,四湖鄉,9038,27263,14890,12373
2009/10/1,雲林縣,口湖鄉,9613,30811,16441,14370
2009/10/1,雲林縣,水林鄉,10381,29513,16151,13362
2009/10/1,嘉義縣,太保市,10940,36111,18691,17420
2009/10/1,嘉義縣,朴子市,14238,44286,22648,21638
2009/10/1,嘉義縣,布袋鎮,10102,30765,15832,14933
2009/10/1,嘉義縣,大林鎮,11102,33971,17488,16483
2009/10/1,嘉義縣,民雄鄉,22353,72708,37437,35271
2009/10/1,嘉義縣,溪口鄉,5372,16554,8828,7726
2009/10/1,嘉義縣,新港鄉,10260,35039,18505,16534
2009/10/1,嘉義縣,六腳鄉,9103,26850,14247,12603
2009/10/1,嘉義縣,東石鄉,9324,28192,14996,13196
2009/10/1,嘉義縣,義竹鄉,7452,21703,11248,10455
2009/10/1,嘉義縣,鹿草鄉,5681,17381,9326,8055
2009/10/1,嘉義縣,水上鄉,17233,52563,27271,25292
2009/10/1,嘉義縣,中埔鄉,15018,47774,25006,22768
2009/10/1,嘉義縣,竹崎鄉,11207,38917,20762,18155
2009/10/1,嘉義縣,梅山鄉,6569,22042,11691,10351
2009/10/1,嘉義縣,番路鄉,3863,11671,6349,5322
2009/10/1,嘉義縣,大埔鄉,1970,4553,2417,2136
2009/10/1,嘉義縣,阿里山鄉,2023,6187,3322,2865
2009/10/1,臺南市,新營區,26777,78296,39181,39115
2009/10/1,臺南市,永康區,73240,214216,106764,107452
2009/10/1,臺南市,鹽水區,9845,27365,14258,13107
2009/10/1,臺南市,白河區,10867,31791,16727,15064
2009/10/1,臺南市,麻豆區,14818,46164,23603,22561
2009/10/1,臺南市,佳里區,19027,59472,29664,29808
2009/10/1,臺南市,新化區,13510,44369,22774,21595
2009/10/1,臺南市,善化區,14242,43336,21971,21365
2009/10/1,臺南市,學甲區,9417,28166,14418,13748
2009/10/1,臺南市,柳營區,7724,22995,12029,10966
2009/10/1,臺南市,後壁區,8667,26172,13652,12520
2009/10/1,臺南市,東山區,8150,23393,12478,10915
2009/10/1,臺南市,下營區,9035,26438,13718,12720
2009/10/1,臺南市,六甲區,7566,24029,12503,11526
2009/10/1,臺南市,官田區,7586,22442,11527,10915
2009/10/1,臺南市,大內區,4065,11114,5909,5205
2009/10/1,臺南市,西港區,7724,25335,12948,12387
2009/10/1,臺南市,七股區,7916,25027,13108,11919
2009/10/1,臺南市,將軍區,7390,21833,11141,10692
2009/10/1,臺南市,北門區,4332,12546,6405,6141
2009/10/1,臺南市,新市區,10662,35002,17624,17378
2009/10/1,臺南市,安定區,9119,30127,15614,14513
2009/10/1,臺南市,山上區,2720,8032,4228,3804
2009/10/1,臺南市,玉井區,5073,15611,8104,7507
2009/10/1,臺南市,楠西區,3600,10814,5747,5067
2009/10/1,臺南市,南化區,2816,9009,4933,4076
2009/10/1,臺南市,左鎮區,1968,5630,3117,2513
2009/10/1,臺南市,仁德區,24241,68846,35489,33357
2009/10/1,臺南市,歸仁區,20177,65927,33630,32297
2009/10/1,臺南市,關廟區,10599,36373,18895,17478
2009/10/1,臺南市,龍崎區,1596,4450,2407,2043
2009/10/1,高雄市,鳳山區,124500,339703,169792,169911
2009/10/1,高雄市,岡山區,32737,97048,48896,48152
2009/10/1,高雄市,旗山區,13678,40402,21118,19284
2009/10/1,高雄市,美濃區,13897,43461,22695,20766
2009/10/1,高雄市,林園區,23764,70733,36421,34312
2009/10/1,高雄市,大寮區,37628,109251,56915,52336
2009/10/1,高雄市,大樹區,12972,44270,22969,21301
2009/10/1,高雄市,仁武區,24678,69958,36170,33788
2009/10/1,高雄市,大社區,11514,32828,16935,15893
2009/10/1,高雄市,鳥松區,16194,42032,21379,20653
2009/10/1,高雄市,橋頭區,12359,36260,18647,17613
2009/10/1,高雄市,燕巢區,9891,31067,16621,14446
2009/10/1,高雄市,田寮區,3558,8326,4616,3710
2009/10/1,高雄市,阿蓮區,9053,30625,15463,15162
2009/10/1,高雄市,路竹區,15837,54128,27684,26444
2009/10/1,高雄市,湖內區,9361,28696,14834,13862
2009/10/1,高雄市,茄萣區,10058,31589,16528,15061
2009/10/1,高雄市,永安區,5751,14186,7258,6928
2009/10/1,高雄市,彌陀區,6519,20628,10771,9857
2009/10/1,高雄市,梓官區,11839,36900,19246,17654
2009/10/1,高雄市,六龜區,5791,15380,8340,7040
2009/10/1,高雄市,甲仙區,2547,7600,4093,3507
2009/10/1,高雄市,杉林區,4026,11106,6063,5043
2009/10/1,高雄市,內門區,5007,16119,8798,7321
2009/10/1,高雄市,茂林區,545,1839,938,901
2009/10/1,高雄市,桃源區,1245,4746,2541,2205
2009/10/1,高雄市,那瑪夏區,869,3447,1799,1648
2009/10/1,屏東縣,屏東市,72073,213818,106841,106977
2009/10/1,屏東縣,潮州鎮,17922,56076,28289,27787
2009/10/1,屏東縣,東港鎮,15275,50246,25562,24684
2009/10/1,屏東縣,恆春鎮,10623,31148,16065,15083
2009/10/1,屏東縣,萬丹鄉,14098,54311,28129,26182
2009/10/1,屏東縣,長治鄉,9642,30940,16216,14724
2009/10/1,屏東縣,麟洛鄉,3537,11593,6011,5582
2009/10/1,屏東縣,九如鄉,6504,23040,12005,11035
2009/10/1,屏東縣,里港鄉,7810,26244,13454,12790
2009/10/1,屏東縣,鹽埔鄉,7626,27430,14276,13154
2009/10/1,屏東縣,高樹鄉,9556,27204,14538,12666
2009/10/1,屏東縣,萬巒鄉,6376,22317,11768,10549
2009/10/1,屏東縣,內埔鄉,17593,58754,30630,28124
2009/10/1,屏東縣,竹田鄉,5445,18473,9832,8641
2009/10/1,屏東縣,新埤鄉,3335,10926,5772,5154
2009/10/1,屏東縣,枋寮鄉,8370,27024,14301,12723
2009/10/1,屏東縣,新園鄉,11207,38992,20138,18854
2009/10/1,屏東縣,崁頂鄉,4106,17272,8858,8414
2009/10/1,屏東縣,林邊鄉,6899,21113,10923,10190
2009/10/1,屏東縣,南州鄉,3655,11923,6136,5787
2009/10/1,屏東縣,佳冬鄉,6995,21708,11341,10367
2009/10/1,屏東縣,琉球鄉,3906,12556,6958,5598
2009/10/1,屏東縣,車城鄉,3489,9948,5376,4572
2009/10/1,屏東縣,滿州鄉,3051,8634,4730,3904
2009/10/1,屏東縣,枋山鄉,2085,6189,3304,2885
2009/10/1,屏東縣,三地門鄉,2128,7545,3863,3682
2009/10/1,屏東縣,霧臺鄉,945,2921,1547,1374
2009/10/1,屏東縣,瑪家鄉,1863,6499,3399,3100
2009/10/1,屏東縣,泰武鄉,1230,5086,2692,2394
2009/10/1,屏東縣,來義鄉,2133,7856,4043,3813
2009/10/1,屏東縣,春日鄉,1312,4869,2541,2328
2009/10/1,屏東縣,獅子鄉,1451,4960,2611,2349
2009/10/1,屏東縣,牡丹鄉,1848,4960,2567,2393
2009/10/1,臺東縣,臺東市,37693,109584,55728,53856
2009/10/1,臺東縣,成功鎮,5403,16010,8546,7464
2009/10/1,臺東縣,關山鎮,3209,9872,5179,4693
2009/10/1,臺東縣,卑南鄉,6530,18390,9972,8418
2009/10/1,臺東縣,大武鄉,2535,7169,3721,3448
2009/10/1,臺東縣,太麻里鄉,4518,12064,6475,5589
2009/10/1,臺東縣,東河鄉,3532,9497,5262,4235
2009/10/1,臺東縣,長濱鄉,2917,8477,4824,3653
2009/10/1,臺東縣,鹿野鄉,3113,8678,4699,3979
2009/10/1,臺東縣,池上鄉,3220,9310,4965,4345
2009/10/1,臺東縣,綠島鄉,982,3281,1767,1514
2009/10/1,臺東縣,延平鄉,1077,3633,2019,1614
2009/10/1,臺東縣,海端鄉,1091,4526,2466,2060
2009/10/1,臺東縣,達仁鄉,1482,4069,2235,1834
2009/10/1,臺東縣,金峰鄉,1017,3460,1814,1646
2009/10/1,臺東縣,蘭嶼鄉,1343,4270,2225,2045
2009/10/1,花蓮縣,花蓮市,40181,109907,54027,55880
2009/10/1,花蓮縣,鳳林鎮,4445,12180,6475,5705
2009/10/1,花蓮縣,玉里鎮,8923,27360,14872,12488
2009/10/1,花蓮縣,新城鄉,7235,20290,10572,9718
2009/10/1,花蓮縣,吉安鄉,28481,79477,40852,38625
2009/10/1,花蓮縣,壽豐鄉,6765,18918,10242,8676
2009/10/1,花蓮縣,光復鄉,4986,14271,7623,6648
2009/10/1,花蓮縣,豐濱鄉,1814,5101,2824,2277
2009/10/1,花蓮縣,瑞穗鄉,4610,13058,7060,5998
2009/10/1,花蓮縣,富里鄉,3973,11845,6522,5323
2009/10/1,花蓮縣,秀林鄉,4581,15087,7866,7221
2009/10/1,花蓮縣,萬榮鄉,2135,6982,3727,3255
2009/10/1,花蓮縣,卓溪鄉,1661,6434,3602,2832
2009/10/1,澎湖縣,馬公市,19319,56261,28537,27724
2009/10/1,澎湖縣,湖西鄉,4610,13417,7023,6394
2009/10/1,澎湖縣,白沙鄉,3092,9369,4907,4462
2009/10/1,澎湖縣,西嶼鄉,2798,8459,4389,4070
2009/10/1,澎湖縣,望安鄉,1850,4700,2548,2152
2009/10/1,澎湖縣,七美鄉,1226,3545,1864,1681
2009/10/1,基隆市,中正區,22046,56425,28990,27435
2009/10/1,基隆市,七堵區,19833,55428,28129,27299
2009/10/1,基隆市,暖暖區,14173,38125,19429,18696
2009/10/1,基隆市,仁愛區,19660,50488,24960,25528
2009/10/1,基隆市,中山區,18882,51493,26354,25139
2009/10/1,基隆市,安樂區,31659,85016,42370,42646
2009/10/1,基隆市,信義區,19874,51567,25889,25678
2009/10/1,新竹市,東區,66195,194398,96094,98304
2009/10/1,新竹市,北區,49355,144074,71375,72699
2009/10/1,新竹市,香山區,22386,71927,36760,35167
2009/10/1,臺中市,中區,8453,23335,11511,11824
2009/10/1,臺中市,東區,25497,73883,37429,36454
2009/10/1,臺中市,西區,42626,117459,56564,60895
2009/10/1,臺中市,南區,41039,112394,54686,57708
2009/10/1,臺中市,北區,54693,147468,71593,75875
2009/10/1,臺中市,西屯區,70763,203292,98964,104328
2009/10/1,臺中市,南屯區,51324,150359,72624,77735
2009/10/1,臺中市,北屯區,81286,243756,118717,125039
2009/10/1,嘉義市,東區,44542,127988,62535,65453
2009/10/1,嘉義市,西區,49856,145873,72447,73426
2009/10/1,臺南市,東區,70203,194452,94219,100233
2009/10/1,臺南市,南區,42699,126644,63648,62996
2009/10/1,臺南市,北區,47231,131153,64943,66210
2009/10/1,臺南市,安南區,53304,176778,90087,86691
2009/10/1,臺南市,安平區,22538,61562,29568,31994
2009/10/1,臺南市,中西區,29864,79994,39348,40646
2009/10/1,臺北市,松山區,77096,208144,98747,109397
2009/10/1,臺北市,信義區,85395,225421,109059,116362
2009/10/1,臺北市,大安區,116038,311496,146931,164565
2009/10/1,臺北市,中山區,90113,218237,103112,115125
2009/10/1,臺北市,中正區,61383,158785,76778,82007
2009/10/1,臺北市,大同區,46330,123510,61024,62486
2009/10/1,臺北市,萬華區,73186,188648,94592,94056
2009/10/1,臺北市,文山區,95801,261005,126710,134295
2009/10/1,臺北市,南港區,40942,113308,56061,57247
2009/10/1,臺北市,內湖區,94724,267577,129247,138330
2009/10/1,臺北市,士林區,99360,283837,138326,145511
2009/10/1,臺北市,北投區,88371,248218,120799,127419
2009/10/1,高雄市,鹽埕區,11116,27698,13956,13742
2009/10/1,高雄市,鼓山區,50510,128853,63409,65444
2009/10/1,高雄市,左營區,72384,189765,93750,96015
2009/10/1,高雄市,楠梓區,60787,171541,85324,86217
2009/10/1,高雄市,三民區,129937,355203,174312,180891
2009/10/1,高雄市,新興區,22849,55893,27309,28584
2009/10/1,高雄市,前金區,12536,29330,14358,14972
2009/10/1,高雄市,苓雅區,71124,185205,90406,94799
2009/10/1,高雄市,前鎮區,75474,200039,99822,100217
2009/10/1,高雄市,旗津區,10875,29943,15581,14362
2009/10/1,高雄市,小港區,61858,153672,77484,76188
2009/10/1,金門縣,金城鎮,10635,31244,16210,15034
2009/10/1,金門縣,金湖鎮,6983,20234,10532,9702
2009/10/1,金門縣,金沙鎮,5209,14712,7566,7146
2009/10/1,金門縣,金寧鄉,5974,17514,9182,8332
2009/10/1,金門縣,烈嶼鄉,2515,8407,4307,4100
2009/10/1,金門縣,烏坵鄉,136,491,248,243
2009/10/1,連江縣,南竿鄉,1168,5934,3425,2509
2009/10/1,連江縣,北竿鄉,377,1757,1016,741
2009/10/1,連江縣,莒光鄉,237,1157,680,477
2009/10/1,連江縣,東引鄉,262,1042,611,431
2009/11/1,總計,臺灣地區,7761194,23006135,11580664,11425471
2009/11/1,總計,臺灣省,6212071,18870817,9564107,9306710
2009/11/1,總計,新北市,1372952,3869879,1926305,1943574
2009/11/1,總計,宜蘭縣,151760,461499,235751,225748
2009/11/1,總計,桃園市,652789,1976897,998330,978567
2009/11/1,總計,新竹縣,157456,510058,262977,247081
2009/11/1,總計,苗栗縣,169841,561549,292274,269275
2009/11/1,總計,臺中市,458877,1561342,792268,769074
2009/11/1,總計,彰化縣,358737,1312373,674707,637666
2009/11/1,總計,南投縣,169035,530891,273672,257219
2009/11/1,總計,雲林縣,226774,722777,377978,344799
2009/11/1,總計,嘉義縣,173987,547457,286056,261401
2009/11/1,總計,臺南市,365001,1104316,564432,539884
2009/11/1,總計,高雄市,426482,1242766,637533,605233
2009/11/1,總計,屏東縣,274453,882796,454703,428093
2009/11/1,總計,臺東縣,79693,232382,121910,110472
2009/11/1,總計,花蓮縣,119842,340949,176203,164746
2009/11/1,總計,澎湖縣,32991,95942,49371,46571
2009/11/1,總計,基隆市,146107,388496,196047,192449
2009/11/1,總計,新竹市,138183,410950,204402,206548
2009/11/1,總計,臺中市,376519,1072738,522359,550379
2009/11/1,總計,嘉義市,94471,273930,134992,138938
2009/11/1,總計,臺南市,266121,770830,381837,388993
2009/11/1,總計,臺北市,969138,2607879,1260899,1346980
2009/11/1,總計,高雄市,579985,1527439,755658,771781
2009/11/1,總計,福建省,33592,103006,53958,49048
2009/11/1,總計,金門縣,31543,93107,48221,44886
2009/11/1,總計,連江縣,2049,9899,5737,4162
2009/11/1,新北市,板橋區,190399,552519,274080,278439
2009/11/1,新北市,三重區,137003,388066,193915,194151
2009/11/1,新北市,永和區,89298,236764,113825,122939
2009/11/1,新北市,中和區,153133,414486,205303,209183
2009/11/1,新北市,新莊區,134023,400649,198218,202431
2009/11/1,新北市,新店區,114149,294242,144614,149628
2009/11/1,新北市,土城區,80872,238769,119619,119150
2009/11/1,新北市,蘆洲區,64210,196880,97661,99219
2009/11/1,新北市,汐止區,77112,186583,92850,93733
2009/11/1,新北市,樹林區,57101,172055,86894,85161
2009/11/1,新北市,鶯歌區,26845,86605,43904,42701
2009/11/1,新北市,三峽區,33730,100394,51459,48935
2009/11/1,新北市,淡水區,54732,139718,68202,71516
2009/11/1,新北市,瑞芳區,15677,42724,21894,20830
2009/11/1,新北市,五股區,26719,79043,40242,38801
2009/11/1,新北市,泰山區,25824,76404,38500,37904
2009/11/1,新北市,林口區,27890,77892,38676,39216
2009/11/1,新北市,深坑區,8564,23112,11682,11430
2009/11/1,新北市,石碇區,3258,7966,4457,3509
2009/11/1,新北市,坪林區,2398,6566,3678,2888
2009/11/1,新北市,三芝區,8736,23382,12107,11275
2009/11/1,新北市,石門區,3883,12344,6518,5826
2009/11/1,新北市,八里區,11734,33851,17288,16563
2009/11/1,新北市,平溪區,2367,5464,3036,2428
2009/11/1,新北市,雙溪區,3812,9816,5295,4521
2009/11/1,新北市,貢寮區,4351,13900,7189,6711
2009/11/1,新北市,金山區,6567,22380,11280,11100
2009/11/1,新北市,萬里區,6872,21570,11007,10563
2009/11/1,新北市,烏來區,1693,5735,2912,2823
2009/11/1,宜蘭縣,宜蘭市,32805,95895,47326,48569
2009/11/1,宜蘭縣,羅東鎮,24614,73145,35198,37947
2009/11/1,宜蘭縣,蘇澳鎮,13437,43283,22259,21024
2009/11/1,宜蘭縣,頭城鎮,9570,31144,16135,15009
2009/11/1,宜蘭縣,礁溪鄉,12133,35848,18819,17029
2009/11/1,宜蘭縣,壯圍鄉,7990,25116,13260,11856
2009/11/1,宜蘭縣,員山鄉,10617,32362,17380,14982
2009/11/1,宜蘭縣,冬山鄉,16925,52315,27042,25273
2009/11/1,宜蘭縣,五結鄉,12724,38742,20180,18562
2009/11/1,宜蘭縣,三星鄉,7368,21743,11722,10021
2009/11/1,宜蘭縣,大同鄉,1807,5971,3272,2699
2009/11/1,宜蘭縣,南澳鄉,1770,5935,3158,2777
2009/11/1,桃園市,桃園區,139549,400711,196554,204157
2009/11/1,桃園市,中壢區,123044,364825,182633,182192
2009/11/1,桃園市,平鎮區,64918,206512,104127,102385
2009/11/1,桃園市,八德區,56348,174870,89241,85629
2009/11/1,桃園市,大溪區,28729,91853,47278,44575
2009/11/1,桃園市,楊梅區,46830,147858,75293,72565
2009/11/1,桃園市,蘆竹區,46261,138436,69513,68923
2009/11/1,桃園市,大園區,25432,81218,42250,38968
2009/11/1,桃園市,龜山區,48328,135558,68847,66711
2009/11/1,桃園市,龍潭區,36141,114205,58136,56069
2009/11/1,桃園市,新屋區,14812,49584,26447,23137
2009/11/1,桃園市,觀音區,18752,60725,32096,28629
2009/11/1,桃園市,復興區,3645,10542,5915,4627
2009/11/1,新竹縣,竹北市,44945,137365,69118,68247
2009/11/1,新竹縣,關西鎮,9178,32409,17263,15146
2009/11/1,新竹縣,新埔鎮,10268,36037,19064,16973
2009/11/1,新竹縣,竹東鎮,30110,97071,49005,48066
2009/11/1,新竹縣,湖口鄉,23045,75445,38610,36835
2009/11/1,新竹縣,橫山鄉,4367,14781,7980,6801
2009/11/1,新竹縣,新豐鄉,15286,52700,27278,25422
2009/11/1,新竹縣,芎林鄉,6238,20923,11027,9896
2009/11/1,新竹縣,寶山鄉,4578,13937,7509,6428
2009/11/1,新竹縣,北埔鄉,3074,10280,5563,4717
2009/11/1,新竹縣,峨眉鄉,2015,6134,3402,2732
2009/11/1,新竹縣,尖石鄉,2649,8325,4574,3751
2009/11/1,新竹縣,五峰鄉,1703,4651,2584,2067
2009/11/1,苗栗縣,苗栗市,28769,90864,45879,44985
2009/11/1,苗栗縣,苑裡鎮,13736,49009,25637,23372
2009/11/1,苗栗縣,通霄鎮,11225,38579,20559,18020
2009/11/1,苗栗縣,竹南鎮,23372,77246,39348,37898
2009/11/1,苗栗縣,頭份市,28788,96186,49066,47120
2009/11/1,苗栗縣,後龍鎮,11548,39824,21090,18734
2009/11/1,苗栗縣,卓蘭鎮,5896,18475,9777,8698
2009/11/1,苗栗縣,大湖鄉,5287,16204,8709,7495
2009/11/1,苗栗縣,公館鄉,10003,34803,18308,16495
2009/11/1,苗栗縣,銅鑼鄉,5950,19626,10400,9226
2009/11/1,苗栗縣,南庄鄉,3953,11328,6260,5068
2009/11/1,苗栗縣,頭屋鄉,3495,11709,6192,5517
2009/11/1,苗栗縣,三義鄉,5229,17668,9323,8345
2009/11/1,苗栗縣,西湖鄉,2657,7929,4390,3539
2009/11/1,苗栗縣,造橋鄉,3943,13740,7281,6459
2009/11/1,苗栗縣,三灣鄉,2382,7410,4021,3389
2009/11/1,苗栗縣,獅潭鄉,1680,5075,2834,2241
2009/11/1,苗栗縣,泰安鄉,1928,5874,3200,2674
2009/11/1,臺中市,豐原區,48777,165217,82154,83063
2009/11/1,臺中市,大里區,60391,195847,97359,98488
2009/11/1,臺中市,太平區,53754,172327,86656,85671
2009/11/1,臺中市,東勢區,16843,53723,27903,25820
2009/11/1,臺中市,大甲區,21347,78678,39969,38709
2009/11/1,臺中市,清水區,24566,85757,44288,41469
2009/11/1,臺中市,沙鹿區,22933,80474,40978,39496
2009/11/1,臺中市,梧棲區,15756,54942,27935,27007
2009/11/1,臺中市,后里區,14635,54431,28063,26368
2009/11/1,臺中市,神岡區,17400,64037,33086,30951
2009/11/1,臺中市,潭子區,31781,99521,49742,49779
2009/11/1,臺中市,大雅區,25825,89355,45082,44273
2009/11/1,臺中市,新社區,7285,25785,13571,12214
2009/11/1,臺中市,石岡區,4814,16146,8427,7719
2009/11/1,臺中市,外埔區,8701,32009,16487,15522
2009/11/1,臺中市,大安區,5200,20437,10789,9648
2009/11/1,臺中市,烏日區,20037,68364,34696,33668
2009/11/1,臺中市,大肚區,15624,55924,28694,27230
2009/11/1,臺中市,龍井區,20218,73736,37604,36132
2009/11/1,臺中市,霧峰區,18528,63885,32911,30974
2009/11/1,臺中市,和平區,4462,10747,5874,4873
2009/11/1,彰化縣,彰化市,70815,237147,118364,118783
2009/11/1,彰化縣,鹿港鎮,21905,85309,43781,41528
2009/11/1,彰化縣,和美鎮,23688,89584,46035,43549
2009/11/1,彰化縣,北斗鎮,9772,33625,17066,16559
2009/11/1,彰化縣,員林市,36235,125824,63382,62442
2009/11/1,彰化縣,溪湖鎮,14905,56247,28781,27466
2009/11/1,彰化縣,田中鎮,12442,44504,23217,21287
2009/11/1,彰化縣,二林鎮,14189,54510,28129,26381
2009/11/1,彰化縣,線西鄉,4054,17081,8780,8301
2009/11/1,彰化縣,伸港鄉,8838,35963,18536,17427
2009/11/1,彰化縣,福興鄉,11872,49194,25769,23425
2009/11/1,彰化縣,秀水鄉,9542,39000,20242,18758
2009/11/1,彰化縣,花壇鄉,12770,46244,23876,22368
2009/11/1,彰化縣,芬園鄉,6835,24993,13259,11734
2009/11/1,彰化縣,大村鄉,10077,36651,19117,17534
2009/11/1,彰化縣,埔鹽鄉,8686,34545,18140,16405
2009/11/1,彰化縣,埔心鄉,9793,35403,18374,17029
2009/11/1,彰化縣,永靖鄉,10302,39597,20546,19051
2009/11/1,彰化縣,社頭鄉,12205,45036,23215,21821
2009/11/1,彰化縣,二水鄉,5296,16755,8832,7923
2009/11/1,彰化縣,田尾鄉,7590,28861,15060,13801
2009/11/1,彰化縣,埤頭鄉,8470,32008,16770,15238
2009/11/1,彰化縣,芳苑鄉,9930,36592,19438,17154
2009/11/1,彰化縣,大城鄉,5356,19146,10405,8741
2009/11/1,彰化縣,竹塘鄉,4554,16686,8784,7902
2009/11/1,彰化縣,溪州鄉,8616,31868,16809,15059
2009/11/1,南投縣,南投市,32900,104686,52724,51962
2009/11/1,南投縣,埔里鎮,28042,85820,43348,42472
2009/11/1,南投縣,草屯鎮,30560,100291,50767,49524
2009/11/1,南投縣,竹山鎮,18778,58883,30425,28458
2009/11/1,南投縣,集集鎮,4271,12053,6343,5710
2009/11/1,南投縣,名間鄉,12002,41605,21856,19749
2009/11/1,南投縣,鹿谷鄉,6622,19362,10291,9071
2009/11/1,南投縣,中寮鄉,5609,16431,8931,7500
2009/11/1,南投縣,魚池鄉,5771,17373,9188,8185
2009/11/1,南投縣,國姓鄉,7207,21005,11496,9509
2009/11/1,南投縣,水里鄉,7219,20443,10735,9708
2009/11/1,南投縣,信義鄉,5145,17320,9380,7940
2009/11/1,南投縣,仁愛鄉,4909,15619,8188,7431
2009/11/1,雲林縣,斗六市,34099,106669,53763,52906
2009/11/1,雲林縣,斗南鎮,15049,47461,24146,23315
2009/11/1,雲林縣,虎尾鎮,22087,70178,35753,34425
2009/11/1,雲林縣,西螺鎮,13874,48992,24924,24068
2009/11/1,雲林縣,土庫鎮,8634,30742,16096,14646
2009/11/1,雲林縣,北港鎮,15098,43588,22703,20885
2009/11/1,雲林縣,古坑鄉,10569,34609,18318,16291
2009/11/1,雲林縣,大埤鄉,6612,21528,11498,10030
2009/11/1,雲林縣,莿桐鄉,8913,30697,16093,14604
2009/11/1,雲林縣,林內鄉,5712,20126,10524,9602
2009/11/1,雲林縣,二崙鄉,8724,30056,16133,13923
2009/11/1,雲林縣,崙背鄉,8251,27745,14651,13094
2009/11/1,雲林縣,麥寮鄉,12022,35074,18470,16604
2009/11/1,雲林縣,東勢鄉,5711,17182,9345,7837
2009/11/1,雲林縣,褒忠鄉,4269,14600,7777,6823
2009/11/1,雲林縣,臺西鄉,8771,26605,14324,12281
2009/11/1,雲林縣,元長鄉,9327,29348,15995,13353
2009/11/1,雲林縣,四湖鄉,9044,27257,14881,12376
2009/11/1,雲林縣,口湖鄉,9630,30818,16447,14371
2009/11/1,雲林縣,水林鄉,10378,29502,16137,13365
2009/11/1,嘉義縣,太保市,10950,36136,18690,17446
2009/11/1,嘉義縣,朴子市,14259,44295,22644,21651
2009/11/1,嘉義縣,布袋鎮,10113,30793,15843,14950
2009/11/1,嘉義縣,大林鎮,11107,33983,17491,16492
2009/11/1,嘉義縣,民雄鄉,22387,72734,37426,35308
2009/11/1,嘉義縣,溪口鄉,5381,16567,8836,7731
2009/11/1,嘉義縣,新港鄉,10287,35039,18504,16535
2009/11/1,嘉義縣,六腳鄉,9110,26856,14242,12614
2009/11/1,嘉義縣,東石鄉,9339,28214,15011,13203
2009/11/1,嘉義縣,義竹鄉,7448,21691,11233,10458
2009/11/1,嘉義縣,鹿草鄉,5689,17395,9329,8066
2009/11/1,嘉義縣,水上鄉,17235,52563,27238,25325
2009/11/1,嘉義縣,中埔鄉,15031,47803,25022,22781
2009/11/1,嘉義縣,竹崎鄉,11214,38928,20758,18170
2009/11/1,嘉義縣,梅山鄉,6570,22020,11680,10340
2009/11/1,嘉義縣,番路鄉,3870,11687,6361,5326
2009/11/1,嘉義縣,大埔鄉,1965,4553,2419,2134
2009/11/1,嘉義縣,阿里山鄉,2032,6200,3329,2871
2009/11/1,臺南市,新營區,26812,78261,39175,39086
2009/11/1,臺南市,永康區,73368,214429,106811,107618
2009/11/1,臺南市,鹽水區,9854,27324,14247,13077
2009/11/1,臺南市,白河區,10867,31754,16686,15068
2009/11/1,臺南市,麻豆區,14856,46121,23583,22538
2009/11/1,臺南市,佳里區,19048,59458,29643,29815
2009/11/1,臺南市,新化區,13550,44383,22770,21613
2009/11/1,臺南市,善化區,14272,43369,21981,21388
2009/11/1,臺南市,學甲區,9443,28179,14426,13753
2009/11/1,臺南市,柳營區,7738,23006,12031,10975
2009/11/1,臺南市,後壁區,8689,26160,13637,12523
2009/11/1,臺南市,東山區,8159,23413,12485,10928
2009/11/1,臺南市,下營區,9040,26400,13695,12705
2009/11/1,臺南市,六甲區,7575,24008,12492,11516
2009/11/1,臺南市,官田區,7580,22446,11516,10930
2009/11/1,臺南市,大內區,4068,11083,5891,5192
2009/11/1,臺南市,西港區,7740,25364,12961,12403
2009/11/1,臺南市,七股區,7919,24986,13092,11894
2009/11/1,臺南市,將軍區,7405,21833,11125,10708
2009/11/1,臺南市,北門區,4343,12567,6419,6148
2009/11/1,臺南市,新市區,10672,34977,17614,17363
2009/11/1,臺南市,安定區,9134,30120,15623,14497
2009/11/1,臺南市,山上區,2724,8035,4225,3810
2009/11/1,臺南市,玉井區,5075,15587,8095,7492
2009/11/1,臺南市,楠西區,3595,10800,5737,5063
2009/11/1,臺南市,南化區,2820,9009,4932,4077
2009/11/1,臺南市,左鎮區,1974,5631,3120,2511
2009/11/1,臺南市,仁德區,24260,68872,35498,33374
2009/11/1,臺南市,歸仁區,20213,65928,33626,32302
2009/11/1,臺南市,關廟區,10612,36372,18892,17480
2009/11/1,臺南市,龍崎區,1596,4441,2404,2037
2009/11/1,高雄市,鳳山區,124669,339905,169860,170045
2009/11/1,高雄市,岡山區,32779,97053,48875,48178
2009/11/1,高雄市,旗山區,13689,40375,21094,19281
2009/11/1,高雄市,美濃區,13911,43444,22679,20765
2009/11/1,高雄市,林園區,23797,70775,36433,34342
2009/11/1,高雄市,大寮區,37698,109240,56873,52367
2009/11/1,高雄市,大樹區,12983,44245,22935,21310
2009/11/1,高雄市,仁武區,24732,70116,36243,33873
2009/11/1,高雄市,大社區,11537,32823,16917,15906
2009/11/1,高雄市,鳥松區,16226,42066,21394,20672
2009/11/1,高雄市,橋頭區,12374,36264,18644,17620
2009/11/1,高雄市,燕巢區,9900,31066,16619,14447
2009/11/1,高雄市,田寮區,3562,8324,4614,3710
2009/11/1,高雄市,阿蓮區,9078,30632,15460,15172
2009/11/1,高雄市,路竹區,15862,54122,27685,26437
2009/11/1,高雄市,湖內區,9381,28721,14837,13884
2009/11/1,高雄市,茄萣區,10087,31609,16531,15078
2009/11/1,高雄市,永安區,5764,14225,7270,6955
2009/11/1,高雄市,彌陀區,6528,20626,10759,9867
2009/11/1,高雄市,梓官區,11863,36897,19245,17652
2009/11/1,高雄市,六龜區,5805,15380,8334,7046
2009/11/1,高雄市,甲仙區,2557,7612,4103,3509
2009/11/1,高雄市,杉林區,4026,11097,6059,5038
2009/11/1,高雄市,內門區,5010,16120,8793,7327
2009/11/1,高雄市,茂林區,550,1843,943,900
2009/11/1,高雄市,桃源區,1245,4734,2534,2200
2009/11/1,高雄市,那瑪夏區,869,3452,1800,1652
2009/11/1,屏東縣,屏東市,72111,213785,106840,106945
2009/11/1,屏東縣,潮州鎮,17929,56054,28265,27789
2009/11/1,屏東縣,東港鎮,15340,50259,25542,24717
2009/11/1,屏東縣,恆春鎮,10654,31183,16073,15110
2009/11/1,屏東縣,萬丹鄉,14108,54309,28122,26187
2009/11/1,屏東縣,長治鄉,9647,30965,16224,14741
2009/11/1,屏東縣,麟洛鄉,3541,11617,6016,5601
2009/11/1,屏東縣,九如鄉,6508,23035,12005,11030
2009/11/1,屏東縣,里港鄉,7813,26244,13444,12800
2009/11/1,屏東縣,鹽埔鄉,7628,27442,14278,13164
2009/11/1,屏東縣,高樹鄉,9563,27207,14531,12676
2009/11/1,屏東縣,萬巒鄉,6389,22326,11758,10568
2009/11/1,屏東縣,內埔鄉,17589,58761,30608,28153
2009/11/1,屏東縣,竹田鄉,5458,18483,9837,8646
2009/11/1,屏東縣,新埤鄉,3340,10938,5780,5158
2009/11/1,屏東縣,枋寮鄉,8381,27009,14282,12727
2009/11/1,屏東縣,新園鄉,11257,38987,20141,18846
2009/11/1,屏東縣,崁頂鄉,4110,17284,8876,8408
2009/11/1,屏東縣,林邊鄉,6928,21126,10923,10203
2009/11/1,屏東縣,南州鄉,3656,11921,6135,5786
2009/11/1,屏東縣,佳冬鄉,7038,21713,11346,10367
2009/11/1,屏東縣,琉球鄉,3917,12593,6979,5614
2009/11/1,屏東縣,車城鄉,3495,9961,5383,4578
2009/11/1,屏東縣,滿州鄉,3047,8621,4722,3899
2009/11/1,屏東縣,枋山鄉,2082,6194,3306,2888
2009/11/1,屏東縣,三地門鄉,2135,7550,3867,3683
2009/11/1,屏東縣,霧臺鄉,948,2922,1545,1377
2009/11/1,屏東縣,瑪家鄉,1862,6520,3407,3113
2009/11/1,屏東縣,泰武鄉,1233,5099,2696,2403
2009/11/1,屏東縣,來義鄉,2133,7880,4053,3827
2009/11/1,屏東縣,春日鄉,1312,4871,2542,2329
2009/11/1,屏東縣,獅子鄉,1451,4954,2603,2351
2009/11/1,屏東縣,牡丹鄉,1850,4983,2574,2409
2009/11/1,臺東縣,臺東市,37678,109583,55706,53877
2009/11/1,臺東縣,成功鎮,5413,16010,8546,7464
2009/11/1,臺東縣,關山鎮,3211,9872,5183,4689
2009/11/1,臺東縣,卑南鄉,6538,18398,9977,8421
2009/11/1,臺東縣,大武鄉,2535,7173,3722,3451
2009/11/1,臺東縣,太麻里鄉,4518,12081,6480,5601
2009/11/1,臺東縣,東河鄉,3542,9517,5279,4238
2009/11/1,臺東縣,長濱鄉,2922,8467,4821,3646
2009/11/1,臺東縣,鹿野鄉,3110,8663,4687,3976
2009/11/1,臺東縣,池上鄉,3227,9325,4965,4360
2009/11/1,臺東縣,綠島鄉,982,3295,1773,1522
2009/11/1,臺東縣,延平鄉,1077,3632,2015,1617
2009/11/1,臺東縣,海端鄉,1090,4534,2471,2063
2009/11/1,臺東縣,達仁鄉,1486,4079,2235,1844
2009/11/1,臺東縣,金峰鄉,1018,3474,1816,1658
2009/11/1,臺東縣,蘭嶼鄉,1346,4279,2234,2045
2009/11/1,花蓮縣,花蓮市,40217,109974,54032,55942
2009/11/1,花蓮縣,鳳林鎮,4449,12178,6472,5706
2009/11/1,花蓮縣,玉里鎮,8921,27313,14843,12470
2009/11/1,花蓮縣,新城鄉,7234,20312,10592,9720
2009/11/1,花蓮縣,吉安鄉,28473,79463,40821,38642
2009/11/1,花蓮縣,壽豐鄉,6774,18893,10237,8656
2009/11/1,花蓮縣,光復鄉,4983,14270,7616,6654
2009/11/1,花蓮縣,豐濱鄉,1814,5102,2823,2279
2009/11/1,花蓮縣,瑞穗鄉,4619,13066,7060,6006
2009/11/1,花蓮縣,富里鄉,3972,11856,6518,5338
2009/11/1,花蓮縣,秀林鄉,4585,15101,7856,7245
2009/11/1,花蓮縣,萬榮鄉,2141,6994,3733,3261
2009/11/1,花蓮縣,卓溪鄉,1660,6427,3600,2827
2009/11/1,澎湖縣,馬公市,19394,56348,28576,27772
2009/11/1,澎湖縣,湖西鄉,4619,13455,7050,6405
2009/11/1,澎湖縣,白沙鄉,3092,9396,4926,4470
2009/11/1,澎湖縣,西嶼鄉,2797,8462,4390,4072
2009/11/1,澎湖縣,望安鄉,1860,4726,2558,2168
2009/11/1,澎湖縣,七美鄉,1229,3555,1871,1684
2009/11/1,基隆市,中正區,22024,56373,28953,27420
2009/11/1,基隆市,七堵區,19859,55504,28152,27352
2009/11/1,基隆市,暖暖區,14176,38110,19411,18699
2009/11/1,基隆市,仁愛區,19642,50433,24934,25499
2009/11/1,基隆市,中山區,18876,51486,26353,25133
2009/11/1,基隆市,安樂區,31654,85008,42351,42657
2009/11/1,基隆市,信義區,19876,51582,25893,25689
2009/11/1,新竹市,東區,66291,194604,96173,98431
2009/11/1,新竹市,北區,49457,144279,71441,72838
2009/11/1,新竹市,香山區,22435,72067,36788,35279
2009/11/1,臺中市,中區,8452,23308,11496,11812
2009/11/1,臺中市,東區,25549,73864,37411,36453
2009/11/1,臺中市,西區,42692,117406,56522,60884
2009/11/1,臺中市,南區,41174,112568,54742,57826
2009/11/1,臺中市,北區,54815,147558,71613,75945
2009/11/1,臺中市,西屯區,70901,203445,98999,104446
2009/11/1,臺中市,南屯區,51453,150643,72771,77872
2009/11/1,臺中市,北屯區,81483,243946,118805,125141
2009/11/1,嘉義市,東區,44552,127969,62512,65457
2009/11/1,嘉義市,西區,49919,145961,72480,73481
2009/11/1,臺南市,東區,70210,194388,94137,100251
2009/11/1,臺南市,南區,42713,126565,63617,62948
2009/11/1,臺南市,北區,47267,131121,64938,66183
2009/11/1,臺南市,安南區,53415,176994,90156,86838
2009/11/1,臺南市,安平區,22588,61723,29627,32096
2009/11/1,臺南市,中西區,29928,80039,39362,40677
2009/11/1,臺北市,松山區,77166,208162,98751,109411
2009/11/1,臺北市,信義區,85426,225410,108993,116417
2009/11/1,臺北市,大安區,116027,311527,146918,164609
2009/11/1,臺北市,中山區,90153,218158,103038,115120
2009/11/1,臺北市,中正區,61399,158710,76706,82004
2009/11/1,臺北市,大同區,46346,123454,60999,62455
2009/11/1,臺北市,萬華區,73238,188702,94562,94140
2009/11/1,臺北市,文山區,95835,260943,126631,134312
2009/11/1,臺北市,南港區,40952,113213,55977,57236
2009/11/1,臺北市,內湖區,94793,267632,129263,138369
2009/11/1,臺北市,士林區,99383,283846,138332,145514
2009/11/1,臺北市,北投區,88420,248122,120729,127393
2009/11/1,高雄市,鹽埕區,11123,27688,13954,13734
2009/11/1,高雄市,鼓山區,50659,129148,63541,65607
2009/11/1,高雄市,左營區,72374,189802,93719,96083
2009/11/1,高雄市,楠梓區,60843,171721,85381,86340
2009/11/1,高雄市,三民區,130075,355232,174276,180956
2009/11/1,高雄市,新興區,22847,55791,27266,28525
2009/11/1,高雄市,前金區,12519,29255,14317,14938
2009/11/1,高雄市,苓雅區,71145,185107,90321,94786
2009/11/1,高雄市,前鎮區,75509,199878,99743,100135
2009/11/1,高雄市,旗津區,10892,29964,15598,14366
2009/11/1,高雄市,小港區,61999,153853,77542,76311
2009/11/1,金門縣,金城鎮,10661,31384,16253,15131
2009/11/1,金門縣,金湖鎮,7005,20343,10573,9770
2009/11/1,金門縣,金沙鎮,5217,14762,7576,7186
2009/11/1,金門縣,金寧鄉,5995,17632,9227,8405
2009/11/1,金門縣,烈嶼鄉,2529,8487,4340,4147
2009/11/1,金門縣,烏坵鄉,136,499,252,247
2009/11/1,連江縣,南竿鄉,1170,5935,3425,2510
2009/11/1,連江縣,北竿鄉,377,1753,1013,740
2009/11/1,連江縣,莒光鄉,238,1163,685,478
2009/11/1,連江縣,東引鄉,264,1048,614,434
2009/12/1,總計,臺灣地區,7772091,23016050,11582510,11433540
2009/12/1,總計,臺灣省,6222003,18880708,9566411,9314297
2009/12/1,總計,新北市,1375268,3873653,1927574,1946079
2009/12/1,總計,宜蘭縣,151942,461625,235714,225911
2009/12/1,總計,桃園市,654106,1978782,999065,979717
2009/12/1,總計,新竹縣,157821,510882,263338,247544
2009/12/1,總計,苗栗縣,170104,561744,292217,269527
2009/12/1,總計,臺中市,459746,1562126,792546,769580
2009/12/1,總計,彰化縣,359341,1312467,674594,637873
2009/12/1,總計,南投縣,169274,530824,273596,257228
2009/12/1,總計,雲林縣,227121,722795,377914,344881
2009/12/1,總計,嘉義縣,174312,547716,286024,261692
2009/12/1,總計,臺南市,365510,1104346,564259,540087
2009/12/1,總計,高雄市,427081,1242973,637505,605468
2009/12/1,總計,屏東縣,274745,882640,454425,428215
2009/12/1,總計,臺東縣,79756,232497,121905,110592
2009/12/1,總計,花蓮縣,119916,340964,176151,164813
2009/12/1,總計,澎湖縣,33134,96210,49499,46711
2009/12/1,總計,基隆市,146136,388321,195932,192389
2009/12/1,總計,新竹市,138505,411587,204640,206947
2009/12/1,總計,臺中市,377296,1073635,522676,550959
2009/12/1,總計,嘉義市,94513,273861,134980,138881
2009/12/1,總計,臺南市,266376,771060,381857,389203
2009/12/1,總計,臺北市,969418,2607428,1260450,1346978
2009/12/1,總計,高雄市,580670,1527914,755649,772265
2009/12/1,總計,福建省,33743,103722,54224,49498
2009/12/1,總計,金門縣,31688,93803,48475,45328
2009/12/1,總計,連江縣,2055,9919,5749,4170
2009/12/1,新北市,板橋區,190705,552884,274166,278718
2009/12/1,新北市,三重區,137206,388304,193957,194347
2009/12/1,新北市,永和區,89304,236812,113827,122985
2009/12/1,新北市,中和區,153254,414535,205247,209288
2009/12/1,新北市,新莊區,134139,400848,198316,202532
2009/12/1,新北市,新店區,114271,294602,144712,149890
2009/12/1,新北市,土城區,81009,238897,119657,119240
2009/12/1,新北市,蘆洲區,64290,197043,97719,99324
2009/12/1,新北市,汐止區,77293,186979,93042,93937
2009/12/1,新北市,樹林區,57251,172300,86954,85346
2009/12/1,新北市,鶯歌區,26877,86589,43901,42688
2009/12/1,新北市,三峽區,33854,100637,51577,49060
2009/12/1,新北市,淡水區,55006,140156,68412,71744
2009/12/1,新北市,瑞芳區,15682,42713,21880,20833
2009/12/1,新北市,五股區,26768,79149,40282,38867
2009/12/1,新北市,泰山區,25873,76491,38505,37986
2009/12/1,新北市,林口區,28128,78462,38922,39540
2009/12/1,新北市,深坑區,8568,23108,11669,11439
2009/12/1,新北市,石碇區,3264,7973,4459,3514
2009/12/1,新北市,坪林區,2400,6549,3670,2879
2009/12/1,新北市,三芝區,8768,23369,12108,11261
2009/12/1,新北市,石門區,3890,12380,6534,5846
2009/12/1,新北市,八里區,11780,33958,17333,16625
2009/12/1,新北市,平溪區,2362,5447,3026,2421
2009/12/1,新北市,雙溪區,3812,9832,5304,4528
2009/12/1,新北市,貢寮區,4352,13876,7179,6697
2009/12/1,新北市,金山區,6583,22408,11298,11110
2009/12/1,新北市,萬里區,6884,21604,11009,10595
2009/12/1,新北市,烏來區,1695,5748,2909,2839
2009/12/1,宜蘭縣,宜蘭市,32807,95831,47279,48552
2009/12/1,宜蘭縣,羅東鎮,24623,73038,35148,37890
2009/12/1,宜蘭縣,蘇澳鎮,13436,43305,22261,21044
2009/12/1,宜蘭縣,頭城鎮,9599,31161,16129,15032
2009/12/1,宜蘭縣,礁溪鄉,12153,35895,18838,17057
2009/12/1,宜蘭縣,壯圍鄉,7996,25109,13254,11855
2009/12/1,宜蘭縣,員山鄉,10645,32378,17381,14997
2009/12/1,宜蘭縣,冬山鄉,16953,52330,27029,25301
2009/12/1,宜蘭縣,五結鄉,12762,38797,20188,18609
2009/12/1,宜蘭縣,三星鄉,7380,21710,11711,9999
2009/12/1,宜蘭縣,大同鄉,1810,6004,3286,2718
2009/12/1,宜蘭縣,南澳鄉,1778,6067,3210,2857
2009/12/1,桃園市,桃園區,139779,401096,196687,204409
2009/12/1,桃園市,中壢區,123308,365109,182735,182374
2009/12/1,桃園市,平鎮區,65022,206471,104064,102407
2009/12/1,桃園市,八德區,56478,175127,89354,85773
2009/12/1,桃園市,大溪區,28762,91875,47267,44608
2009/12/1,桃園市,楊梅區,46997,148092,75400,72692
2009/12/1,桃園市,蘆竹區,46389,138727,69656,69071
2009/12/1,桃園市,大園區,25493,81309,42277,39032
2009/12/1,桃園市,龜山區,48426,135692,68907,66785
2009/12/1,桃園市,龍潭區,36191,114266,58174,56092
2009/12/1,桃園市,新屋區,14827,49576,26453,23123
2009/12/1,桃園市,觀音區,18783,60831,32146,28685
2009/12/1,桃園市,復興區,3651,10611,5945,4666
2009/12/1,新竹縣,竹北市,45089,137861,69351,68510
2009/12/1,新竹縣,關西鎮,9199,32431,17273,15158
2009/12/1,新竹縣,新埔鎮,10276,36012,19057,16955
2009/12/1,新竹縣,竹東鎮,30167,97089,48991,48098
2009/12/1,新竹縣,湖口鄉,23098,75546,38639,36907
2009/12/1,新竹縣,橫山鄉,4375,14772,7991,6781
2009/12/1,新竹縣,新豐鄉,15312,52761,27292,25469
2009/12/1,新竹縣,芎林鄉,6251,20963,11043,9920
2009/12/1,新竹縣,寶山鄉,4588,13998,7548,6450
2009/12/1,新竹縣,北埔鄉,3080,10289,5570,4719
2009/12/1,新竹縣,峨眉鄉,2018,6133,3404,2729
2009/12/1,新竹縣,尖石鄉,2662,8351,4584,3767
2009/12/1,新竹縣,五峰鄉,1706,4676,2595,2081
2009/12/1,苗栗縣,苗栗市,28812,90826,45834,44992
2009/12/1,苗栗縣,苑裡鎮,13751,49016,25609,23407
2009/12/1,苗栗縣,通霄鎮,11237,38535,20534,18001
2009/12/1,苗栗縣,竹南鎮,23443,77344,39371,37973
2009/12/1,苗栗縣,頭份市,28840,96261,49088,47173
2009/12/1,苗栗縣,後龍鎮,11560,39822,21079,18743
2009/12/1,苗栗縣,卓蘭鎮,5898,18497,9777,8720
2009/12/1,苗栗縣,大湖鄉,5292,16186,8695,7491
2009/12/1,苗栗縣,公館鄉,10022,34813,18325,16488
2009/12/1,苗栗縣,銅鑼鄉,5960,19633,10401,9232
2009/12/1,苗栗縣,南庄鄉,3953,11318,6248,5070
2009/12/1,苗栗縣,頭屋鄉,3492,11702,6185,5517
2009/12/1,苗栗縣,三義鄉,5237,17713,9343,8370
2009/12/1,苗栗縣,西湖鄉,2662,7939,4390,3549
2009/12/1,苗栗縣,造橋鄉,3950,13737,7269,6468
2009/12/1,苗栗縣,三灣鄉,2379,7393,4014,3379
2009/12/1,苗栗縣,獅潭鄉,1682,5059,2826,2233
2009/12/1,苗栗縣,泰安鄉,1934,5950,3229,2721
2009/12/1,臺中市,豐原區,48848,165245,82141,83104
2009/12/1,臺中市,大里區,60457,196056,97438,98618
2009/12/1,臺中市,太平區,53860,172389,86680,85709
2009/12/1,臺中市,東勢區,16859,53696,27876,25820
2009/12/1,臺中市,大甲區,21395,78707,39990,38717
2009/12/1,臺中市,清水區,24626,85743,44273,41470
2009/12/1,臺中市,沙鹿區,23035,80640,41082,39558
2009/12/1,臺中市,梧棲區,15777,54943,27915,27028
2009/12/1,臺中市,后里區,14653,54401,28041,26360
2009/12/1,臺中市,神岡區,17411,63982,33060,30922
2009/12/1,臺中市,潭子區,31868,99677,49803,49874
2009/12/1,臺中市,大雅區,25905,89499,45158,44341
2009/12/1,臺中市,新社區,7298,25761,13560,12201
2009/12/1,臺中市,石岡區,4818,16146,8432,7714
2009/12/1,臺中市,外埔區,8716,32007,16489,15518
2009/12/1,臺中市,大安區,5201,20417,10774,9643
2009/12/1,臺中市,烏日區,20078,68373,34704,33669
2009/12/1,臺中市,大肚區,15641,55874,28669,27205
2009/12/1,臺中市,龍井區,20282,73934,37683,36251
2009/12/1,臺中市,霧峰區,18556,63906,32914,30992
2009/12/1,臺中市,和平區,4462,10730,5864,4866
2009/12/1,彰化縣,彰化市,70929,237160,118364,118796
2009/12/1,彰化縣,鹿港鎮,21988,85364,43799,41565
2009/12/1,彰化縣,和美鎮,23734,89624,46034,43590
2009/12/1,彰化縣,北斗鎮,9797,33631,17061,16570
2009/12/1,彰化縣,員林市,36297,125838,63356,62482
2009/12/1,彰化縣,溪湖鎮,14927,56260,28798,27462
2009/12/1,彰化縣,田中鎮,12442,44499,23198,21301
2009/12/1,彰化縣,二林鎮,14198,54479,28118,26361
2009/12/1,彰化縣,線西鄉,4060,17081,8785,8296
2009/12/1,彰化縣,伸港鄉,8848,35942,18520,17422
2009/12/1,彰化縣,福興鄉,11893,49130,25738,23392
2009/12/1,彰化縣,秀水鄉,9569,38985,20238,18747
2009/12/1,彰化縣,花壇鄉,12791,46238,23865,22373
2009/12/1,彰化縣,芬園鄉,6849,24980,13244,11736
2009/12/1,彰化縣,大村鄉,10090,36646,19099,17547
2009/12/1,彰化縣,埔鹽鄉,8701,34565,18141,16424
2009/12/1,彰化縣,埔心鄉,9812,35410,18369,17041
2009/12/1,彰化縣,永靖鄉,10311,39607,20547,19060
2009/12/1,彰化縣,社頭鄉,12231,45038,23210,21828
2009/12/1,彰化縣,二水鄉,5300,16749,8819,7930
2009/12/1,彰化縣,田尾鄉,7603,28890,15080,13810
2009/12/1,彰化縣,埤頭鄉,8478,32008,16752,15256
2009/12/1,彰化縣,芳苑鄉,9934,36637,19452,17185
2009/12/1,彰化縣,大城鄉,5366,19151,10409,8742
2009/12/1,彰化縣,竹塘鄉,4565,16693,8787,7906
2009/12/1,彰化縣,溪州鄉,8628,31862,16811,15051
2009/12/1,南投縣,南投市,32968,104670,52703,51967
2009/12/1,南投縣,埔里鎮,28061,85779,43303,42476
2009/12/1,南投縣,草屯鎮,30618,100294,50764,49530
2009/12/1,南投縣,竹山鎮,18801,58826,30407,28419
2009/12/1,南投縣,集集鎮,4286,12103,6361,5742
2009/12/1,南投縣,名間鄉,12027,41603,21855,19748
2009/12/1,南投縣,鹿谷鄉,6623,19376,10294,9082
2009/12/1,南投縣,中寮鄉,5610,16405,8914,7491
2009/12/1,南投縣,魚池鄉,5783,17411,9208,8203
2009/12/1,南投縣,國姓鄉,7208,20964,11477,9487
2009/12/1,南投縣,水里鄉,7227,20383,10696,9687
2009/12/1,南投縣,信義鄉,5153,17360,9399,7961
2009/12/1,南投縣,仁愛鄉,4909,15650,8215,7435
2009/12/1,雲林縣,斗六市,34169,106723,53759,52964
2009/12/1,雲林縣,斗南鎮,15063,47461,24157,23304
2009/12/1,雲林縣,虎尾鎮,22146,70259,35791,34468
2009/12/1,雲林縣,西螺鎮,13905,48954,24918,24036
2009/12/1,雲林縣,土庫鎮,8649,30730,16082,14648
2009/12/1,雲林縣,北港鎮,15125,43537,22675,20862
2009/12/1,雲林縣,古坑鄉,10603,34598,18304,16294
2009/12/1,雲林縣,大埤鄉,6616,21533,11500,10033
2009/12/1,雲林縣,莿桐鄉,8925,30715,16093,14622
2009/12/1,雲林縣,林內鄉,5728,20089,10500,9589
2009/12/1,雲林縣,二崙鄉,8744,30076,16134,13942
2009/12/1,雲林縣,崙背鄉,8264,27755,14653,13102
2009/12/1,雲林縣,麥寮鄉,12042,35053,18462,16591
2009/12/1,雲林縣,東勢鄉,5714,17170,9324,7846
2009/12/1,雲林縣,褒忠鄉,4277,14623,7791,6832
2009/12/1,雲林縣,臺西鄉,8781,26563,14308,12255
2009/12/1,雲林縣,元長鄉,9326,29325,15974,13351
2009/12/1,雲林縣,四湖鄉,9041,27252,14880,12372
2009/12/1,雲林縣,口湖鄉,9628,30894,16480,14414
2009/12/1,雲林縣,水林鄉,10375,29485,16129,13356
2009/12/1,嘉義縣,太保市,10987,36210,18724,17486
2009/12/1,嘉義縣,朴子市,14289,44326,22640,21686
2009/12/1,嘉義縣,布袋鎮,10132,30824,15844,14980
2009/12/1,嘉義縣,大林鎮,11111,33982,17479,16503
2009/12/1,嘉義縣,民雄鄉,22447,72793,37439,35354
2009/12/1,嘉義縣,溪口鄉,5387,16563,8832,7731
2009/12/1,嘉義縣,新港鄉,10293,34995,18471,16524
2009/12/1,嘉義縣,六腳鄉,9122,26890,14246,12644
2009/12/1,嘉義縣,東石鄉,9383,28224,15008,13216
2009/12/1,嘉義縣,義竹鄉,7447,21617,11188,10429
2009/12/1,嘉義縣,鹿草鄉,5693,17405,9335,8070
2009/12/1,嘉義縣,水上鄉,17246,52562,27229,25333
2009/12/1,嘉義縣,中埔鄉,15071,47790,24991,22799
2009/12/1,嘉義縣,竹崎鄉,11233,38962,20763,18199
2009/12/1,嘉義縣,梅山鄉,6590,22049,11695,10354
2009/12/1,嘉義縣,番路鄉,3883,11730,6374,5356
2009/12/1,嘉義縣,大埔鄉,1962,4572,2424,2148
2009/12/1,嘉義縣,阿里山鄉,2036,6222,3342,2880
2009/12/1,臺南市,新營區,26836,78233,39139,39094
2009/12/1,臺南市,永康區,73491,214622,106886,107736
2009/12/1,臺南市,鹽水區,9861,27321,14239,13082
2009/12/1,臺南市,白河區,10876,31735,16669,15066
2009/12/1,臺南市,麻豆區,14883,46089,23567,22522
2009/12/1,臺南市,佳里區,19079,59464,29630,29834
2009/12/1,臺南市,新化區,13548,44361,22749,21612
2009/12/1,臺南市,善化區,14306,43361,21978,21383
2009/12/1,臺南市,學甲區,9464,28173,14420,13753
2009/12/1,臺南市,柳營區,7742,22987,12031,10956
2009/12/1,臺南市,後壁區,8711,26163,13628,12535
2009/12/1,臺南市,東山區,8173,23414,12488,10926
2009/12/1,臺南市,下營區,9051,26411,13699,12712
2009/12/1,臺南市,六甲區,7569,23984,12482,11502
2009/12/1,臺南市,官田區,7591,22455,11505,10950
2009/12/1,臺南市,大內區,4070,11093,5892,5201
2009/12/1,臺南市,西港區,7745,25357,12950,12407
2009/12/1,臺南市,七股區,7939,24958,13075,11883
2009/12/1,臺南市,將軍區,7417,21798,11102,10696
2009/12/1,臺南市,北門區,4357,12560,6410,6150
2009/12/1,臺南市,新市區,10679,34977,17605,17372
2009/12/1,臺南市,安定區,9153,30129,15607,14522
2009/12/1,臺南市,山上區,2727,8021,4218,3803
2009/12/1,臺南市,玉井區,5076,15579,8093,7486
2009/12/1,臺南市,楠西區,3593,10794,5735,5059
2009/12/1,臺南市,南化區,2822,9009,4928,4081
2009/12/1,臺南市,左鎮區,1974,5614,3109,2505
2009/12/1,臺南市,仁德區,24309,68947,35502,33445
2009/12/1,臺南市,歸仁區,20246,65924,33627,32297
2009/12/1,臺南市,關廟區,10631,36380,18898,17482
2009/12/1,臺南市,龍崎區,1591,4433,2398,2035
2009/12/1,高雄市,鳳山區,124821,339952,169883,170069
2009/12/1,高雄市,岡山區,32826,97095,48888,48207
2009/12/1,高雄市,旗山區,13719,40368,21092,19276
2009/12/1,高雄市,美濃區,13935,43444,22671,20773
2009/12/1,高雄市,林園區,23830,70770,36407,34363
2009/12/1,高雄市,大寮區,37762,109257,56836,52421
2009/12/1,高雄市,大樹區,12991,44230,22927,21303
2009/12/1,高雄市,仁武區,24804,70242,36316,33926
2009/12/1,高雄市,大社區,11549,32808,16903,15905
2009/12/1,高雄市,鳥松區,16252,42135,21427,20708
2009/12/1,高雄市,橋頭區,12376,36284,18641,17643
2009/12/1,高雄市,燕巢區,9912,31059,16622,14437
2009/12/1,高雄市,田寮區,3559,8325,4613,3712
2009/12/1,高雄市,阿蓮區,9075,30613,15457,15156
2009/12/1,高雄市,路竹區,15898,54137,27688,26449
2009/12/1,高雄市,湖內區,9400,28697,14821,13876
2009/12/1,高雄市,茄萣區,10096,31583,16508,15075
2009/12/1,高雄市,永安區,5767,14253,7284,6969
2009/12/1,高雄市,彌陀區,6526,20613,10738,9875
2009/12/1,高雄市,梓官區,11873,36867,19218,17649
2009/12/1,高雄市,六龜區,5808,15354,8322,7032
2009/12/1,高雄市,甲仙區,2568,7616,4100,3516
2009/12/1,高雄市,杉林區,4028,11102,6066,5036
2009/12/1,高雄市,內門區,5011,16085,8775,7310
2009/12/1,高雄市,茂林區,554,1850,950,900
2009/12/1,高雄市,桃源區,1273,4777,2549,2228
2009/12/1,高雄市,那瑪夏區,868,3457,1803,1654
2009/12/1,屏東縣,屏東市,72116,213614,106707,106907
2009/12/1,屏東縣,潮州鎮,17953,55969,28230,27739
2009/12/1,屏東縣,東港鎮,15397,50234,25529,24705
2009/12/1,屏東縣,恆春鎮,10661,31170,16071,15099
2009/12/1,屏東縣,萬丹鄉,14125,54309,28103,26206
2009/12/1,屏東縣,長治鄉,9657,30979,16214,14765
2009/12/1,屏東縣,麟洛鄉,3548,11649,6037,5612
2009/12/1,屏東縣,九如鄉,6512,23004,11984,11020
2009/12/1,屏東縣,里港鄉,7815,26231,13432,12799
2009/12/1,屏東縣,鹽埔鄉,7637,27479,14296,13183
2009/12/1,屏東縣,高樹鄉,9562,27226,14524,12702
2009/12/1,屏東縣,萬巒鄉,6384,22282,11729,10553
2009/12/1,屏東縣,內埔鄉,17598,58685,30562,28123
2009/12/1,屏東縣,竹田鄉,5454,18474,9830,8644
2009/12/1,屏東縣,新埤鄉,3344,10913,5768,5145
2009/12/1,屏東縣,枋寮鄉,8394,26986,14261,12725
2009/12/1,屏東縣,新園鄉,11290,38980,20127,18853
2009/12/1,屏東縣,崁頂鄉,4133,17335,8888,8447
2009/12/1,屏東縣,林邊鄉,6950,21143,10912,10231
2009/12/1,屏東縣,南州鄉,3659,11919,6128,5791
2009/12/1,屏東縣,佳冬鄉,7052,21715,11346,10369
2009/12/1,屏東縣,琉球鄉,3922,12620,6987,5633
2009/12/1,屏東縣,車城鄉,3498,9999,5398,4601
2009/12/1,屏東縣,滿州鄉,3053,8679,4744,3935
2009/12/1,屏東縣,枋山鄉,2087,6180,3301,2879
2009/12/1,屏東縣,三地門鄉,2137,7556,3865,3691
2009/12/1,屏東縣,霧臺鄉,950,2915,1545,1370
2009/12/1,屏東縣,瑪家鄉,1866,6537,3405,3132
2009/12/1,屏東縣,泰武鄉,1235,5122,2707,2415
2009/12/1,屏東縣,來義鄉,2132,7883,4056,3827
2009/12/1,屏東縣,春日鄉,1314,4866,2540,2326
2009/12/1,屏東縣,獅子鄉,1456,4983,2615,2368
2009/12/1,屏東縣,牡丹鄉,1854,5004,2584,2420
2009/12/1,臺東縣,臺東市,37697,109576,55700,53876
2009/12/1,臺東縣,成功鎮,5409,15984,8523,7461
2009/12/1,臺東縣,關山鎮,3209,9849,5173,4676
2009/12/1,臺東縣,卑南鄉,6542,18379,9962,8417
2009/12/1,臺東縣,大武鄉,2532,7160,3706,3454
2009/12/1,臺東縣,太麻里鄉,4522,12094,6481,5613
2009/12/1,臺東縣,東河鄉,3545,9523,5273,4250
2009/12/1,臺東縣,長濱鄉,2923,8477,4825,3652
2009/12/1,臺東縣,鹿野鄉,3111,8676,4683,3993
2009/12/1,臺東縣,池上鄉,3242,9356,4970,4386
2009/12/1,臺東縣,綠島鄉,985,3331,1789,1542
2009/12/1,臺東縣,延平鄉,1074,3621,2014,1607
2009/12/1,臺東縣,海端鄉,1093,4535,2471,2064
2009/12/1,臺東縣,達仁鄉,1488,4103,2242,1861
2009/12/1,臺東縣,金峰鄉,1029,3526,1839,1687
2009/12/1,臺東縣,蘭嶼鄉,1355,4307,2254,2053
2009/12/1,花蓮縣,花蓮市,40228,109945,53992,55953
2009/12/1,花蓮縣,鳳林鎮,4453,12174,6467,5707
2009/12/1,花蓮縣,玉里鎮,8938,27279,14821,12458
2009/12/1,花蓮縣,新城鄉,7225,20324,10597,9727
2009/12/1,花蓮縣,吉安鄉,28505,79445,40811,38634
2009/12/1,花蓮縣,壽豐鄉,6784,18908,10238,8670
2009/12/1,花蓮縣,光復鄉,4983,14271,7616,6655
2009/12/1,花蓮縣,豐濱鄉,1815,5135,2837,2298
2009/12/1,花蓮縣,瑞穗鄉,4621,13086,7059,6027
2009/12/1,花蓮縣,富里鄉,3979,11869,6519,5350
2009/12/1,花蓮縣,秀林鄉,4583,15107,7865,7242
2009/12/1,花蓮縣,萬榮鄉,2140,7001,3733,3268
2009/12/1,花蓮縣,卓溪鄉,1662,6420,3596,2824
2009/12/1,澎湖縣,馬公市,19496,56435,28628,27807
2009/12/1,澎湖縣,湖西鄉,4635,13520,7079,6441
2009/12/1,澎湖縣,白沙鄉,3108,9458,4957,4501
2009/12/1,澎湖縣,西嶼鄉,2804,8483,4395,4088
2009/12/1,澎湖縣,望安鄉,1866,4743,2564,2179
2009/12/1,澎湖縣,七美鄉,1225,3571,1876,1695
2009/12/1,基隆市,中正區,22007,56247,28889,27358
2009/12/1,基隆市,七堵區,19885,55496,28143,27353
2009/12/1,基隆市,暖暖區,14179,38095,19391,18704
2009/12/1,基隆市,仁愛區,19649,50400,24905,25495
2009/12/1,基隆市,中山區,18905,51574,26399,25175
2009/12/1,基隆市,安樂區,31638,84859,42292,42567
2009/12/1,基隆市,信義區,19873,51650,25913,25737
2009/12/1,新竹市,東區,66450,194927,96295,98632
2009/12/1,新竹市,北區,49574,144484,71520,72964
2009/12/1,新竹市,香山區,22481,72176,36825,35351
2009/12/1,臺中市,中區,8433,23228,11448,11780
2009/12/1,臺中市,東區,25577,73891,37399,36492
2009/12/1,臺中市,西區,42727,117390,56491,60899
2009/12/1,臺中市,南區,41256,112722,54799,57923
2009/12/1,臺中市,北區,54930,147529,71592,75937
2009/12/1,臺中市,西屯區,71059,203680,99114,104566
2009/12/1,臺中市,南屯區,51616,150884,72890,77994
2009/12/1,臺中市,北屯區,81698,244311,118943,125368
2009/12/1,嘉義市,東區,44517,127736,62428,65308
2009/12/1,嘉義市,西區,49996,146125,72552,73573
2009/12/1,臺南市,東區,70248,194401,94128,100273
2009/12/1,臺南市,南區,42769,126571,63608,62963
2009/12/1,臺南市,北區,47341,131203,64955,66248
2009/12/1,臺南市,安南區,53489,177116,90205,86911
2009/12/1,臺南市,安平區,22594,61740,29615,32125
2009/12/1,臺南市,中西區,29935,80029,39346,40683
2009/12/1,臺北市,松山區,77154,207995,98700,109295
2009/12/1,臺北市,信義區,85412,225364,108918,116446
2009/12/1,臺北市,大安區,116065,311612,146914,164698
2009/12/1,臺北市,中山區,90199,218245,103033,115212
2009/12/1,臺北市,中正區,61412,158752,76745,82007
2009/12/1,臺北市,大同區,46386,123399,60957,62442
2009/12/1,臺北市,萬華區,73214,188437,94381,94056
2009/12/1,臺北市,文山區,95842,260869,126579,134290
2009/12/1,臺北市,南港區,40982,113149,55938,57211
2009/12/1,臺北市,內湖區,94827,267704,129278,138426
2009/12/1,臺北市,士林區,99484,283855,138331,145524
2009/12/1,臺北市,北投區,88441,248047,120676,127371
2009/12/1,高雄市,鹽埕區,11121,27651,13928,13723
2009/12/1,高雄市,鼓山區,50859,129521,63687,65834
2009/12/1,高雄市,左營區,72447,189944,93732,96212
2009/12/1,高雄市,楠梓區,60947,171906,85434,86472
2009/12/1,高雄市,三民區,130124,355097,174151,180946
2009/12/1,高雄市,新興區,22843,55744,27234,28510
2009/12/1,高雄市,前金區,12528,29208,14299,14909
2009/12/1,高雄市,苓雅區,71194,185021,90258,94763
2009/12/1,高雄市,前鎮區,75619,199951,99759,100192
2009/12/1,高雄市,旗津區,10902,29975,15619,14356
2009/12/1,高雄市,小港區,62086,153896,77548,76348
2009/12/1,金門縣,金城鎮,10693,31563,16302,15261
2009/12/1,金門縣,金湖鎮,7039,20467,10624,9843
2009/12/1,金門縣,金沙鎮,5244,14851,7607,7244
2009/12/1,金門縣,金寧鄉,6033,17836,9310,8526
2009/12/1,金門縣,烈嶼鄉,2543,8580,4375,4205
2009/12/1,金門縣,烏坵鄉,136,506,257,249
2009/12/1,連江縣,南竿鄉,1176,5939,3427,2512
2009/12/1,連江縣,北竿鄉,377,1755,1014,741
2009/12/1,連江縣,莒光鄉,238,1166,686,480
2009/12/1,連江縣,東引鄉,264,1059,622,437
2010/1/1,總計,臺灣地區,7779839,23020307,11582770,11437537
2010/1/1,總計,臺灣省,6229226,18885950,9567594,9318356
2010/1/1,總計,新北市,1377152,3876070,1928449,1947621
2010/1/1,總計,宜蘭縣,152069,461876,235791,226085
2010/1/1,總計,桃園市,655323,1980038,999548,980490
2010/1/1,總計,新竹縣,158076,511288,263523,247765
2010/1/1,總計,苗栗縣,170355,561946,292270,269676
2010/1/1,總計,臺中市,460244,1562197,792526,769671
2010/1/1,總計,彰化縣,359629,1312491,674449,638042
2010/1/1,總計,南投縣,169453,530875,273569,257306
2010/1/1,總計,雲林縣,227367,722688,377791,344897
2010/1/1,總計,嘉義縣,174510,547709,286009,261700
2010/1/1,總計,臺南市,365753,1104009,564050,539959
2010/1/1,總計,高雄市,427480,1242783,637340,605443
2010/1/1,總計,屏東縣,274891,882339,454211,428128
2010/1/1,總計,臺東縣,79794,232821,121999,110822
2010/1/1,總計,花蓮縣,119970,341026,176136,164890
2010/1/1,總計,澎湖縣,33209,96387,49558,46829
2010/1/1,總計,基隆市,146163,388136,195822,192314
2010/1/1,總計,新竹市,138772,411981,204755,207226
2010/1/1,總計,臺中市,377837,1074277,522964,551313
2010/1/1,總計,嘉義市,94564,273778,134925,138853
2010/1/1,總計,臺南市,266615,771235,381909,389326
2010/1/1,總計,臺北市,969408,2606151,1259546,1346605
2010/1/1,總計,高雄市,581205,1528206,755630,772576
2010/1/1,總計,福建省,33857,104207,54457,49750
2010/1/1,總計,金門縣,31789,94205,48652,45553
2010/1/1,總計,連江縣,2068,10002,5805,4197
2010/1/1,新北市,板橋區,190963,552974,274144,278830
2010/1/1,新北市,三重區,137419,388576,194067,194509
2010/1/1,新北市,永和區,89312,236872,113831,123041
2010/1/1,新北市,中和區,153412,414685,205249,209436
2010/1/1,新北市,新莊區,134245,400863,198273,202590
2010/1/1,新北市,新店區,114407,294862,144810,150052
2010/1/1,新北市,土城區,81054,238827,119639,119188
2010/1/1,新北市,蘆洲區,64417,197203,97796,99407
2010/1/1,新北市,汐止區,77421,187255,93168,94087
2010/1/1,新北市,樹林區,57332,172480,87017,85463
2010/1/1,新北市,鶯歌區,26888,86598,43901,42697
2010/1/1,新北市,三峽區,33961,100942,51741,49201
2010/1/1,新北市,淡水區,55197,140449,68531,71918
2010/1/1,新北市,瑞芳區,15701,42685,21871,20814
2010/1/1,新北市,五股區,26814,79190,40304,38886
2010/1/1,新北市,泰山區,25895,76529,38520,38009
2010/1/1,新北市,林口區,28299,78865,39097,39768
2010/1/1,新北市,深坑區,8574,23115,11679,11436
2010/1/1,新北市,石碇區,3264,7960,4448,3512
2010/1/1,新北市,坪林區,2405,6538,3663,2875
2010/1/1,新北市,三芝區,8768,23348,12092,11256
2010/1/1,新北市,石門區,3897,12394,6540,5854
2010/1/1,新北市,八里區,11808,34022,17376,16646
2010/1/1,新北市,平溪區,2361,5438,3022,2416
2010/1/1,新北市,雙溪區,3809,9821,5303,4518
2010/1/1,新北市,貢寮區,4352,13840,7166,6674
2010/1/1,新北市,金山區,6586,22399,11286,11113
2010/1/1,新北市,萬里區,6899,21602,11008,10594
2010/1/1,新北市,烏來區,1692,5738,2907,2831
2010/1/1,宜蘭縣,宜蘭市,32822,95858,47306,48552
2010/1/1,宜蘭縣,羅東鎮,24625,73022,35126,37896
2010/1/1,宜蘭縣,蘇澳鎮,13461,43351,22283,21068
2010/1/1,宜蘭縣,頭城鎮,9600,31190,16148,15042
2010/1/1,宜蘭縣,礁溪鄉,12179,35933,18865,17068
2010/1/1,宜蘭縣,壯圍鄉,8004,25156,13256,11900
2010/1/1,宜蘭縣,員山鄉,10661,32380,17382,14998
2010/1/1,宜蘭縣,冬山鄉,16978,52346,27022,25324
2010/1/1,宜蘭縣,五結鄉,12769,38815,20185,18630
2010/1/1,宜蘭縣,三星鄉,7379,21674,11695,9979
2010/1/1,宜蘭縣,大同鄉,1812,6043,3290,2753
2010/1/1,宜蘭縣,南澳鄉,1779,6108,3233,2875
2010/1/1,桃園市,桃園區,140012,401328,196785,204543
2010/1/1,桃園市,中壢區,123584,365445,182867,182578
2010/1/1,桃園市,平鎮區,65148,206521,104076,102445
2010/1/1,桃園市,八德區,56642,175325,89441,85884
2010/1/1,桃園市,大溪區,28761,91804,47247,44557
2010/1/1,桃園市,楊梅區,47113,148257,75465,72792
2010/1/1,桃園市,蘆竹區,46511,138962,69775,69187
2010/1/1,桃園市,大園區,25512,81274,42245,39029
2010/1/1,桃園市,龜山區,48508,135805,68939,66866
2010/1/1,桃園市,龍潭區,36240,114272,58161,56111
2010/1/1,桃園市,新屋區,14829,49545,26433,23112
2010/1/1,桃園市,觀音區,18809,60817,32140,28677
2010/1/1,桃園市,復興區,3654,10683,5974,4709
2010/1/1,新竹縣,竹北市,45230,138234,69545,68689
2010/1/1,新竹縣,關西鎮,9211,32411,17251,15160
2010/1/1,新竹縣,新埔鎮,10277,35974,19040,16934
2010/1/1,新竹縣,竹東鎮,30177,96941,48930,48011
2010/1/1,新竹縣,湖口鄉,23112,75536,38623,36913
2010/1/1,新竹縣,橫山鄉,4381,14772,7989,6783
2010/1/1,新竹縣,新豐鄉,15338,52816,27302,25514
2010/1/1,新竹縣,芎林鄉,6265,20988,11057,9931
2010/1/1,新竹縣,寶山鄉,4602,14039,7580,6459
2010/1/1,新竹縣,北埔鄉,3091,10305,5579,4726
2010/1/1,新竹縣,峨眉鄉,2017,6125,3398,2727
2010/1/1,新竹縣,尖石鄉,2667,8397,4600,3797
2010/1/1,新竹縣,五峰鄉,1708,4750,2629,2121
2010/1/1,苗栗縣,苗栗市,28808,90777,45814,44963
2010/1/1,苗栗縣,苑裡鎮,13766,48998,25589,23409
2010/1/1,苗栗縣,通霄鎮,11243,38515,20516,17999
2010/1/1,苗栗縣,竹南鎮,23505,77407,39383,38024
2010/1/1,苗栗縣,頭份市,28900,96291,49116,47175
2010/1/1,苗栗縣,後龍鎮,11583,39809,21086,18723
2010/1/1,苗栗縣,卓蘭鎮,5905,18511,9778,8733
2010/1/1,苗栗縣,大湖鄉,5294,16150,8675,7475
2010/1/1,苗栗縣,公館鄉,10038,34836,18322,16514
2010/1/1,苗栗縣,銅鑼鄉,5962,19639,10405,9234
2010/1/1,苗栗縣,南庄鄉,3966,11324,6258,5066
2010/1/1,苗栗縣,頭屋鄉,3495,11718,6192,5526
2010/1/1,苗栗縣,三義鄉,5265,17731,9343,8388
2010/1/1,苗栗縣,西湖鄉,2669,7961,4398,3563
2010/1/1,苗栗縣,造橋鄉,3957,13754,7274,6480
2010/1/1,苗栗縣,三灣鄉,2385,7411,4016,3395
2010/1/1,苗栗縣,獅潭鄉,1680,5056,2820,2236
2010/1/1,苗栗縣,泰安鄉,1934,6058,3285,2773
2010/1/1,臺中市,豐原區,48930,165275,82136,83139
2010/1/1,臺中市,大里區,60517,196162,97496,98666
2010/1/1,臺中市,太平區,53916,172470,86713,85757
2010/1/1,臺中市,東勢區,16858,53650,27850,25800
2010/1/1,臺中市,大甲區,21417,78728,40003,38725
2010/1/1,臺中市,清水區,24656,85728,44268,41460
2010/1/1,臺中市,沙鹿區,23096,80724,41129,39595
2010/1/1,臺中市,梧棲區,15781,54949,27906,27043
2010/1/1,臺中市,后里區,14660,54353,28013,26340
2010/1/1,臺中市,神岡區,17419,63953,33041,30912
2010/1/1,臺中市,潭子區,31934,99655,49800,49855
2010/1/1,臺中市,大雅區,25940,89522,45164,44358
2010/1/1,臺中市,新社區,7295,25758,13550,12208
2010/1/1,臺中市,石岡區,4820,16149,8433,7716
2010/1/1,臺中市,外埔區,8722,31998,16482,15516
2010/1/1,臺中市,大安區,5205,20395,10758,9637
2010/1/1,臺中市,烏日區,20106,68353,34688,33665
2010/1/1,臺中市,大肚區,15645,55852,28666,27186
2010/1/1,臺中市,龍井區,20308,73951,37685,36266
2010/1/1,臺中市,霧峰區,18552,63864,32889,30975
2010/1/1,臺中市,和平區,4467,10708,5856,4852
2010/1/1,彰化縣,彰化市,70967,237170,118320,118850
2010/1/1,彰化縣,鹿港鎮,22023,85383,43800,41583
2010/1/1,彰化縣,和美鎮,23766,89638,46031,43607
2010/1/1,彰化縣,北斗鎮,9805,33648,17076,16572
2010/1/1,彰化縣,員林市,36328,125880,63366,62514
2010/1/1,彰化縣,溪湖鎮,14935,56270,28807,27463
2010/1/1,彰化縣,田中鎮,12452,44471,23176,21295
2010/1/1,彰化縣,二林鎮,14200,54483,28118,26365
2010/1/1,彰化縣,線西鄉,4070,17098,8793,8305
2010/1/1,彰化縣,伸港鄉,8854,35976,18534,17442
2010/1/1,彰化縣,福興鄉,11892,49086,25702,23384
2010/1/1,彰化縣,秀水鄉,9573,38992,20233,18759
2010/1/1,彰化縣,花壇鄉,12801,46212,23837,22375
2010/1/1,彰化縣,芬園鄉,6853,24984,13254,11730
2010/1/1,彰化縣,大村鄉,10095,36639,19090,17549
2010/1/1,彰化縣,埔鹽鄉,8708,34531,18119,16412
2010/1/1,彰化縣,埔心鄉,9823,35407,18351,17056
2010/1/1,彰化縣,永靖鄉,10311,39586,20534,19052
2010/1/1,彰化縣,社頭鄉,12252,45052,23225,21827
2010/1/1,彰化縣,二水鄉,5303,16760,8821,7939
2010/1/1,彰化縣,田尾鄉,7616,28884,15073,13811
2010/1/1,彰化縣,埤頭鄉,8481,31997,16735,15262
2010/1/1,彰化縣,芳苑鄉,9934,36586,19425,17161
2010/1/1,彰化縣,大城鄉,5383,19237,10462,8775
2010/1/1,彰化縣,竹塘鄉,4570,16686,8774,7912
2010/1/1,彰化縣,溪州鄉,8634,31835,16793,15042
2010/1/1,南投縣,南投市,33011,104637,52696,51941
2010/1/1,南投縣,埔里鎮,28062,85698,43252,42446
2010/1/1,南投縣,草屯鎮,30658,100296,50762,49534
2010/1/1,南投縣,竹山鎮,18839,58829,30391,28438
2010/1/1,南投縣,集集鎮,4320,12259,6437,5822
2010/1/1,南投縣,名間鄉,12020,41520,21814,19706
2010/1/1,南投縣,鹿谷鄉,6629,19372,10286,9086
2010/1/1,南投縣,中寮鄉,5610,16377,8905,7472
2010/1/1,南投縣,魚池鄉,5788,17435,9208,8227
2010/1/1,南投縣,國姓鄉,7222,20980,11474,9506
2010/1/1,南投縣,水里鄉,7226,20341,10675,9666
2010/1/1,南投縣,信義鄉,5163,17450,9437,8013
2010/1/1,南投縣,仁愛鄉,4905,15681,8232,7449
2010/1/1,雲林縣,斗六市,34236,106779,53776,53003
2010/1/1,雲林縣,斗南鎮,15089,47460,24157,23303
2010/1/1,雲林縣,虎尾鎮,22180,70258,35787,34471
2010/1/1,雲林縣,西螺鎮,13919,48979,24920,24059
2010/1/1,雲林縣,土庫鎮,8656,30724,16080,14644
2010/1/1,雲林縣,北港鎮,15151,43496,22637,20859
2010/1/1,雲林縣,古坑鄉,10608,34588,18294,16294
2010/1/1,雲林縣,大埤鄉,6613,21458,11468,9990
2010/1/1,雲林縣,莿桐鄉,8936,30672,16077,14595
2010/1/1,雲林縣,林內鄉,5737,20044,10471,9573
2010/1/1,雲林縣,二崙鄉,8750,30022,16110,13912
2010/1/1,雲林縣,崙背鄉,8271,27755,14649,13106
2010/1/1,雲林縣,麥寮鄉,12055,35063,18474,16589
2010/1/1,雲林縣,東勢鄉,5711,17175,9326,7849
2010/1/1,雲林縣,褒忠鄉,4286,14625,7797,6828
2010/1/1,雲林縣,臺西鄉,8788,26535,14291,12244
2010/1/1,雲林縣,元長鄉,9323,29353,15969,13384
2010/1/1,雲林縣,四湖鄉,9055,27276,14890,12386
2010/1/1,雲林縣,口湖鄉,9639,30954,16506,14448
2010/1/1,雲林縣,水林鄉,10364,29472,16112,13360
2010/1/1,嘉義縣,太保市,11016,36246,18738,17508
2010/1/1,嘉義縣,朴子市,14320,44339,22627,21712
2010/1/1,嘉義縣,布袋鎮,10129,30776,15825,14951
2010/1/1,嘉義縣,大林鎮,11115,33995,17475,16520
2010/1/1,嘉義縣,民雄鄉,22483,72831,37465,35366
2010/1/1,嘉義縣,溪口鄉,5382,16533,8823,7710
2010/1/1,嘉義縣,新港鄉,10301,34998,18474,16524
2010/1/1,嘉義縣,六腳鄉,9127,26874,14245,12629
2010/1/1,嘉義縣,東石鄉,9411,28208,15006,13202
2010/1/1,嘉義縣,義竹鄉,7446,21586,11167,10419
2010/1/1,嘉義縣,鹿草鄉,5697,17437,9350,8087
2010/1/1,嘉義縣,水上鄉,17256,52540,27227,25313
2010/1/1,嘉義縣,中埔鄉,15085,47739,24976,22763
2010/1/1,嘉義縣,竹崎鄉,11250,38963,20758,18205
2010/1/1,嘉義縣,梅山鄉,6603,22050,11690,10360
2010/1/1,嘉義縣,番路鄉,3884,11745,6376,5369
2010/1/1,嘉義縣,大埔鄉,1961,4602,2436,2166
2010/1/1,嘉義縣,阿里山鄉,2044,6247,3351,2896
2010/1/1,臺南市,新營區,26847,78226,39136,39090
2010/1/1,臺南市,永康區,73588,214820,106967,107853
2010/1/1,臺南市,鹽水區,9868,27299,14223,13076
2010/1/1,臺南市,白河區,10872,31701,16653,15048
2010/1/1,臺南市,麻豆區,14905,46080,23573,22507
2010/1/1,臺南市,佳里區,19087,59453,29619,29834
2010/1/1,臺南市,新化區,13558,44338,22738,21600
2010/1/1,臺南市,善化區,14308,43352,21962,21390
2010/1/1,臺南市,學甲區,9469,28141,14403,13738
2010/1/1,臺南市,柳營區,7745,22945,12007,10938
2010/1/1,臺南市,後壁區,8716,26113,13607,12506
2010/1/1,臺南市,東山區,8173,23385,12476,10909
2010/1/1,臺南市,下營區,9056,26391,13695,12696
2010/1/1,臺南市,六甲區,7559,23953,12449,11504
2010/1/1,臺南市,官田區,7592,22424,11494,10930
2010/1/1,臺南市,大內區,4075,11064,5878,5186
2010/1/1,臺南市,西港區,7757,25339,12943,12396
2010/1/1,臺南市,七股區,7939,24945,13068,11877
2010/1/1,臺南市,將軍區,7416,21756,11087,10669
2010/1/1,臺南市,北門區,4362,12548,6403,6145
2010/1/1,臺南市,新市區,10669,34951,17582,17369
2010/1/1,臺南市,安定區,9156,30119,15590,14529
2010/1/1,臺南市,山上區,2728,8004,4209,3795
2010/1/1,臺南市,玉井區,5069,15568,8082,7486
2010/1/1,臺南市,楠西區,3594,10780,5726,5054
2010/1/1,臺南市,南化區,2822,9004,4929,4075
2010/1/1,臺南市,左鎮區,1977,5617,3113,2504
2010/1/1,臺南市,仁德區,24346,68973,35512,33461
2010/1/1,臺南市,歸仁區,20271,65929,33633,32296
2010/1/1,臺南市,關廟區,10635,36356,18890,17466
2010/1/1,臺南市,龍崎區,1594,4435,2403,2032
2010/1/1,高雄市,鳳山區,124932,340015,169905,170110
2010/1/1,高雄市,岡山區,32852,97112,48887,48225
2010/1/1,高雄市,旗山區,13736,40349,21082,19267
2010/1/1,高雄市,美濃區,13939,43408,22655,20753
2010/1/1,高雄市,林園區,23854,70757,36392,34365
2010/1/1,高雄市,大寮區,37788,109180,56786,52394
2010/1/1,高雄市,大樹區,13000,44204,22907,21297
2010/1/1,高雄市,仁武區,24869,70261,36348,33913
2010/1/1,高雄市,大社區,11556,32821,16903,15918
2010/1/1,高雄市,鳥松區,16266,42212,21467,20745
2010/1/1,高雄市,橋頭區,12367,36251,18609,17642
2010/1/1,高雄市,燕巢區,9916,31036,16607,14429
2010/1/1,高雄市,田寮區,3558,8316,4612,3704
2010/1/1,高雄市,阿蓮區,9089,30603,15451,15152
2010/1/1,高雄市,路竹區,15913,54115,27657,26458
2010/1/1,高雄市,湖內區,9409,28696,14819,13877
2010/1/1,高雄市,茄萣區,10094,31511,16479,15032
2010/1/1,高雄市,永安區,5774,14267,7292,6975
2010/1/1,高雄市,彌陀區,6533,20602,10720,9882
2010/1/1,高雄市,梓官區,11892,36842,19213,17629
2010/1/1,高雄市,六龜區,5819,15344,8321,7023
2010/1/1,高雄市,甲仙區,2566,7604,4092,3512
2010/1/1,高雄市,杉林區,4027,11067,6048,5019
2010/1/1,高雄市,內門區,5015,16094,8781,7313
2010/1/1,高雄市,茂林區,557,1849,947,902
2010/1/1,高雄市,桃源區,1290,4801,2552,2249
2010/1/1,高雄市,那瑪夏區,869,3466,1808,1658
2010/1/1,屏東縣,屏東市,72141,213416,106633,106783
2010/1/1,屏東縣,潮州鎮,17954,55895,28198,27697
2010/1/1,屏東縣,東港鎮,15411,50235,25538,24697
2010/1/1,屏東縣,恆春鎮,10661,31202,16062,15140
2010/1/1,屏東縣,萬丹鄉,14144,54275,28093,26182
2010/1/1,屏東縣,長治鄉,9648,30974,16205,14769
2010/1/1,屏東縣,麟洛鄉,3551,11648,6027,5621
2010/1/1,屏東縣,九如鄉,6511,22996,11973,11023
2010/1/1,屏東縣,里港鄉,7820,26232,13440,12792
2010/1/1,屏東縣,鹽埔鄉,7647,27452,14276,13176
2010/1/1,屏東縣,高樹鄉,9562,27196,14504,12692
2010/1/1,屏東縣,萬巒鄉,6382,22261,11710,10551
2010/1/1,屏東縣,內埔鄉,17595,58589,30502,28087
2010/1/1,屏東縣,竹田鄉,5459,18494,9838,8656
2010/1/1,屏東縣,新埤鄉,3348,10898,5768,5130
2010/1/1,屏東縣,枋寮鄉,8399,26943,14241,12702
2010/1/1,屏東縣,新園鄉,11289,38953,20108,18845
2010/1/1,屏東縣,崁頂鄉,4140,17349,8891,8458
2010/1/1,屏東縣,林邊鄉,6962,21148,10921,10227
2010/1/1,屏東縣,南州鄉,3660,11898,6116,5782
2010/1/1,屏東縣,佳冬鄉,7060,21693,11327,10366
2010/1/1,屏東縣,琉球鄉,3921,12635,6992,5643
2010/1/1,屏東縣,車城鄉,3503,10015,5401,4614
2010/1/1,屏東縣,滿州鄉,3050,8690,4750,3940
2010/1/1,屏東縣,枋山鄉,2084,6169,3299,2870
2010/1/1,屏東縣,三地門鄉,2141,7572,3872,3700
2010/1/1,屏東縣,霧臺鄉,956,2929,1546,1383
2010/1/1,屏東縣,瑪家鄉,1873,6576,3427,3149
2010/1/1,屏東縣,泰武鄉,1237,5156,2717,2439
2010/1/1,屏東縣,來義鄉,2144,7909,4065,3844
2010/1/1,屏東縣,春日鄉,1314,4868,2539,2329
2010/1/1,屏東縣,獅子鄉,1459,5021,2625,2396
2010/1/1,屏東縣,牡丹鄉,1865,5052,2607,2445
2010/1/1,臺東縣,臺東市,37681,109477,55631,53846
2010/1/1,臺東縣,成功鎮,5401,15979,8519,7460
2010/1/1,臺東縣,關山鎮,3211,9839,5168,4671
2010/1/1,臺東縣,卑南鄉,6560,18417,9981,8436
2010/1/1,臺東縣,大武鄉,2534,7196,3721,3475
2010/1/1,臺東縣,太麻里鄉,4525,12131,6488,5643
2010/1/1,臺東縣,東河鄉,3555,9557,5290,4267
2010/1/1,臺東縣,長濱鄉,2928,8536,4854,3682
2010/1/1,臺東縣,鹿野鄉,3115,8666,4677,3989
2010/1/1,臺東縣,池上鄉,3248,9361,4963,4398
2010/1/1,臺東縣,綠島鄉,979,3335,1793,1542
2010/1/1,臺東縣,延平鄉,1077,3673,2035,1638
2010/1/1,臺東縣,海端鄉,1092,4536,2471,2065
2010/1/1,臺東縣,達仁鄉,1496,4152,2259,1893
2010/1/1,臺東縣,金峰鄉,1033,3616,1879,1737
2010/1/1,臺東縣,蘭嶼鄉,1359,4350,2270,2080
2010/1/1,花蓮縣,花蓮市,40215,109813,53932,55881
2010/1/1,花蓮縣,鳳林鎮,4449,12155,6460,5695
2010/1/1,花蓮縣,玉里鎮,8925,27245,14809,12436
2010/1/1,花蓮縣,新城鄉,7232,20315,10586,9729
2010/1/1,花蓮縣,吉安鄉,28532,79461,40796,38665
2010/1/1,花蓮縣,壽豐鄉,6792,18923,10250,8673
2010/1/1,花蓮縣,光復鄉,4992,14341,7646,6695
2010/1/1,花蓮縣,豐濱鄉,1818,5183,2856,2327
2010/1/1,花蓮縣,瑞穗鄉,4629,13105,7062,6043
2010/1/1,花蓮縣,富里鄉,3981,11874,6514,5360
2010/1/1,花蓮縣,秀林鄉,4601,15165,7890,7275
2010/1/1,花蓮縣,萬榮鄉,2143,7016,3739,3277
2010/1/1,花蓮縣,卓溪鄉,1661,6430,3596,2834
2010/1/1,澎湖縣,馬公市,19541,56458,28633,27825
2010/1/1,澎湖縣,湖西鄉,4655,13622,7109,6513
2010/1/1,澎湖縣,白沙鄉,3114,9500,4979,4521
2010/1/1,澎湖縣,西嶼鄉,2811,8471,4390,4081
2010/1/1,澎湖縣,望安鄉,1866,4756,2567,2189
2010/1/1,澎湖縣,七美鄉,1222,3580,1880,1700
2010/1/1,基隆市,中正區,21992,56175,28843,27332
2010/1/1,基隆市,七堵區,19876,55497,28134,27363
2010/1/1,基隆市,暖暖區,14189,38097,19382,18715
2010/1/1,基隆市,仁愛區,19659,50382,24912,25470
2010/1/1,基隆市,中山區,18937,51576,26383,25193
2010/1/1,基隆市,安樂區,31643,84790,42266,42524
2010/1/1,基隆市,信義區,19867,51619,25902,25717
2010/1/1,新竹市,東區,66611,195108,96346,98762
2010/1/1,新竹市,北區,49657,144642,71561,73081
2010/1/1,新竹市,香山區,22504,72231,36848,35383
2010/1/1,臺中市,中區,8432,23188,11417,11771
2010/1/1,臺中市,東區,25595,73878,37403,36475
2010/1/1,臺中市,西區,42759,117399,56499,60900
2010/1/1,臺中市,南區,41280,112665,54745,57920
2010/1/1,臺中市,北區,54988,147527,71608,75919
2010/1/1,臺中市,西屯區,71206,203974,99239,104735
2010/1/1,臺中市,南屯區,51719,151006,72969,78037
2010/1/1,臺中市,北屯區,81858,244640,119084,125556
2010/1/1,嘉義市,東區,44535,127678,62387,65291
2010/1/1,嘉義市,西區,50029,146100,72538,73562
2010/1/1,臺南市,東區,70281,194410,94132,100278
2010/1/1,臺南市,南區,42784,126525,63594,62931
2010/1/1,臺南市,北區,47379,131211,64940,66271
2010/1/1,臺南市,安南區,53576,177235,90233,87002
2010/1/1,臺南市,安平區,22628,61837,29666,32171
2010/1/1,臺南市,中西區,29967,80017,39344,40673
2010/1/1,臺北市,松山區,77133,207945,98680,109265
2010/1/1,臺北市,信義區,85422,225282,108845,116437
2010/1/1,臺北市,大安區,115997,311299,146697,164602
2010/1/1,臺北市,中山區,90241,218167,102978,115189
2010/1/1,臺北市,中正區,61400,158674,76671,82003
2010/1/1,臺北市,大同區,46408,123463,60966,62497
2010/1/1,臺北市,萬華區,73178,188175,94202,93973
2010/1/1,臺北市,文山區,95832,260744,126530,134214
2010/1/1,臺北市,南港區,41001,113029,55889,57140
2010/1/1,臺北市,內湖區,94848,267734,129274,138460
2010/1/1,臺北市,士林區,99523,283724,138220,145504
2010/1/1,臺北市,北投區,88425,247915,120594,127321
2010/1/1,高雄市,鹽埕區,11131,27661,13937,13724
2010/1/1,高雄市,鼓山區,50967,129715,63744,65971
2010/1/1,高雄市,左營區,72511,190090,93778,96312
2010/1/1,高雄市,楠梓區,61004,171996,85500,86496
2010/1/1,高雄市,三民區,130249,355152,174162,180990
2010/1/1,高雄市,新興區,22841,55727,27213,28514
2010/1/1,高雄市,前金區,12523,29196,14298,14898
2010/1/1,高雄市,苓雅區,71246,185020,90251,94769
2010/1/1,高雄市,前鎮區,75654,199748,99594,100154
2010/1/1,高雄市,旗津區,10911,30006,15631,14375
2010/1/1,高雄市,小港區,62168,153895,77522,76373
2010/1/1,金門縣,金城鎮,10731,31680,16343,15337
2010/1/1,金門縣,金湖鎮,7062,20552,10674,9878
2010/1/1,金門縣,金沙鎮,5255,14904,7616,7288
2010/1/1,金門縣,金寧鄉,6052,17921,9362,8559
2010/1/1,金門縣,烈嶼鄉,2553,8641,4400,4241
2010/1/1,金門縣,烏坵鄉,136,507,257,250
2010/1/1,連江縣,南竿鄉,1183,5964,3449,2515
2010/1/1,連江縣,北竿鄉,379,1784,1028,756
2010/1/1,連江縣,莒光鄉,240,1184,702,482
2010/1/1,連江縣,東引鄉,266,1070,626,444
2010/2/1,總計,臺灣地區,7785506,23023327,11582345,11440982
2010/2/1,總計,臺灣省,6234329,18890003,9567981,9322022
2010/2/1,總計,新北市,1378679,3878282,1929080,1949202
2010/2/1,總計,宜蘭縣,152185,461901,235764,226137
2010/2/1,總計,桃園市,656191,1981364,999977,981387
2010/2/1,總計,新竹縣,158307,511608,263625,247983
2010/2/1,總計,苗栗縣,170487,561946,292201,269745
2010/2/1,總計,臺中市,460548,1562335,792547,769788
2010/2/1,總計,彰化縣,359808,1312355,674294,638061
2010/2/1,總計,南投縣,169494,530705,273427,257278
2010/2/1,總計,雲林縣,227463,722615,377679,344936
2010/2/1,總計,嘉義縣,174586,547628,285931,261697
2010/2/1,總計,臺南市,365907,1103642,563830,539812
2010/2/1,總計,高雄市,427827,1242834,637218,605616
2010/2/1,總計,屏東縣,275046,882191,454041,428150
2010/2/1,總計,臺東縣,79825,232913,122020,110893
2010/2/1,總計,花蓮縣,119971,340997,176092,164905
2010/2/1,總計,澎湖縣,33219,96426,49585,46841
2010/2/1,總計,基隆市,146166,388017,195721,192296
2010/2/1,總計,新竹市,138989,412233,204857,207376
2010/2/1,總計,臺中市,378185,1074897,523224,551673
2010/2/1,總計,嘉義市,94561,273691,134860,138831
2010/2/1,總計,臺南市,266885,771423,382008,389415
2010/2/1,總計,臺北市,969556,2605063,1258904,1346159
2010/2/1,總計,高雄市,581621,1528261,755460,772801
2010/2/1,總計,福建省,33914,104518,54585,49933
2010/2/1,總計,金門縣,31844,94474,48755,45719
2010/2/1,總計,連江縣,2070,10044,5830,4214
2010/2/1,新北市,板橋區,191116,553145,274169,278976
2010/2/1,新北市,三重區,137542,388740,194099,194641
2010/2/1,新北市,永和區,89352,236838,113806,123032
2010/2/1,新北市,中和區,153506,414740,205185,209555
2010/2/1,新北市,新莊區,134387,401022,198329,202693
2010/2/1,新北市,新店區,114508,295021,144839,150182
2010/2/1,新北市,土城區,81118,238934,119687,119247
2010/2/1,新北市,蘆洲區,64518,197326,97842,99484
2010/2/1,新北市,汐止區,77530,187562,93271,94291
2010/2/1,新北市,樹林區,57411,172608,87053,85555
2010/2/1,新北市,鶯歌區,26922,86615,43914,42701
2010/2/1,新北市,三峽區,34078,101077,51807,49270
2010/2/1,新北市,淡水區,55332,140667,68613,72054
2010/2/1,新北市,瑞芳區,15711,42660,21844,20816
2010/2/1,新北市,五股區,26853,79289,40337,38952
2010/2/1,新北市,泰山區,25907,76556,38530,38026
2010/2/1,新北市,林口區,28458,79289,39302,39987
2010/2/1,新北市,深坑區,8577,23149,11693,11456
2010/2/1,新北市,石碇區,3263,7955,4446,3509
2010/2/1,新北市,坪林區,2409,6537,3666,2871
2010/2/1,新北市,三芝區,8764,23336,12093,11243
2010/2/1,新北市,石門區,3901,12405,6541,5864
2010/2/1,新北市,八里區,11818,34031,17364,16667
2010/2/1,新北市,平溪區,2363,5431,3020,2411
2010/2/1,新北市,雙溪區,3803,9803,5289,4514
2010/2/1,新北市,貢寮區,4349,13825,7154,6671
2010/2/1,新北市,金山區,6587,22379,11278,11101
2010/2/1,新北市,萬里區,6903,21607,11003,10604
2010/2/1,新北市,烏來區,1693,5735,2906,2829
2010/2/1,宜蘭縣,宜蘭市,32829,95853,47301,48552
2010/2/1,宜蘭縣,羅東鎮,24638,72969,35111,37858
2010/2/1,宜蘭縣,蘇澳鎮,13486,43409,22306,21103
2010/2/1,宜蘭縣,頭城鎮,9597,31169,16124,15045
2010/2/1,宜蘭縣,礁溪鄉,12207,35940,18855,17085
2010/2/1,宜蘭縣,壯圍鄉,8015,25190,13270,11920
2010/2/1,宜蘭縣,員山鄉,10666,32384,17382,15002
2010/2/1,宜蘭縣,冬山鄉,17001,52358,27000,25358
2010/2/1,宜蘭縣,五結鄉,12766,38776,20187,18589
2010/2/1,宜蘭縣,三星鄉,7385,21678,11699,9979
2010/2/1,宜蘭縣,大同鄉,1818,6066,3298,2768
2010/2/1,宜蘭縣,南澳鄉,1777,6109,3231,2878
2010/2/1,桃園市,桃園區,140158,401596,196884,204712
2010/2/1,桃園市,中壢區,123828,365894,183058,182836
2010/2/1,桃園市,平鎮區,65187,206515,104047,102468
2010/2/1,桃園市,八德區,56721,175396,89444,85952
2010/2/1,桃園市,大溪區,28756,91776,47233,44543
2010/2/1,桃園市,楊梅區,47189,148410,75520,72890
2010/2/1,桃園市,蘆竹區,46603,139157,69841,69316
2010/2/1,桃園市,大園區,25556,81320,42247,39073
2010/2/1,桃園市,龜山區,48598,135872,68967,66905
2010/2/1,桃園市,龍潭區,36270,114344,58175,56169
2010/2/1,桃園市,新屋區,14822,49541,26431,23110
2010/2/1,桃園市,觀音區,18854,60835,32140,28695
2010/2/1,桃園市,復興區,3649,10708,5990,4718
2010/2/1,新竹縣,竹北市,45355,138525,69660,68865
2010/2/1,新竹縣,關西鎮,9208,32412,17246,15166
2010/2/1,新竹縣,新埔鎮,10284,35953,19029,16924
2010/2/1,新竹縣,竹東鎮,30209,96927,48927,48000
2010/2/1,新竹縣,湖口鄉,23118,75505,38590,36915
2010/2/1,新竹縣,橫山鄉,4380,14782,7985,6797
2010/2/1,新竹縣,新豐鄉,15386,52874,27321,25553
2010/2/1,新竹縣,芎林鄉,6272,20973,11048,9925
2010/2/1,新竹縣,寶山鄉,4615,14059,7597,6462
2010/2/1,新竹縣,北埔鄉,3091,10293,5574,4719
2010/2/1,新竹縣,峨眉鄉,2016,6112,3395,2717
2010/2/1,新竹縣,尖石鄉,2663,8411,4610,3801
2010/2/1,新竹縣,五峰鄉,1710,4782,2643,2139
2010/2/1,苗栗縣,苗栗市,28822,90775,45800,44975
2010/2/1,苗栗縣,苑裡鎮,13773,48981,25585,23396
2010/2/1,苗栗縣,通霄鎮,11247,38473,20486,17987
2010/2/1,苗栗縣,竹南鎮,23551,77519,39429,38090
2010/2/1,苗栗縣,頭份市,28931,96308,49127,47181
2010/2/1,苗栗縣,後龍鎮,11593,39788,21070,18718
2010/2/1,苗栗縣,卓蘭鎮,5906,18522,9776,8746
2010/2/1,苗栗縣,大湖鄉,5300,16144,8666,7478
2010/2/1,苗栗縣,公館鄉,10043,34829,18314,16515
2010/2/1,苗栗縣,銅鑼鄉,5956,19622,10386,9236
2010/2/1,苗栗縣,南庄鄉,3973,11335,6263,5072
2010/2/1,苗栗縣,頭屋鄉,3503,11699,6182,5517
2010/2/1,苗栗縣,三義鄉,5263,17716,9335,8381
2010/2/1,苗栗縣,西湖鄉,2672,7959,4397,3562
2010/2/1,苗栗縣,造橋鄉,3950,13736,7268,6468
2010/2/1,苗栗縣,三灣鄉,2384,7401,4009,3392
2010/2/1,苗栗縣,獅潭鄉,1680,5043,2814,2229
2010/2/1,苗栗縣,泰安鄉,1940,6096,3294,2802
2010/2/1,臺中市,豐原區,48962,165313,82159,83154
2010/2/1,臺中市,大里區,60606,196335,97585,98750
2010/2/1,臺中市,太平區,53949,172412,86657,85755
2010/2/1,臺中市,東勢區,16855,53624,27842,25782
2010/2/1,臺中市,大甲區,21416,78739,40016,38723
2010/2/1,臺中市,清水區,24664,85681,44243,41438
2010/2/1,臺中市,沙鹿區,23125,80777,41172,39605
2010/2/1,臺中市,梧棲區,15790,54999,27925,27074
2010/2/1,臺中市,后里區,14649,54344,28003,26341
2010/2/1,臺中市,神岡區,17415,63936,33011,30925
2010/2/1,臺中市,潭子區,31964,99660,49811,49849
2010/2/1,臺中市,大雅區,25953,89532,45176,44356
2010/2/1,臺中市,新社區,7292,25737,13535,12202
2010/2/1,臺中市,石岡區,4820,16135,8425,7710
2010/2/1,臺中市,外埔區,8730,31963,16476,15487
2010/2/1,臺中市,大安區,5207,20368,10725,9643
2010/2/1,臺中市,烏日區,20117,68370,34689,33681
2010/2/1,臺中市,大肚區,15683,55872,28672,27200
2010/2/1,臺中市,龍井區,20332,73982,37702,36280
2010/2/1,臺中市,霧峰區,18555,63844,32867,30977
2010/2/1,臺中市,和平區,4464,10712,5856,4856
2010/2/1,彰化縣,彰化市,70999,237167,118304,118863
2010/2/1,彰化縣,鹿港鎮,22044,85426,43822,41604
2010/2/1,彰化縣,和美鎮,23784,89624,46020,43604
2010/2/1,彰化縣,北斗鎮,9814,33646,17071,16575
2010/2/1,彰化縣,員林市,36365,125894,63366,62528
2010/2/1,彰化縣,溪湖鎮,14947,56346,28833,27513
2010/2/1,彰化縣,田中鎮,12454,44427,23131,21296
2010/2/1,彰化縣,二林鎮,14197,54447,28095,26352
2010/2/1,彰化縣,線西鄉,4083,17129,8806,8323
2010/2/1,彰化縣,伸港鄉,8863,35982,18547,17435
2010/2/1,彰化縣,福興鄉,11903,49091,25704,23387
2010/2/1,彰化縣,秀水鄉,9572,39010,20250,18760
2010/2/1,彰化縣,花壇鄉,12802,46230,23849,22381
2010/2/1,彰化縣,芬園鄉,6859,24987,13258,11729
2010/2/1,彰化縣,大村鄉,10096,36626,19079,17547
2010/2/1,彰化縣,埔鹽鄉,8718,34505,18097,16408
2010/2/1,彰化縣,埔心鄉,9818,35366,18329,17037
2010/2/1,彰化縣,永靖鄉,10317,39530,20509,19021
2010/2/1,彰化縣,社頭鄉,12244,45027,23205,21822
2010/2/1,彰化縣,二水鄉,5305,16754,8809,7945
2010/2/1,彰化縣,田尾鄉,7628,28885,15067,13818
2010/2/1,彰化縣,埤頭鄉,8476,31971,16713,15258
2010/2/1,彰化縣,芳苑鄉,9935,36554,19402,17152
2010/2/1,彰化縣,大城鄉,5379,19231,10461,8770
2010/2/1,彰化縣,竹塘鄉,4573,16654,8762,7892
2010/2/1,彰化縣,溪州鄉,8633,31846,16805,15041
2010/2/1,南投縣,南投市,33020,104617,52683,51934
2010/2/1,南投縣,埔里鎮,28062,85643,43211,42432
2010/2/1,南投縣,草屯鎮,30670,100275,50745,49530
2010/2/1,南投縣,竹山鎮,18846,58780,30365,28415
2010/2/1,南投縣,集集鎮,4325,12273,6440,5833
2010/2/1,南投縣,名間鄉,12015,41486,21793,19693
2010/2/1,南投縣,鹿谷鄉,6633,19348,10267,9081
2010/2/1,南投縣,中寮鄉,5611,16367,8890,7477
2010/2/1,南投縣,魚池鄉,5792,17446,9217,8229
2010/2/1,南投縣,國姓鄉,7217,20971,11460,9511
2010/2/1,南投縣,水里鄉,7225,20317,10661,9656
2010/2/1,南投縣,信義鄉,5171,17463,9439,8024
2010/2/1,南投縣,仁愛鄉,4907,15719,8256,7463
2010/2/1,雲林縣,斗六市,34273,106825,53776,53049
2010/2/1,雲林縣,斗南鎮,15103,47441,24138,23303
2010/2/1,雲林縣,虎尾鎮,22192,70265,35785,34480
2010/2/1,雲林縣,西螺鎮,13922,48951,24909,24042
2010/2/1,雲林縣,土庫鎮,8652,30724,16084,14640
2010/2/1,雲林縣,北港鎮,15161,43469,22634,20835
2010/2/1,雲林縣,古坑鄉,10610,34584,18288,16296
2010/2/1,雲林縣,大埤鄉,6609,21448,11462,9986
2010/2/1,雲林縣,莿桐鄉,8942,30672,16077,14595
2010/2/1,雲林縣,林內鄉,5739,19996,10448,9548
2010/2/1,雲林縣,二崙鄉,8745,29968,16073,13895
2010/2/1,雲林縣,崙背鄉,8281,27768,14651,13117
2010/2/1,雲林縣,麥寮鄉,12060,35070,18484,16586
2010/2/1,雲林縣,東勢鄉,5712,17172,9323,7849
2010/2/1,雲林縣,褒忠鄉,4285,14603,7777,6826
2010/2/1,雲林縣,臺西鄉,8805,26565,14293,12272
2010/2/1,雲林縣,元長鄉,9327,29369,15986,13383
2010/2/1,雲林縣,四湖鄉,9053,27280,14884,12396
2010/2/1,雲林縣,口湖鄉,9637,30973,16504,14469
2010/2/1,雲林縣,水林鄉,10355,29472,16103,13369
2010/2/1,嘉義縣,太保市,11028,36329,18771,17558
2010/2/1,嘉義縣,朴子市,14341,44356,22634,21722
2010/2/1,嘉義縣,布袋鎮,10126,30740,15808,14932
2010/2/1,嘉義縣,大林鎮,11125,33972,17467,16505
2010/2/1,嘉義縣,民雄鄉,22495,72855,37477,35378
2010/2/1,嘉義縣,溪口鄉,5383,16515,8805,7710
2010/2/1,嘉義縣,新港鄉,10307,35023,18483,16540
2010/2/1,嘉義縣,六腳鄉,9121,26822,14222,12600
2010/2/1,嘉義縣,東石鄉,9418,28190,14996,13194
2010/2/1,嘉義縣,義竹鄉,7438,21547,11145,10402
2010/2/1,嘉義縣,鹿草鄉,5692,17416,9341,8075
2010/2/1,嘉義縣,水上鄉,17256,52494,27205,25289
2010/2/1,嘉義縣,中埔鄉,15092,47730,24966,22764
2010/2/1,嘉義縣,竹崎鄉,11252,38941,20738,18203
2010/2/1,嘉義縣,梅山鄉,6605,22048,11686,10362
2010/2/1,嘉義縣,番路鄉,3889,11773,6396,5377
2010/2/1,嘉義縣,大埔鄉,1968,4625,2440,2185
2010/2/1,嘉義縣,阿里山鄉,2050,6252,3351,2901
2010/2/1,臺南市,新營區,26850,78224,39129,39095
2010/2/1,臺南市,永康區,73684,214977,107056,107921
2010/2/1,臺南市,鹽水區,9862,27279,14213,13066
2010/2/1,臺南市,白河區,10872,31683,16639,15044
2010/2/1,臺南市,麻豆區,14923,46063,23572,22491
2010/2/1,臺南市,佳里區,19094,59419,29600,29819
2010/2/1,臺南市,新化區,13579,44345,22733,21612
2010/2/1,臺南市,善化區,14322,43356,21958,21398
2010/2/1,臺南市,學甲區,9461,28103,14382,13721
2010/2/1,臺南市,柳營區,7748,22922,11985,10937
2010/2/1,臺南市,後壁區,8715,26081,13598,12483
2010/2/1,臺南市,東山區,8178,23353,12454,10899
2010/2/1,臺南市,下營區,9051,26357,13679,12678
2010/2/1,臺南市,六甲區,7564,23944,12441,11503
2010/2/1,臺南市,官田區,7585,22382,11467,10915
2010/2/1,臺南市,大內區,4077,11037,5869,5168
2010/2/1,臺南市,西港區,7759,25315,12927,12388
2010/2/1,臺南市,七股區,7941,24954,13082,11872
2010/2/1,臺南市,將軍區,7406,21719,11063,10656
2010/2/1,臺南市,北門區,4359,12535,6397,6138
2010/2/1,臺南市,新市區,10665,34907,17557,17350
2010/2/1,臺南市,安定區,9165,30112,15595,14517
2010/2/1,臺南市,山上區,2726,7996,4207,3789
2010/2/1,臺南市,玉井區,5064,15556,8083,7473
2010/2/1,臺南市,楠西區,3595,10778,5722,5056
2010/2/1,臺南市,南化區,2825,8988,4916,4072
2010/2/1,臺南市,左鎮區,1975,5599,3104,2495
2010/2/1,臺南市,仁德區,24348,68956,35492,33464
2010/2/1,臺南市,歸仁區,20281,65957,33643,32314
2010/2/1,臺南市,關廟區,10641,36315,18868,17447
2010/2/1,臺南市,龍崎區,1592,4430,2399,2031
2010/2/1,高雄市,鳳山區,125062,340098,169887,170211
2010/2/1,高雄市,岡山區,32849,97127,48867,48260
2010/2/1,高雄市,旗山區,13740,40336,21067,19269
2010/2/1,高雄市,美濃區,13955,43391,22639,20752
2010/2/1,高雄市,林園區,23872,70740,36359,34381
2010/2/1,高雄市,大寮區,37797,109084,56739,52345
2010/2/1,高雄市,大樹區,13022,44198,22912,21286
2010/2/1,高雄市,仁武區,24914,70385,36417,33968
2010/2/1,高雄市,大社區,11562,32854,16919,15935
2010/2/1,高雄市,鳥松區,16299,42262,21503,20759
2010/2/1,高雄市,橋頭區,12380,36266,18610,17656
2010/2/1,高雄市,燕巢區,9915,31018,16583,14435
2010/2/1,高雄市,田寮區,3555,8296,4604,3692
2010/2/1,高雄市,阿蓮區,9095,30579,15439,15140
2010/2/1,高雄市,路竹區,15919,54099,27648,26451
2010/2/1,高雄市,湖內區,9416,28702,14819,13883
2010/2/1,高雄市,茄萣區,10093,31494,16465,15029
2010/2/1,高雄市,永安區,5783,14276,7293,6983
2010/2/1,高雄市,彌陀區,6534,20595,10715,9880
2010/2/1,高雄市,梓官區,11890,36829,19195,17634
2010/2/1,高雄市,六龜區,5820,15343,8316,7027
2010/2/1,高雄市,甲仙區,2566,7608,4092,3516
2010/2/1,高雄市,杉林區,4029,11055,6048,5007
2010/2/1,高雄市,內門區,5017,16067,8771,7296
2010/2/1,高雄市,茂林區,560,1852,948,904
2010/2/1,高雄市,桃源區,1311,4815,2561,2254
2010/2/1,高雄市,那瑪夏區,872,3465,1802,1663
2010/2/1,屏東縣,屏東市,72155,213265,106574,106691
2010/2/1,屏東縣,潮州鎮,17956,55830,28154,27676
2010/2/1,屏東縣,東港鎮,15449,50321,25546,24775
2010/2/1,屏東縣,恆春鎮,10672,31216,16062,15154
2010/2/1,屏東縣,萬丹鄉,14140,54259,28087,26172
2010/2/1,屏東縣,長治鄉,9645,30992,16206,14786
2010/2/1,屏東縣,麟洛鄉,3549,11651,6034,5617
2010/2/1,屏東縣,九如鄉,6508,22996,11967,11029
2010/2/1,屏東縣,里港鄉,7816,26209,13422,12787
2010/2/1,屏東縣,鹽埔鄉,7655,27454,14270,13184
2010/2/1,屏東縣,高樹鄉,9570,27193,14514,12679
2010/2/1,屏東縣,萬巒鄉,6383,22243,11703,10540
2010/2/1,屏東縣,內埔鄉,17596,58593,30469,28124
2010/2/1,屏東縣,竹田鄉,5460,18484,9840,8644
2010/2/1,屏東縣,新埤鄉,3350,10908,5777,5131
2010/2/1,屏東縣,枋寮鄉,8409,26938,14230,12708
2010/2/1,屏東縣,新園鄉,11307,38928,20078,18850
2010/2/1,屏東縣,崁頂鄉,4148,17353,8902,8451
2010/2/1,屏東縣,林邊鄉,6976,21138,10916,10222
2010/2/1,屏東縣,南州鄉,3664,11907,6119,5788
2010/2/1,屏東縣,佳冬鄉,7063,21659,11308,10351
2010/2/1,屏東縣,琉球鄉,3920,12620,6984,5636
2010/2/1,屏東縣,車城鄉,3508,9997,5394,4603
2010/2/1,屏東縣,滿州鄉,3049,8675,4747,3928
2010/2/1,屏東縣,枋山鄉,2085,6164,3292,2872
2010/2/1,屏東縣,三地門鄉,2149,7582,3880,3702
2010/2/1,屏東縣,霧臺鄉,962,2959,1559,1400
2010/2/1,屏東縣,瑪家鄉,1874,6572,3428,3144
2010/2/1,屏東縣,泰武鄉,1235,5165,2719,2446
2010/2/1,屏東縣,來義鄉,2145,7912,4069,3843
2010/2/1,屏東縣,春日鄉,1317,4872,2538,2334
2010/2/1,屏東縣,獅子鄉,1459,5057,2637,2420
2010/2/1,屏東縣,牡丹鄉,1872,5079,2616,2463
2010/2/1,臺東縣,臺東市,37700,109387,55571,53816
2010/2/1,臺東縣,成功鎮,5399,15998,8528,7470
2010/2/1,臺東縣,關山鎮,3210,9838,5160,4678
2010/2/1,臺東縣,卑南鄉,6549,18399,9971,8428
2010/2/1,臺東縣,大武鄉,2531,7225,3730,3495
2010/2/1,臺東縣,太麻里鄉,4528,12136,6494,5642
2010/2/1,臺東縣,東河鄉,3560,9564,5300,4264
2010/2/1,臺東縣,長濱鄉,2931,8548,4859,3689
2010/2/1,臺東縣,鹿野鄉,3120,8672,4681,3991
2010/2/1,臺東縣,池上鄉,3244,9347,4956,4391
2010/2/1,臺東縣,綠島鄉,980,3328,1788,1540
2010/2/1,臺東縣,延平鄉,1080,3697,2041,1656
2010/2/1,臺東縣,海端鄉,1091,4543,2470,2073
2010/2/1,臺東縣,達仁鄉,1499,4199,2282,1917
2010/2/1,臺東縣,金峰鄉,1036,3657,1902,1755
2010/2/1,臺東縣,蘭嶼鄉,1367,4375,2287,2088
2010/2/1,花蓮縣,花蓮市,40186,109747,53898,55849
2010/2/1,花蓮縣,鳳林鎮,4450,12146,6451,5695
2010/2/1,花蓮縣,玉里鎮,8927,27259,14808,12451
2010/2/1,花蓮縣,新城鄉,7222,20265,10559,9706
2010/2/1,花蓮縣,吉安鄉,28566,79507,40808,38699
2010/2/1,花蓮縣,壽豐鄉,6791,18886,10233,8653
2010/2/1,花蓮縣,光復鄉,4990,14340,7645,6695
2010/2/1,花蓮縣,豐濱鄉,1821,5250,2885,2365
2010/2/1,花蓮縣,瑞穗鄉,4626,13076,7047,6029
2010/2/1,花蓮縣,富里鄉,3977,11871,6512,5359
2010/2/1,花蓮縣,秀林鄉,4611,15205,7911,7294
2010/2/1,花蓮縣,萬榮鄉,2145,7003,3733,3270
2010/2/1,花蓮縣,卓溪鄉,1659,6442,3602,2840
2010/2/1,澎湖縣,馬公市,19540,56419,28611,27808
2010/2/1,澎湖縣,湖西鄉,4660,13665,7128,6537
2010/2/1,澎湖縣,白沙鄉,3115,9521,4995,4526
2010/2/1,澎湖縣,西嶼鄉,2813,8471,4388,4083
2010/2/1,澎湖縣,望安鄉,1867,4761,2569,2192
2010/2/1,澎湖縣,七美鄉,1224,3589,1894,1695
2010/2/1,基隆市,中正區,22006,56163,28829,27334
2010/2/1,基隆市,七堵區,19872,55495,28135,27360
2010/2/1,基隆市,暖暖區,14195,38128,19396,18732
2010/2/1,基隆市,仁愛區,19676,50394,24906,25488
2010/2/1,基隆市,中山區,18942,51570,26358,25212
2010/2/1,基隆市,安樂區,31626,84711,42244,42467
2010/2/1,基隆市,信義區,19849,51556,25853,25703
2010/2/1,新竹市,東區,66754,195296,96444,98852
2010/2/1,新竹市,北區,49714,144666,71550,73116
2010/2/1,新竹市,香山區,22521,72271,36863,35408
2010/2/1,臺中市,中區,8415,23129,11388,11741
2010/2/1,臺中市,東區,25590,73850,37385,36465
2010/2/1,臺中市,西區,42787,117431,56507,60924
2010/2/1,臺中市,南區,41291,112682,54774,57908
2010/2/1,臺中市,北區,55063,147653,71674,75979
2010/2/1,臺中市,西屯區,71283,204145,99278,104867
2010/2/1,臺中市,南屯區,51818,151214,73063,78151
2010/2/1,臺中市,北屯區,81938,244793,119155,125638
2010/2/1,嘉義市,東區,44021,126209,61663,64546
2010/2/1,嘉義市,西區,50540,147482,73197,74285
2010/2/1,臺南市,東區,70336,194461,94179,100282
2010/2/1,臺南市,南區,42799,126495,63564,62931
2010/2/1,臺南市,北區,47464,131262,64950,66312
2010/2/1,臺南市,安南區,53614,177222,90227,86995
2010/2/1,臺南市,安平區,22668,61883,29698,32185
2010/2/1,臺南市,中西區,30004,80100,39390,40710
2010/2/1,臺北市,松山區,77129,207907,98659,109248
2010/2/1,臺北市,信義區,85383,225074,108729,116345
2010/2/1,臺北市,大安區,115930,311136,146584,164552
2010/2/1,臺北市,中山區,90315,218219,103017,115202
2010/2/1,臺北市,中正區,61450,158685,76647,82038
2010/2/1,臺北市,大同區,46419,123388,60949,62439
2010/2/1,臺北市,萬華區,73176,188025,94105,93920
2010/2/1,臺北市,文山區,95837,260651,126478,134173
2010/2/1,臺北市,南港區,41017,112956,55834,57122
2010/2/1,臺北市,內湖區,94903,267656,129255,138401
2010/2/1,臺北市,士林區,99562,283601,138148,145453
2010/2/1,臺北市,北投區,88435,247765,120499,127266
2010/2/1,高雄市,鹽埕區,11140,27688,13936,13752
2010/2/1,高雄市,鼓山區,51061,129864,63810,66054
2010/2/1,高雄市,左營區,72608,190152,93783,96369
2010/2/1,高雄市,楠梓區,61060,172112,85555,86557
2010/2/1,高雄市,三民區,130315,355015,174063,180952
2010/2/1,高雄市,新興區,22843,55687,27184,28503
2010/2/1,高雄市,前金區,12520,29131,14264,14867
2010/2/1,高雄市,苓雅區,71269,185050,90245,94805
2010/2/1,高雄市,前鎮區,75719,199772,99554,100218
2010/2/1,高雄市,旗津區,10906,29975,15613,14362
2010/2/1,高雄市,小港區,62180,153815,77453,76362
2010/2/1,金門縣,金城鎮,10746,31741,16366,15375
2010/2/1,金門縣,金湖鎮,7081,20629,10705,9924
2010/2/1,金門縣,金沙鎮,5265,14953,7635,7318
2010/2/1,金門縣,金寧鄉,6062,17968,9377,8591
2010/2/1,金門縣,烈嶼鄉,2554,8675,4415,4260
2010/2/1,金門縣,烏坵鄉,136,508,257,251
2010/2/1,連江縣,南竿鄉,1185,5994,3475,2519
2010/2/1,連江縣,北竿鄉,379,1802,1038,764
2010/2/1,連江縣,莒光鄉,237,1171,689,482
2010/2/1,連江縣,東引鄉,269,1077,628,449
2010/3/1,總計,臺灣地區,7801380,23026376,11581960,11444416
2010/3/1,總計,臺灣省,6248044,18893326,9568106,9325220
2010/3/1,總計,新北市,1382479,3882039,1930746,1951293
2010/3/1,總計,宜蘭縣,152429,461783,235658,226125
2010/3/1,總計,桃園市,658073,1982961,1000628,982333
2010/3/1,總計,新竹縣,158727,511852,263709,248143
2010/3/1,總計,苗栗縣,170802,561622,291998,269624
2010/3/1,總計,臺中市,461771,1562657,792672,769985
2010/3/1,總計,彰化縣,360359,1311701,673899,637802
2010/3/1,總計,南投縣,169644,530198,273116,257082
2010/3/1,總計,雲林縣,227653,721784,377165,344619
2010/3/1,總計,嘉義縣,174863,546901,285574,261327
2010/3/1,總計,臺南市,366516,1103517,563709,539808
2010/3/1,總計,高雄市,428619,1242985,637063,605922
2010/3/1,總計,屏東縣,275468,881385,453566,427819
2010/3/1,總計,臺東縣,79922,232688,121914,110774
2010/3/1,總計,花蓮縣,120153,340794,175916,164878
2010/3/1,總計,澎湖縣,33333,96459,49593,46866
2010/3/1,總計,基隆市,146308,387624,195504,192120
2010/3/1,總計,新竹市,139410,412850,205108,207742
2010/3/1,總計,臺中市,379351,1076161,523696,552465
2010/3/1,總計,嘉義市,94713,273717,134840,138877
2010/3/1,總計,臺南市,267451,771648,382032,389616
2010/3/1,總計,臺北市,970913,2604744,1258557,1346187
2010/3/1,總計,高雄市,582423,1528306,755297,773009
2010/3/1,總計,福建省,33995,104717,54613,50104
2010/3/1,總計,金門縣,31928,94701,48804,45897
2010/3/1,總計,連江縣,2067,10016,5809,4207
2010/3/1,新北市,板橋區,191617,553666,274412,279254
2010/3/1,新北市,三重區,138004,389201,194356,194845
2010/3/1,新北市,永和區,89470,236824,113788,123036
2010/3/1,新北市,中和區,153778,414849,205227,209622
2010/3/1,新北市,新莊區,134776,401306,198454,202852
2010/3/1,新北市,新店區,114783,295171,144893,150278
2010/3/1,新北市,土城區,81201,238806,119632,119174
2010/3/1,新北市,蘆洲區,64673,197524,97919,99605
2010/3/1,新北市,汐止區,77746,187961,93432,94529
2010/3/1,新北市,樹林區,57685,173027,87239,85788
2010/3/1,新北市,鶯歌區,26992,86620,43924,42696
2010/3/1,新北市,三峽區,34239,101353,51909,49444
2010/3/1,新北市,淡水區,55636,141130,68818,72312
2010/3/1,新北市,瑞芳區,15720,42619,21814,20805
2010/3/1,新北市,五股區,26896,79318,40334,38984
2010/3/1,新北市,泰山區,25946,76589,38524,38065
2010/3/1,新北市,林口區,28752,79898,39614,40284
2010/3/1,新北市,深坑區,8606,23124,11680,11444
2010/3/1,新北市,石碇區,3276,7971,4462,3509
2010/3/1,新北市,坪林區,2413,6529,3662,2867
2010/3/1,新北市,三芝區,8772,23356,12110,11246
2010/3/1,新北市,石門區,3912,12402,6537,5865
2010/3/1,新北市,八里區,11857,34072,17367,16705
2010/3/1,新北市,平溪區,2366,5392,3008,2384
2010/3/1,新北市,雙溪區,3810,9805,5295,4510
2010/3/1,新北市,貢寮區,4351,13784,7138,6646
2010/3/1,新北市,金山區,6594,22388,11282,11106
2010/3/1,新北市,萬里區,6916,21633,11012,10621
2010/3/1,新北市,烏來區,1692,5721,2904,2817
2010/3/1,宜蘭縣,宜蘭市,32859,95862,47294,48568
2010/3/1,宜蘭縣,羅東鎮,24685,72975,35107,37868
2010/3/1,宜蘭縣,蘇澳鎮,13519,43383,22287,21096
2010/3/1,宜蘭縣,頭城鎮,9611,31134,16104,15030
2010/3/1,宜蘭縣,礁溪鄉,12217,35923,18850,17073
2010/3/1,宜蘭縣,壯圍鄉,8015,25159,13247,11912
2010/3/1,宜蘭縣,員山鄉,10671,32367,17356,15011
2010/3/1,宜蘭縣,冬山鄉,17056,52393,27004,25389
2010/3/1,宜蘭縣,五結鄉,12786,38783,20196,18587
2010/3/1,宜蘭縣,三星鄉,7402,21642,11688,9954
2010/3/1,宜蘭縣,大同鄉,1824,6055,3293,2762
2010/3/1,宜蘭縣,南澳鄉,1784,6107,3232,2875
2010/3/1,桃園市,桃園區,140552,402014,197032,204982
2010/3/1,桃園市,中壢區,124161,366099,183126,182973
2010/3/1,桃園市,平鎮區,65408,206723,104160,102563
2010/3/1,桃園市,八德區,56895,175471,89462,86009
2010/3/1,桃園市,大溪區,28800,91827,47273,44554
2010/3/1,桃園市,楊梅區,47344,148717,75635,73082
2010/3/1,桃園市,蘆竹區,46750,139397,69933,69464
2010/3/1,桃園市,大園區,25646,81428,42307,39121
2010/3/1,桃園市,龜山區,48771,135966,69045,66921
2010/3/1,桃園市,龍潭區,36343,114345,58155,56190
2010/3/1,桃園市,新屋區,14826,49463,26388,23075
2010/3/1,桃園市,觀音區,18916,60811,32121,28690
2010/3/1,桃園市,復興區,3661,10700,5991,4709
2010/3/1,新竹縣,竹北市,45580,138985,69840,69145
2010/3/1,新竹縣,關西鎮,9217,32363,17216,15147
2010/3/1,新竹縣,新埔鎮,10288,35897,19007,16890
2010/3/1,新竹縣,竹東鎮,30270,96903,48901,48002
2010/3/1,新竹縣,湖口鄉,23171,75498,38624,36874
2010/3/1,新竹縣,橫山鄉,4388,14763,7971,6792
2010/3/1,新竹縣,新豐鄉,15422,52933,27344,25589
2010/3/1,新竹縣,芎林鄉,6280,20954,11044,9910
2010/3/1,新竹縣,寶山鄉,4625,14021,7582,6439
2010/3/1,新竹縣,北埔鄉,3088,10286,5573,4713
2010/3/1,新竹縣,峨眉鄉,2016,6095,3382,2713
2010/3/1,新竹縣,尖石鄉,2663,8384,4597,3787
2010/3/1,新竹縣,五峰鄉,1719,4770,2628,2142
2010/3/1,苗栗縣,苗栗市,28858,90696,45757,44939
2010/3/1,苗栗縣,苑裡鎮,13781,48884,25544,23340
2010/3/1,苗栗縣,通霄鎮,11272,38401,20441,17960
2010/3/1,苗栗縣,竹南鎮,23634,77639,39501,38138
2010/3/1,苗栗縣,頭份市,29018,96389,49155,47234
2010/3/1,苗栗縣,後龍鎮,11604,39731,21047,18684
2010/3/1,苗栗縣,卓蘭鎮,5921,18513,9761,8752
2010/3/1,苗栗縣,大湖鄉,5297,16129,8640,7489
2010/3/1,苗栗縣,公館鄉,10067,34823,18305,16518
2010/3/1,苗栗縣,銅鑼鄉,5962,19572,10356,9216
2010/3/1,苗栗縣,南庄鄉,3984,11350,6270,5080
2010/3/1,苗栗縣,頭屋鄉,3506,11664,6162,5502
2010/3/1,苗栗縣,三義鄉,5261,17682,9316,8366
2010/3/1,苗栗縣,西湖鄉,2670,7946,4389,3557
2010/3/1,苗栗縣,造橋鄉,3954,13723,7257,6466
2010/3/1,苗栗縣,三灣鄉,2387,7363,3998,3365
2010/3/1,苗栗縣,獅潭鄉,1684,5031,2807,2224
2010/3/1,苗栗縣,泰安鄉,1942,6086,3292,2794
2010/3/1,臺中市,豐原區,49126,165404,82224,83180
2010/3/1,臺中市,大里區,60805,196609,97682,98927
2010/3/1,臺中市,太平區,54104,172507,86723,85784
2010/3/1,臺中市,東勢區,16871,53580,27826,25754
2010/3/1,臺中市,大甲區,21476,78766,40043,38723
2010/3/1,臺中市,清水區,24731,85689,44261,41428
2010/3/1,臺中市,沙鹿區,23221,80824,41191,39633
2010/3/1,臺中市,梧棲區,15809,54962,27899,27063
2010/3/1,臺中市,后里區,14663,54280,27955,26325
2010/3/1,臺中市,神岡區,17434,63872,32968,30904
2010/3/1,臺中市,潭子區,32066,99741,49819,49922
2010/3/1,臺中市,大雅區,26023,89574,45211,44363
2010/3/1,臺中市,新社區,7305,25692,13506,12186
2010/3/1,臺中市,石岡區,4828,16150,8426,7724
2010/3/1,臺中市,外埔區,8761,31990,16483,15507
2010/3/1,臺中市,大安區,5209,20337,10710,9627
2010/3/1,臺中市,烏日區,20178,68379,34692,33687
2010/3/1,臺中市,大肚區,15719,55890,28692,27198
2010/3/1,臺中市,龍井區,20387,73943,37684,36259
2010/3/1,臺中市,霧峰區,18595,63756,32826,30930
2010/3/1,臺中市,和平區,4460,10712,5851,4861
2010/3/1,彰化縣,彰化市,71134,237101,118259,118842
2010/3/1,彰化縣,鹿港鎮,22075,85383,43800,41583
2010/3/1,彰化縣,和美鎮,23810,89627,46003,43624
2010/3/1,彰化縣,北斗鎮,9825,33625,17061,16564
2010/3/1,彰化縣,員林市,36432,125994,63406,62588
2010/3/1,彰化縣,溪湖鎮,14968,56396,28863,27533
2010/3/1,彰化縣,田中鎮,12468,44371,23110,21261
2010/3/1,彰化縣,二林鎮,14207,54357,28049,26308
2010/3/1,彰化縣,線西鄉,4098,17124,8799,8325
2010/3/1,彰化縣,伸港鄉,8873,35970,18535,17435
2010/3/1,彰化縣,福興鄉,11946,49100,25690,23410
2010/3/1,彰化縣,秀水鄉,9597,39048,20267,18781
2010/3/1,彰化縣,花壇鄉,12823,46194,23840,22354
2010/3/1,彰化縣,芬園鄉,6864,24948,13241,11707
2010/3/1,彰化縣,大村鄉,10119,36592,19068,17524
2010/3/1,彰化縣,埔鹽鄉,8741,34467,18075,16392
2010/3/1,彰化縣,埔心鄉,9832,35327,18309,17018
2010/3/1,彰化縣,永靖鄉,10337,39480,20491,18989
2010/3/1,彰化縣,社頭鄉,12248,44977,23163,21814
2010/3/1,彰化縣,二水鄉,5309,16743,8799,7944
2010/3/1,彰化縣,田尾鄉,7624,28874,15066,13808
2010/3/1,彰化縣,埤頭鄉,8491,31949,16699,15250
2010/3/1,彰化縣,芳苑鄉,9933,36465,19362,17103
2010/3/1,彰化縣,大城鄉,5385,19182,10429,8753
2010/3/1,彰化縣,竹塘鄉,4576,16609,8742,7867
2010/3/1,彰化縣,溪州鄉,8644,31798,16773,15025
2010/3/1,南投縣,南投市,33057,104590,52640,51950
2010/3/1,南投縣,埔里鎮,28090,85544,43177,42367
2010/3/1,南投縣,草屯鎮,30717,100212,50709,49503
2010/3/1,南投縣,竹山鎮,18870,58713,30324,28389
2010/3/1,南投縣,集集鎮,4320,12254,6429,5825
2010/3/1,南投縣,名間鄉,12035,41449,21767,19682
2010/3/1,南投縣,鹿谷鄉,6646,19307,10246,9061
2010/3/1,南投縣,中寮鄉,5611,16343,8881,7462
2010/3/1,南投縣,魚池鄉,5785,17403,9181,8222
2010/3/1,南投縣,國姓鄉,7213,20942,11443,9499
2010/3/1,南投縣,水里鄉,7213,20269,10635,9634
2010/3/1,南投縣,信義鄉,5184,17458,9431,8027
2010/3/1,南投縣,仁愛鄉,4903,15714,8253,7461
2010/3/1,雲林縣,斗六市,34302,106817,53764,53053
2010/3/1,雲林縣,斗南鎮,15106,47419,24133,23286
2010/3/1,雲林縣,虎尾鎮,22248,70277,35781,34496
2010/3/1,雲林縣,西螺鎮,13942,48950,24891,24059
2010/3/1,雲林縣,土庫鎮,8661,30686,16066,14620
2010/3/1,雲林縣,北港鎮,15164,43412,22602,20810
2010/3/1,雲林縣,古坑鄉,10604,34503,18266,16237
2010/3/1,雲林縣,大埤鄉,6610,21432,11447,9985
2010/3/1,雲林縣,莿桐鄉,8946,30646,16060,14586
2010/3/1,雲林縣,林內鄉,5745,19941,10416,9525
2010/3/1,雲林縣,二崙鄉,8750,29900,16047,13853
2010/3/1,雲林縣,崙背鄉,8288,27735,14635,13100
2010/3/1,雲林縣,麥寮鄉,12092,35069,18467,16602
2010/3/1,雲林縣,東勢鄉,5718,17142,9302,7840
2010/3/1,雲林縣,褒忠鄉,4289,14545,7735,6810
2010/3/1,雲林縣,臺西鄉,8811,26513,14263,12250
2010/3/1,雲林縣,元長鄉,9324,29316,15938,13378
2010/3/1,雲林縣,四湖鄉,9054,27215,14838,12377
2010/3/1,雲林縣,口湖鄉,9644,30868,16438,14430
2010/3/1,雲林縣,水林鄉,10355,29398,16076,13322
2010/3/1,嘉義縣,太保市,11054,36301,18758,17543
2010/3/1,嘉義縣,朴子市,14402,44372,22645,21727
2010/3/1,嘉義縣,布袋鎮,10129,30615,15750,14865
2010/3/1,嘉義縣,大林鎮,11129,33894,17425,16469
2010/3/1,嘉義縣,民雄鄉,22515,72831,37474,35357
2010/3/1,嘉義縣,溪口鄉,5392,16466,8780,7686
2010/3/1,嘉義縣,新港鄉,10329,34992,18468,16524
2010/3/1,嘉義縣,六腳鄉,9129,26766,14179,12587
2010/3/1,嘉義縣,東石鄉,9434,28134,14967,13167
2010/3/1,嘉義縣,義竹鄉,7453,21499,11131,10368
2010/3/1,嘉義縣,鹿草鄉,5705,17397,9340,8057
2010/3/1,嘉義縣,水上鄉,17271,52449,27182,25267
2010/3/1,嘉義縣,中埔鄉,15114,47620,24915,22705
2010/3/1,嘉義縣,竹崎鄉,11270,38901,20712,18189
2010/3/1,嘉義縣,梅山鄉,6615,21982,11655,10327
2010/3/1,嘉義縣,番路鄉,3890,11767,6388,5379
2010/3/1,嘉義縣,大埔鄉,1971,4649,2447,2202
2010/3/1,嘉義縣,阿里山鄉,2061,6266,3358,2908
2010/3/1,臺南市,新營區,26919,78384,39200,39184
2010/3/1,臺南市,永康區,73912,215392,107232,108160
2010/3/1,臺南市,鹽水區,9883,27235,14199,13036
2010/3/1,臺南市,白河區,10899,31651,16620,15031
2010/3/1,臺南市,麻豆區,14949,46025,23568,22457
2010/3/1,臺南市,佳里區,19115,59456,29605,29851
2010/3/1,臺南市,新化區,13606,44303,22706,21597
2010/3/1,臺南市,善化區,14353,43394,21982,21412
2010/3/1,臺南市,學甲區,9477,28061,14360,13701
2010/3/1,臺南市,柳營區,7756,22865,11963,10902
2010/3/1,臺南市,後壁區,8725,26057,13585,12472
2010/3/1,臺南市,東山區,8165,23274,12412,10862
2010/3/1,臺南市,下營區,9059,26315,13648,12667
2010/3/1,臺南市,六甲區,7565,23907,12416,11491
2010/3/1,臺南市,官田區,7582,22336,11449,10887
2010/3/1,臺南市,大內區,4079,11025,5856,5169
2010/3/1,臺南市,西港區,7772,25308,12917,12391
2010/3/1,臺南市,七股區,7947,24925,13077,11848
2010/3/1,臺南市,將軍區,7407,21663,11026,10637
2010/3/1,臺南市,北門區,4365,12524,6385,6139
2010/3/1,臺南市,新市區,10681,34918,17549,17369
2010/3/1,臺南市,安定區,9185,30110,15606,14504
2010/3/1,臺南市,山上區,2724,7987,4200,3787
2010/3/1,臺南市,玉井區,5060,15528,8060,7468
2010/3/1,臺南市,楠西區,3589,10755,5708,5047
2010/3/1,臺南市,南化區,2825,8983,4908,4075
2010/3/1,臺南市,左鎮區,1973,5578,3097,2481
2010/3/1,臺南市,仁德區,24375,68930,35500,33430
2010/3/1,臺南市,歸仁區,20314,65964,33650,32314
2010/3/1,臺南市,關廟區,10658,36241,18828,17413
2010/3/1,臺南市,龍崎區,1597,4423,2397,2026
2010/3/1,高雄市,鳳山區,125298,340225,169876,170349
2010/3/1,高雄市,岡山區,32880,97097,48830,48267
2010/3/1,高雄市,旗山區,13756,40294,21045,19249
2010/3/1,高雄市,美濃區,13993,43351,22628,20723
2010/3/1,高雄市,林園區,23890,70723,36337,34386
2010/3/1,高雄市,大寮區,37873,109057,56717,52340
2010/3/1,高雄市,大樹區,13035,44209,22908,21301
2010/3/1,高雄市,仁武區,25053,70648,36523,34125
2010/3/1,高雄市,大社區,11582,32852,16902,15950
2010/3/1,高雄市,鳥松區,16317,42229,21499,20730
2010/3/1,高雄市,橋頭區,12391,36297,18619,17678
2010/3/1,高雄市,燕巢區,9920,30999,16567,14432
2010/3/1,高雄市,田寮區,3556,8281,4600,3681
2010/3/1,高雄市,阿蓮區,9110,30597,15447,15150
2010/3/1,高雄市,路竹區,15959,54119,27648,26471
2010/3/1,高雄市,湖內區,9435,28713,14811,13902
2010/3/1,高雄市,茄萣區,10108,31477,16444,15033
2010/3/1,高雄市,永安區,5793,14233,7267,6966
2010/3/1,高雄市,彌陀區,6531,20570,10702,9868
2010/3/1,高雄市,梓官區,11916,36839,19184,17655
2010/3/1,高雄市,六龜區,5835,15337,8310,7027
2010/3/1,高雄市,甲仙區,2574,7603,4087,3516
2010/3/1,高雄市,杉林區,4033,11051,6043,5008
2010/3/1,高雄市,內門區,5016,16041,8759,7282
2010/3/1,高雄市,茂林區,560,1847,943,904
2010/3/1,高雄市,桃源區,1332,4833,2564,2269
2010/3/1,高雄市,那瑪夏區,873,3463,1803,1660
2010/3/1,屏東縣,屏東市,72203,213060,106453,106607
2010/3/1,屏東縣,潮州鎮,17993,55765,28118,27647
2010/3/1,屏東縣,東港鎮,15511,50400,25568,24832
2010/3/1,屏東縣,恆春鎮,10692,31250,16067,15183
2010/3/1,屏東縣,萬丹鄉,14160,54262,28084,26178
2010/3/1,屏東縣,長治鄉,9655,30978,16199,14779
2010/3/1,屏東縣,麟洛鄉,3555,11629,6028,5601
2010/3/1,屏東縣,九如鄉,6523,22991,11970,11021
2010/3/1,屏東縣,里港鄉,7825,26191,13417,12774
2010/3/1,屏東縣,鹽埔鄉,7657,27475,14270,13205
2010/3/1,屏東縣,高樹鄉,9563,27127,14483,12644
2010/3/1,屏東縣,萬巒鄉,6396,22223,11690,10533
2010/3/1,屏東縣,內埔鄉,17606,58493,30426,28067
2010/3/1,屏東縣,竹田鄉,5455,18439,9804,8635
2010/3/1,屏東縣,新埤鄉,3348,10876,5763,5113
2010/3/1,屏東縣,枋寮鄉,8420,26898,14200,12698
2010/3/1,屏東縣,新園鄉,11338,38812,20014,18798
2010/3/1,屏東縣,崁頂鄉,4160,17399,8926,8473
2010/3/1,屏東縣,林邊鄉,7038,21111,10895,10216
2010/3/1,屏東縣,南州鄉,3664,11890,6112,5778
2010/3/1,屏東縣,佳冬鄉,7083,21599,11276,10323
2010/3/1,屏東縣,琉球鄉,3924,12579,6965,5614
2010/3/1,屏東縣,車城鄉,3517,9956,5379,4577
2010/3/1,屏東縣,滿州鄉,3049,8648,4737,3911
2010/3/1,屏東縣,枋山鄉,2086,6133,3277,2856
2010/3/1,屏東縣,三地門鄉,2154,7583,3878,3705
2010/3/1,屏東縣,霧臺鄉,968,2961,1556,1405
2010/3/1,屏東縣,瑪家鄉,1878,6580,3432,3148
2010/3/1,屏東縣,泰武鄉,1236,5171,2719,2452
2010/3/1,屏東縣,來義鄉,2149,7900,4063,3837
2010/3/1,屏東縣,春日鄉,1325,4864,2538,2326
2010/3/1,屏東縣,獅子鄉,1465,5059,2639,2420
2010/3/1,屏東縣,牡丹鄉,1872,5083,2620,2463
2010/3/1,臺東縣,臺東市,37748,109323,55539,53784
2010/3/1,臺東縣,成功鎮,5409,15984,8529,7455
2010/3/1,臺東縣,關山鎮,3211,9862,5164,4698
2010/3/1,臺東縣,卑南鄉,6560,18389,9960,8429
2010/3/1,臺東縣,大武鄉,2535,7200,3729,3471
2010/3/1,臺東縣,太麻里鄉,4530,12129,6494,5635
2010/3/1,臺東縣,東河鄉,3560,9548,5296,4252
2010/3/1,臺東縣,長濱鄉,2932,8503,4839,3664
2010/3/1,臺東縣,鹿野鄉,3121,8654,4671,3983
2010/3/1,臺東縣,池上鄉,3249,9312,4936,4376
2010/3/1,臺東縣,綠島鄉,980,3330,1784,1546
2010/3/1,臺東縣,延平鄉,1079,3679,2032,1647
2010/3/1,臺東縣,海端鄉,1091,4533,2469,2064
2010/3/1,臺東縣,達仁鄉,1506,4197,2284,1913
2010/3/1,臺東縣,金峰鄉,1040,3666,1904,1762
2010/3/1,臺東縣,蘭嶼鄉,1371,4379,2284,2095
2010/3/1,花蓮縣,花蓮市,40253,109741,53880,55861
2010/3/1,花蓮縣,鳳林鎮,4458,12137,6435,5702
2010/3/1,花蓮縣,玉里鎮,8922,27167,14758,12409
2010/3/1,花蓮縣,新城鄉,7233,20235,10532,9703
2010/3/1,花蓮縣,吉安鄉,28654,79552,40827,38725
2010/3/1,花蓮縣,壽豐鄉,6790,18857,10215,8642
2010/3/1,花蓮縣,光復鄉,4995,14339,7642,6697
2010/3/1,花蓮縣,豐濱鄉,1824,5234,2876,2358
2010/3/1,花蓮縣,瑞穗鄉,4627,13078,7038,6040
2010/3/1,花蓮縣,富里鄉,3980,11832,6491,5341
2010/3/1,花蓮縣,秀林鄉,4616,15219,7910,7309
2010/3/1,花蓮縣,萬榮鄉,2148,6977,3725,3252
2010/3/1,花蓮縣,卓溪鄉,1653,6426,3587,2839
2010/3/1,澎湖縣,馬公市,19608,56465,28618,27847
2010/3/1,澎湖縣,湖西鄉,4683,13655,7125,6530
2010/3/1,澎湖縣,白沙鄉,3124,9518,4990,4528
2010/3/1,澎湖縣,西嶼鄉,2818,8467,4388,4079
2010/3/1,澎湖縣,望安鄉,1872,4761,2573,2188
2010/3/1,澎湖縣,七美鄉,1228,3593,1899,1694
2010/3/1,基隆市,中正區,22026,56054,28766,27288
2010/3/1,基隆市,七堵區,19881,55469,28125,27344
2010/3/1,基隆市,暖暖區,14203,38110,19395,18715
2010/3/1,基隆市,仁愛區,19701,50376,24887,25489
2010/3/1,基隆市,中山區,18966,51502,26325,25177
2010/3/1,基隆市,安樂區,31658,84667,42212,42455
2010/3/1,基隆市,信義區,19873,51446,25794,25652
2010/3/1,新竹市,東區,67025,195743,96619,99124
2010/3/1,新竹市,北區,49799,144772,71594,73178
2010/3/1,新竹市,香山區,22586,72335,36895,35440
2010/3/1,臺中市,中區,8422,23116,11385,11731
2010/3/1,臺中市,東區,25606,73821,37361,36460
2010/3/1,臺中市,西區,42875,117512,56547,60965
2010/3/1,臺中市,南區,41433,112772,54795,57977
2010/3/1,臺中市,北區,55227,147777,71731,76046
2010/3/1,臺中市,西屯區,71556,204512,99401,105111
2010/3/1,臺中市,南屯區,52075,151676,73290,78386
2010/3/1,臺中市,北屯區,82157,244975,119186,125789
2010/3/1,嘉義市,東區,44083,126145,61620,64525
2010/3/1,嘉義市,西區,50630,147572,73220,74352
2010/3/1,臺南市,東區,70461,194484,94167,100317
2010/3/1,臺南市,南區,42862,126440,63527,62913
2010/3/1,臺南市,北區,47558,131349,64949,66400
2010/3/1,臺南市,安南區,53734,177267,90262,87005
2010/3/1,臺南市,安平區,22729,61914,29711,32203
2010/3/1,臺南市,中西區,30107,80194,39416,40778
2010/3/1,臺北市,松山區,77269,208101,98792,109309
2010/3/1,臺北市,信義區,85422,224883,108597,116286
2010/3/1,臺北市,大安區,116030,311159,146633,164526
2010/3/1,臺北市,中山區,90416,218153,102921,115232
2010/3/1,臺北市,中正區,61523,158882,76736,82146
2010/3/1,臺北市,大同區,46565,123471,60967,62504
2010/3/1,臺北市,萬華區,73248,187733,93906,93827
2010/3/1,臺北市,文山區,95952,260639,126430,134209
2010/3/1,臺北市,南港區,41046,112854,55755,57099
2010/3/1,臺北市,內湖區,95145,267805,129339,138466
2010/3/1,臺北市,士林區,99696,283461,138080,145381
2010/3/1,臺北市,北投區,88601,247603,120401,127202
2010/3/1,高雄市,鹽埕區,11158,27724,13951,13773
2010/3/1,高雄市,鼓山區,51226,130048,63869,66179
2010/3/1,高雄市,左營區,72739,190316,93812,96504
2010/3/1,高雄市,楠梓區,61186,172194,85579,86615
2010/3/1,高雄市,三民區,130429,354938,173960,180978
2010/3/1,高雄市,新興區,22858,55692,27182,28510
2010/3/1,高雄市,前金區,12510,29049,14220,14829
2010/3/1,高雄市,苓雅區,71362,184940,90247,94693
2010/3/1,高雄市,前鎮區,75762,199623,99443,100180
2010/3/1,高雄市,旗津區,10913,29934,15581,14353
2010/3/1,高雄市,小港區,62280,153848,77453,76395
2010/3/1,金門縣,金城鎮,10756,31817,16392,15425
2010/3/1,金門縣,金湖鎮,7112,20679,10715,9964
2010/3/1,金門縣,金沙鎮,5282,15010,7659,7351
2010/3/1,金門縣,金寧鄉,6077,17984,9357,8627
2010/3/1,金門縣,烈嶼鄉,2565,8695,4420,4275
2010/3/1,金門縣,烏坵鄉,136,516,261,255
2010/3/1,連江縣,南竿鄉,1186,5973,3459,2514
2010/3/1,連江縣,北竿鄉,377,1798,1033,765
2010/3/1,連江縣,莒光鄉,235,1170,687,483
2010/3/1,連江縣,東引鄉,269,1075,630,445
2010/4/1,總計,臺灣地區,7814010,23028153,11580839,11447314
2010/4/1,總計,臺灣省,6258748,18896072,9567874,9328198
2010/4/1,總計,新北市,1385529,3884754,1931736,1953018
2010/4/1,總計,宜蘭縣,152604,461592,235538,226054
2010/4/1,總計,桃園市,659854,1985209,1001677,983532
2010/4/1,總計,新竹縣,159014,512147,263800,248347
2010/4/1,總計,苗栗縣,171063,561392,291846,269546
2010/4/1,總計,臺中市,462515,1562780,792621,770159
2010/4/1,總計,彰化縣,360801,1311188,673517,637671
2010/4/1,總計,南投縣,169780,529767,272853,256914
2010/4/1,總計,雲林縣,227781,721121,376786,344335
2010/4/1,總計,嘉義縣,175030,546386,285244,261142
2010/4/1,總計,臺南市,366971,1103276,563555,539721
2010/4/1,總計,高雄市,429235,1243050,636976,606074
2010/4/1,總計,屏東縣,275732,880550,453069,427481
2010/4/1,總計,臺東縣,79968,232491,121773,110718
2010/4/1,總計,花蓮縣,120304,340705,175843,164862
2010/4/1,總計,澎湖縣,33404,96455,49580,46875
2010/4/1,總計,基隆市,146400,387207,195237,191970
2010/4/1,總計,新竹市,139808,413317,205307,208010
2010/4/1,總計,臺中市,380283,1077182,524120,553062
2010/4/1,總計,嘉義市,94812,273639,134758,138881
2010/4/1,總計,臺南市,267860,771864,382038,389826
2010/4/1,總計,臺北市,972084,2603651,1257798,1345853
2010/4/1,總計,高雄市,583178,1528430,755167,773263
2010/4/1,總計,福建省,34058,104921,54723,50198
2010/4/1,總計,金門縣,31990,94911,48918,45993
2010/4/1,總計,連江縣,2068,10010,5805,4205
2010/4/1,新北市,板橋區,192060,553972,274505,279467
2010/4/1,新北市,三重區,138259,389308,194345,194963
2010/4/1,新北市,永和區,89497,236676,113708,122968
2010/4/1,新北市,中和區,153991,414798,205187,209611
2010/4/1,新北市,新莊區,135156,401788,198692,203096
2010/4/1,新北市,新店區,115001,295265,144874,150391
2010/4/1,新北市,土城區,81362,238963,119704,119259
2010/4/1,新北市,蘆洲區,64791,197642,97978,99664
2010/4/1,新北市,汐止區,77937,188340,93614,94726
2010/4/1,新北市,樹林區,57857,173201,87329,85872
2010/4/1,新北市,鶯歌區,27041,86556,43885,42671
2010/4/1,新北市,三峽區,34395,101581,52022,49559
2010/4/1,新北市,淡水區,55878,141483,68956,72527
2010/4/1,新北市,瑞芳區,15736,42610,21809,20801
2010/4/1,新北市,五股區,26937,79352,40345,39007
2010/4/1,新北市,泰山區,25958,76606,38524,38082
2010/4/1,新北市,林口區,29007,80345,39790,40555
2010/4/1,新北市,深坑區,8622,23154,11681,11473
2010/4/1,新北市,石碇區,3284,7969,4453,3516
2010/4/1,新北市,坪林區,2412,6526,3663,2863
2010/4/1,新北市,三芝區,8776,23339,12110,11229
2010/4/1,新北市,石門區,3916,12423,6544,5879
2010/4/1,新北市,八里區,11905,34118,17370,16748
2010/4/1,新北市,平溪區,2366,5387,3008,2379
2010/4/1,新北市,雙溪區,3806,9792,5293,4499
2010/4/1,新北市,貢寮區,4361,13788,7133,6655
2010/4/1,新北市,金山區,6598,22386,11277,11109
2010/4/1,新北市,萬里區,6928,21667,11028,10639
2010/4/1,新北市,烏來區,1692,5719,2909,2810
2010/4/1,宜蘭縣,宜蘭市,32886,95845,47294,48551
2010/4/1,宜蘭縣,羅東鎮,24713,72983,35105,37878
2010/4/1,宜蘭縣,蘇澳鎮,13521,43354,22262,21092
2010/4/1,宜蘭縣,頭城鎮,9622,31111,16101,15010
2010/4/1,宜蘭縣,礁溪鄉,12231,35911,18837,17074
2010/4/1,宜蘭縣,壯圍鄉,8029,25136,13238,11898
2010/4/1,宜蘭縣,員山鄉,10696,32357,17325,15032
2010/4/1,宜蘭縣,冬山鄉,17071,52345,26987,25358
2010/4/1,宜蘭縣,五結鄉,12806,38759,20170,18589
2010/4/1,宜蘭縣,三星鄉,7414,21623,11692,9931
2010/4/1,宜蘭縣,大同鄉,1825,6070,3299,2771
2010/4/1,宜蘭縣,南澳鄉,1790,6098,3228,2870
2010/4/1,桃園市,桃園區,140917,402637,197377,205260
2010/4/1,桃園市,中壢區,124518,366454,183240,183214
2010/4/1,桃園市,平鎮區,65561,206819,104200,102619
2010/4/1,桃園市,八德區,57033,175651,89548,86103
2010/4/1,桃園市,大溪區,28882,91880,47312,44568
2010/4/1,桃園市,楊梅區,47533,148973,75761,73212
2010/4/1,桃園市,蘆竹區,46928,139696,70082,69614
2010/4/1,桃園市,大園區,25696,81518,42348,39170
2010/4/1,桃園市,龜山區,48907,136136,69110,67026
2010/4/1,桃園市,龍潭區,36409,114437,58196,56241
2010/4/1,桃園市,新屋區,14840,49403,26363,23040
2010/4/1,桃園市,觀音區,18964,60905,32149,28756
2010/4/1,桃園市,復興區,3666,10700,5991,4709
2010/4/1,新竹縣,竹北市,45755,139414,70008,69406
2010/4/1,新竹縣,關西鎮,9224,32298,17171,15127
2010/4/1,新竹縣,新埔鎮,10309,35876,19003,16873
2010/4/1,新竹縣,竹東鎮,30292,96893,48900,47993
2010/4/1,新竹縣,湖口鄉,23199,75522,38638,36884
2010/4/1,新竹縣,橫山鄉,4389,14731,7956,6775
2010/4/1,新竹縣,新豐鄉,15441,52990,27375,25615
2010/4/1,新竹縣,芎林鄉,6287,20946,11040,9906
2010/4/1,新竹縣,寶山鄉,4627,14015,7570,6445
2010/4/1,新竹縣,北埔鄉,3088,10262,5564,4698
2010/4/1,新竹縣,峨眉鄉,2018,6080,3371,2709
2010/4/1,新竹縣,尖石鄉,2664,8360,4581,3779
2010/4/1,新竹縣,五峰鄉,1721,4760,2623,2137
2010/4/1,苗栗縣,苗栗市,28895,90638,45734,44904
2010/4/1,苗栗縣,苑裡鎮,13793,48844,25511,23333
2010/4/1,苗栗縣,通霄鎮,11287,38375,20415,17960
2010/4/1,苗栗縣,竹南鎮,23678,77692,39522,38170
2010/4/1,苗栗縣,頭份市,29109,96411,49176,47235
2010/4/1,苗栗縣,後龍鎮,11624,39707,21034,18673
2010/4/1,苗栗縣,卓蘭鎮,5924,18482,9743,8739
2010/4/1,苗栗縣,大湖鄉,5302,16114,8632,7482
2010/4/1,苗栗縣,公館鄉,10075,34813,18300,16513
2010/4/1,苗栗縣,銅鑼鄉,5971,19557,10341,9216
2010/4/1,苗栗縣,南庄鄉,3990,11322,6251,5071
2010/4/1,苗栗縣,頭屋鄉,3505,11639,6145,5494
2010/4/1,苗栗縣,三義鄉,5269,17680,9311,8369
2010/4/1,苗栗縣,西湖鄉,2669,7940,4385,3555
2010/4/1,苗栗縣,造橋鄉,3956,13734,7266,6468
2010/4/1,苗栗縣,三灣鄉,2384,7347,3989,3358
2010/4/1,苗栗縣,獅潭鄉,1689,5020,2800,2220
2010/4/1,苗栗縣,泰安鄉,1943,6077,3291,2786
2010/4/1,臺中市,豐原區,49212,165397,82205,83192
2010/4/1,臺中市,大里區,60954,196736,97745,98991
2010/4/1,臺中市,太平區,54193,172555,86742,85813
2010/4/1,臺中市,東勢區,16877,53564,27812,25752
2010/4/1,臺中市,大甲區,21495,78719,40017,38702
2010/4/1,臺中市,清水區,24778,85707,44253,41454
2010/4/1,臺中市,沙鹿區,23310,80974,41273,39701
2010/4/1,臺中市,梧棲區,15842,55002,27928,27074
2010/4/1,臺中市,后里區,14681,54305,27953,26352
2010/4/1,臺中市,神岡區,17475,63852,32957,30895
2010/4/1,臺中市,潭子區,32105,99711,49805,49906
2010/4/1,臺中市,大雅區,26062,89529,45196,44333
2010/4/1,臺中市,新社區,7305,25662,13479,12183
2010/4/1,臺中市,石岡區,4828,16141,8417,7724
2010/4/1,臺中市,外埔區,8769,32014,16488,15526
2010/4/1,臺中市,大安區,5211,20313,10694,9619
2010/4/1,臺中市,烏日區,20225,68382,34686,33696
2010/4/1,臺中市,大肚區,15732,55875,28684,27191
2010/4/1,臺中市,龍井區,20398,73895,37629,36266
2010/4/1,臺中市,霧峰區,18613,63774,32827,30947
2010/4/1,臺中市,和平區,4450,10673,5831,4842
2010/4/1,彰化縣,彰化市,71256,237101,118219,118882
2010/4/1,彰化縣,鹿港鎮,22107,85393,43804,41589
2010/4/1,彰化縣,和美鎮,23836,89623,46017,43606
2010/4/1,彰化縣,北斗鎮,9848,33626,17048,16578
2010/4/1,彰化縣,員林市,36494,126020,63382,62638
2010/4/1,彰化縣,溪湖鎮,14988,56393,28836,27557
2010/4/1,彰化縣,田中鎮,12482,44325,23078,21247
2010/4/1,彰化縣,二林鎮,14200,54320,28029,26291
2010/4/1,彰化縣,線西鄉,4106,17124,8799,8325
2010/4/1,彰化縣,伸港鄉,8884,35968,18525,17443
2010/4/1,彰化縣,福興鄉,11955,49066,25670,23396
2010/4/1,彰化縣,秀水鄉,9626,39078,20280,18798
2010/4/1,彰化縣,花壇鄉,12832,46154,23825,22329
2010/4/1,彰化縣,芬園鄉,6870,24932,13240,11692
2010/4/1,彰化縣,大村鄉,10143,36575,19065,17510
2010/4/1,彰化縣,埔鹽鄉,8741,34435,18062,16373
2010/4/1,彰化縣,埔心鄉,9848,35285,18302,16983
2010/4/1,彰化縣,永靖鄉,10349,39460,20474,18986
2010/4/1,彰化縣,社頭鄉,12255,44935,23141,21794
2010/4/1,彰化縣,二水鄉,5311,16722,8778,7944
2010/4/1,彰化縣,田尾鄉,7621,28817,15035,13782
2010/4/1,彰化縣,埤頭鄉,8499,31922,16685,15237
2010/4/1,彰化縣,芳苑鄉,9936,36417,19339,17078
2010/4/1,彰化縣,大城鄉,5384,19167,10423,8744
2010/4/1,彰化縣,竹塘鄉,4584,16592,8732,7860
2010/4/1,彰化縣,溪州鄉,8646,31738,16729,15009
2010/4/1,南投縣,南投市,33075,104537,52604,51933
2010/4/1,南投縣,埔里鎮,28113,85499,43161,42338
2010/4/1,南投縣,草屯鎮,30729,100131,50672,49459
2010/4/1,南投縣,竹山鎮,18872,58651,30268,28383
2010/4/1,南投縣,集集鎮,4331,12219,6406,5813
2010/4/1,南投縣,名間鄉,12040,41381,21724,19657
2010/4/1,南投縣,鹿谷鄉,6653,19290,10249,9041
2010/4/1,南投縣,中寮鄉,5621,16346,8882,7464
2010/4/1,南投縣,魚池鄉,5791,17387,9175,8212
2010/4/1,南投縣,國姓鄉,7224,20913,11426,9487
2010/4/1,南投縣,水里鄉,7222,20251,10621,9630
2010/4/1,南投縣,信義鄉,5195,17456,9431,8025
2010/4/1,南投縣,仁愛鄉,4914,15706,8234,7472
2010/4/1,雲林縣,斗六市,34344,106838,53778,53060
2010/4/1,雲林縣,斗南鎮,15129,47381,24106,23275
2010/4/1,雲林縣,虎尾鎮,22262,70262,35777,34485
2010/4/1,雲林縣,西螺鎮,13945,48962,24884,24078
2010/4/1,雲林縣,土庫鎮,8660,30669,16046,14623
2010/4/1,雲林縣,北港鎮,15181,43408,22605,20803
2010/4/1,雲林縣,古坑鄉,10605,34434,18231,16203
2010/4/1,雲林縣,大埤鄉,6613,21387,11435,9952
2010/4/1,雲林縣,莿桐鄉,8943,30600,16041,14559
2010/4/1,雲林縣,林內鄉,5744,19920,10403,9517
2010/4/1,雲林縣,二崙鄉,8751,29850,16013,13837
2010/4/1,雲林縣,崙背鄉,8294,27724,14624,13100
2010/4/1,雲林縣,麥寮鄉,12111,35058,18451,16607
2010/4/1,雲林縣,東勢鄉,5715,17122,9289,7833
2010/4/1,雲林縣,褒忠鄉,4291,14511,7725,6786
2010/4/1,雲林縣,臺西鄉,8816,26464,14232,12232
2010/4/1,雲林縣,元長鄉,9329,29229,15888,13341
2010/4/1,雲林縣,四湖鄉,9051,27171,14819,12352
2010/4/1,雲林縣,口湖鄉,9634,30789,16399,14390
2010/4/1,雲林縣,水林鄉,10363,29342,16040,13302
2010/4/1,嘉義縣,太保市,11081,36344,18767,17577
2010/4/1,嘉義縣,朴子市,14417,44347,22625,21722
2010/4/1,嘉義縣,布袋鎮,10130,30544,15701,14843
2010/4/1,嘉義縣,大林鎮,11137,33833,17388,16445
2010/4/1,嘉義縣,民雄鄉,22535,72763,37416,35347
2010/4/1,嘉義縣,溪口鄉,5388,16450,8771,7679
2010/4/1,嘉義縣,新港鄉,10335,34964,18466,16498
2010/4/1,嘉義縣,六腳鄉,9132,26714,14157,12557
2010/4/1,嘉義縣,東石鄉,9441,28068,14930,13138
2010/4/1,嘉義縣,義竹鄉,7452,21446,11100,10346
2010/4/1,嘉義縣,鹿草鄉,5702,17373,9321,8052
2010/4/1,嘉義縣,水上鄉,17305,52446,27162,25284
2010/4/1,嘉義縣,中埔鄉,15145,47621,24918,22703
2010/4/1,嘉義縣,竹崎鄉,11270,38841,20694,18147
2010/4/1,嘉義縣,梅山鄉,6627,21964,11646,10318
2010/4/1,嘉義縣,番路鄉,3900,11758,6380,5378
2010/4/1,嘉義縣,大埔鄉,1970,4646,2448,2198
2010/4/1,嘉義縣,阿里山鄉,2063,6264,3354,2910
2010/4/1,臺南市,新營區,26942,78343,39175,39168
2010/4/1,臺南市,永康區,74044,215609,107352,108257
2010/4/1,臺南市,鹽水區,9889,27200,14184,13016
2010/4/1,臺南市,白河區,10903,31620,16604,15016
2010/4/1,臺南市,麻豆區,14978,46035,23587,22448
2010/4/1,臺南市,佳里區,19117,59463,29606,29857
2010/4/1,臺南市,新化區,13611,44269,22690,21579
2010/4/1,臺南市,善化區,14392,43432,22005,21427
2010/4/1,臺南市,學甲區,9492,28036,14336,13700
2010/4/1,臺南市,柳營區,7757,22832,11941,10891
2010/4/1,臺南市,後壁區,8740,26048,13575,12473
2010/4/1,臺南市,東山區,8180,23271,12412,10859
2010/4/1,臺南市,下營區,9070,26287,13625,12662
2010/4/1,臺南市,六甲區,7581,23881,12394,11487
2010/4/1,臺南市,官田區,7585,22290,11430,10860
2010/4/1,臺南市,大內區,4078,11009,5841,5168
2010/4/1,臺南市,西港區,7782,25305,12917,12388
2010/4/1,臺南市,七股區,7955,24903,13044,11859
2010/4/1,臺南市,將軍區,7408,21655,11019,10636
2010/4/1,臺南市,北門區,4373,12521,6377,6144
2010/4/1,臺南市,新市區,10690,34893,17533,17360
2010/4/1,臺南市,安定區,9199,30085,15605,14480
2010/4/1,臺南市,山上區,2727,7978,4200,3778
2010/4/1,臺南市,玉井區,5070,15528,8058,7470
2010/4/1,臺南市,楠西區,3593,10739,5698,5041
2010/4/1,臺南市,南化區,2825,8964,4899,4065
2010/4/1,臺南市,左鎮區,1975,5575,3096,2479
2010/4/1,臺南市,仁德區,24411,68983,35509,33474
2010/4/1,臺南市,歸仁區,20345,65918,33648,32270
2010/4/1,臺南市,關廟區,10664,36184,18804,17380
2010/4/1,臺南市,龍崎區,1595,4420,2391,2029
2010/4/1,高雄市,鳳山區,125526,340458,169963,170495
2010/4/1,高雄市,岡山區,32922,97120,48821,48299
2010/4/1,高雄市,旗山區,13767,40295,21029,19266
2010/4/1,高雄市,美濃區,14017,43310,22611,20699
2010/4/1,高雄市,林園區,23932,70675,36307,34368
2010/4/1,高雄市,大寮區,37891,108941,56656,52285
2010/4/1,高雄市,大樹區,13029,44160,22876,21284
2010/4/1,高雄市,仁武區,25131,70748,36578,34170
2010/4/1,高雄市,大社區,11591,32879,16911,15968
2010/4/1,高雄市,鳥松區,16338,42267,21518,20749
2010/4/1,高雄市,橋頭區,12408,36317,18617,17700
2010/4/1,高雄市,燕巢區,9932,30967,16552,14415
2010/4/1,高雄市,田寮區,3556,8280,4598,3682
2010/4/1,高雄市,阿蓮區,9113,30569,15437,15132
2010/4/1,高雄市,路竹區,15965,54055,27595,26460
2010/4/1,高雄市,湖內區,9456,28740,14831,13909
2010/4/1,高雄市,茄萣區,10107,31462,16432,15030
2010/4/1,高雄市,永安區,5802,14231,7267,6964
2010/4/1,高雄市,彌陀區,6534,20564,10693,9871
2010/4/1,高雄市,梓官區,11932,36832,19181,17651
2010/4/1,高雄市,六龜區,5800,15193,8227,6966
2010/4/1,高雄市,甲仙區,2546,7527,4052,3475
2010/4/1,高雄市,杉林區,4155,11283,6168,5115
2010/4/1,高雄市,內門區,5017,16032,8751,7281
2010/4/1,高雄市,茂林區,560,1842,942,900
2010/4/1,高雄市,桃源區,1335,4842,2566,2276
2010/4/1,高雄市,那瑪夏區,873,3461,1797,1664
2010/4/1,屏東縣,屏東市,72266,212917,106368,106549
2010/4/1,屏東縣,潮州鎮,18007,55723,28103,27620
2010/4/1,屏東縣,東港鎮,15547,50436,25579,24857
2010/4/1,屏東縣,恆春鎮,10712,31256,16059,15197
2010/4/1,屏東縣,萬丹鄉,14186,54249,28055,26194
2010/4/1,屏東縣,長治鄉,9653,30928,16172,14756
2010/4/1,屏東縣,麟洛鄉,3565,11638,6038,5600
2010/4/1,屏東縣,九如鄉,6527,22961,11956,11005
2010/4/1,屏東縣,里港鄉,7818,26174,13412,12762
2010/4/1,屏東縣,鹽埔鄉,7654,27454,14259,13195
2010/4/1,屏東縣,高樹鄉,9559,27073,14451,12622
2010/4/1,屏東縣,萬巒鄉,6395,22181,11673,10508
2010/4/1,屏東縣,內埔鄉,17620,58457,30404,28053
2010/4/1,屏東縣,竹田鄉,5457,18409,9787,8622
2010/4/1,屏東縣,新埤鄉,3354,10834,5738,5096
2010/4/1,屏東縣,枋寮鄉,8421,26880,14193,12687
2010/4/1,屏東縣,新園鄉,11355,38734,19975,18759
2010/4/1,屏東縣,崁頂鄉,4166,17375,8901,8474
2010/4/1,屏東縣,林邊鄉,7058,21089,10880,10209
2010/4/1,屏東縣,南州鄉,3664,11857,6103,5754
2010/4/1,屏東縣,佳冬鄉,7086,21550,11243,10307
2010/4/1,屏東縣,琉球鄉,3939,12556,6948,5608
2010/4/1,屏東縣,車城鄉,3523,9914,5355,4559
2010/4/1,屏東縣,滿州鄉,3056,8624,4724,3900
2010/4/1,屏東縣,枋山鄉,2083,6118,3273,2845
2010/4/1,屏東縣,三地門鄉,2157,7594,3882,3712
2010/4/1,屏東縣,霧臺鄉,971,2972,1561,1411
2010/4/1,屏東縣,瑪家鄉,1879,6569,3428,3141
2010/4/1,屏東縣,泰武鄉,1233,5174,2719,2455
2010/4/1,屏東縣,來義鄉,2149,7881,4045,3836
2010/4/1,屏東縣,春日鄉,1326,4854,2535,2319
2010/4/1,屏東縣,獅子鄉,1468,5037,2629,2408
2010/4/1,屏東縣,牡丹鄉,1878,5082,2621,2461
2010/4/1,臺東縣,臺東市,37761,109242,55464,53778
2010/4/1,臺東縣,成功鎮,5411,15969,8520,7449
2010/4/1,臺東縣,關山鎮,3214,9860,5151,4709
2010/4/1,臺東縣,卑南鄉,6564,18373,9953,8420
2010/4/1,臺東縣,大武鄉,2531,7182,3723,3459
2010/4/1,臺東縣,太麻里鄉,4528,12126,6495,5631
2010/4/1,臺東縣,東河鄉,3553,9523,5283,4240
2010/4/1,臺東縣,長濱鄉,2935,8476,4825,3651
2010/4/1,臺東縣,鹿野鄉,3126,8654,4669,3985
2010/4/1,臺東縣,池上鄉,3256,9299,4929,4370
2010/4/1,臺東縣,綠島鄉,988,3336,1786,1550
2010/4/1,臺東縣,延平鄉,1078,3672,2025,1647
2010/4/1,臺東縣,海端鄉,1090,4538,2470,2068
2010/4/1,臺東縣,達仁鄉,1509,4192,2283,1909
2010/4/1,臺東縣,金峰鄉,1048,3672,1909,1763
2010/4/1,臺東縣,蘭嶼鄉,1376,4377,2288,2089
2010/4/1,花蓮縣,花蓮市,40335,109826,53899,55927
2010/4/1,花蓮縣,鳳林鎮,4459,12110,6421,5689
2010/4/1,花蓮縣,玉里鎮,8924,27140,14741,12399
2010/4/1,花蓮縣,新城鄉,7251,20244,10540,9704
2010/4/1,花蓮縣,吉安鄉,28691,79511,40807,38704
2010/4/1,花蓮縣,壽豐鄉,6792,18850,10214,8636
2010/4/1,花蓮縣,光復鄉,4994,14306,7625,6681
2010/4/1,花蓮縣,豐濱鄉,1823,5227,2875,2352
2010/4/1,花蓮縣,瑞穗鄉,4627,13054,7025,6029
2010/4/1,花蓮縣,富里鄉,3988,11836,6488,5348
2010/4/1,花蓮縣,秀林鄉,4616,15225,7915,7310
2010/4/1,花蓮縣,萬榮鄉,2150,6958,3714,3244
2010/4/1,花蓮縣,卓溪鄉,1654,6418,3579,2839
2010/4/1,澎湖縣,馬公市,19638,56479,28623,27856
2010/4/1,澎湖縣,湖西鄉,4696,13644,7113,6531
2010/4/1,澎湖縣,白沙鄉,3122,9532,5003,4529
2010/4/1,澎湖縣,西嶼鄉,2830,8461,4382,4079
2010/4/1,澎湖縣,望安鄉,1883,4754,2569,2185
2010/4/1,澎湖縣,七美鄉,1235,3585,1890,1695
2010/4/1,基隆市,中正區,22014,55957,28707,27250
2010/4/1,基隆市,七堵區,19908,55421,28099,27322
2010/4/1,基隆市,暖暖區,14214,38063,19363,18700
2010/4/1,基隆市,仁愛區,19736,50362,24854,25508
2010/4/1,基隆市,中山區,18959,51403,26284,25119
2010/4/1,基隆市,安樂區,31687,84667,42187,42480
2010/4/1,基隆市,信義區,19882,51334,25743,25591
2010/4/1,新竹市,東區,67237,196026,96768,99258
2010/4/1,新竹市,北區,49933,144918,71640,73278
2010/4/1,新竹市,香山區,22638,72373,36899,35474
2010/4/1,臺中市,中區,8433,23105,11388,11717
2010/4/1,臺中市,東區,25638,73788,37352,36436
2010/4/1,臺中市,西區,42960,117564,56557,61007
2010/4/1,臺中市,南區,41515,112830,54809,58021
2010/4/1,臺中市,北區,55298,147792,71719,76073
2010/4/1,臺中市,西屯區,71811,204864,99581,105283
2010/4/1,臺中市,南屯區,52228,151952,73436,78516
2010/4/1,臺中市,北屯區,82400,245287,119278,126009
2010/4/1,嘉義市,東區,44081,126034,61532,64502
2010/4/1,嘉義市,西區,50731,147605,73226,74379
2010/4/1,臺南市,東區,70526,194475,94148,100327
2010/4/1,臺南市,南區,42928,126380,63459,62921
2010/4/1,臺南市,北區,47628,131465,64973,66492
2010/4/1,臺南市,安南區,53848,177361,90298,87063
2010/4/1,臺南市,安平區,22799,62036,29771,32265
2010/4/1,臺南市,中西區,30131,80147,39389,40758
2010/4/1,臺北市,松山區,77349,208213,98792,109421
2010/4/1,臺北市,信義區,85444,224601,108444,116157
2010/4/1,臺北市,大安區,116089,310925,146510,164415
2010/4/1,臺北市,中山區,90521,217843,102826,115017
2010/4/1,臺北市,中正區,61658,158957,76740,82217
2010/4/1,臺北市,大同區,46681,123499,60975,62524
2010/4/1,臺北市,萬華區,73300,187542,93780,93762
2010/4/1,臺北市,文山區,96061,260580,126418,134162
2010/4/1,臺北市,南港區,41126,112845,55716,57129
2010/4/1,臺北市,內湖區,95274,267725,129306,138419
2010/4/1,臺北市,士林區,99839,283280,137924,145356
2010/4/1,臺北市,北投區,88742,247641,120367,127274
2010/4/1,高雄市,鹽埕區,11162,27695,13933,13762
2010/4/1,高雄市,鼓山區,51373,130295,63998,66297
2010/4/1,高雄市,左營區,72917,190546,93917,96629
2010/4/1,高雄市,楠梓區,61271,172346,85647,86699
2010/4/1,高雄市,三民區,130577,354831,173875,180956
2010/4/1,高雄市,新興區,22879,55682,27158,28524
2010/4/1,高雄市,前金區,12490,28999,14191,14808
2010/4/1,高雄市,苓雅區,71430,184747,90132,94615
2010/4/1,高雄市,前鎮區,75832,199462,99304,100158
2010/4/1,高雄市,旗津區,10930,29962,15593,14369
2010/4/1,高雄市,小港區,62317,153865,77419,76446
2010/4/1,金門縣,金城鎮,10782,31870,16428,15442
2010/4/1,金門縣,金湖鎮,7120,20746,10756,9990
2010/4/1,金門縣,金沙鎮,5293,15048,7673,7375
2010/4/1,金門縣,金寧鄉,6084,18019,9374,8645
2010/4/1,金門縣,烈嶼鄉,2575,8713,4427,4286
2010/4/1,金門縣,烏坵鄉,136,515,260,255
2010/4/1,連江縣,南竿鄉,1185,5964,3451,2513
2010/4/1,連江縣,北竿鄉,377,1795,1034,761
2010/4/1,連江縣,莒光鄉,235,1168,685,483
2010/4/1,連江縣,東引鄉,271,1083,635,448
2010/5/1,總計,臺灣地區,7826034,23030692,11580316,11450376
2010/5/1,總計,臺灣省,6268968,18898156,9567655,9330501
2010/5/1,總計,新北市,1388539,3885507,1931973,1953534
2010/5/1,總計,宜蘭縣,152692,461409,235392,226017
2010/5/1,總計,桃園市,662649,1990917,1004420,986497
2010/5/1,總計,新竹縣,159220,511855,263608,248247
2010/5/1,總計,苗栗縣,171289,561319,291646,269673
2010/5/1,總計,臺中市,463112,1562567,792465,770102
2010/5/1,總計,彰化縣,360999,1310398,673000,637398
2010/5/1,總計,南投縣,169827,529321,272621,256700
2010/5/1,總計,雲林縣,227916,720469,376413,344056
2010/5/1,總計,嘉義縣,175173,545878,284913,260965
2010/5/1,總計,臺南市,367329,1102889,563300,539589
2010/5/1,總計,高雄市,429904,1243279,637044,606235
2010/5/1,總計,屏東縣,275923,879746,452597,427149
2010/5/1,總計,臺東縣,79990,232226,121634,110592
2010/5/1,總計,花蓮縣,120337,340423,175644,164779
2010/5/1,總計,澎湖縣,33445,96467,49565,46902
2010/5/1,總計,基隆市,146483,386757,194990,191767
2010/5/1,總計,新竹市,140068,413384,205324,208060
2010/5/1,總計,臺中市,381156,1077996,524423,553573
2010/5/1,總計,嘉義市,94850,273444,134608,138836
2010/5/1,總計,臺南市,268067,771905,382075,389830
2010/5/1,總計,臺北市,973131,2604150,1257676,1346474
2010/5/1,總計,高雄市,583935,1528386,754985,773401
2010/5/1,總計,福建省,34097,105023,54724,50299
2010/5/1,總計,金門縣,32031,95038,48937,46101
2010/5/1,總計,連江縣,2066,9985,5787,4198
2010/5/1,新北市,板橋區,192480,553890,274416,279474
2010/5/1,新北市,三重區,138603,389303,194372,194931
2010/5/1,新北市,永和區,89485,236356,113532,122824
2010/5/1,新北市,中和區,154203,414601,205103,209498
2010/5/1,新北市,新莊區,135474,401934,198768,203166
2010/5/1,新北市,新店區,115204,295237,144820,150417
2010/5/1,新北市,土城區,81461,238885,119682,119203
2010/5/1,新北市,蘆洲區,64871,197617,97985,99632
2010/5/1,新北市,汐止區,78099,188399,93629,94770
2010/5/1,新北市,樹林區,58032,173399,87441,85958
2010/5/1,新北市,鶯歌區,27111,86599,43887,42712
2010/5/1,新北市,三峽區,34569,101839,52121,49718
2010/5/1,新北市,淡水區,56190,141849,69094,72755
2010/5/1,新北市,瑞芳區,15761,42596,21811,20785
2010/5/1,新北市,五股區,27007,79332,40349,38983
2010/5/1,新北市,泰山區,25989,76592,38514,38078
2010/5/1,新北市,林口區,29248,80769,39984,40785
2010/5/1,新北市,深坑區,8632,23165,11675,11490
2010/5/1,新北市,石碇區,3290,7970,4453,3517
2010/5/1,新北市,坪林區,2413,6508,3645,2863
2010/5/1,新北市,三芝區,8773,23295,12091,11204
2010/5/1,新北市,石門區,3924,12425,6555,5870
2010/5/1,新北市,八里區,11949,34197,17405,16792
2010/5/1,新北市,平溪區,2373,5394,3009,2385
2010/5/1,新北市,雙溪區,3809,9784,5287,4497
2010/5/1,新北市,貢寮區,4366,13779,7137,6642
2010/5/1,新北市,金山區,6609,22388,11266,11122
2010/5/1,新北市,萬里區,6924,21697,11042,10655
2010/5/1,新北市,烏來區,1690,5708,2900,2808
2010/5/1,宜蘭縣,宜蘭市,32892,95780,47248,48532
2010/5/1,宜蘭縣,羅東鎮,24728,73001,35097,37904
2010/5/1,宜蘭縣,蘇澳鎮,13518,43302,22223,21079
2010/5/1,宜蘭縣,頭城鎮,9635,31080,16071,15009
2010/5/1,宜蘭縣,礁溪鄉,12244,35911,18844,17067
2010/5/1,宜蘭縣,壯圍鄉,8038,25131,13237,11894
2010/5/1,宜蘭縣,員山鄉,10704,32364,17332,15032
2010/5/1,宜蘭縣,冬山鄉,17088,52349,26995,25354
2010/5/1,宜蘭縣,五結鄉,12809,38756,20163,18593
2010/5/1,宜蘭縣,三星鄉,7423,21584,11667,9917
2010/5/1,宜蘭縣,大同鄉,1822,6058,3290,2768
2010/5/1,宜蘭縣,南澳鄉,1791,6093,3225,2868
2010/5/1,桃園市,桃園區,141445,403902,197997,205905
2010/5/1,桃園市,中壢區,125016,367492,183733,183759
2010/5/1,桃園市,平鎮區,65771,207109,104342,102767
2010/5/1,桃園市,八德區,57232,176069,89738,86331
2010/5/1,桃園市,大溪區,28939,91966,47394,44572
2010/5/1,桃園市,楊梅區,47903,150022,76285,73737
2010/5/1,桃園市,蘆竹區,47158,140051,70264,69787
2010/5/1,桃園市,大園區,25814,81669,42412,39257
2010/5/1,桃園市,龜山區,49274,136898,69493,67405
2010/5/1,桃園市,龍潭區,36576,114714,58266,56448
2010/5/1,桃園市,新屋區,14862,49383,26349,23034
2010/5/1,桃園市,觀音區,18983,60909,32147,28762
2010/5/1,桃園市,復興區,3676,10733,6000,4733
2010/5/1,新竹縣,竹北市,45924,139715,70141,69574
2010/5/1,新竹縣,關西鎮,9209,32147,17101,15046
2010/5/1,新竹縣,新埔鎮,10301,35758,18928,16830
2010/5/1,新竹縣,竹東鎮,30328,96821,48847,47974
2010/5/1,新竹縣,湖口鄉,23201,75391,38585,36806
2010/5/1,新竹縣,橫山鄉,4386,14695,7938,6757
2010/5/1,新竹縣,新豐鄉,15473,52964,27362,25602
2010/5/1,新竹縣,芎林鄉,6271,20893,11003,9890
2010/5/1,新竹縣,寶山鄉,4631,14038,7588,6450
2010/5/1,新竹縣,北埔鄉,3087,10256,5558,4698
2010/5/1,新竹縣,峨眉鄉,2022,6066,3363,2703
2010/5/1,新竹縣,尖石鄉,2662,8351,4575,3776
2010/5/1,新竹縣,五峰鄉,1725,4760,2619,2141
2010/5/1,苗栗縣,苗栗市,28920,90579,45658,44921
2010/5/1,苗栗縣,苑裡鎮,13800,48814,25480,23334
2010/5/1,苗栗縣,通霄鎮,11298,38321,20371,17950
2010/5/1,苗栗縣,竹南鎮,23754,77768,39549,38219
2010/5/1,苗栗縣,頭份市,29150,96507,49177,47330
2010/5/1,苗栗縣,後龍鎮,11635,39695,21027,18668
2010/5/1,苗栗縣,卓蘭鎮,5927,18474,9739,8735
2010/5/1,苗栗縣,大湖鄉,5308,16092,8622,7470
2010/5/1,苗栗縣,公館鄉,10103,34804,18294,16510
2010/5/1,苗栗縣,銅鑼鄉,5979,19562,10338,9224
2010/5/1,苗栗縣,南庄鄉,3995,11296,6234,5062
2010/5/1,苗栗縣,頭屋鄉,3503,11636,6146,5490
2010/5/1,苗栗縣,三義鄉,5272,17662,9301,8361
2010/5/1,苗栗縣,西湖鄉,2673,7942,4385,3557
2010/5/1,苗栗縣,造橋鄉,3959,13759,7275,6484
2010/5/1,苗栗縣,三灣鄉,2385,7327,3979,3348
2010/5/1,苗栗縣,獅潭鄉,1687,5001,2785,2216
2010/5/1,苗栗縣,泰安鄉,1941,6080,3286,2794
2010/5/1,臺中市,豐原區,49262,165321,82161,83160
2010/5/1,臺中市,大里區,61039,196716,97722,98994
2010/5/1,臺中市,太平區,54250,172524,86729,85795
2010/5/1,臺中市,東勢區,16876,53508,27791,25717
2010/5/1,臺中市,大甲區,21540,78714,39997,38717
2010/5/1,臺中市,清水區,24821,85679,44234,41445
2010/5/1,臺中市,沙鹿區,23374,81085,41318,39767
2010/5/1,臺中市,梧棲區,15857,54993,27939,27054
2010/5/1,臺中市,后里區,14703,54311,27974,26337
2010/5/1,臺中市,神岡區,17516,63818,32921,30897
2010/5/1,臺中市,潭子區,32149,99679,49766,49913
2010/5/1,臺中市,大雅區,26089,89582,45218,44364
2010/5/1,臺中市,新社區,7311,25655,13471,12184
2010/5/1,臺中市,石岡區,4829,16100,8377,7723
2010/5/1,臺中市,外埔區,8769,31990,16466,15524
2010/5/1,臺中市,大安區,5216,20307,10693,9614
2010/5/1,臺中市,烏日區,20267,68393,34702,33691
2010/5/1,臺中市,大肚區,15735,55824,28669,27155
2010/5/1,臺中市,龍井區,20423,73901,37639,36262
2010/5/1,臺中市,霧峰區,18633,63771,32838,30933
2010/5/1,臺中市,和平區,4453,10696,5840,4856
2010/5/1,彰化縣,彰化市,71303,236872,118097,118775
2010/5/1,彰化縣,鹿港鎮,22132,85398,43798,41600
2010/5/1,彰化縣,和美鎮,23868,89675,46013,43662
2010/5/1,彰化縣,北斗鎮,9841,33593,17038,16555
2010/5/1,彰化縣,員林市,36502,125952,63342,62610
2010/5/1,彰化縣,溪湖鎮,14995,56332,28798,27534
2010/5/1,彰化縣,田中鎮,12481,44286,23057,21229
2010/5/1,彰化縣,二林鎮,14195,54235,27986,26249
2010/5/1,彰化縣,線西鄉,4110,17102,8793,8309
2010/5/1,彰化縣,伸港鄉,8900,35958,18519,17439
2010/5/1,彰化縣,福興鄉,11968,49055,25670,23385
2010/5/1,彰化縣,秀水鄉,9632,39077,20259,18818
2010/5/1,彰化縣,花壇鄉,12840,46153,23813,22340
2010/5/1,彰化縣,芬園鄉,6863,24940,13239,11701
2010/5/1,彰化縣,大村鄉,10150,36586,19069,17517
2010/5/1,彰化縣,埔鹽鄉,8753,34432,18050,16382
2010/5/1,彰化縣,埔心鄉,9856,35268,18296,16972
2010/5/1,彰化縣,永靖鄉,10356,39436,20456,18980
2010/5/1,彰化縣,社頭鄉,12251,44906,23113,21793
2010/5/1,彰化縣,二水鄉,5314,16674,8762,7912
2010/5/1,彰化縣,田尾鄉,7639,28792,15027,13765
2010/5/1,彰化縣,埤頭鄉,8506,31873,16657,15216
2010/5/1,彰化縣,芳苑鄉,9931,36382,19310,17072
2010/5/1,彰化縣,大城鄉,5387,19156,10414,8742
2010/5/1,彰化縣,竹塘鄉,4585,16564,8710,7854
2010/5/1,彰化縣,溪州鄉,8641,31701,16714,14987
2010/5/1,南投縣,南投市,33066,104474,52590,51884
2010/5/1,南投縣,埔里鎮,28155,85498,43171,42327
2010/5/1,南投縣,草屯鎮,30727,100011,50610,49401
2010/5/1,南投縣,竹山鎮,18869,58642,30253,28389
2010/5/1,南投縣,集集鎮,4333,12190,6388,5802
2010/5/1,南投縣,名間鄉,12051,41359,21709,19650
2010/5/1,南投縣,鹿谷鄉,6658,19243,10226,9017
2010/5/1,南投縣,中寮鄉,5618,16315,8862,7453
2010/5/1,南投縣,魚池鄉,5790,17339,9152,8187
2010/5/1,南投縣,國姓鄉,7236,20893,11409,9484
2010/5/1,南投縣,水里鄉,7217,20231,10605,9626
2010/5/1,南投縣,信義鄉,5196,17427,9420,8007
2010/5/1,南投縣,仁愛鄉,4911,15699,8226,7473
2010/5/1,雲林縣,斗六市,34399,106787,53738,53049
2010/5/1,雲林縣,斗南鎮,15140,47349,24082,23267
2010/5/1,雲林縣,虎尾鎮,22276,70204,35749,34455
2010/5/1,雲林縣,西螺鎮,13941,48943,24862,24081
2010/5/1,雲林縣,土庫鎮,8673,30659,16036,14623
2010/5/1,雲林縣,北港鎮,15186,43418,22596,20822
2010/5/1,雲林縣,古坑鄉,10609,34327,18178,16149
2010/5/1,雲林縣,大埤鄉,6610,21374,11430,9944
2010/5/1,雲林縣,莿桐鄉,8951,30570,16024,14546
2010/5/1,雲林縣,林內鄉,5750,20042,10479,9563
2010/5/1,雲林縣,二崙鄉,8755,29812,15998,13814
2010/5/1,雲林縣,崙背鄉,8298,27703,14597,13106
2010/5/1,雲林縣,麥寮鄉,12119,35046,18445,16601
2010/5/1,雲林縣,東勢鄉,5708,17070,9264,7806
2010/5/1,雲林縣,褒忠鄉,4287,14468,7711,6757
2010/5/1,雲林縣,臺西鄉,8823,26428,14219,12209
2010/5/1,雲林縣,元長鄉,9325,29152,15852,13300
2010/5/1,雲林縣,四湖鄉,9055,27110,14783,12327
2010/5/1,雲林縣,口湖鄉,9637,30737,16375,14362
2010/5/1,雲林縣,水林鄉,10374,29270,15995,13275
2010/5/1,嘉義縣,太保市,11100,36357,18762,17595
2010/5/1,嘉義縣,朴子市,14439,44359,22626,21733
2010/5/1,嘉義縣,布袋鎮,10142,30482,15671,14811
2010/5/1,嘉義縣,大林鎮,11137,33817,17369,16448
2010/5/1,嘉義縣,民雄鄉,22564,72666,37365,35301
2010/5/1,嘉義縣,溪口鄉,5391,16452,8770,7682
2010/5/1,嘉義縣,新港鄉,10343,34955,18472,16483
2010/5/1,嘉義縣,六腳鄉,9124,26659,14126,12533
2010/5/1,嘉義縣,東石鄉,9454,27999,14885,13114
2010/5/1,嘉義縣,義竹鄉,7449,21375,11063,10312
2010/5/1,嘉義縣,鹿草鄉,5706,17371,9311,8060
2010/5/1,嘉義縣,水上鄉,17313,52429,27157,25272
2010/5/1,嘉義縣,中埔鄉,15169,47583,24878,22705
2010/5/1,嘉義縣,竹崎鄉,11276,38804,20670,18134
2010/5/1,嘉義縣,梅山鄉,6630,21920,11616,10304
2010/5/1,嘉義縣,番路鄉,3899,11726,6363,5363
2010/5/1,嘉義縣,大埔鄉,1974,4658,2457,2201
2010/5/1,嘉義縣,阿里山鄉,2063,6266,3352,2914
2010/5/1,臺南市,新營區,26957,78293,39163,39130
2010/5/1,臺南市,永康區,74172,215685,107356,108329
2010/5/1,臺南市,鹽水區,9890,27233,14202,13031
2010/5/1,臺南市,白河區,10910,31592,16578,15014
2010/5/1,臺南市,麻豆區,14986,46024,23564,22460
2010/5/1,臺南市,佳里區,19147,59434,29595,29839
2010/5/1,臺南市,新化區,13623,44236,22662,21574
2010/5/1,臺南市,善化區,14427,43458,22025,21433
2010/5/1,臺南市,學甲區,9506,27999,14311,13688
2010/5/1,臺南市,柳營區,7763,22818,11936,10882
2010/5/1,臺南市,後壁區,8747,26034,13564,12470
2010/5/1,臺南市,東山區,8200,23256,12402,10854
2010/5/1,臺南市,下營區,9071,26237,13598,12639
2010/5/1,臺南市,六甲區,7581,23873,12390,11483
2010/5/1,臺南市,官田區,7577,22294,11428,10866
2010/5/1,臺南市,大內區,4075,10996,5839,5157
2010/5/1,臺南市,西港區,7784,25278,12893,12385
2010/5/1,臺南市,七股區,7970,24920,13055,11865
2010/5/1,臺南市,將軍區,7409,21645,11022,10623
2010/5/1,臺南市,北門區,4374,12540,6386,6154
2010/5/1,臺南市,新市區,10699,34838,17529,17309
2010/5/1,臺南市,安定區,9204,30098,15609,14489
2010/5/1,臺南市,山上區,2726,7948,4182,3766
2010/5/1,臺南市,玉井區,5070,15497,8043,7454
2010/5/1,臺南市,楠西區,3588,10710,5684,5026
2010/5/1,臺南市,南化區,2825,8945,4886,4059
2010/5/1,臺南市,左鎮區,1974,5556,3091,2465
2010/5/1,臺南市,仁德區,24448,68999,35511,33488
2010/5/1,臺南市,歸仁區,20365,65887,33633,32254
2010/5/1,臺南市,關廟區,10660,36145,18769,17376
2010/5/1,臺南市,龍崎區,1601,4421,2394,2027
2010/5/1,高雄市,鳳山區,125755,340594,170005,170589
2010/5/1,高雄市,岡山區,32965,97163,48835,48328
2010/5/1,高雄市,旗山區,13778,40262,21004,19258
2010/5/1,高雄市,美濃區,14026,43259,22584,20675
2010/5/1,高雄市,林園區,23948,70656,36300,34356
2010/5/1,高雄市,大寮區,37967,108872,56620,52252
2010/5/1,高雄市,大樹區,13035,44147,22860,21287
2010/5/1,高雄市,仁武區,25248,71017,36716,34301
2010/5/1,高雄市,大社區,11597,32861,16909,15952
2010/5/1,高雄市,鳥松區,16366,42319,21546,20773
2010/5/1,高雄市,橋頭區,12434,36349,18635,17714
2010/5/1,高雄市,燕巢區,9946,30981,16556,14425
2010/5/1,高雄市,田寮區,3551,8267,4590,3677
2010/5/1,高雄市,阿蓮區,9120,30550,15431,15119
2010/5/1,高雄市,路竹區,15982,54019,27585,26434
2010/5/1,高雄市,湖內區,9466,28741,14834,13907
2010/5/1,高雄市,茄萣區,10104,31459,16431,15028
2010/5/1,高雄市,永安區,5801,14257,7268,6989
2010/5/1,高雄市,彌陀區,6536,20539,10678,9861
2010/5/1,高雄市,梓官區,11933,36786,19149,17637
2010/5/1,高雄市,六龜區,5794,15130,8196,6934
2010/5/1,高雄市,甲仙區,2530,7424,3999,3425
2010/5/1,高雄市,杉林區,4216,11474,6265,5209
2010/5/1,高雄市,內門區,5019,16034,8753,7281
2010/5/1,高雄市,茂林區,565,1837,936,901
2010/5/1,高雄市,桃源區,1342,4844,2571,2273
2010/5/1,高雄市,那瑪夏區,880,3438,1788,1650
2010/5/1,屏東縣,屏東市,72303,212731,106248,106483
2010/5/1,屏東縣,潮州鎮,18015,55668,28065,27603
2010/5/1,屏東縣,東港鎮,15573,50409,25566,24843
2010/5/1,屏東縣,恆春鎮,10708,31201,16037,15164
2010/5/1,屏東縣,萬丹鄉,14200,54225,28038,26187
2010/5/1,屏東縣,長治鄉,9667,30946,16183,14763
2010/5/1,屏東縣,麟洛鄉,3575,11638,6030,5608
2010/5/1,屏東縣,九如鄉,6526,22930,11937,10993
2010/5/1,屏東縣,里港鄉,7817,26163,13405,12758
2010/5/1,屏東縣,鹽埔鄉,7654,27403,14231,13172
2010/5/1,屏東縣,高樹鄉,9554,27034,14434,12600
2010/5/1,屏東縣,萬巒鄉,6390,22137,11655,10482
2010/5/1,屏東縣,內埔鄉,17637,58430,30375,28055
2010/5/1,屏東縣,竹田鄉,5462,18406,9791,8615
2010/5/1,屏東縣,新埤鄉,3356,10822,5732,5090
2010/5/1,屏東縣,枋寮鄉,8432,26856,14179,12677
2010/5/1,屏東縣,新園鄉,11377,38665,19938,18727
2010/5/1,屏東縣,崁頂鄉,4175,17376,8883,8493
2010/5/1,屏東縣,林邊鄉,7088,21075,10871,10204
2010/5/1,屏東縣,南州鄉,3663,11843,6101,5742
2010/5/1,屏東縣,佳冬鄉,7089,21511,11231,10280
2010/5/1,屏東縣,琉球鄉,3939,12524,6933,5591
2010/5/1,屏東縣,車城鄉,3526,9895,5345,4550
2010/5/1,屏東縣,滿州鄉,3050,8613,4712,3901
2010/5/1,屏東縣,枋山鄉,2081,6119,3276,2843
2010/5/1,屏東縣,三地門鄉,2159,7590,3880,3710
2010/5/1,屏東縣,霧臺鄉,971,2971,1560,1411
2010/5/1,屏東縣,瑪家鄉,1882,6577,3430,3147
2010/5/1,屏東縣,泰武鄉,1232,5170,2715,2455
2010/5/1,屏東縣,來義鄉,2152,7864,4039,3825
2010/5/1,屏東縣,春日鄉,1326,4856,2535,2321
2010/5/1,屏東縣,獅子鄉,1469,5023,2622,2401
2010/5/1,屏東縣,牡丹鄉,1875,5075,2620,2455
2010/5/1,臺東縣,臺東市,37763,109177,55434,53743
2010/5/1,臺東縣,成功鎮,5415,15925,8498,7427
2010/5/1,臺東縣,關山鎮,3213,9830,5137,4693
2010/5/1,臺東縣,卑南鄉,6561,18334,9924,8410
2010/5/1,臺東縣,大武鄉,2529,7177,3719,3458
2010/5/1,臺東縣,太麻里鄉,4532,12131,6498,5633
2010/5/1,臺東縣,東河鄉,3551,9490,5264,4226
2010/5/1,臺東縣,長濱鄉,2931,8438,4813,3625
2010/5/1,臺東縣,鹿野鄉,3127,8648,4668,3980
2010/5/1,臺東縣,池上鄉,3260,9296,4922,4374
2010/5/1,臺東縣,綠島鄉,992,3336,1789,1547
2010/5/1,臺東縣,延平鄉,1079,3669,2022,1647
2010/5/1,臺東縣,海端鄉,1094,4537,2468,2069
2010/5/1,臺東縣,達仁鄉,1508,4186,2278,1908
2010/5/1,臺東縣,金峰鄉,1051,3673,1908,1765
2010/5/1,臺東縣,蘭嶼鄉,1384,4379,2292,2087
2010/5/1,花蓮縣,花蓮市,40356,109808,53870,55938
2010/5/1,花蓮縣,鳳林鎮,4454,12079,6400,5679
2010/5/1,花蓮縣,玉里鎮,8911,27108,14719,12389
2010/5/1,花蓮縣,新城鄉,7258,20257,10547,9710
2010/5/1,花蓮縣,吉安鄉,28696,79452,40764,38688
2010/5/1,花蓮縣,壽豐鄉,6792,18813,10199,8614
2010/5/1,花蓮縣,光復鄉,5001,14284,7601,6683
2010/5/1,花蓮縣,豐濱鄉,1820,5204,2868,2336
2010/5/1,花蓮縣,瑞穗鄉,4630,13028,7013,6015
2010/5/1,花蓮縣,富里鄉,3989,11807,6471,5336
2010/5/1,花蓮縣,秀林鄉,4625,15230,7911,7319
2010/5/1,花蓮縣,萬榮鄉,2146,6946,3707,3239
2010/5/1,花蓮縣,卓溪鄉,1659,6407,3574,2833
2010/5/1,澎湖縣,馬公市,19663,56482,28613,27869
2010/5/1,澎湖縣,湖西鄉,4703,13663,7123,6540
2010/5/1,澎湖縣,白沙鄉,3124,9523,4993,4530
2010/5/1,澎湖縣,西嶼鄉,2837,8455,4380,4075
2010/5/1,澎湖縣,望安鄉,1880,4756,2568,2188
2010/5/1,澎湖縣,七美鄉,1238,3588,1888,1700
2010/5/1,基隆市,中正區,22005,55812,28637,27175
2010/5/1,基隆市,七堵區,19931,55367,28063,27304
2010/5/1,基隆市,暖暖區,14228,38049,19346,18703
2010/5/1,基隆市,仁愛區,19739,50299,24805,25494
2010/5/1,基隆市,中山區,18960,51314,26233,25081
2010/5/1,基隆市,安樂區,31698,84593,42160,42433
2010/5/1,基隆市,信義區,19922,51323,25746,25577
2010/5/1,新竹市,東區,67362,196116,96813,99303
2010/5/1,新竹市,北區,50053,144935,71635,73300
2010/5/1,新竹市,香山區,22653,72333,36876,35457
2010/5/1,臺中市,中區,8438,23101,11384,11717
2010/5/1,臺中市,東區,25644,73736,37289,36447
2010/5/1,臺中市,西區,43024,117587,56538,61049
2010/5/1,臺中市,南區,41600,112955,54873,58082
2010/5/1,臺中市,北區,55417,147841,71728,76113
2010/5/1,臺中市,西屯區,72022,205103,99662,105441
2010/5/1,臺中市,南屯區,52428,152225,73578,78647
2010/5/1,臺中市,北屯區,82583,245448,119371,126077
2010/5/1,嘉義市,東區,44110,125967,61496,64471
2010/5/1,嘉義市,西區,50740,147477,73112,74365
2010/5/1,臺南市,東區,70552,194392,94144,100248
2010/5/1,臺南市,南區,42969,126306,63409,62897
2010/5/1,臺南市,北區,47704,131590,65039,66551
2010/5/1,臺南市,安南區,53925,177499,90348,87151
2010/5/1,臺南市,安平區,22839,62137,29808,32329
2010/5/1,臺南市,中西區,30078,79981,39327,40654
2010/5/1,臺北市,松山區,77443,208225,98840,109385
2010/5/1,臺北市,信義區,85436,224444,108330,116114
2010/5/1,臺北市,大安區,116189,310966,146493,164473
2010/5/1,臺北市,中山區,90746,218074,102916,115158
2010/5/1,臺北市,中正區,61741,159073,76776,82297
2010/5/1,臺北市,大同區,46801,123685,61046,62639
2010/5/1,臺北市,萬華區,73339,187461,93677,93784
2010/5/1,臺北市,文山區,96106,260713,126481,134232
2010/5/1,臺北市,南港區,41167,112824,55678,57146
2010/5/1,臺北市,內湖區,95398,267757,129256,138501
2010/5/1,臺北市,士林區,99893,283171,137828,145343
2010/5/1,臺北市,北投區,88872,247757,120355,127402
2010/5/1,高雄市,鹽埕區,11166,27678,13926,13752
2010/5/1,高雄市,鼓山區,51501,130380,64054,66326
2010/5/1,高雄市,左營區,73036,190747,93994,96753
2010/5/1,高雄市,楠梓區,61327,172314,85591,86723
2010/5/1,高雄市,三民區,130748,354690,173804,180886
2010/5/1,高雄市,新興區,22869,55584,27098,28486
2010/5/1,高雄市,前金區,12512,29087,14203,14884
2010/5/1,高雄市,苓雅區,71498,184685,90057,94628
2010/5/1,高雄市,前鎮區,75945,199376,99250,100126
2010/5/1,高雄市,旗津區,10923,29941,15586,14355
2010/5/1,高雄市,小港區,62410,153904,77422,76482
2010/5/1,金門縣,金城鎮,10793,31919,16427,15492
2010/5/1,金門縣,金湖鎮,7137,20813,10776,10037
2010/5/1,金門縣,金沙鎮,5305,15078,7688,7390
2010/5/1,金門縣,金寧鄉,6082,18003,9360,8643
2010/5/1,金門縣,烈嶼鄉,2578,8707,4424,4283
2010/5/1,金門縣,烏坵鄉,136,518,262,256
2010/5/1,連江縣,南竿鄉,1183,5942,3437,2505
2010/5/1,連江縣,北竿鄉,377,1795,1034,761
2010/5/1,連江縣,莒光鄉,236,1168,684,484
2010/5/1,連江縣,東引鄉,270,1080,632,448
2010/6/1,總計,臺灣地區,7840923,23033307,11580078,11453229
2010/6/1,總計,臺灣省,6282292,18902312,9568497,9333815
2010/6/1,總計,新北市,1390687,3880743,1929633,1951110
2010/6/1,總計,宜蘭縣,152756,460604,234986,225618
2010/6/1,總計,桃園市,670717,2017047,1016776,1000271
2010/6/1,總計,新竹縣,159255,509802,262613,247189
2010/6/1,總計,苗栗縣,171309,559921,290839,269082
2010/6/1,總計,臺中市,463617,1561882,792055,769827
2010/6/1,總計,彰化縣,361251,1308926,672190,636736
2010/6/1,總計,南投縣,169868,528283,272042,256241
2010/6/1,總計,雲林縣,227986,718671,375427,343244
2010/6/1,總計,嘉義縣,175295,544782,284358,260424
2010/6/1,總計,臺南市,367705,1102059,562872,539187
2010/6/1,總計,高雄市,430257,1242555,636589,605966
2010/6/1,總計,屏東縣,276052,878062,451724,426338
2010/6/1,總計,臺東縣,79990,231737,121361,110376
2010/6/1,總計,花蓮縣,120380,339671,175261,164410
2010/6/1,總計,澎湖縣,33525,96388,49523,46865
2010/6/1,總計,基隆市,146522,385869,194532,191337
2010/6/1,總計,新竹市,140282,412893,205159,207734
2010/6/1,總計,臺中市,381719,1078023,524332,553691
2010/6/1,總計,嘉義市,94821,272882,134334,138548
2010/6/1,總計,臺南市,268298,771512,381891,389621
2010/6/1,總計,臺北市,973957,2602868,1256830,1346038
2010/6/1,總計,高雄市,584674,1528127,754751,773376
2010/6/1,總計,福建省,34145,105074,54714,50360
2010/6/1,總計,金門縣,32073,95145,48957,46188
2010/6/1,總計,連江縣,2072,9929,5757,4172
2010/6/1,新北市,板橋區,192738,553175,274066,279109
2010/6/1,新北市,三重區,138877,389361,194380,194981
2010/6/1,新北市,永和區,89451,235837,113284,122553
2010/6/1,新北市,中和區,154364,414160,204865,209295
2010/6/1,新北市,新莊區,135533,400973,198314,202659
2010/6/1,新北市,新店區,115395,295076,144723,150353
2010/6/1,新北市,土城區,81523,238359,119442,118917
2010/6/1,新北市,蘆洲區,64917,197272,97829,99443
2010/6/1,新北市,汐止區,78251,188375,93632,94743
2010/6/1,新北市,樹林區,58241,173442,87459,85983
2010/6/1,新北市,鶯歌區,27019,85377,43323,42054
2010/6/1,新北市,三峽區,34744,101771,52089,49682
2010/6/1,新北市,淡水區,56405,142039,69177,72862
2010/6/1,新北市,瑞芳區,15751,42535,21793,20742
2010/6/1,新北市,五股區,27030,79201,40302,38899
2010/6/1,新北市,泰山區,26032,76509,38465,38044
2010/6/1,新北市,林口區,29502,80901,40026,40875
2010/6/1,新北市,深坑區,8654,23145,11673,11472
2010/6/1,新北市,石碇區,3294,7984,4458,3526
2010/6/1,新北市,坪林區,2414,6511,3636,2875
2010/6/1,新北市,三芝區,8781,23286,12090,11196
2010/6/1,新北市,石門區,3941,12419,6549,5870
2010/6/1,新北市,八里區,12015,34262,17421,16841
2010/6/1,新北市,平溪區,2378,5391,3011,2380
2010/6/1,新北市,雙溪區,3810,9785,5293,4492
2010/6/1,新北市,貢寮區,4371,13755,7112,6643
2010/6/1,新北市,金山區,6625,22341,11241,11100
2010/6/1,新北市,萬里區,6941,21792,11079,10713
2010/6/1,新北市,烏來區,1690,5709,2901,2808
2010/6/1,宜蘭縣,宜蘭市,32924,95637,47179,48458
2010/6/1,宜蘭縣,羅東鎮,24733,72925,35062,37863
2010/6/1,宜蘭縣,蘇澳鎮,13509,43178,22165,21013
2010/6/1,宜蘭縣,頭城鎮,9640,31004,16037,14967
2010/6/1,宜蘭縣,礁溪鄉,12220,35803,18772,17031
2010/6/1,宜蘭縣,壯圍鄉,8038,25083,13208,11875
2010/6/1,宜蘭縣,員山鄉,10702,32328,17323,15005
2010/6/1,宜蘭縣,冬山鄉,17117,52309,26954,25355
2010/6/1,宜蘭縣,五結鄉,12830,38712,20149,18563
2010/6/1,宜蘭縣,三星鄉,7422,21521,11644,9877
2010/6/1,宜蘭縣,大同鄉,1824,6026,3274,2752
2010/6/1,宜蘭縣,南澳鄉,1797,6078,3219,2859
2010/6/1,桃園市,桃園區,143858,413347,202302,211045
2010/6/1,桃園市,中壢區,126127,371326,185517,185809
2010/6/1,桃園市,平鎮區,66084,207654,104582,103072
2010/6/1,桃園市,八德區,57861,177783,90567,87216
2010/6/1,桃園市,大溪區,29533,93589,48188,45401
2010/6/1,桃園市,楊梅區,48381,151404,76976,74428
2010/6/1,桃園市,蘆竹區,47684,141638,71050,70588
2010/6/1,桃園市,大園區,26106,82413,42777,39636
2010/6/1,桃園市,龜山區,50057,138972,70536,68436
2010/6/1,桃園市,龍潭區,37324,117431,59532,57899
2010/6/1,桃園市,新屋區,14924,49553,26447,23106
2010/6/1,桃園市,觀音區,19085,61121,32256,28865
2010/6/1,桃園市,復興區,3693,10816,6046,4770
2010/6/1,新竹縣,竹北市,46033,139748,70194,69554
2010/6/1,新竹縣,關西鎮,9195,31734,16888,14846
2010/6/1,新竹縣,新埔鎮,10291,35519,18816,16703
2010/6/1,新竹縣,竹東鎮,30352,96630,48732,47898
2010/6/1,新竹縣,湖口鄉,23158,74805,38304,36501
2010/6/1,新竹縣,橫山鄉,4373,14521,7858,6663
2010/6/1,新竹縣,新豐鄉,15475,52756,27265,25491
2010/6/1,新竹縣,芎林鄉,6266,20770,10944,9826
2010/6/1,新竹縣,寶山鄉,4636,14050,7585,6465
2010/6/1,新竹縣,北埔鄉,3087,10198,5537,4661
2010/6/1,新竹縣,峨眉鄉,2017,6056,3354,2702
2010/6/1,新竹縣,尖石鄉,2651,8282,4533,3749
2010/6/1,新竹縣,五峰鄉,1721,4733,2603,2130
2010/6/1,苗栗縣,苗栗市,28932,90401,45567,44834
2010/6/1,苗栗縣,苑裡鎮,13784,48711,25430,23281
2010/6/1,苗栗縣,通霄鎮,11295,38175,20294,17881
2010/6/1,苗栗縣,竹南鎮,23789,77733,39538,38195
2010/6/1,苗栗縣,頭份市,29151,96273,49003,47270
2010/6/1,苗栗縣,後龍鎮,11645,39605,20974,18631
2010/6/1,苗栗縣,卓蘭鎮,5929,18464,9741,8723
2010/6/1,苗栗縣,大湖鄉,5300,16038,8590,7448
2010/6/1,苗栗縣,公館鄉,10116,34708,18240,16468
2010/6/1,苗栗縣,銅鑼鄉,5969,19489,10300,9189
2010/6/1,苗栗縣,南庄鄉,3989,11209,6178,5031
2010/6/1,苗栗縣,頭屋鄉,3499,11614,6132,5482
2010/6/1,苗栗縣,三義鄉,5255,17574,9240,8334
2010/6/1,苗栗縣,西湖鄉,2681,7914,4371,3543
2010/6/1,苗栗縣,造橋鄉,3970,13716,7248,6468
2010/6/1,苗栗縣,三灣鄉,2383,7288,3955,3333
2010/6/1,苗栗縣,獅潭鄉,1684,4974,2771,2203
2010/6/1,苗栗縣,泰安鄉,1938,6035,3267,2768
2010/6/1,臺中市,豐原區,49335,165238,82116,83122
2010/6/1,臺中市,大里區,61092,196616,97653,98963
2010/6/1,臺中市,太平區,54317,172490,86727,85763
2010/6/1,臺中市,東勢區,16878,53451,27785,25666
2010/6/1,臺中市,大甲區,21547,78615,39955,38660
2010/6/1,臺中市,清水區,24819,85490,44137,41353
2010/6/1,臺中市,沙鹿區,23434,81111,41324,39787
2010/6/1,臺中市,梧棲區,15875,55008,27951,27057
2010/6/1,臺中市,后里區,14713,54269,27939,26330
2010/6/1,臺中市,神岡區,17517,63740,32863,30877
2010/6/1,臺中市,潭子區,32186,99755,49784,49971
2010/6/1,臺中市,大雅區,26135,89574,45217,44357
2010/6/1,臺中市,新社區,7318,25672,13470,12202
2010/6/1,臺中市,石岡區,4830,16059,8356,7703
2010/6/1,臺中市,外埔區,8778,31969,16447,15522
2010/6/1,臺中市,大安區,5231,20319,10689,9630
2010/6/1,臺中市,烏日區,20318,68396,34697,33699
2010/6/1,臺中市,大肚區,15756,55758,28640,27118
2010/6/1,臺中市,龍井區,20442,73892,37644,36248
2010/6/1,臺中市,霧峰區,18652,63764,32829,30935
2010/6/1,臺中市,和平區,4444,10696,5832,4864
2010/6/1,彰化縣,彰化市,71357,236724,118024,118700
2010/6/1,彰化縣,鹿港鎮,22167,85364,43757,41607
2010/6/1,彰化縣,和美鎮,23889,89590,45962,43628
2010/6/1,彰化縣,北斗鎮,9838,33533,16998,16535
2010/6/1,彰化縣,員林市,36523,125799,63273,62526
2010/6/1,彰化縣,溪湖鎮,15010,56217,28746,27471
2010/6/1,彰化縣,田中鎮,12482,44187,22993,21194
2010/6/1,彰化縣,二林鎮,14207,54134,27930,26204
2010/6/1,彰化縣,線西鄉,4119,17131,8800,8331
2010/6/1,彰化縣,伸港鄉,8908,35919,18496,17423
2010/6/1,彰化縣,福興鄉,11988,49020,25656,23364
2010/6/1,彰化縣,秀水鄉,9647,39063,20251,18812
2010/6/1,彰化縣,花壇鄉,12860,46122,23800,22322
2010/6/1,彰化縣,芬園鄉,6865,24905,13218,11687
2010/6/1,彰化縣,大村鄉,10160,36540,19048,17492
2010/6/1,彰化縣,埔鹽鄉,8759,34404,18037,16367
2010/6/1,彰化縣,埔心鄉,9850,35230,18279,16951
2010/6/1,彰化縣,永靖鄉,10361,39406,20445,18961
2010/6/1,彰化縣,社頭鄉,12252,44832,23080,21752
2010/6/1,彰化縣,二水鄉,5316,16625,8738,7887
2010/6/1,彰化縣,田尾鄉,7637,28749,15008,13741
2010/6/1,彰化縣,埤頭鄉,8513,31835,16625,15210
2010/6/1,彰化縣,芳苑鄉,9936,36336,19282,17054
2010/6/1,彰化縣,大城鄉,5381,19079,10373,8706
2010/6/1,彰化縣,竹塘鄉,4582,16549,8697,7852
2010/6/1,彰化縣,溪州鄉,8644,31633,16674,14959
2010/6/1,南投縣,南投市,33074,104282,52468,51814
2010/6/1,南投縣,埔里鎮,28195,85438,43132,42306
2010/6/1,南投縣,草屯鎮,30737,99844,50520,49324
2010/6/1,南投縣,竹山鎮,18868,58558,30215,28343
2010/6/1,南投縣,集集鎮,4302,12058,6314,5744
2010/6/1,南投縣,名間鄉,12060,41325,21682,19643
2010/6/1,南投縣,鹿谷鄉,6658,19151,10177,8974
2010/6/1,南投縣,中寮鄉,5618,16265,8836,7429
2010/6/1,南投縣,魚池鄉,5795,17291,9132,8159
2010/6/1,南投縣,國姓鄉,7232,20850,11380,9470
2010/6/1,南投縣,水里鄉,7214,20213,10596,9617
2010/6/1,南投縣,信義鄉,5205,17388,9409,7979
2010/6/1,南投縣,仁愛鄉,4910,15620,8181,7439
2010/6/1,雲林縣,斗六市,34424,106653,53645,53008
2010/6/1,雲林縣,斗南鎮,15150,47314,24065,23249
2010/6/1,雲林縣,虎尾鎮,22323,70129,35709,34420
2010/6/1,雲林縣,西螺鎮,13951,48798,24790,24008
2010/6/1,雲林縣,土庫鎮,8693,30635,16027,14608
2010/6/1,雲林縣,北港鎮,15208,43374,22567,20807
2010/6/1,雲林縣,古坑鄉,10617,34236,18131,16105
2010/6/1,雲林縣,大埤鄉,6610,21311,11390,9921
2010/6/1,雲林縣,莿桐鄉,8958,30491,15984,14507
2010/6/1,雲林縣,林內鄉,5737,19972,10448,9524
2010/6/1,雲林縣,二崙鄉,8760,29766,15972,13794
2010/6/1,雲林縣,崙背鄉,8298,27629,14559,13070
2010/6/1,雲林縣,麥寮鄉,12111,34952,18409,16543
2010/6/1,雲林縣,東勢鄉,5703,17009,9232,7777
2010/6/1,雲林縣,褒忠鄉,4283,14397,7675,6722
2010/6/1,雲林縣,臺西鄉,8806,26345,14171,12174
2010/6/1,雲林縣,元長鄉,9306,28982,15750,13232
2010/6/1,雲林縣,四湖鄉,9043,26960,14709,12251
2010/6/1,雲林縣,口湖鄉,9626,30593,16283,14310
2010/6/1,雲林縣,水林鄉,10379,29125,15911,13214
2010/6/1,嘉義縣,太保市,11123,36333,18748,17585
2010/6/1,嘉義縣,朴子市,14461,44292,22594,21698
2010/6/1,嘉義縣,布袋鎮,10140,30396,15617,14779
2010/6/1,嘉義縣,大林鎮,11147,33732,17326,16406
2010/6/1,嘉義縣,民雄鄉,22583,72562,37296,35266
2010/6/1,嘉義縣,溪口鄉,5387,16408,8745,7663
2010/6/1,嘉義縣,新港鄉,10348,34877,18447,16430
2010/6/1,嘉義縣,六腳鄉,9119,26549,14066,12483
2010/6/1,嘉義縣,東石鄉,9457,27929,14855,13074
2010/6/1,嘉義縣,義竹鄉,7453,21339,11042,10297
2010/6/1,嘉義縣,鹿草鄉,5718,17342,9300,8042
2010/6/1,嘉義縣,水上鄉,17318,52298,27092,25206
2010/6/1,嘉義縣,中埔鄉,15193,47543,24855,22688
2010/6/1,嘉義縣,竹崎鄉,11268,38724,20634,18090
2010/6/1,嘉義縣,梅山鄉,6636,21866,11589,10277
2010/6/1,嘉義縣,番路鄉,3906,11665,6345,5320
2010/6/1,嘉義縣,大埔鄉,1970,4661,2454,2207
2010/6/1,嘉義縣,阿里山鄉,2068,6266,3353,2913
2010/6/1,臺南市,新營區,26976,78194,39105,39089
2010/6/1,臺南市,永康區,74312,215698,107370,108328
2010/6/1,臺南市,鹽水區,9904,27259,14228,13031
2010/6/1,臺南市,白河區,10910,31540,16559,14981
2010/6/1,臺南市,麻豆區,14992,45934,23509,22425
2010/6/1,臺南市,佳里區,19165,59396,29576,29820
2010/6/1,臺南市,新化區,13640,44186,22649,21537
2010/6/1,臺南市,善化區,14437,43427,22002,21425
2010/6/1,臺南市,學甲區,9515,27969,14289,13680
2010/6/1,臺南市,柳營區,7761,22752,11905,10847
2010/6/1,臺南市,後壁區,8765,26043,13563,12480
2010/6/1,臺南市,東山區,8208,23246,12391,10855
2010/6/1,臺南市,下營區,9075,26195,13581,12614
2010/6/1,臺南市,六甲區,7580,23819,12367,11452
2010/6/1,臺南市,官田區,7574,22237,11406,10831
2010/6/1,臺南市,大內區,4074,10968,5827,5141
2010/6/1,臺南市,西港區,7784,25242,12869,12373
2010/6/1,臺南市,七股區,7975,24917,13037,11880
2010/6/1,臺南市,將軍區,7424,21612,11002,10610
2010/6/1,臺南市,北門區,4371,12520,6381,6139
2010/6/1,臺南市,新市區,10693,34786,17499,17287
2010/6/1,臺南市,安定區,9219,30117,15620,14497
2010/6/1,臺南市,山上區,2721,7927,4170,3757
2010/6/1,臺南市,玉井區,5076,15487,8041,7446
2010/6/1,臺南市,楠西區,3586,10696,5677,5019
2010/6/1,臺南市,南化區,2822,8927,4877,4050
2010/6/1,臺南市,左鎮區,1975,5549,3090,2459
2010/6/1,臺南市,仁德區,24502,68998,35506,33492
2010/6/1,臺南市,歸仁區,20395,65894,33641,32253
2010/6/1,臺南市,關廟區,10674,36129,18749,17380
2010/6/1,臺南市,龍崎區,1600,4395,2386,2009
2010/6/1,高雄市,鳳山區,125893,340373,169866,170507
2010/6/1,高雄市,岡山區,32997,97140,48827,48313
2010/6/1,高雄市,旗山區,13770,40169,20955,19214
2010/6/1,高雄市,美濃區,14042,43200,22562,20638
2010/6/1,高雄市,林園區,23963,70565,36255,34310
2010/6/1,高雄市,大寮區,37982,108765,56574,52191
2010/6/1,高雄市,大樹區,13039,44098,22825,21273
2010/6/1,高雄市,仁武區,25296,71110,36745,34365
2010/6/1,高雄市,大社區,11593,32825,16889,15936
2010/6/1,高雄市,鳥松區,16361,42344,21541,20803
2010/6/1,高雄市,橋頭區,12444,36325,18617,17708
2010/6/1,高雄市,燕巢區,9974,30945,16539,14406
2010/6/1,高雄市,田寮區,3544,8255,4588,3667
2010/6/1,高雄市,阿蓮區,9122,30525,15414,15111
2010/6/1,高雄市,路竹區,15996,53973,27550,26423
2010/6/1,高雄市,湖內區,9480,28768,14850,13918
2010/6/1,高雄市,茄萣區,10110,31472,16425,15047
2010/6/1,高雄市,永安區,5802,14256,7276,6980
2010/6/1,高雄市,彌陀區,6538,20503,10665,9838
2010/6/1,高雄市,梓官區,11941,36777,19130,17647
2010/6/1,高雄市,六龜區,5786,15067,8163,6904
2010/6/1,高雄市,甲仙區,2530,7404,3990,3414
2010/6/1,高雄市,杉林區,4226,11537,6297,5240
2010/6/1,高雄市,內門區,5028,16033,8748,7285
2010/6/1,高雄市,茂林區,566,1837,936,901
2010/6/1,高雄市,桃源區,1351,4861,2579,2282
2010/6/1,高雄市,那瑪夏區,883,3428,1783,1645
2010/6/1,屏東縣,屏東市,72315,212368,106034,106334
2010/6/1,屏東縣,潮州鎮,18008,55517,27992,27525
2010/6/1,屏東縣,東港鎮,15604,50406,25567,24839
2010/6/1,屏東縣,恆春鎮,10710,31160,16012,15148
2010/6/1,屏東縣,萬丹鄉,14214,54197,28036,26161
2010/6/1,屏東縣,長治鄉,9667,30879,16144,14735
2010/6/1,屏東縣,麟洛鄉,3579,11609,6024,5585
2010/6/1,屏東縣,九如鄉,6535,22900,11917,10983
2010/6/1,屏東縣,里港鄉,7813,26126,13394,12732
2010/6/1,屏東縣,鹽埔鄉,7650,27358,14205,13153
2010/6/1,屏東縣,高樹鄉,9560,26984,14400,12584
2010/6/1,屏東縣,萬巒鄉,6378,22089,11630,10459
2010/6/1,屏東縣,內埔鄉,17657,58351,30347,28004
2010/6/1,屏東縣,竹田鄉,5477,18411,9781,8630
2010/6/1,屏東縣,新埤鄉,3357,10791,5722,5069
2010/6/1,屏東縣,枋寮鄉,8429,26750,14117,12633
2010/6/1,屏東縣,新園鄉,11390,38548,19883,18665
2010/6/1,屏東縣,崁頂鄉,4187,17387,8887,8500
2010/6/1,屏東縣,林邊鄉,7105,21019,10844,10175
2010/6/1,屏東縣,南州鄉,3664,11813,6084,5729
2010/6/1,屏東縣,佳冬鄉,7105,21481,11208,10273
2010/6/1,屏東縣,琉球鄉,3944,12473,6919,5554
2010/6/1,屏東縣,車城鄉,3521,9837,5317,4520
2010/6/1,屏東縣,滿州鄉,3049,8580,4694,3886
2010/6/1,屏東縣,枋山鄉,2086,6097,3262,2835
2010/6/1,屏東縣,三地門鄉,2153,7557,3865,3692
2010/6/1,屏東縣,霧臺鄉,968,2962,1557,1405
2010/6/1,屏東縣,瑪家鄉,1876,6551,3413,3138
2010/6/1,屏東縣,泰武鄉,1232,5140,2698,2442
2010/6/1,屏東縣,來義鄉,2152,7827,4018,3809
2010/6/1,屏東縣,春日鄉,1324,4852,2534,2318
2010/6/1,屏東縣,獅子鄉,1467,4991,2606,2385
2010/6/1,屏東縣,牡丹鄉,1876,5051,2613,2438
2010/6/1,臺東縣,臺東市,37778,109067,55353,53714
2010/6/1,臺東縣,成功鎮,5415,15898,8489,7409
2010/6/1,臺東縣,關山鎮,3213,9795,5118,4677
2010/6/1,臺東縣,卑南鄉,6562,18311,9922,8389
2010/6/1,臺東縣,大武鄉,2530,7129,3699,3430
2010/6/1,臺東縣,太麻里鄉,4536,12098,6482,5616
2010/6/1,臺東縣,東河鄉,3542,9468,5245,4223
2010/6/1,臺東縣,長濱鄉,2929,8396,4793,3603
2010/6/1,臺東縣,鹿野鄉,3126,8611,4647,3964
2010/6/1,臺東縣,池上鄉,3260,9277,4905,4372
2010/6/1,臺東縣,綠島鄉,994,3342,1791,1551
2010/6/1,臺東縣,延平鄉,1076,3642,2007,1635
2010/6/1,臺東縣,海端鄉,1093,4521,2462,2059
2010/6/1,臺東縣,達仁鄉,1504,4140,2255,1885
2010/6/1,臺東縣,金峰鄉,1048,3646,1897,1749
2010/6/1,臺東縣,蘭嶼鄉,1384,4396,2296,2100
2010/6/1,花蓮縣,花蓮市,40390,109607,53784,55823
2010/6/1,花蓮縣,鳳林鎮,4455,12067,6385,5682
2010/6/1,花蓮縣,玉里鎮,8903,27020,14660,12360
2010/6/1,花蓮縣,新城鄉,7254,20200,10526,9674
2010/6/1,花蓮縣,吉安鄉,28699,79329,40682,38647
2010/6/1,花蓮縣,壽豐鄉,6792,18745,10172,8573
2010/6/1,花蓮縣,光復鄉,5016,14262,7586,6676
2010/6/1,花蓮縣,豐濱鄉,1821,5182,2861,2321
2010/6/1,花蓮縣,瑞穗鄉,4628,12986,6989,5997
2010/6/1,花蓮縣,富里鄉,3997,11790,6460,5330
2010/6/1,花蓮縣,秀林鄉,4615,15174,7898,7276
2010/6/1,花蓮縣,萬榮鄉,2148,6929,3697,3232
2010/6/1,花蓮縣,卓溪鄉,1662,6380,3561,2819
2010/6/1,澎湖縣,馬公市,19718,56489,28615,27874
2010/6/1,澎湖縣,湖西鄉,4712,13633,7111,6522
2010/6/1,澎湖縣,白沙鄉,3131,9508,4992,4516
2010/6/1,澎湖縣,西嶼鄉,2841,8440,4369,4071
2010/6/1,澎湖縣,望安鄉,1881,4743,2556,2187
2010/6/1,澎湖縣,七美鄉,1242,3575,1880,1695
2010/6/1,基隆市,中正區,22017,55696,28584,27112
2010/6/1,基隆市,七堵區,19929,55315,28036,27279
2010/6/1,基隆市,暖暖區,14211,37939,19269,18670
2010/6/1,基隆市,仁愛區,19732,50116,24712,25404
2010/6/1,基隆市,中山區,18971,51135,26149,24986
2010/6/1,基隆市,安樂區,31721,84450,42080,42370
2010/6/1,基隆市,信義區,19941,51218,25702,25516
2010/6/1,新竹市,東區,67517,195933,96759,99174
2010/6/1,新竹市,北區,50100,144787,71565,73222
2010/6/1,新竹市,香山區,22665,72173,36835,35338
2010/6/1,臺中市,中區,8424,22989,11332,11657
2010/6/1,臺中市,東區,25689,73828,37308,36520
2010/6/1,臺中市,西區,43072,117537,56498,61039
2010/6/1,臺中市,南區,41655,112979,54879,58100
2010/6/1,臺中市,北區,55445,147739,71666,76073
2010/6/1,臺中市,西屯區,72135,205104,99664,105440
2010/6/1,臺中市,南屯區,52566,152451,73668,78783
2010/6/1,臺中市,北屯區,82733,245396,119317,126079
2010/6/1,嘉義市,東區,44094,125740,61386,64354
2010/6/1,嘉義市,西區,50727,147142,72948,74194
2010/6/1,臺南市,東區,70591,194258,94090,100168
2010/6/1,臺南市,南區,43012,126299,63408,62891
2010/6/1,臺南市,北區,47767,131633,65053,66580
2010/6/1,臺南市,安南區,54000,177430,90316,87114
2010/6/1,臺南市,安平區,22861,62133,29800,32333
2010/6/1,臺南市,中西區,30067,79759,39224,40535
2010/6/1,臺北市,松山區,77506,207999,98745,109254
2010/6/1,臺北市,信義區,85407,224114,108145,115969
2010/6/1,臺北市,大安區,116247,310912,146422,164490
2010/6/1,臺北市,中山區,90790,218077,102896,115181
2010/6/1,臺北市,中正區,61857,159082,76786,82296
2010/6/1,臺北市,大同區,46834,123582,60979,62603
2010/6/1,臺北市,萬華區,73390,187241,93523,93718
2010/6/1,臺北市,文山區,96200,260646,126452,134194
2010/6/1,臺北市,南港區,41222,112803,55629,57174
2010/6/1,臺北市,內湖區,95567,267771,129246,138525
2010/6/1,臺北市,士林區,99976,282968,137717,145251
2010/6/1,臺北市,北投區,88961,247673,120290,127383
2010/6/1,高雄市,鹽埕區,11170,27648,13909,13739
2010/6/1,高雄市,鼓山區,51603,130555,64117,66438
2010/6/1,高雄市,左營區,73112,190779,94041,96738
2010/6/1,高雄市,楠梓區,61397,172334,85563,86771
2010/6/1,高雄市,三民區,130842,354353,173585,180768
2010/6/1,高雄市,新興區,22904,55570,27100,28470
2010/6/1,高雄市,前金區,12518,29056,14194,14862
2010/6/1,高雄市,苓雅區,71553,184504,89985,94519
2010/6/1,高雄市,前鎮區,76074,199319,99181,100138
2010/6/1,高雄市,旗津區,10938,29990,15613,14377
2010/6/1,高雄市,小港區,62563,154019,77463,76556
2010/6/1,金門縣,金城鎮,10799,31950,16431,15519
2010/6/1,金門縣,金湖鎮,7157,20866,10797,10069
2010/6/1,金門縣,金沙鎮,5310,15094,7691,7403
2010/6/1,金門縣,金寧鄉,6088,17990,9349,8641
2010/6/1,金門縣,烈嶼鄉,2583,8723,4424,4299
2010/6/1,金門縣,烏坵鄉,136,522,265,257
2010/6/1,連江縣,南竿鄉,1188,5901,3408,2493
2010/6/1,連江縣,北竿鄉,376,1782,1028,754
2010/6/1,連江縣,莒光鄉,237,1169,687,482
2010/6/1,連江縣,東引鄉,271,1077,634,443
2010/7/1,總計,臺灣地區,7852461,23037125,11579852,11457273
2010/7/1,總計,臺灣省,6291282,18902719,9567151,9335568
2010/7/1,總計,新北市,1394643,3889049,1933166,1955883
2010/7/1,總計,宜蘭縣,153058,460676,234974,225702
2010/7/1,總計,桃園市,669544,2006213,1011697,994516
2010/7/1,總計,新竹縣,159662,510874,263119,247755
2010/7/1,總計,苗栗縣,171604,560214,290946,269268
2010/7/1,總計,臺中市,464456,1563334,792673,770661
2010/7/1,總計,彰化縣,361704,1308676,671948,636728
2010/7/1,總計,南投縣,169985,527940,271823,256117
2010/7/1,總計,雲林縣,228253,718231,375165,343066
2010/7/1,總計,嘉義縣,175468,544374,284064,260310
2010/7/1,總計,臺南市,368085,1102268,562901,539367
2010/7/1,總計,高雄市,430943,1243300,636757,606543
2010/7/1,總計,屏東縣,276248,877109,451144,425965
2010/7/1,總計,臺東縣,80039,231421,121181,110240
2010/7/1,總計,花蓮縣,120537,339659,175229,164430
2010/7/1,總計,澎湖縣,33571,96436,49538,46898
2010/7/1,總計,基隆市,146627,385532,194349,191183
2010/7/1,總計,新竹市,140696,413482,205455,208027
2010/7/1,總計,臺中市,382525,1079343,524832,554511
2010/7/1,總計,嘉義市,94910,272833,134306,138527
2010/7/1,總計,臺南市,268724,771755,381884,389871
2010/7/1,總計,臺北市,975669,2605357,1257688,1347669
2010/7/1,總計,高雄市,585510,1529049,755013,774036
2010/7/1,總計,福建省,34228,105335,54771,50564
2010/7/1,總計,金門縣,32148,95409,49029,46380
2010/7/1,總計,連江縣,2080,9926,5742,4184
2010/7/1,新北市,板橋區,193295,554171,274546,279625
2010/7/1,新北市,三重區,139281,390023,194635,195388
2010/7/1,新北市,永和區,89505,235761,113191,122570
2010/7/1,新北市,中和區,154616,414600,205054,209546
2010/7/1,新北市,新莊區,135883,401743,198624,203119
2010/7/1,新北市,新店區,115653,295486,144885,150601
2010/7/1,新北市,土城區,81691,238662,119538,119124
2010/7/1,新北市,蘆洲區,65051,197466,97916,99550
2010/7/1,新北市,汐止區,78535,188798,93825,94973
2010/7/1,新北市,樹林區,58596,174279,87890,86389
2010/7/1,新北市,鶯歌區,27200,86250,43696,42554
2010/7/1,新北市,三峽區,34957,102387,52333,50054
2010/7/1,新北市,淡水區,56630,142516,69394,73122
2010/7/1,新北市,瑞芳區,15763,42604,21812,20792
2010/7/1,新北市,五股區,27117,79419,40386,39033
2010/7/1,新北市,泰山區,26064,76561,38498,38063
2010/7/1,新北市,林口區,29767,81577,40332,41245
2010/7/1,新北市,深坑區,8679,23210,11692,11518
2010/7/1,新北市,石碇區,3304,7988,4459,3529
2010/7/1,新北市,坪林區,2419,6513,3637,2876
2010/7/1,新北市,三芝區,8809,23277,12078,11199
2010/7/1,新北市,石門區,3960,12482,6590,5892
2010/7/1,新北市,八里區,12033,34347,17467,16880
2010/7/1,新北市,平溪區,2378,5409,3022,2387
2010/7/1,新北市,雙溪區,3818,9795,5301,4494
2010/7/1,新北市,貢寮區,4371,13758,7108,6650
2010/7/1,新北市,金山區,6628,22342,11233,11109
2010/7/1,新北市,萬里區,6950,21892,11117,10775
2010/7/1,新北市,烏來區,1690,5733,2907,2826
2010/7/1,宜蘭縣,宜蘭市,32969,95606,47159,48447
2010/7/1,宜蘭縣,羅東鎮,24809,73019,35112,37907
2010/7/1,宜蘭縣,蘇澳鎮,13522,43154,22149,21005
2010/7/1,宜蘭縣,頭城鎮,9645,30997,16035,14962
2010/7/1,宜蘭縣,礁溪鄉,12238,35784,18746,17038
2010/7/1,宜蘭縣,壯圍鄉,8056,25051,13198,11853
2010/7/1,宜蘭縣,員山鄉,10719,32336,17329,15007
2010/7/1,宜蘭縣,冬山鄉,17175,52377,26971,25406
2010/7/1,宜蘭縣,五結鄉,12854,38757,20153,18604
2010/7/1,宜蘭縣,三星鄉,7450,21499,11635,9864
2010/7/1,宜蘭縣,大同鄉,1825,6032,3274,2758
2010/7/1,宜蘭縣,南澳鄉,1796,6064,3213,2851
2010/7/1,桃園市,桃園區,143197,408847,200274,208573
2010/7/1,桃園市,中壢區,126101,369948,184854,185094
2010/7/1,桃園市,平鎮區,66159,207404,104431,102973
2010/7/1,桃園市,八德區,57823,177158,90228,86930
2010/7/1,桃園市,大溪區,29314,92642,47733,44909
2010/7/1,桃園市,楊梅區,48430,151210,76895,74315
2010/7/1,桃園市,蘆竹區,47755,141498,70973,70525
2010/7/1,桃園市,大園區,26014,82094,42634,39460
2010/7/1,桃園市,龜山區,50033,138364,70280,68084
2010/7/1,桃園市,龍潭區,37023,115924,58808,57116
2010/7/1,桃園市,新屋區,14921,49426,26391,23035
2010/7/1,桃園市,觀音區,19081,60979,32188,28791
2010/7/1,桃園市,復興區,3693,10719,6008,4711
2010/7/1,新竹縣,竹北市,46224,140283,70432,69851
2010/7/1,新竹縣,關西鎮,9196,31801,16928,14873
2010/7/1,新竹縣,新埔鎮,10297,35559,18836,16723
2010/7/1,新竹縣,竹東鎮,30425,96790,48811,47979
2010/7/1,新竹縣,湖口鄉,23209,75036,38422,36614
2010/7/1,新竹縣,橫山鄉,4381,14466,7824,6642
2010/7/1,新竹縣,新豐鄉,15538,52912,27346,25566
2010/7/1,新竹縣,芎林鄉,6275,20775,10952,9823
2010/7/1,新竹縣,寶山鄉,4642,14048,7584,6464
2010/7/1,新竹縣,北埔鄉,3081,10178,5521,4657
2010/7/1,新竹縣,峨眉鄉,2020,6051,3348,2703
2010/7/1,新竹縣,尖石鄉,2656,8259,4519,3740
2010/7/1,新竹縣,五峰鄉,1718,4716,2596,2120
2010/7/1,苗栗縣,苗栗市,28981,90501,45626,44875
2010/7/1,苗栗縣,苑裡鎮,13796,48702,25433,23269
2010/7/1,苗栗縣,通霄鎮,11306,38135,20271,17864
2010/7/1,苗栗縣,竹南鎮,23872,77866,39569,38297
2010/7/1,苗栗縣,頭份市,29256,96548,49125,47423
2010/7/1,苗栗縣,後龍鎮,11642,39524,20923,18601
2010/7/1,苗栗縣,卓蘭鎮,5941,18460,9735,8725
2010/7/1,苗栗縣,大湖鄉,5300,16045,8592,7453
2010/7/1,苗栗縣,公館鄉,10125,34714,18247,16467
2010/7/1,苗栗縣,銅鑼鄉,5976,19490,10298,9192
2010/7/1,苗栗縣,南庄鄉,3992,11171,6161,5010
2010/7/1,苗栗縣,頭屋鄉,3499,11604,6129,5475
2010/7/1,苗栗縣,三義鄉,5251,17563,9238,8325
2010/7/1,苗栗縣,西湖鄉,2681,7910,4371,3539
2010/7/1,苗栗縣,造橋鄉,3983,13736,7256,6480
2010/7/1,苗栗縣,三灣鄉,2384,7297,3961,3336
2010/7/1,苗栗縣,獅潭鄉,1680,4939,2752,2187
2010/7/1,苗栗縣,泰安鄉,1939,6009,3259,2750
2010/7/1,臺中市,豐原區,49429,165362,82189,83173
2010/7/1,臺中市,大里區,61273,196928,97803,99125
2010/7/1,臺中市,太平區,54395,172639,86771,85868
2010/7/1,臺中市,東勢區,16902,53452,27762,25690
2010/7/1,臺中市,大甲區,21591,78649,39952,38697
2010/7/1,臺中市,清水區,24866,85567,44185,41382
2010/7/1,臺中市,沙鹿區,23528,81310,41431,39879
2010/7/1,臺中市,梧棲區,15887,55091,27996,27095
2010/7/1,臺中市,后里區,14720,54274,27934,26340
2010/7/1,臺中市,神岡區,17536,63744,32858,30886
2010/7/1,臺中市,潭子區,32270,99999,49889,50110
2010/7/1,臺中市,大雅區,26151,89584,45213,44371
2010/7/1,臺中市,新社區,7326,25674,13472,12202
2010/7/1,臺中市,石岡區,4840,16031,8340,7691
2010/7/1,臺中市,外埔區,8798,31999,16463,15536
2010/7/1,臺中市,大安區,5237,20305,10679,9626
2010/7/1,臺中市,烏日區,20355,68527,34738,33789
2010/7/1,臺中市,大肚區,15772,55724,28620,27104
2010/7/1,臺中市,龍井區,20467,73944,37664,36280
2010/7/1,臺中市,霧峰區,18668,63814,32875,30939
2010/7/1,臺中市,和平區,4445,10717,5839,4878
2010/7/1,彰化縣,彰化市,71453,236658,117970,118688
2010/7/1,彰化縣,鹿港鎮,22186,85307,43729,41578
2010/7/1,彰化縣,和美鎮,23934,89656,45966,43690
2010/7/1,彰化縣,北斗鎮,9850,33503,16983,16520
2010/7/1,彰化縣,員林市,36549,125699,63222,62477
2010/7/1,彰化縣,溪湖鎮,15048,56247,28750,27497
2010/7/1,彰化縣,田中鎮,12504,44184,22978,21206
2010/7/1,彰化縣,二林鎮,14207,54070,27900,26170
2010/7/1,彰化縣,線西鄉,4122,17158,8816,8342
2010/7/1,彰化縣,伸港鄉,8921,35922,18481,17441
2010/7/1,彰化縣,福興鄉,12007,49035,25670,23365
2010/7/1,彰化縣,秀水鄉,9665,39073,20264,18809
2010/7/1,彰化縣,花壇鄉,12889,46184,23834,22350
2010/7/1,彰化縣,芬園鄉,6870,24857,13200,11657
2010/7/1,彰化縣,大村鄉,10188,36587,19074,17513
2010/7/1,彰化縣,埔鹽鄉,8772,34365,18007,16358
2010/7/1,彰化縣,埔心鄉,9862,35269,18297,16972
2010/7/1,彰化縣,永靖鄉,10374,39407,20442,18965
2010/7/1,彰化縣,社頭鄉,12267,44852,23069,21783
2010/7/1,彰化縣,二水鄉,5306,16599,8723,7876
2010/7/1,彰化縣,田尾鄉,7641,28707,14988,13719
2010/7/1,彰化縣,埤頭鄉,8527,31830,16620,15210
2010/7/1,彰化縣,芳苑鄉,9950,36354,19276,17078
2010/7/1,彰化縣,大城鄉,5378,19045,10347,8698
2010/7/1,彰化縣,竹塘鄉,4583,16521,8693,7828
2010/7/1,彰化縣,溪州鄉,8651,31587,16649,14938
2010/7/1,南投縣,南投市,33089,104280,52460,51820
2010/7/1,南投縣,埔里鎮,28221,85397,43104,42293
2010/7/1,南投縣,草屯鎮,30754,99837,50497,49340
2010/7/1,南投縣,竹山鎮,18892,58531,30195,28336
2010/7/1,南投縣,集集鎮,4300,11990,6282,5708
2010/7/1,南投縣,名間鄉,12079,41345,21689,19656
2010/7/1,南投縣,鹿谷鄉,6675,19139,10164,8975
2010/7/1,南投縣,中寮鄉,5622,16244,8827,7417
2010/7/1,南投縣,魚池鄉,5794,17267,9119,8148
2010/7/1,南投縣,國姓鄉,7222,20799,11357,9442
2010/7/1,南投縣,水里鄉,7214,20186,10575,9611
2010/7/1,南投縣,信義鄉,5217,17339,9388,7951
2010/7/1,南投縣,仁愛鄉,4906,15586,8166,7420
2010/7/1,雲林縣,斗六市,34494,106751,53713,53038
2010/7/1,雲林縣,斗南鎮,15165,47292,24061,23231
2010/7/1,雲林縣,虎尾鎮,22357,70136,35695,34441
2010/7/1,雲林縣,西螺鎮,13962,48735,24770,23965
2010/7/1,雲林縣,土庫鎮,8700,30618,16018,14600
2010/7/1,雲林縣,北港鎮,15244,43359,22563,20796
2010/7/1,雲林縣,古坑鄉,10628,34191,18105,16086
2010/7/1,雲林縣,大埤鄉,6616,21273,11378,9895
2010/7/1,雲林縣,莿桐鄉,8973,30521,15997,14524
2010/7/1,雲林縣,林內鄉,5742,19937,10421,9516
2010/7/1,雲林縣,二崙鄉,8764,29771,15966,13805
2010/7/1,雲林縣,崙背鄉,8309,27589,14529,13060
2010/7/1,雲林縣,麥寮鄉,12118,34934,18396,16538
2010/7/1,雲林縣,東勢鄉,5707,16967,9215,7752
2010/7/1,雲林縣,褒忠鄉,4291,14367,7648,6719
2010/7/1,雲林縣,臺西鄉,8810,26336,14167,12169
2010/7/1,雲林縣,元長鄉,9317,28902,15712,13190
2010/7/1,雲林縣,四湖鄉,9047,26876,14657,12219
2010/7/1,雲林縣,口湖鄉,9619,30514,16238,14276
2010/7/1,雲林縣,水林鄉,10390,29162,15916,13246
2010/7/1,嘉義縣,太保市,11164,36364,18763,17601
2010/7/1,嘉義縣,朴子市,14496,44256,22578,21678
2010/7/1,嘉義縣,布袋鎮,10144,30360,15588,14772
2010/7/1,嘉義縣,大林鎮,11156,33729,17319,16410
2010/7/1,嘉義縣,民雄鄉,22616,72544,37273,35271
2010/7/1,嘉義縣,溪口鄉,5390,16372,8717,7655
2010/7/1,嘉義縣,新港鄉,10355,34869,18436,16433
2010/7/1,嘉義縣,六腳鄉,9119,26498,14029,12469
2010/7/1,嘉義縣,東石鄉,9457,27881,14835,13046
2010/7/1,嘉義縣,義竹鄉,7461,21290,11024,10266
2010/7/1,嘉義縣,鹿草鄉,5723,17297,9287,8010
2010/7/1,嘉義縣,水上鄉,17343,52303,27063,25240
2010/7/1,嘉義縣,中埔鄉,15194,47530,24837,22693
2010/7/1,嘉義縣,竹崎鄉,11268,38710,20611,18099
2010/7/1,嘉義縣,梅山鄉,6640,21833,11572,10261
2010/7/1,嘉義縣,番路鄉,3906,11628,6329,5299
2010/7/1,嘉義縣,大埔鄉,1970,4664,2456,2208
2010/7/1,嘉義縣,阿里山鄉,2066,6246,3347,2899
2010/7/1,臺南市,新營區,27008,78178,39074,39104
2010/7/1,臺南市,永康區,74420,215940,107467,108473
2010/7/1,臺南市,鹽水區,9927,27314,14253,13061
2010/7/1,臺南市,白河區,10922,31539,16542,14997
2010/7/1,臺南市,麻豆區,15018,45959,23515,22444
2010/7/1,臺南市,佳里區,19188,59362,29560,29802
2010/7/1,臺南市,新化區,13649,44172,22633,21539
2010/7/1,臺南市,善化區,14458,43426,21997,21429
2010/7/1,臺南市,學甲區,9530,27962,14288,13674
2010/7/1,臺南市,柳營區,7779,22724,11892,10832
2010/7/1,臺南市,後壁區,8753,26042,13568,12474
2010/7/1,臺南市,東山區,8208,23214,12376,10838
2010/7/1,臺南市,下營區,9077,26178,13588,12590
2010/7/1,臺南市,六甲區,7595,23826,12377,11449
2010/7/1,臺南市,官田區,7572,22266,11414,10852
2010/7/1,臺南市,大內區,4076,10947,5818,5129
2010/7/1,臺南市,西港區,7792,25252,12867,12385
2010/7/1,臺南市,七股區,7994,24906,13026,11880
2010/7/1,臺南市,將軍區,7428,21630,11012,10618
2010/7/1,臺南市,北門區,4366,12522,6380,6142
2010/7/1,臺南市,新市區,10717,34821,17510,17311
2010/7/1,臺南市,安定區,9237,30161,15644,14517
2010/7/1,臺南市,山上區,2719,7921,4164,3757
2010/7/1,臺南市,玉井區,5077,15460,8033,7427
2010/7/1,臺南市,楠西區,3580,10700,5679,5021
2010/7/1,臺南市,南化區,2825,8924,4877,4047
2010/7/1,臺南市,左鎮區,1976,5536,3083,2453
2010/7/1,臺南市,仁德區,24541,69027,35535,33492
2010/7/1,臺南市,歸仁區,20371,65831,33597,32234
2010/7/1,臺南市,關廟區,10682,36140,18751,17389
2010/7/1,臺南市,龍崎區,1600,4388,2381,2007
2010/7/1,高雄市,鳳山區,126140,340685,169970,170715
2010/7/1,高雄市,岡山區,33032,97135,48799,48336
2010/7/1,高雄市,旗山區,13780,40113,20904,19209
2010/7/1,高雄市,美濃區,14077,43197,22567,20630
2010/7/1,高雄市,林園區,24001,70623,36272,34351
2010/7/1,高雄市,大寮區,37995,108751,56573,52178
2010/7/1,高雄市,大樹區,13022,44107,22820,21287
2010/7/1,高雄市,仁武區,25422,71360,36851,34509
2010/7/1,高雄市,大社區,11596,32843,16892,15951
2010/7/1,高雄市,鳥松區,16388,42420,21564,20856
2010/7/1,高雄市,橋頭區,12471,36327,18623,17704
2010/7/1,高雄市,燕巢區,9987,30951,16540,14411
2010/7/1,高雄市,田寮區,3545,8253,4586,3667
2010/7/1,高雄市,阿蓮區,9121,30493,15396,15097
2010/7/1,高雄市,路竹區,16022,53987,27550,26437
2010/7/1,高雄市,湖內區,9493,28765,14841,13924
2010/7/1,高雄市,茄萣區,10107,31546,16455,15091
2010/7/1,高雄市,永安區,5806,14263,7276,6987
2010/7/1,高雄市,彌陀區,6553,20486,10661,9825
2010/7/1,高雄市,梓官區,11957,36733,19103,17630
2010/7/1,高雄市,六龜區,5774,14994,8111,6883
2010/7/1,高雄市,甲仙區,2530,7354,3957,3397
2010/7/1,高雄市,杉林區,4294,11719,6396,5323
2010/7/1,高雄市,內門區,5024,16043,8749,7294
2010/7/1,高雄市,茂林區,571,1878,946,932
2010/7/1,高雄市,桃源區,1354,4836,2567,2269
2010/7/1,高雄市,那瑪夏區,881,3438,1788,1650
2010/7/1,屏東縣,屏東市,72301,212153,105893,106260
2010/7/1,屏東縣,潮州鎮,18021,55456,27952,27504
2010/7/1,屏東縣,東港鎮,15639,50419,25551,24868
2010/7/1,屏東縣,恆春鎮,10738,31195,16027,15168
2010/7/1,屏東縣,萬丹鄉,14241,54207,28040,26167
2010/7/1,屏東縣,長治鄉,9681,30902,16163,14739
2010/7/1,屏東縣,麟洛鄉,3591,11580,6004,5576
2010/7/1,屏東縣,九如鄉,6543,22901,11920,10981
2010/7/1,屏東縣,里港鄉,7815,26080,13372,12708
2010/7/1,屏東縣,鹽埔鄉,7660,27343,14209,13134
2010/7/1,屏東縣,高樹鄉,9550,26918,14358,12560
2010/7/1,屏東縣,萬巒鄉,6387,22040,11606,10434
2010/7/1,屏東縣,內埔鄉,17671,58307,30315,27992
2010/7/1,屏東縣,竹田鄉,5480,18400,9779,8621
2010/7/1,屏東縣,新埤鄉,3354,10787,5716,5071
2010/7/1,屏東縣,枋寮鄉,8440,26744,14100,12644
2010/7/1,屏東縣,新園鄉,11399,38452,19834,18618
2010/7/1,屏東縣,崁頂鄉,4193,17400,8907,8493
2010/7/1,屏東縣,林邊鄉,7117,20994,10827,10167
2010/7/1,屏東縣,南州鄉,3663,11779,6057,5722
2010/7/1,屏東縣,佳冬鄉,7123,21470,11194,10276
2010/7/1,屏東縣,琉球鄉,3949,12415,6885,5530
2010/7/1,屏東縣,車城鄉,3515,9762,5274,4488
2010/7/1,屏東縣,滿州鄉,3049,8549,4680,3869
2010/7/1,屏東縣,枋山鄉,2083,6086,3254,2832
2010/7/1,屏東縣,三地門鄉,2152,7534,3853,3681
2010/7/1,屏東縣,霧臺鄉,970,2957,1549,1408
2010/7/1,屏東縣,瑪家鄉,1873,6533,3399,3134
2010/7/1,屏東縣,泰武鄉,1233,5129,2694,2435
2010/7/1,屏東縣,來義鄉,2155,7815,4016,3799
2010/7/1,屏東縣,春日鄉,1322,4823,2519,2304
2010/7/1,屏東縣,獅子鄉,1464,4957,2589,2368
2010/7/1,屏東縣,牡丹鄉,1876,5022,2608,2414
2010/7/1,臺東縣,臺東市,37839,109091,55355,53736
2010/7/1,臺東縣,成功鎮,5414,15907,8489,7418
2010/7/1,臺東縣,關山鎮,3213,9751,5097,4654
2010/7/1,臺東縣,卑南鄉,6564,18261,9898,8363
2010/7/1,臺東縣,大武鄉,2539,7093,3687,3406
2010/7/1,臺東縣,太麻里鄉,4535,12067,6461,5606
2010/7/1,臺東縣,東河鄉,3539,9436,5228,4208
2010/7/1,臺東縣,長濱鄉,2927,8344,4763,3581
2010/7/1,臺東縣,鹿野鄉,3121,8604,4646,3958
2010/7/1,臺東縣,池上鄉,3255,9255,4890,4365
2010/7/1,臺東縣,綠島鄉,995,3348,1793,1555
2010/7/1,臺東縣,延平鄉,1070,3619,1997,1622
2010/7/1,臺東縣,海端鄉,1093,4513,2460,2053
2010/7/1,臺東縣,達仁鄉,1500,4112,2246,1866
2010/7/1,臺東縣,金峰鄉,1044,3617,1875,1742
2010/7/1,臺東縣,蘭嶼鄉,1391,4403,2296,2107
2010/7/1,花蓮縣,花蓮市,40438,109675,53824,55851
2010/7/1,花蓮縣,鳳林鎮,4466,12050,6367,5683
2010/7/1,花蓮縣,玉里鎮,8904,26986,14637,12349
2010/7/1,花蓮縣,新城鄉,7255,20210,10521,9689
2010/7/1,花蓮縣,吉安鄉,28763,79427,40713,38714
2010/7/1,花蓮縣,壽豐鄉,6796,18703,10146,8557
2010/7/1,花蓮縣,光復鄉,5021,14234,7581,6653
2010/7/1,花蓮縣,豐濱鄉,1825,5167,2855,2312
2010/7/1,花蓮縣,瑞穗鄉,4630,12955,6970,5985
2010/7/1,花蓮縣,富里鄉,3998,11771,6450,5321
2010/7/1,花蓮縣,秀林鄉,4633,15200,7921,7279
2010/7/1,花蓮縣,萬榮鄉,2148,6908,3688,3220
2010/7/1,花蓮縣,卓溪鄉,1660,6373,3556,2817
2010/7/1,澎湖縣,馬公市,19751,56515,28612,27903
2010/7/1,澎湖縣,湖西鄉,4726,13663,7127,6536
2010/7/1,澎湖縣,白沙鄉,3129,9483,4985,4498
2010/7/1,澎湖縣,西嶼鄉,2841,8445,4371,4074
2010/7/1,澎湖縣,望安鄉,1887,4750,2561,2189
2010/7/1,澎湖縣,七美鄉,1237,3580,1882,1698
2010/7/1,基隆市,中正區,22010,55607,28544,27063
2010/7/1,基隆市,七堵區,19957,55271,28015,27256
2010/7/1,基隆市,暖暖區,14227,37921,19253,18668
2010/7/1,基隆市,仁愛區,19739,50076,24693,25383
2010/7/1,基隆市,中山區,18979,51066,26104,24962
2010/7/1,基隆市,安樂區,31753,84402,42068,42334
2010/7/1,基隆市,信義區,19962,51189,25672,25517
2010/7/1,新竹市,東區,67745,196319,96949,99370
2010/7/1,新竹市,北區,50237,144993,71678,73315
2010/7/1,新竹市,香山區,22714,72170,36828,35342
2010/7/1,臺中市,中區,8407,22935,11301,11634
2010/7/1,臺中市,東區,25735,73839,37284,36555
2010/7/1,臺中市,西區,43168,117645,56537,61108
2010/7/1,臺中市,南區,41746,113109,54907,58202
2010/7/1,臺中市,北區,55550,147779,71691,76088
2010/7/1,臺中市,西屯區,72294,205408,99731,105677
2010/7/1,臺中市,南屯區,52739,152811,73892,78919
2010/7/1,臺中市,北屯區,82886,245817,119489,126328
2010/7/1,嘉義市,東區,44101,125624,61333,64291
2010/7/1,嘉義市,西區,50809,147209,72973,74236
2010/7/1,臺南市,東區,70637,194110,93984,100126
2010/7/1,臺南市,南區,43088,126365,63413,62952
2010/7/1,臺南市,北區,47874,131798,65109,66689
2010/7/1,臺南市,安南區,54114,177611,90378,87233
2010/7/1,臺南市,安平區,22915,62233,29846,32387
2010/7/1,臺南市,中西區,30096,79638,39154,40484
2010/7/1,臺北市,松山區,77646,208146,98814,109332
2010/7/1,臺北市,信義區,85516,224353,108162,116191
2010/7/1,臺北市,大安區,116365,310992,146461,164531
2010/7/1,臺北市,中山區,90999,218529,103064,115465
2010/7/1,臺北市,中正區,61918,159050,76773,82277
2010/7/1,臺北市,大同區,46893,123611,60989,62622
2010/7/1,臺北市,萬華區,73557,187534,93633,93901
2010/7/1,臺北市,文山區,96372,260797,126450,134347
2010/7/1,臺北市,南港區,41331,113028,55742,57286
2010/7/1,臺北市,內湖區,95814,268107,129385,138722
2010/7/1,臺北市,士林區,100154,283311,137857,145454
2010/7/1,臺北市,北投區,89104,247899,120358,127541
2010/7/1,高雄市,鹽埕區,11153,27605,13884,13721
2010/7/1,高雄市,鼓山區,51739,130729,64171,66558
2010/7/1,高雄市,左營區,73224,190981,94110,96871
2010/7/1,高雄市,楠梓區,61510,172535,85634,86901
2010/7/1,高雄市,三民區,131004,354426,173645,180781
2010/7/1,高雄市,新興區,22920,55573,27090,28483
2010/7/1,高雄市,前金區,12516,29068,14170,14898
2010/7/1,高雄市,苓雅區,71681,184586,90046,94540
2010/7/1,高雄市,前鎮區,76193,199436,99176,100260
2010/7/1,高雄市,旗津區,10928,29969,15581,14388
2010/7/1,高雄市,小港區,62642,154141,77506,76635
2010/7/1,金門縣,金城鎮,10832,32000,16430,15570
2010/7/1,金門縣,金湖鎮,7188,20947,10823,10124
2010/7/1,金門縣,金沙鎮,5316,15125,7706,7419
2010/7/1,金門縣,金寧鄉,6088,18047,9361,8686
2010/7/1,金門縣,烈嶼鄉,2588,8767,4445,4322
2010/7/1,金門縣,烏坵鄉,136,523,264,259
2010/7/1,連江縣,南竿鄉,1196,5893,3396,2497
2010/7/1,連江縣,北竿鄉,375,1790,1028,762
2010/7/1,連江縣,莒光鄉,239,1172,688,484
2010/7/1,連江縣,東引鄉,270,1071,630,441
2010/8/1,總計,臺灣地區,7866678,23039288,11579220,11460068
2010/8/1,總計,臺灣省,6302680,18904564,9566841,9337723
2010/8/1,總計,新北市,1398209,3892616,1934517,1958099
2010/8/1,總計,宜蘭縣,153342,460719,234972,225747
2010/8/1,總計,桃園市,670330,2003205,1010164,993041
2010/8/1,總計,新竹縣,160129,511644,263503,248141
2010/8/1,總計,苗栗縣,171872,560561,291098,269463
2010/8/1,總計,臺中市,465198,1564130,792908,771222
2010/8/1,總計,彰化縣,362183,1308326,671685,636641
2010/8/1,總計,南投縣,170205,527774,271683,256091
2010/8/1,總計,雲林縣,228767,718196,375120,343076
2010/8/1,總計,嘉義縣,175797,544236,283971,260265
2010/8/1,總計,臺南市,368518,1102096,562737,539359
2010/8/1,總計,高雄市,431528,1243453,636744,606709
2010/8/1,總計,屏東縣,276478,876181,450678,425503
2010/8/1,總計,臺東縣,80116,231140,121037,110103
2010/8/1,總計,花蓮縣,120683,339546,175162,164384
2010/8/1,總計,澎湖縣,33655,96490,49573,46917
2010/8/1,總計,基隆市,146855,385388,194260,191128
2010/8/1,總計,新竹市,141121,414004,205694,208310
2010/8/1,總計,臺中市,383424,1080140,525154,554986
2010/8/1,總計,嘉義市,95006,272782,134252,138530
2010/8/1,總計,臺南市,269264,771937,381929,390008
2010/8/1,總計,臺北市,977408,2605309,1257395,1347914
2010/8/1,總計,高雄市,586590,1529415,754984,774431
2010/8/1,總計,福建省,34311,105732,54930,50802
2010/8/1,總計,金門縣,32224,95783,49166,46617
2010/8/1,總計,連江縣,2087,9949,5764,4185
2010/8/1,新北市,板橋區,193790,554543,274656,279887
2010/8/1,新北市,三重區,139578,390214,194687,195527
2010/8/1,新北市,永和區,89543,235525,113062,122463
2010/8/1,新北市,中和區,154963,414625,204979,209646
2010/8/1,新北市,新莊區,136139,401999,198765,203234
2010/8/1,新北市,新店區,115933,295663,144993,150670
2010/8/1,新北市,土城區,81839,238833,119589,119244
2010/8/1,新北市,蘆洲區,65202,197652,97980,99672
2010/8/1,新北市,汐止區,78759,189117,93960,95157
2010/8/1,新北市,樹林區,58886,174655,88051,86604
2010/8/1,新北市,鶯歌區,27290,86516,43817,42699
2010/8/1,新北市,三峽區,35137,102720,52478,50242
2010/8/1,新北市,淡水區,56943,142971,69581,73390
2010/8/1,新北市,瑞芳區,15790,42566,21781,20785
2010/8/1,新北市,五股區,27190,79584,40466,39118
2010/8/1,新北市,泰山區,26057,76494,38446,38048
2010/8/1,新北市,林口區,29999,82026,40538,41488
2010/8/1,新北市,深坑區,8713,23253,11709,11544
2010/8/1,新北市,石碇區,3310,7998,4469,3529
2010/8/1,新北市,坪林區,2425,6524,3640,2884
2010/8/1,新北市,三芝區,8825,23303,12091,11212
2010/8/1,新北市,石門區,3967,12475,6586,5889
2010/8/1,新北市,八里區,12059,34410,17482,16928
2010/8/1,新北市,平溪區,2381,5398,3016,2382
2010/8/1,新北市,雙溪區,3813,9781,5310,4471
2010/8/1,新北市,貢寮區,4378,13763,7108,6655
2010/8/1,新北市,金山區,6652,22342,11242,11100
2010/8/1,新北市,萬里區,6956,21924,11127,10797
2010/8/1,新北市,烏來區,1692,5742,2908,2834
2010/8/1,宜蘭縣,宜蘭市,33026,95671,47184,48487
2010/8/1,宜蘭縣,羅東鎮,24847,73009,35072,37937
2010/8/1,宜蘭縣,蘇澳鎮,13530,43123,22147,20976
2010/8/1,宜蘭縣,頭城鎮,9665,30987,16026,14961
2010/8/1,宜蘭縣,礁溪鄉,12259,35830,18780,17050
2010/8/1,宜蘭縣,壯圍鄉,8076,25048,13193,11855
2010/8/1,宜蘭縣,員山鄉,10734,32307,17304,15003
2010/8/1,宜蘭縣,冬山鄉,17223,52440,27004,25436
2010/8/1,宜蘭縣,五結鄉,12892,38798,20182,18616
2010/8/1,宜蘭縣,三星鄉,7464,21471,11618,9853
2010/8/1,宜蘭縣,大同鄉,1828,6004,3266,2738
2010/8/1,宜蘭縣,南澳鄉,1798,6031,3196,2835
2010/8/1,桃園市,桃園區,143231,407076,199494,207582
2010/8/1,桃園市,中壢區,126330,369652,184661,184991
2010/8/1,桃園市,平鎮區,66349,207404,104411,102993
2010/8/1,桃園市,八德區,57947,177116,90189,86927
2010/8/1,桃園市,楊梅區,48509,151076,76834,74242
2010/8/1,桃園市,大溪區,29251,92399,47616,44783
2010/8/1,桃園市,蘆竹區,47844,141615,71002,70613
2010/8/1,桃園市,大園區,26057,82026,42570,39456
2010/8/1,桃園市,龜山區,50123,138413,70298,68115
2010/8/1,桃園市,龍潭區,36962,115526,58627,56899
2010/8/1,桃園市,新屋區,14933,49326,26346,22980
2010/8/1,桃園市,觀音區,19101,60931,32136,28795
2010/8/1,桃園市,復興區,3693,10645,5980,4665
2010/8/1,新竹縣,竹北市,46405,140689,70651,70038
2010/8/1,新竹縣,關西鎮,9205,31797,16927,14870
2010/8/1,新竹縣,新埔鎮,10311,35539,18839,16700
2010/8/1,新竹縣,竹東鎮,30505,96881,48840,48041
2010/8/1,新竹縣,湖口鄉,23267,75226,38517,36709
2010/8/1,新竹縣,橫山鄉,4396,14461,7821,6640
2010/8/1,新竹縣,新豐鄉,15629,53067,27399,25668
2010/8/1,新竹縣,芎林鄉,6279,20782,10947,9835
2010/8/1,新竹縣,寶山鄉,4653,14074,7609,6465
2010/8/1,新竹縣,北埔鄉,3083,10158,5514,4644
2010/8/1,新竹縣,峨眉鄉,2017,6016,3330,2686
2010/8/1,新竹縣,尖石鄉,2663,8261,4515,3746
2010/8/1,新竹縣,五峰鄉,1716,4693,2594,2099
2010/8/1,苗栗縣,苗栗市,29040,90607,45671,44936
2010/8/1,苗栗縣,苑裡鎮,13818,48704,25420,23284
2010/8/1,苗栗縣,通霄鎮,11306,38076,20242,17834
2010/8/1,苗栗縣,竹南鎮,23925,77942,39611,38331
2010/8/1,苗栗縣,頭份市,29329,96745,49202,47543
2010/8/1,苗栗縣,後龍鎮,11650,39471,20904,18567
2010/8/1,苗栗縣,卓蘭鎮,5941,18457,9737,8720
2010/8/1,苗栗縣,大湖鄉,5300,16086,8601,7485
2010/8/1,苗栗縣,公館鄉,10147,34755,18262,16493
2010/8/1,苗栗縣,銅鑼鄉,5975,19472,10294,9178
2010/8/1,苗栗縣,南庄鄉,4002,11172,6160,5012
2010/8/1,苗栗縣,頭屋鄉,3505,11613,6141,5472
2010/8/1,苗栗縣,三義鄉,5255,17580,9247,8333
2010/8/1,苗栗縣,西湖鄉,2675,7900,4366,3534
2010/8/1,苗栗縣,造橋鄉,3997,13748,7267,6481
2010/8/1,苗栗縣,三灣鄉,2382,7295,3967,3328
2010/8/1,苗栗縣,獅潭鄉,1686,4942,2752,2190
2010/8/1,苗栗縣,泰安鄉,1939,5996,3254,2742
2010/8/1,臺中市,豐原區,49520,165388,82211,83177
2010/8/1,臺中市,大里區,61381,197102,97859,99243
2010/8/1,臺中市,太平區,54527,172859,86855,86004
2010/8/1,臺中市,東勢區,16926,53374,27717,25657
2010/8/1,臺中市,大甲區,21598,78584,39925,38659
2010/8/1,臺中市,清水區,24891,85571,44175,41396
2010/8/1,臺中市,沙鹿區,23582,81398,41489,39909
2010/8/1,臺中市,梧棲區,15906,55143,28026,27117
2010/8/1,臺中市,后里區,14736,54290,27935,26355
2010/8/1,臺中市,神岡區,17586,63800,32868,30932
2010/8/1,臺中市,潭子區,32314,100099,49910,50189
2010/8/1,臺中市,大雅區,26184,89675,45230,44445
2010/8/1,臺中市,新社區,7342,25644,13457,12187
2010/8/1,臺中市,石岡區,4846,16021,8342,7679
2010/8/1,臺中市,外埔區,8809,32002,16461,15541
2010/8/1,臺中市,大安區,5242,20289,10674,9615
2010/8/1,臺中市,烏日區,20379,68586,34755,33831
2010/8/1,臺中市,大肚區,15793,55751,28621,27130
2010/8/1,臺中市,龍井區,20508,73985,37679,36306
2010/8/1,臺中市,霧峰區,18686,63846,32881,30965
2010/8/1,臺中市,和平區,4442,10723,5838,4885
2010/8/1,彰化縣,彰化市,71550,236614,117927,118687
2010/8/1,彰化縣,鹿港鎮,22237,85270,43710,41560
2010/8/1,彰化縣,和美鎮,23966,89676,45987,43689
2010/8/1,彰化縣,北斗鎮,9866,33531,16994,16537
2010/8/1,彰化縣,員林市,36615,125623,63161,62462
2010/8/1,彰化縣,溪湖鎮,15055,56212,28718,27494
2010/8/1,彰化縣,田中鎮,12514,44170,22971,21199
2010/8/1,彰化縣,二林鎮,14224,54050,27898,26152
2010/8/1,彰化縣,線西鄉,4128,17144,8802,8342
2010/8/1,彰化縣,伸港鄉,8921,35906,18467,17439
2010/8/1,彰化縣,福興鄉,12020,49016,25653,23363
2010/8/1,彰化縣,秀水鄉,9679,39078,20264,18814
2010/8/1,彰化縣,花壇鄉,12917,46226,23848,22378
2010/8/1,彰化縣,芬園鄉,6872,24820,13188,11632
2010/8/1,彰化縣,大村鄉,10202,36638,19099,17539
2010/8/1,彰化縣,埔鹽鄉,8791,34360,18015,16345
2010/8/1,彰化縣,埔心鄉,9877,35234,18276,16958
2010/8/1,彰化縣,永靖鄉,10391,39383,20434,18949
2010/8/1,彰化縣,社頭鄉,12293,44866,23073,21793
2010/8/1,彰化縣,二水鄉,5303,16584,8720,7864
2010/8/1,彰化縣,田尾鄉,7648,28701,14971,13730
2010/8/1,彰化縣,埤頭鄉,8542,31797,16601,15196
2010/8/1,彰化縣,芳苑鄉,9949,36342,19257,17085
2010/8/1,彰化縣,大城鄉,5383,18984,10302,8682
2010/8/1,彰化縣,竹塘鄉,4584,16497,8681,7816
2010/8/1,彰化縣,溪州鄉,8656,31604,16668,14936
2010/8/1,南投縣,南投市,33154,104312,52469,51843
2010/8/1,南投縣,埔里鎮,28259,85455,43118,42337
2010/8/1,南投縣,草屯鎮,30796,99849,50491,49358
2010/8/1,南投縣,竹山鎮,18941,58521,30202,28319
2010/8/1,南投縣,集集鎮,4289,11956,6271,5685
2010/8/1,南投縣,名間鄉,12095,41284,21665,19619
2010/8/1,南投縣,鹿谷鄉,6685,19135,10159,8976
2010/8/1,南投縣,中寮鄉,5615,16229,8810,7419
2010/8/1,南投縣,魚池鄉,5794,17250,9112,8138
2010/8/1,南投縣,國姓鄉,7208,20728,11308,9420
2010/8/1,南投縣,水里鄉,7234,20158,10557,9601
2010/8/1,南投縣,信義鄉,5218,17321,9367,7954
2010/8/1,南投縣,仁愛鄉,4917,15576,8154,7422
2010/8/1,雲林縣,斗六市,34591,106830,53745,53085
2010/8/1,雲林縣,斗南鎮,15213,47283,24047,23236
2010/8/1,雲林縣,虎尾鎮,22393,70130,35693,34437
2010/8/1,雲林縣,西螺鎮,13973,48665,24744,23921
2010/8/1,雲林縣,土庫鎮,8701,30571,15978,14593
2010/8/1,雲林縣,北港鎮,15257,43346,22546,20800
2010/8/1,雲林縣,古坑鄉,10643,34136,18073,16063
2010/8/1,雲林縣,大埤鄉,6628,21266,11384,9882
2010/8/1,雲林縣,莿桐鄉,8990,30527,15997,14530
2010/8/1,雲林縣,林內鄉,5749,19920,10412,9508
2010/8/1,雲林縣,二崙鄉,8779,29751,15950,13801
2010/8/1,雲林縣,崙背鄉,8312,27544,14515,13029
2010/8/1,雲林縣,麥寮鄉,12281,35376,18615,16761
2010/8/1,雲林縣,東勢鄉,5717,16935,9197,7738
2010/8/1,雲林縣,褒忠鄉,4288,14325,7628,6697
2010/8/1,雲林縣,臺西鄉,8860,26284,14138,12146
2010/8/1,雲林縣,元長鄉,9318,28864,15697,13167
2010/8/1,雲林縣,四湖鄉,9060,26861,14654,12207
2010/8/1,雲林縣,口湖鄉,9627,30445,16197,14248
2010/8/1,雲林縣,水林鄉,10387,29137,15910,13227
2010/8/1,嘉義縣,太保市,11206,36455,18800,17655
2010/8/1,嘉義縣,朴子市,14537,44210,22559,21651
2010/8/1,嘉義縣,布袋鎮,10161,30366,15581,14785
2010/8/1,嘉義縣,大林鎮,11173,33720,17322,16398
2010/8/1,嘉義縣,民雄鄉,22690,72625,37308,35317
2010/8/1,嘉義縣,溪口鄉,5386,16351,8702,7649
2010/8/1,嘉義縣,新港鄉,10365,34804,18406,16398
2010/8/1,嘉義縣,六腳鄉,9133,26439,14010,12429
2010/8/1,嘉義縣,東石鄉,9484,27867,14825,13042
2010/8/1,嘉義縣,義竹鄉,7467,21253,11000,10253
2010/8/1,嘉義縣,鹿草鄉,5727,17294,9285,8009
2010/8/1,嘉義縣,水上鄉,17352,52286,27044,25242
2010/8/1,嘉義縣,中埔鄉,15244,47547,24833,22714
2010/8/1,嘉義縣,竹崎鄉,11268,38640,20583,18057
2010/8/1,嘉義縣,梅山鄉,6636,21776,11538,10238
2010/8/1,嘉義縣,番路鄉,3942,11723,6386,5337
2010/8/1,嘉義縣,大埔鄉,1966,4647,2450,2197
2010/8/1,嘉義縣,阿里山鄉,2060,6233,3339,2894
2010/8/1,臺南市,新營區,27052,78155,39060,39095
2010/8/1,臺南市,永康區,74557,216157,107590,108567
2010/8/1,臺南市,鹽水區,9935,27220,14210,13010
2010/8/1,臺南市,白河區,10937,31514,16533,14981
2010/8/1,臺南市,麻豆區,15056,45953,23503,22450
2010/8/1,臺南市,佳里區,19220,59319,29537,29782
2010/8/1,臺南市,新化區,13679,44169,22629,21540
2010/8/1,臺南市,善化區,14476,43454,22013,21441
2010/8/1,臺南市,學甲區,9526,27943,14278,13665
2010/8/1,臺南市,柳營區,7781,22746,11905,10841
2010/8/1,臺南市,後壁區,8766,26002,13552,12450
2010/8/1,臺南市,東山區,8208,23182,12354,10828
2010/8/1,臺南市,下營區,9083,26165,13570,12595
2010/8/1,臺南市,六甲區,7593,23787,12353,11434
2010/8/1,臺南市,官田區,7589,22284,11410,10874
2010/8/1,臺南市,大內區,4077,10903,5795,5108
2010/8/1,臺南市,西港區,7799,25242,12863,12379
2010/8/1,臺南市,七股區,7997,24857,12996,11861
2010/8/1,臺南市,將軍區,7423,21633,11004,10629
2010/8/1,臺南市,北門區,4369,12504,6374,6130
2010/8/1,臺南市,新市區,10722,34806,17508,17298
2010/8/1,臺南市,安定區,9253,30200,15663,14537
2010/8/1,臺南市,山上區,2720,7912,4162,3750
2010/8/1,臺南市,玉井區,5075,15442,8012,7430
2010/8/1,臺南市,楠西區,3580,10687,5667,5020
2010/8/1,臺南市,南化區,2822,8919,4874,4045
2010/8/1,臺南市,左鎮區,1974,5531,3076,2455
2010/8/1,臺南市,仁德區,24577,69094,35553,33541
2010/8/1,臺南市,歸仁區,20384,65812,33589,32223
2010/8/1,臺南市,關廟區,10687,36109,18723,17386
2010/8/1,臺南市,龍崎區,1601,4395,2381,2014
2010/8/1,高雄市,鳳山區,126360,340760,169995,170765
2010/8/1,高雄市,岡山區,33059,97159,48807,48352
2010/8/1,高雄市,旗山區,13778,40065,20882,19183
2010/8/1,高雄市,美濃區,14094,43174,22554,20620
2010/8/1,高雄市,林園區,24011,70584,36249,34335
2010/8/1,高雄市,大寮區,38043,108878,56606,52272
2010/8/1,高雄市,大樹區,13015,44085,22808,21277
2010/8/1,高雄市,仁武區,25536,71507,36924,34583
2010/8/1,高雄市,大社區,11604,32846,16892,15954
2010/8/1,高雄市,鳥松區,16425,42480,21598,20882
2010/8/1,高雄市,橋頭區,12478,36313,18615,17698
2010/8/1,高雄市,燕巢區,9998,30965,16547,14418
2010/8/1,高雄市,田寮區,3550,8241,4583,3658
2010/8/1,高雄市,阿蓮區,9131,30461,15371,15090
2010/8/1,高雄市,路竹區,16020,53947,27519,26428
2010/8/1,高雄市,湖內區,9524,28821,14870,13951
2010/8/1,高雄市,茄萣區,10106,31498,16432,15066
2010/8/1,高雄市,永安區,5813,14282,7280,7002
2010/8/1,高雄市,彌陀區,6543,20467,10655,9812
2010/8/1,高雄市,梓官區,11968,36732,19086,17646
2010/8/1,高雄市,六龜區,5763,14914,8075,6839
2010/8/1,高雄市,甲仙區,2519,7298,3922,3376
2010/8/1,高雄市,杉林區,4357,11847,6460,5387
2010/8/1,高雄市,內門區,5022,16019,8735,7284
2010/8/1,高雄市,茂林區,574,1868,940,928
2010/8/1,高雄市,桃源區,1354,4818,2563,2255
2010/8/1,高雄市,那瑪夏區,883,3424,1776,1648
2010/8/1,屏東縣,屏東市,72243,211909,105796,106113
2010/8/1,屏東縣,潮州鎮,18072,55533,27964,27569
2010/8/1,屏東縣,東港鎮,15659,50336,25497,24839
2010/8/1,屏東縣,恆春鎮,10747,31203,16029,15174
2010/8/1,屏東縣,萬丹鄉,14258,54148,28000,26148
2010/8/1,屏東縣,長治鄉,9695,30944,16172,14772
2010/8/1,屏東縣,麟洛鄉,3597,11570,5997,5573
2010/8/1,屏東縣,九如鄉,6546,22914,11918,10996
2010/8/1,屏東縣,里港鄉,7830,26036,13353,12683
2010/8/1,屏東縣,鹽埔鄉,7669,27314,14185,13129
2010/8/1,屏東縣,高樹鄉,9554,26876,14353,12523
2010/8/1,屏東縣,萬巒鄉,6395,22018,11596,10422
2010/8/1,屏東縣,內埔鄉,17684,58192,30274,27918
2010/8/1,屏東縣,竹田鄉,5488,18396,9769,8627
2010/8/1,屏東縣,新埤鄉,3357,10776,5715,5061
2010/8/1,屏東縣,枋寮鄉,8455,26693,14069,12624
2010/8/1,屏東縣,新園鄉,11413,38394,19816,18578
2010/8/1,屏東縣,崁頂鄉,4200,17392,8895,8497
2010/8/1,屏東縣,林邊鄉,7152,20954,10807,10147
2010/8/1,屏東縣,南州鄉,3669,11759,6051,5708
2010/8/1,屏東縣,佳冬鄉,7134,21441,11177,10264
2010/8/1,屏東縣,琉球鄉,3954,12385,6874,5511
2010/8/1,屏東縣,車城鄉,3518,9726,5257,4469
2010/8/1,屏東縣,滿州鄉,3045,8522,4674,3848
2010/8/1,屏東縣,枋山鄉,2078,6055,3237,2818
2010/8/1,屏東縣,三地門鄉,2159,7555,3861,3694
2010/8/1,屏東縣,霧臺鄉,977,2970,1557,1413
2010/8/1,屏東縣,瑪家鄉,1881,6528,3403,3125
2010/8/1,屏東縣,泰武鄉,1234,5120,2685,2435
2010/8/1,屏東縣,來義鄉,2155,7785,4006,3779
2010/8/1,屏東縣,春日鄉,1322,4814,2511,2303
2010/8/1,屏東縣,獅子鄉,1465,4923,2578,2345
2010/8/1,屏東縣,牡丹鄉,1873,5000,2602,2398
2010/8/1,臺東縣,臺東市,37905,109061,55348,53713
2010/8/1,臺東縣,成功鎮,5414,15881,8473,7408
2010/8/1,臺東縣,關山鎮,3221,9731,5092,4639
2010/8/1,臺東縣,卑南鄉,6564,18243,9886,8357
2010/8/1,臺東縣,大武鄉,2542,7076,3684,3392
2010/8/1,臺東縣,太麻里鄉,4531,12038,6444,5594
2010/8/1,臺東縣,東河鄉,3530,9399,5206,4193
2010/8/1,臺東縣,長濱鄉,2925,8312,4738,3574
2010/8/1,臺東縣,鹿野鄉,3123,8596,4647,3949
2010/8/1,臺東縣,池上鄉,3256,9242,4885,4357
2010/8/1,臺東縣,綠島鄉,994,3350,1795,1555
2010/8/1,臺東縣,延平鄉,1065,3606,1990,1616
2010/8/1,臺東縣,海端鄉,1093,4508,2456,2052
2010/8/1,臺東縣,達仁鄉,1497,4083,2231,1852
2010/8/1,臺東縣,金峰鄉,1047,3589,1864,1725
2010/8/1,臺東縣,蘭嶼鄉,1409,4425,2298,2127
2010/8/1,花蓮縣,花蓮市,40446,109592,53764,55828
2010/8/1,花蓮縣,鳳林鎮,4470,12040,6366,5674
2010/8/1,花蓮縣,玉里鎮,8916,26954,14623,12331
2010/8/1,花蓮縣,新城鄉,7271,20206,10504,9702
2010/8/1,花蓮縣,吉安鄉,28832,79534,40775,38759
2010/8/1,花蓮縣,壽豐鄉,6817,18720,10158,8562
2010/8/1,花蓮縣,光復鄉,5027,14227,7596,6631
2010/8/1,花蓮縣,豐濱鄉,1820,5123,2839,2284
2010/8/1,花蓮縣,瑞穗鄉,4636,12945,6968,5977
2010/8/1,花蓮縣,富里鄉,3995,11748,6430,5318
2010/8/1,花蓮縣,秀林鄉,4647,15215,7916,7299
2010/8/1,花蓮縣,萬榮鄉,2145,6886,3676,3210
2010/8/1,花蓮縣,卓溪鄉,1661,6356,3547,2809
2010/8/1,澎湖縣,馬公市,19796,56573,28656,27917
2010/8/1,澎湖縣,湖西鄉,4737,13668,7121,6547
2010/8/1,澎湖縣,白沙鄉,3132,9481,4979,4502
2010/8/1,澎湖縣,西嶼鄉,2846,8439,4373,4066
2010/8/1,澎湖縣,望安鄉,1900,4763,2564,2199
2010/8/1,澎湖縣,七美鄉,1244,3566,1880,1686
2010/8/1,基隆市,中正區,22031,55557,28502,27055
2010/8/1,基隆市,七堵區,19999,55316,28022,27294
2010/8/1,基隆市,暖暖區,14271,37958,19264,18694
2010/8/1,基隆市,仁愛區,19758,49958,24660,25298
2010/8/1,基隆市,中山區,19009,51022,26075,24947
2010/8/1,基隆市,安樂區,31791,84389,42065,42324
2010/8/1,基隆市,信義區,19996,51188,25672,25516
2010/8/1,新竹市,東區,67968,196489,97032,99457
2010/8/1,新竹市,北區,50360,145183,71752,73431
2010/8/1,新竹市,香山區,22793,72332,36910,35422
2010/8/1,臺中市,中區,8405,22840,11263,11577
2010/8/1,臺中市,東區,25787,73918,37330,36588
2010/8/1,臺中市,西區,43208,117515,56488,61027
2010/8/1,臺中市,南區,41828,113236,54930,58306
2010/8/1,臺中市,北區,55588,147568,71543,76025
2010/8/1,臺中市,西屯區,72598,205881,99939,105942
2010/8/1,臺中市,南屯區,52939,153109,74046,79063
2010/8/1,臺中市,北屯區,83071,246073,119615,126458
2010/8/1,嘉義市,東區,44110,125500,61258,64242
2010/8/1,嘉義市,西區,50896,147282,72994,74288
2010/8/1,臺南市,東區,70739,194130,93981,100149
2010/8/1,臺南市,南區,43181,126413,63417,62996
2010/8/1,臺南市,北區,47976,131786,65087,66699
2010/8/1,臺南市,安南區,54214,177675,90429,87246
2010/8/1,臺南市,安平區,23014,62378,29904,32474
2010/8/1,臺南市,中西區,30140,79555,39111,40444
2010/8/1,臺北市,松山區,77613,207709,98592,109117
2010/8/1,臺北市,信義區,85582,224190,108057,116133
2010/8/1,臺北市,大安區,116475,310597,146241,164356
2010/8/1,臺北市,中山區,91196,218692,103115,115577
2010/8/1,臺北市,中正區,61983,158934,76741,82193
2010/8/1,臺北市,大同區,47036,123769,61025,62744
2010/8/1,臺北市,萬華區,73694,187694,93684,94010
2010/8/1,臺北市,文山區,96673,260962,126487,134475
2010/8/1,臺北市,南港區,41485,113185,55772,57413
2010/8/1,臺北市,內湖區,96114,268420,129525,138895
2010/8/1,臺北市,士林區,100334,283292,137813,145479
2010/8/1,臺北市,北投區,89223,247865,120343,127522
2010/8/1,高雄市,鹽埕區,11156,27551,13838,13713
2010/8/1,高雄市,鼓山區,51935,131076,64296,66780
2010/8/1,高雄市,左營區,73411,191221,94207,97014
2010/8/1,高雄市,楠梓區,61637,172706,85728,86978
2010/8/1,高雄市,三民區,131230,354320,173555,180765
2010/8/1,高雄市,新興區,22936,55474,27052,28422
2010/8/1,高雄市,前金區,12531,29079,14175,14904
2010/8/1,高雄市,苓雅區,71777,184429,89926,94503
2010/8/1,高雄市,前鎮區,76301,199454,99132,100322
2010/8/1,高雄市,旗津區,10918,29928,15562,14366
2010/8/1,高雄市,小港區,62758,154177,77513,76664
2010/8/1,金門縣,金城鎮,10857,32063,16450,15613
2010/8/1,金門縣,金湖鎮,7207,21040,10849,10191
2010/8/1,金門縣,金沙鎮,5321,15191,7738,7453
2010/8/1,金門縣,金寧鄉,6108,18151,9403,8748
2010/8/1,金門縣,烈嶼鄉,2595,8813,4462,4351
2010/8/1,金門縣,烏坵鄉,136,525,264,261
2010/8/1,連江縣,南竿鄉,1200,5910,3410,2500
2010/8/1,連江縣,北竿鄉,377,1797,1033,764
2010/8/1,連江縣,莒光鄉,239,1180,697,483
2010/8/1,連江縣,東引鄉,271,1062,624,438
2010/9/1,總計,臺灣地區,7883909,23040042,11578190,11461852
2010/9/1,總計,臺灣省,6315077,18901674,9564615,9337059
2010/9/1,總計,新北市,1401971,3892603,1934414,1958189
2010/9/1,總計,宜蘭縣,153656,460679,234923,225756
2010/9/1,總計,桃園市,671974,2002318,1009786,992532
2010/9/1,總計,新竹縣,160604,512097,263691,248406
2010/9/1,總計,苗栗縣,172188,560557,291110,269447
2010/9/1,總計,臺中市,465935,1564577,793000,771577
2010/9/1,總計,彰化縣,362709,1307843,671354,636489
2010/9/1,總計,南投縣,170369,527299,271440,255859
2010/9/1,總計,雲林縣,229111,718054,375031,343023
2010/9/1,總計,嘉義縣,176016,543853,283738,260115
2010/9/1,總計,臺南市,368915,1101866,562573,539293
2010/9/1,總計,高雄市,432237,1243332,636573,606759
2010/9/1,總計,屏東縣,276696,875379,450289,425090
2010/9/1,總計,臺東縣,80187,230941,120949,109992
2010/9/1,總計,花蓮縣,120784,339295,174982,164313
2010/9/1,總計,澎湖縣,33737,96488,49574,46914
2010/9/1,總計,基隆市,147176,384954,194030,190924
2010/9/1,總計,新竹市,141655,414323,205849,208474
2010/9/1,總計,臺中市,384256,1080617,525304,555313
2010/9/1,總計,嘉義市,95114,272711,134221,138490
2010/9/1,總計,臺南市,269787,771888,381784,390104
2010/9/1,總計,臺北市,981000,2608923,1258762,1350161
2010/9/1,總計,高雄市,587832,1529445,754813,774632
2010/9/1,總計,福建省,34395,106048,55070,50978
2010/9/1,總計,金門縣,32298,96091,49306,46785
2010/9/1,總計,連江縣,2097,9957,5764,4193
2010/9/1,新北市,板橋區,194222,554398,274481,279917
2010/9/1,新北市,三重區,139882,390017,194549,195468
2010/9/1,新北市,永和區,89576,234990,112772,122218
2010/9/1,新北市,中和區,155353,414318,204847,209471
2010/9/1,新北市,新莊區,136415,401918,198694,203224
2010/9/1,新北市,新店區,116254,295640,144974,150666
2010/9/1,新北市,土城區,81967,238637,119485,119152
2010/9/1,新北市,蘆洲區,65321,197563,97976,99587
2010/9/1,新北市,汐止區,79080,189228,94051,95177
2010/9/1,新北市,樹林區,59220,175107,88302,86805
2010/9/1,新北市,鶯歌區,27382,86590,43850,42740
2010/9/1,新北市,三峽區,35307,102939,52558,50381
2010/9/1,新北市,淡水區,57243,143227,69735,73492
2010/9/1,新北市,瑞芳區,15807,42509,21748,20761
2010/9/1,新北市,五股區,27265,79704,40502,39202
2010/9/1,新北市,泰山區,26104,76445,38442,38003
2010/9/1,新北市,林口區,30223,82302,40682,41620
2010/9/1,新北市,深坑區,8759,23262,11726,11536
2010/9/1,新北市,石碇區,3311,7984,4468,3516
2010/9/1,新北市,坪林區,2431,6522,3643,2879
2010/9/1,新北市,三芝區,8840,23284,12075,11209
2010/9/1,新北市,石門區,3972,12454,6573,5881
2010/9/1,新北市,八里區,12138,34536,17538,16998
2010/9/1,新北市,平溪區,2380,5381,3006,2375
2010/9/1,新北市,雙溪區,3813,9778,5306,4472
2010/9/1,新北市,貢寮區,4375,13762,7104,6658
2010/9/1,新北市,金山區,6661,22354,11244,11110
2010/9/1,新北市,萬里區,6978,21984,11157,10827
2010/9/1,新北市,烏來區,1692,5770,2926,2844
2010/9/1,宜蘭縣,宜蘭市,33125,95643,47139,48504
2010/9/1,宜蘭縣,羅東鎮,24854,72973,35074,37899
2010/9/1,宜蘭縣,蘇澳鎮,13547,43091,22125,20966
2010/9/1,宜蘭縣,頭城鎮,9676,30961,16002,14959
2010/9/1,宜蘭縣,礁溪鄉,12305,35860,18796,17064
2010/9/1,宜蘭縣,壯圍鄉,8101,25029,13187,11842
2010/9/1,宜蘭縣,員山鄉,10758,32327,17322,15005
2010/9/1,宜蘭縣,冬山鄉,17252,52481,27023,25458
2010/9/1,宜蘭縣,五結鄉,12930,38852,20200,18652
2010/9/1,宜蘭縣,三星鄉,7471,21424,11591,9833
2010/9/1,宜蘭縣,大同鄉,1833,6012,3271,2741
2010/9/1,宜蘭縣,南澳鄉,1804,6026,3193,2833
2010/9/1,桃園市,桃園區,143634,406772,199336,207436
2010/9/1,桃園市,中壢區,126673,369562,184603,184959
2010/9/1,桃園市,平鎮區,66512,207360,104403,102957
2010/9/1,桃園市,八德區,58144,177116,90198,86918
2010/9/1,桃園市,楊梅區,48619,151036,76833,74203
2010/9/1,桃園市,大溪區,29252,92201,47536,44665
2010/9/1,桃園市,蘆竹區,48062,141816,71084,70732
2010/9/1,桃園市,大園區,26091,81995,42586,39409
2010/9/1,桃園市,龜山區,50240,138236,70192,68044
2010/9/1,桃園市,龍潭區,36972,115401,58586,56815
2010/9/1,桃園市,新屋區,14943,49212,26297,22915
2010/9/1,桃園市,觀音區,19129,60960,32146,28814
2010/9/1,桃園市,復興區,3703,10651,5986,4665
2010/9/1,新竹縣,竹北市,46625,141036,70804,70232
2010/9/1,新竹縣,關西鎮,9206,31779,16916,14863
2010/9/1,新竹縣,新埔鎮,10327,35519,18841,16678
2010/9/1,新竹縣,竹東鎮,30603,96946,48866,48080
2010/9/1,新竹縣,湖口鄉,23322,75296,38539,36757
2010/9/1,新竹縣,橫山鄉,4401,14428,7795,6633
2010/9/1,新竹縣,新豐鄉,15675,53110,27426,25684
2010/9/1,新竹縣,芎林鄉,6281,20773,10933,9840
2010/9/1,新竹縣,寶山鄉,4676,14095,7619,6476
2010/9/1,新竹縣,北埔鄉,3086,10149,5511,4638
2010/9/1,新竹縣,峨眉鄉,2025,6008,3322,2686
2010/9/1,新竹縣,尖石鄉,2661,8275,4528,3747
2010/9/1,新竹縣,五峰鄉,1716,4683,2591,2092
2010/9/1,苗栗縣,苗栗市,29086,90579,45678,44901
2010/9/1,苗栗縣,苑裡鎮,13809,48672,25415,23257
2010/9/1,苗栗縣,通霄鎮,11312,38037,20209,17828
2010/9/1,苗栗縣,竹南鎮,24028,78066,39673,38393
2010/9/1,苗栗縣,頭份市,29426,96873,49272,47601
2010/9/1,苗栗縣,後龍鎮,11664,39445,20883,18562
2010/9/1,苗栗縣,卓蘭鎮,5952,18449,9729,8720
2010/9/1,苗栗縣,大湖鄉,5312,16060,8582,7478
2010/9/1,苗栗縣,公館鄉,10164,34753,18256,16497
2010/9/1,苗栗縣,銅鑼鄉,5980,19460,10296,9164
2010/9/1,苗栗縣,南庄鄉,3998,11151,6156,4995
2010/9/1,苗栗縣,頭屋鄉,3511,11612,6140,5472
2010/9/1,苗栗縣,三義鄉,5263,17552,9230,8322
2010/9/1,苗栗縣,西湖鄉,2676,7890,4362,3528
2010/9/1,苗栗縣,造橋鄉,3999,13739,7263,6476
2010/9/1,苗栗縣,三灣鄉,2379,7283,3964,3319
2010/9/1,苗栗縣,獅潭鄉,1688,4931,2749,2182
2010/9/1,苗栗縣,泰安鄉,1941,6005,3253,2752
2010/9/1,臺中市,豐原區,49647,165457,82240,83217
2010/9/1,臺中市,大里區,61463,197227,97933,99294
2010/9/1,臺中市,太平區,54592,172855,86813,86042
2010/9/1,臺中市,東勢區,16940,53313,27690,25623
2010/9/1,臺中市,大甲區,21624,78503,39885,38618
2010/9/1,臺中市,清水區,24902,85580,44168,41412
2010/9/1,臺中市,沙鹿區,23674,81470,41532,39938
2010/9/1,臺中市,梧棲區,15939,55198,28045,27153
2010/9/1,臺中市,后里區,14752,54286,27911,26375
2010/9/1,臺中市,神岡區,17604,63761,32841,30920
2010/9/1,臺中市,潭子區,32351,100181,49938,50243
2010/9/1,臺中市,大雅區,26207,89715,45233,44482
2010/9/1,臺中市,新社區,7342,25618,13445,12173
2010/9/1,臺中市,石岡區,4849,16012,8330,7682
2010/9/1,臺中市,外埔區,8833,32052,16483,15569
2010/9/1,臺中市,大安區,5241,20292,10672,9620
2010/9/1,臺中市,烏日區,20426,68654,34783,33871
2010/9/1,臺中市,大肚區,15821,55745,28613,27132
2010/9/1,臺中市,龍井區,20554,74064,37700,36364
2010/9/1,臺中市,霧峰區,18728,63864,32896,30968
2010/9/1,臺中市,和平區,4446,10730,5849,4881
2010/9/1,彰化縣,彰化市,71643,236485,117830,118655
2010/9/1,彰化縣,鹿港鎮,22261,85260,43709,41551
2010/9/1,彰化縣,和美鎮,24011,89702,46006,43696
2010/9/1,彰化縣,北斗鎮,9893,33549,17004,16545
2010/9/1,彰化縣,員林市,36691,125564,63114,62450
2010/9/1,彰化縣,溪湖鎮,15080,56167,28701,27466
2010/9/1,彰化縣,田中鎮,12526,44121,22942,21179
2010/9/1,彰化縣,二林鎮,14237,53988,27877,26111
2010/9/1,彰化縣,線西鄉,4131,17130,8795,8335
2010/9/1,彰化縣,伸港鄉,8941,35897,18462,17435
2010/9/1,彰化縣,福興鄉,12042,48960,25623,23337
2010/9/1,彰化縣,秀水鄉,9711,39120,20278,18842
2010/9/1,彰化縣,花壇鄉,12941,46196,23826,22370
2010/9/1,彰化縣,芬園鄉,6886,24853,13204,11649
2010/9/1,彰化縣,大村鄉,10209,36620,19102,17518
2010/9/1,彰化縣,埔鹽鄉,8809,34374,18024,16350
2010/9/1,彰化縣,埔心鄉,9898,35258,18295,16963
2010/9/1,彰化縣,永靖鄉,10404,39345,20391,18954
2010/9/1,彰化縣,社頭鄉,12290,44798,23030,21768
2010/9/1,彰化縣,二水鄉,5307,16563,8703,7860
2010/9/1,彰化縣,田尾鄉,7659,28697,14967,13730
2010/9/1,彰化縣,埤頭鄉,8555,31797,16584,15213
2010/9/1,彰化縣,芳苑鄉,9951,36303,19233,17070
2010/9/1,彰化縣,大城鄉,5380,18978,10296,8682
2010/9/1,彰化縣,竹塘鄉,4589,16500,8683,7817
2010/9/1,彰化縣,溪州鄉,8664,31618,16675,14943
2010/9/1,南投縣,南投市,33204,104169,52402,51767
2010/9/1,南投縣,埔里鎮,28269,85332,43053,42279
2010/9/1,南投縣,草屯鎮,30837,99786,50444,49342
2010/9/1,南投縣,竹山鎮,18979,58466,30174,28292
2010/9/1,南投縣,集集鎮,4294,11958,6282,5676
2010/9/1,南投縣,名間鄉,12103,41299,21672,19627
2010/9/1,南投縣,鹿谷鄉,6693,19114,10149,8965
2010/9/1,南投縣,中寮鄉,5617,16219,8814,7405
2010/9/1,南投縣,魚池鄉,5790,17237,9090,8147
2010/9/1,南投縣,國姓鄉,7214,20724,11301,9423
2010/9/1,南投縣,水里鄉,7236,20112,10536,9576
2010/9/1,南投縣,信義鄉,5216,17297,9358,7939
2010/9/1,南投縣,仁愛鄉,4917,15586,8165,7421
2010/9/1,雲林縣,斗六市,34657,106848,53747,53101
2010/9/1,雲林縣,斗南鎮,15222,47199,24003,23196
2010/9/1,雲林縣,虎尾鎮,22428,70071,35674,34397
2010/9/1,雲林縣,西螺鎮,13975,48580,24710,23870
2010/9/1,雲林縣,土庫鎮,8708,30547,15959,14588
2010/9/1,雲林縣,北港鎮,15284,43253,22502,20751
2010/9/1,雲林縣,古坑鄉,10652,34134,18067,16067
2010/9/1,雲林縣,大埤鄉,6628,21249,11379,9870
2010/9/1,雲林縣,莿桐鄉,8996,30519,15991,14528
2010/9/1,雲林縣,林內鄉,5747,19856,10383,9473
2010/9/1,雲林縣,二崙鄉,8778,29722,15927,13795
2010/9/1,雲林縣,崙背鄉,8309,27471,14482,12989
2010/9/1,雲林縣,麥寮鄉,12388,35942,18858,17084
2010/9/1,雲林縣,東勢鄉,5715,16880,9184,7696
2010/9/1,雲林縣,褒忠鄉,4299,14327,7625,6702
2010/9/1,雲林縣,臺西鄉,8928,26280,14133,12147
2010/9/1,雲林縣,元長鄉,9328,28843,15691,13152
2010/9/1,雲林縣,四湖鄉,9055,26814,14621,12193
2010/9/1,雲林縣,口湖鄉,9631,30435,16213,14222
2010/9/1,雲林縣,水林鄉,10383,29084,15882,13202
2010/9/1,嘉義縣,太保市,11237,36504,18820,17684
2010/9/1,嘉義縣,朴子市,14572,44153,22524,21629
2010/9/1,嘉義縣,布袋鎮,10159,30326,15567,14759
2010/9/1,嘉義縣,大林鎮,11194,33699,17298,16401
2010/9/1,嘉義縣,民雄鄉,22726,72576,37280,35296
2010/9/1,嘉義縣,溪口鄉,5393,16341,8699,7642
2010/9/1,嘉義縣,新港鄉,10380,34778,18390,16388
2010/9/1,嘉義縣,六腳鄉,9132,26398,13992,12406
2010/9/1,嘉義縣,東石鄉,9495,27832,14805,13027
2010/9/1,嘉義縣,義竹鄉,7469,21199,10976,10223
2010/9/1,嘉義縣,鹿草鄉,5729,17266,9279,7987
2010/9/1,嘉義縣,水上鄉,17381,52315,27045,25270
2010/9/1,嘉義縣,中埔鄉,15257,47542,24818,22724
2010/9/1,嘉義縣,竹崎鄉,11279,38580,20541,18039
2010/9/1,嘉義縣,梅山鄉,6642,21757,11536,10221
2010/9/1,嘉義縣,番路鄉,3946,11715,6385,5330
2010/9/1,嘉義縣,大埔鄉,1964,4648,2450,2198
2010/9/1,嘉義縣,阿里山鄉,2061,6224,3333,2891
2010/9/1,臺南市,新營區,27090,78059,39015,39044
2010/9/1,臺南市,永康區,74675,216326,107661,108665
2010/9/1,臺南市,鹽水區,9937,27208,14190,13018
2010/9/1,臺南市,白河區,10941,31476,16519,14957
2010/9/1,臺南市,麻豆區,15061,45873,23472,22401
2010/9/1,臺南市,佳里區,19264,59312,29547,29765
2010/9/1,臺南市,新化區,13688,44116,22602,21514
2010/9/1,臺南市,善化區,14497,43420,21990,21430
2010/9/1,臺南市,學甲區,9531,27944,14269,13675
2010/9/1,臺南市,柳營區,7789,22760,11907,10853
2010/9/1,臺南市,後壁區,8777,25995,13552,12443
2010/9/1,臺南市,東山區,8213,23167,12342,10825
2010/9/1,臺南市,下營區,9075,26151,13558,12593
2010/9/1,臺南市,六甲區,7595,23750,12336,11414
2010/9/1,臺南市,官田區,7601,22297,11413,10884
2010/9/1,臺南市,大內區,4076,10911,5807,5104
2010/9/1,臺南市,西港區,7796,25224,12851,12373
2010/9/1,臺南市,七股區,7998,24817,12973,11844
2010/9/1,臺南市,將軍區,7434,21642,11006,10636
2010/9/1,臺南市,北門區,4375,12471,6358,6113
2010/9/1,臺南市,新市區,10720,34811,17509,17302
2010/9/1,臺南市,安定區,9280,30212,15655,14557
2010/9/1,臺南市,山上區,2719,7896,4154,3742
2010/9/1,臺南市,玉井區,5080,15457,8019,7438
2010/9/1,臺南市,楠西區,3580,10680,5660,5020
2010/9/1,臺南市,南化區,2821,8925,4882,4043
2010/9/1,臺南市,左鎮區,1975,5508,3057,2451
2010/9/1,臺南市,仁德區,24619,69178,35606,33572
2010/9/1,臺南市,歸仁區,20416,65816,33584,32232
2010/9/1,臺南市,關廟區,10691,36065,18699,17366
2010/9/1,臺南市,龍崎區,1601,4399,2380,2019
2010/9/1,高雄市,鳳山區,126590,340789,169961,170828
2010/9/1,高雄市,岡山區,33117,97104,48770,48334
2010/9/1,高雄市,旗山區,13780,39976,20838,19138
2010/9/1,高雄市,美濃區,14105,43123,22524,20599
2010/9/1,高雄市,林園區,24018,70526,36219,34307
2010/9/1,高雄市,大寮區,38114,108938,56610,52328
2010/9/1,高雄市,大樹區,13020,44047,22786,21261
2010/9/1,高雄市,仁武區,25669,71658,36994,34664
2010/9/1,高雄市,大社區,11617,32861,16903,15958
2010/9/1,高雄市,鳥松區,16482,42521,21628,20893
2010/9/1,高雄市,橋頭區,12516,36331,18616,17715
2010/9/1,高雄市,燕巢區,10030,30944,16536,14408
2010/9/1,高雄市,田寮區,3552,8240,4578,3662
2010/9/1,高雄市,阿蓮區,9128,30426,15361,15065
2010/9/1,高雄市,路竹區,16024,53891,27505,26386
2010/9/1,高雄市,湖內區,9519,28822,14861,13961
2010/9/1,高雄市,茄萣區,10114,31493,16420,15073
2010/9/1,高雄市,永安區,5818,14265,7277,6988
2010/9/1,高雄市,彌陀區,6560,20449,10638,9811
2010/9/1,高雄市,梓官區,12000,36789,19107,17682
2010/9/1,高雄市,六龜區,5767,14884,8061,6823
2010/9/1,高雄市,甲仙區,2511,7281,3908,3373
2010/9/1,高雄市,杉林區,4353,11845,6461,5384
2010/9/1,高雄市,內門區,5019,16027,8737,7290
2010/9/1,高雄市,茂林區,573,1868,940,928
2010/9/1,高雄市,桃源區,1356,4819,2560,2259
2010/9/1,高雄市,那瑪夏區,885,3415,1774,1641
2010/9/1,屏東縣,屏東市,72191,211620,105636,105984
2010/9/1,屏東縣,潮州鎮,18109,55526,27946,27580
2010/9/1,屏東縣,東港鎮,15689,50261,25461,24800
2010/9/1,屏東縣,恆春鎮,10752,31205,16035,15170
2010/9/1,屏東縣,萬丹鄉,14267,54057,27956,26101
2010/9/1,屏東縣,長治鄉,9705,30963,16178,14785
2010/9/1,屏東縣,麟洛鄉,3604,11581,6007,5574
2010/9/1,屏東縣,九如鄉,6556,22882,11902,10980
2010/9/1,屏東縣,里港鄉,7839,26020,13345,12675
2010/9/1,屏東縣,鹽埔鄉,7677,27314,14198,13116
2010/9/1,屏東縣,高樹鄉,9551,26841,14339,12502
2010/9/1,屏東縣,萬巒鄉,6409,22001,11592,10409
2010/9/1,屏東縣,內埔鄉,17709,58106,30219,27887
2010/9/1,屏東縣,竹田鄉,5514,18399,9760,8639
2010/9/1,屏東縣,新埤鄉,3360,10765,5712,5053
2010/9/1,屏東縣,枋寮鄉,8460,26684,14051,12633
2010/9/1,屏東縣,新園鄉,11454,38403,19845,18558
2010/9/1,屏東縣,崁頂鄉,4210,17429,8905,8524
2010/9/1,屏東縣,林邊鄉,7163,20910,10790,10120
2010/9/1,屏東縣,南州鄉,3673,11728,6029,5699
2010/9/1,屏東縣,佳冬鄉,7136,21424,11170,10254
2010/9/1,屏東縣,琉球鄉,3962,12361,6860,5501
2010/9/1,屏東縣,車城鄉,3514,9696,5243,4453
2010/9/1,屏東縣,滿州鄉,3043,8491,4667,3824
2010/9/1,屏東縣,枋山鄉,2083,6070,3247,2823
2010/9/1,屏東縣,三地門鄉,2162,7554,3867,3687
2010/9/1,屏東縣,霧臺鄉,974,2969,1561,1408
2010/9/1,屏東縣,瑪家鄉,1884,6537,3407,3130
2010/9/1,屏東縣,泰武鄉,1232,5121,2689,2432
2010/9/1,屏東縣,來義鄉,2152,7758,3995,3763
2010/9/1,屏東縣,春日鄉,1324,4815,2508,2307
2010/9/1,屏東縣,獅子鄉,1466,4900,2573,2327
2010/9/1,屏東縣,牡丹鄉,1872,4988,2596,2392
2010/9/1,臺東縣,臺東市,37919,108946,55297,53649
2010/9/1,臺東縣,成功鎮,5419,15845,8459,7386
2010/9/1,臺東縣,關山鎮,3232,9741,5099,4642
2010/9/1,臺東縣,卑南鄉,6576,18242,9878,8364
2010/9/1,臺東縣,大武鄉,2541,7054,3678,3376
2010/9/1,臺東縣,太麻里鄉,4527,12032,6441,5591
2010/9/1,臺東縣,東河鄉,3535,9379,5200,4179
2010/9/1,臺東縣,長濱鄉,2933,8315,4740,3575
2010/9/1,臺東縣,鹿野鄉,3132,8600,4648,3952
2010/9/1,臺東縣,池上鄉,3257,9221,4880,4341
2010/9/1,臺東縣,綠島鄉,994,3354,1803,1551
2010/9/1,臺東縣,延平鄉,1066,3600,1985,1615
2010/9/1,臺東縣,海端鄉,1090,4499,2447,2052
2010/9/1,臺東縣,達仁鄉,1502,4086,2229,1857
2010/9/1,臺東縣,金峰鄉,1048,3591,1865,1726
2010/9/1,臺東縣,蘭嶼鄉,1416,4436,2300,2136
2010/9/1,花蓮縣,花蓮市,40469,109388,53657,55731
2010/9/1,花蓮縣,鳳林鎮,4458,12012,6344,5668
2010/9/1,花蓮縣,玉里鎮,8909,26950,14617,12333
2010/9/1,花蓮縣,新城鄉,7276,20206,10514,9692
2010/9/1,花蓮縣,吉安鄉,28896,79592,40781,38811
2010/9/1,花蓮縣,壽豐鄉,6835,18700,10136,8564
2010/9/1,花蓮縣,光復鄉,5031,14195,7581,6614
2010/9/1,花蓮縣,豐濱鄉,1816,5104,2827,2277
2010/9/1,花蓮縣,瑞穗鄉,4638,12920,6955,5965
2010/9/1,花蓮縣,富里鄉,3999,11719,6416,5303
2010/9/1,花蓮縣,秀林鄉,4656,15273,7939,7334
2010/9/1,花蓮縣,萬榮鄉,2141,6865,3669,3196
2010/9/1,花蓮縣,卓溪鄉,1660,6371,3546,2825
2010/9/1,澎湖縣,馬公市,19857,56629,28687,27942
2010/9/1,澎湖縣,湖西鄉,4742,13658,7117,6541
2010/9/1,澎湖縣,白沙鄉,3147,9470,4972,4498
2010/9/1,澎湖縣,西嶼鄉,2850,8428,4370,4058
2010/9/1,澎湖縣,望安鄉,1902,4755,2561,2194
2010/9/1,澎湖縣,七美鄉,1239,3548,1867,1681
2010/9/1,基隆市,中正區,22101,55477,28447,27030
2010/9/1,基隆市,七堵區,20047,55309,28026,27283
2010/9/1,基隆市,暖暖區,14316,37946,19246,18700
2010/9/1,基隆市,仁愛區,19766,49801,24594,25207
2010/9/1,基隆市,中山區,19053,50987,26062,24925
2010/9/1,基隆市,安樂區,31823,84230,41971,42259
2010/9/1,基隆市,信義區,20070,51204,25684,25520
2010/9/1,新竹市,東區,68293,196722,97176,99546
2010/9/1,新竹市,北區,50485,145182,71730,73452
2010/9/1,新竹市,香山區,22877,72419,36943,35476
2010/9/1,臺中市,中區,8397,22737,11237,11500
2010/9/1,臺中市,東區,25826,73942,37341,36601
2010/9/1,臺中市,西區,43254,117448,56426,61022
2010/9/1,臺中市,南區,41976,113382,54978,58404
2010/9/1,臺中市,北區,55713,147620,71548,76072
2010/9/1,臺中市,西屯區,72788,206058,100012,106046
2010/9/1,臺中市,南屯區,53060,153209,74082,79127
2010/9/1,臺中市,北屯區,83242,246221,119680,126541
2010/9/1,嘉義市,東區,44149,125483,61263,64220
2010/9/1,嘉義市,西區,50965,147228,72958,74270
2010/9/1,臺南市,東區,70809,194008,93900,100108
2010/9/1,臺南市,南區,43261,126317,63353,62964
2010/9/1,臺南市,北區,48130,131897,65107,66790
2010/9/1,臺南市,安南區,54335,177783,90451,87332
2010/9/1,臺南市,安平區,23096,62444,29920,32524
2010/9/1,臺南市,中西區,30156,79439,39053,40386
2010/9/1,臺北市,松山區,77838,207740,98592,109148
2010/9/1,臺北市,信義區,85816,224353,108136,116217
2010/9/1,臺北市,大安區,116752,310492,146189,164303
2010/9/1,臺北市,中山區,91636,219203,103333,115870
2010/9/1,臺北市,中正區,62222,159019,76744,82275
2010/9/1,臺北市,大同區,47209,124025,61143,62882
2010/9/1,臺北市,萬華區,73993,188274,93901,94373
2010/9/1,臺北市,文山區,97065,261408,126689,134719
2010/9/1,臺北市,南港區,41700,113538,55916,57622
2010/9/1,臺北市,內湖區,96586,268897,129717,139180
2010/9/1,臺北市,士林區,100650,283728,137929,145799
2010/9/1,臺北市,北投區,89533,248246,120473,127773
2010/9/1,高雄市,鹽埕區,11172,27507,13816,13691
2010/9/1,高雄市,鼓山區,52112,131298,64392,66906
2010/9/1,高雄市,左營區,73633,191409,94273,97136
2010/9/1,高雄市,楠梓區,61789,172800,85744,87056
2010/9/1,高雄市,三民區,131468,354147,173440,180707
2010/9/1,高雄市,新興區,22975,55427,27028,28399
2010/9/1,高雄市,前金區,12543,28980,14134,14846
2010/9/1,高雄市,苓雅區,71888,184280,89779,94501
2010/9/1,高雄市,前鎮區,76442,199445,99097,100348
2010/9/1,高雄市,旗津區,10927,29934,15563,14371
2010/9/1,高雄市,小港區,62883,154218,77547,76671
2010/9/1,金門縣,金城鎮,10881,32141,16470,15671
2010/9/1,金門縣,金湖鎮,7233,21096,10879,10217
2010/9/1,金門縣,金沙鎮,5320,15202,7746,7456
2010/9/1,金門縣,金寧鄉,6130,18286,9477,8809
2010/9/1,金門縣,烈嶼鄉,2599,8842,4471,4371
2010/9/1,金門縣,烏坵鄉,135,524,263,261
2010/9/1,連江縣,南竿鄉,1203,5921,3414,2507
2010/9/1,連江縣,北竿鄉,380,1801,1035,766
2010/9/1,連江縣,莒光鄉,240,1181,700,481
2010/9/1,連江縣,東引鄉,274,1054,615,439
2010/10/1,總計,臺灣地區,7889472,23044370,11578300,11466070
2010/10/1,總計,臺灣省,6319526,18901580,9563166,9338414
2010/10/1,總計,新北市,1402627,3893740,1934706,1959034
2010/10/1,總計,宜蘭縣,153778,460570,234812,225758
2010/10/1,總計,桃園市,672347,2001537,1009331,992206
2010/10/1,總計,新竹縣,160805,512353,263751,248602
2010/10/1,總計,苗栗縣,172394,560617,291119,269498
2010/10/1,總計,臺中市,466395,1564994,793061,771933
2010/10/1,總計,彰化縣,362989,1307500,671091,636409
2010/10/1,總計,南投縣,170476,526911,271250,255661
2010/10/1,總計,雲林縣,229269,717915,374931,342984
2010/10/1,總計,嘉義縣,176145,543738,283618,260120
2010/10/1,總計,臺南市,369275,1101877,562481,539396
2010/10/1,總計,高雄市,432613,1243273,636393,606880
2010/10/1,總計,屏東縣,276760,874696,449918,424778
2010/10/1,總計,臺東縣,80273,230832,120854,109978
2010/10/1,總計,花蓮縣,120848,339092,174823,164269
2010/10/1,總計,澎湖縣,34014,96711,49681,47030
2010/10/1,總計,基隆市,147147,384590,193830,190760
2010/10/1,總計,新竹市,141751,414682,205969,208713
2010/10/1,總計,臺中市,384658,1081487,525633,555854
2010/10/1,總計,嘉義市,95066,272523,134132,138391
2010/10/1,總計,臺南市,269896,771942,381782,390160
2010/10/1,總計,臺北市,981817,2613071,1260385,1352686
2010/10/1,總計,高雄市,588129,1529719,754749,774970
2010/10/1,總計,福建省,34462,106553,55280,51273
2010/10/1,總計,金門縣,32362,96622,49531,47091
2010/10/1,總計,連江縣,2100,9931,5749,4182
2010/10/1,新北市,板橋區,194332,554541,274523,280018
2010/10/1,新北市,三重區,139934,390037,194520,195517
2010/10/1,新北市,永和區,89580,234951,112766,122185
2010/10/1,新北市,中和區,155379,414379,204855,209524
2010/10/1,新北市,新莊區,136493,402051,198743,203308
2010/10/1,新北市,新店區,116242,295673,144947,150726
2010/10/1,新北市,土城區,81980,238601,119433,119168
2010/10/1,新北市,蘆洲區,65312,197545,97945,99600
2010/10/1,新北市,汐止區,79090,189166,94023,95143
2010/10/1,新北市,樹林區,59336,175350,88414,86936
2010/10/1,新北市,鶯歌區,27413,86677,43894,42783
2010/10/1,新北市,三峽區,35357,103046,52604,50442
2010/10/1,新北市,淡水區,57298,143354,69796,73558
2010/10/1,新北市,瑞芳區,15829,42521,21749,20772
2010/10/1,新北市,五股區,27279,79751,40526,39225
2010/10/1,新北市,泰山區,26101,76435,38423,38012
2010/10/1,新北市,林口區,30279,82532,40796,41736
2010/10/1,新北市,深坑區,8757,23248,11712,11536
2010/10/1,新北市,石碇區,3315,7977,4462,3515
2010/10/1,新北市,坪林區,2434,6533,3646,2887
2010/10/1,新北市,三芝區,8841,23286,12069,11217
2010/10/1,新北市,石門區,3977,12476,6580,5896
2010/10/1,新北市,八里區,12150,34590,17552,17038
2010/10/1,新北市,平溪區,2384,5375,3001,2374
2010/10/1,新北市,雙溪區,3812,9775,5300,4475
2010/10/1,新北市,貢寮區,4379,13766,7101,6665
2010/10/1,新北市,金山區,6671,22346,11242,11104
2010/10/1,新北市,萬里區,6981,21975,11151,10824
2010/10/1,新北市,烏來區,1692,5783,2933,2850
2010/10/1,宜蘭縣,宜蘭市,33118,95598,47097,48501
2010/10/1,宜蘭縣,羅東鎮,24875,72959,35063,37896
2010/10/1,宜蘭縣,蘇澳鎮,13574,43061,22102,20959
2010/10/1,宜蘭縣,頭城鎮,9679,30945,15995,14950
2010/10/1,宜蘭縣,礁溪鄉,12315,35840,18776,17064
2010/10/1,宜蘭縣,壯圍鄉,8111,25026,13191,11835
2010/10/1,宜蘭縣,員山鄉,10760,32356,17332,15024
2010/10/1,宜蘭縣,冬山鄉,17296,52515,27043,25472
2010/10/1,宜蘭縣,五結鄉,12937,38846,20184,18662
2010/10/1,宜蘭縣,三星鄉,7473,21407,11577,9830
2010/10/1,宜蘭縣,大同鄉,1833,6003,3262,2741
2010/10/1,宜蘭縣,南澳鄉,1807,6014,3190,2824
2010/10/1,桃園市,桃園區,143621,406497,199208,207289
2010/10/1,桃園市,中壢區,126784,369549,184550,184999
2010/10/1,桃園市,平鎮區,66591,207345,104406,102939
2010/10/1,桃園市,八德區,58169,177017,90126,86891
2010/10/1,桃園市,楊梅區,48675,150988,76807,74181
2010/10/1,桃園市,大溪區,29232,92029,47445,44584
2010/10/1,桃園市,蘆竹區,48106,141882,71116,70766
2010/10/1,桃園市,大園區,26127,81980,42575,39405
2010/10/1,桃園市,龜山區,50246,138137,70135,68002
2010/10/1,桃園市,龍潭區,36972,115323,58547,56776
2010/10/1,桃園市,新屋區,14962,49168,26281,22887
2010/10/1,桃園市,觀音區,19151,60962,32154,28808
2010/10/1,桃園市,復興區,3711,10660,5981,4679
2010/10/1,新竹縣,竹北市,46692,141272,70883,70389
2010/10/1,新竹縣,關西鎮,9226,31787,16923,14864
2010/10/1,新竹縣,新埔鎮,10322,35509,18828,16681
2010/10/1,新竹縣,竹東鎮,30634,96882,48840,48042
2010/10/1,新竹縣,湖口鄉,23348,75323,38540,36783
2010/10/1,新竹縣,橫山鄉,4404,14413,7788,6625
2010/10/1,新竹縣,新豐鄉,15696,53150,27433,25717
2010/10/1,新竹縣,芎林鄉,6291,20798,10943,9855
2010/10/1,新竹縣,寶山鄉,4687,14102,7616,6486
2010/10/1,新竹縣,北埔鄉,3089,10133,5507,4626
2010/10/1,新竹縣,峨眉鄉,2023,5997,3318,2679
2010/10/1,新竹縣,尖石鄉,2672,8299,4541,3758
2010/10/1,新竹縣,五峰鄉,1721,4688,2591,2097
2010/10/1,苗栗縣,苗栗市,29122,90621,45685,44936
2010/10/1,苗栗縣,苑裡鎮,13827,48653,25413,23240
2010/10/1,苗栗縣,通霄鎮,11316,38015,20185,17830
2010/10/1,苗栗縣,竹南鎮,24068,78225,39745,38480
2010/10/1,苗栗縣,頭份市,29487,96914,49290,47624
2010/10/1,苗栗縣,後龍鎮,11673,39424,20862,18562
2010/10/1,苗栗縣,卓蘭鎮,5966,18460,9732,8728
2010/10/1,苗栗縣,大湖鄉,5311,16040,8570,7470
2010/10/1,苗栗縣,公館鄉,10178,34722,18252,16470
2010/10/1,苗栗縣,銅鑼鄉,5981,19439,10297,9142
2010/10/1,苗栗縣,南庄鄉,3991,11143,6150,4993
2010/10/1,苗栗縣,頭屋鄉,3515,11594,6134,5460
2010/10/1,苗栗縣,三義鄉,5272,17543,9232,8311
2010/10/1,苗栗縣,西湖鄉,2676,7879,4361,3518
2010/10/1,苗栗縣,造橋鄉,4004,13730,7241,6489
2010/10/1,苗栗縣,三灣鄉,2381,7278,3968,3310
2010/10/1,苗栗縣,獅潭鄉,1687,4932,2746,2186
2010/10/1,苗栗縣,泰安鄉,1939,6005,3256,2749
2010/10/1,臺中市,豐原區,49698,165483,82232,83251
2010/10/1,臺中市,大里區,61522,197363,97969,99394
2010/10/1,臺中市,太平區,54619,172865,86794,86071
2010/10/1,臺中市,東勢區,16953,53310,27676,25634
2010/10/1,臺中市,大甲區,21631,78476,39848,38628
2010/10/1,臺中市,清水區,24920,85580,44175,41405
2010/10/1,臺中市,沙鹿區,23734,81510,41551,39959
2010/10/1,臺中市,梧棲區,15955,55201,28049,27152
2010/10/1,臺中市,后里區,14782,54296,27909,26387
2010/10/1,臺中市,神岡區,17619,63799,32854,30945
2010/10/1,臺中市,潭子區,32388,100158,49939,50219
2010/10/1,臺中市,大雅區,26249,89742,45241,44501
2010/10/1,臺中市,新社區,7345,25628,13435,12193
2010/10/1,臺中市,石岡區,4849,16005,8326,7679
2010/10/1,臺中市,外埔區,8835,32033,16468,15565
2010/10/1,臺中市,大安區,5243,20310,10679,9631
2010/10/1,臺中市,烏日區,20444,68672,34786,33886
2010/10/1,臺中市,大肚區,15824,55761,28612,27149
2010/10/1,臺中市,龍井區,20598,74159,37743,36416
2010/10/1,臺中市,霧峰區,18739,63891,32911,30980
2010/10/1,臺中市,和平區,4448,10752,5864,4888
2010/10/1,彰化縣,彰化市,71696,236478,117793,118685
2010/10/1,彰化縣,鹿港鎮,22268,85242,43699,41543
2010/10/1,彰化縣,和美鎮,24015,89663,45984,43679
2010/10/1,彰化縣,北斗鎮,9900,33526,16987,16539
2010/10/1,彰化縣,員林市,36703,125465,63063,62402
2010/10/1,彰化縣,溪湖鎮,15083,56101,28665,27436
2010/10/1,彰化縣,田中鎮,12529,44124,22931,21193
2010/10/1,彰化縣,二林鎮,14259,53990,27873,26117
2010/10/1,彰化縣,線西鄉,4137,17139,8807,8332
2010/10/1,彰化縣,伸港鄉,8960,35900,18460,17440
2010/10/1,彰化縣,福興鄉,12056,48992,25637,23355
2010/10/1,彰化縣,秀水鄉,9732,39124,20267,18857
2010/10/1,彰化縣,花壇鄉,12974,46175,23824,22351
2010/10/1,彰化縣,芬園鄉,6888,24847,13199,11648
2010/10/1,彰化縣,大村鄉,10224,36623,19092,17531
2010/10/1,彰化縣,埔鹽鄉,8811,34351,18014,16337
2010/10/1,彰化縣,埔心鄉,9909,35319,18318,17001
2010/10/1,彰化縣,永靖鄉,10415,39321,20382,18939
2010/10/1,彰化縣,社頭鄉,12297,44775,23013,21762
2010/10/1,彰化縣,二水鄉,5308,16536,8694,7842
2010/10/1,彰化縣,田尾鄉,7673,28658,14944,13714
2010/10/1,彰化縣,埤頭鄉,8558,31788,16588,15200
2010/10/1,彰化縣,芳苑鄉,9955,36314,19237,17077
2010/10/1,彰化縣,大城鄉,5384,18968,10284,8684
2010/10/1,彰化縣,竹塘鄉,4589,16488,8673,7815
2010/10/1,彰化縣,溪州鄉,8666,31593,16663,14930
2010/10/1,南投縣,南投市,33237,104115,52380,51735
2010/10/1,南投縣,埔里鎮,28288,85190,42987,42203
2010/10/1,南投縣,草屯鎮,30859,99710,50405,49305
2010/10/1,南投縣,竹山鎮,18996,58387,30128,28259
2010/10/1,南投縣,集集鎮,4294,11954,6286,5668
2010/10/1,南投縣,名間鄉,12100,41289,21667,19622
2010/10/1,南投縣,鹿谷鄉,6707,19141,10167,8974
2010/10/1,南投縣,中寮鄉,5614,16210,8809,7401
2010/10/1,南投縣,魚池鄉,5793,17215,9080,8135
2010/10/1,南投縣,國姓鄉,7212,20690,11285,9405
2010/10/1,南投縣,水里鄉,7231,20097,10530,9567
2010/10/1,南投縣,信義鄉,5222,17308,9362,7946
2010/10/1,南投縣,仁愛鄉,4923,15605,8164,7441
2010/10/1,雲林縣,斗六市,34690,106812,53710,53102
2010/10/1,雲林縣,斗南鎮,15227,47178,23989,23189
2010/10/1,雲林縣,虎尾鎮,22435,70010,35647,34363
2010/10/1,雲林縣,西螺鎮,13968,48535,24690,23845
2010/10/1,雲林縣,土庫鎮,8712,30517,15941,14576
2010/10/1,雲林縣,北港鎮,15309,43152,22454,20698
2010/10/1,雲林縣,古坑鄉,10648,34073,18049,16024
2010/10/1,雲林縣,大埤鄉,6636,21242,11388,9854
2010/10/1,雲林縣,莿桐鄉,9006,30525,15995,14530
2010/10/1,雲林縣,林內鄉,5743,19784,10334,9450
2010/10/1,雲林縣,二崙鄉,8774,29709,15917,13792
2010/10/1,雲林縣,崙背鄉,8307,27430,14450,12980
2010/10/1,雲林縣,麥寮鄉,12460,36423,19070,17353
2010/10/1,雲林縣,東勢鄉,5711,16850,9168,7682
2010/10/1,雲林縣,褒忠鄉,4302,14306,7614,6692
2010/10/1,雲林縣,臺西鄉,8943,26296,14133,12163
2010/10/1,雲林縣,元長鄉,9330,28831,15691,13140
2010/10/1,雲林縣,四湖鄉,9063,26776,14608,12168
2010/10/1,雲林縣,口湖鄉,9627,30426,16216,14210
2010/10/1,雲林縣,水林鄉,10378,29040,15867,13173
2010/10/1,嘉義縣,太保市,11264,36614,18863,17751
2010/10/1,嘉義縣,朴子市,14582,44124,22531,21593
2010/10/1,嘉義縣,布袋鎮,10149,30296,15544,14752
2010/10/1,嘉義縣,大林鎮,11202,33660,17276,16384
2010/10/1,嘉義縣,民雄鄉,22759,72564,37268,35296
2010/10/1,嘉義縣,溪口鄉,5383,16330,8699,7631
2010/10/1,嘉義縣,新港鄉,10389,34745,18363,16382
2010/10/1,嘉義縣,六腳鄉,9144,26403,13988,12415
2010/10/1,嘉義縣,東石鄉,9494,27782,14777,13005
2010/10/1,嘉義縣,義竹鄉,7477,21175,10960,10215
2010/10/1,嘉義縣,鹿草鄉,5734,17251,9268,7983
2010/10/1,嘉義縣,水上鄉,17394,52325,27023,25302
2010/10/1,嘉義縣,中埔鄉,15258,47538,24800,22738
2010/10/1,嘉義縣,竹崎鄉,11289,38569,20530,18039
2010/10/1,嘉義縣,梅山鄉,6653,21737,11532,10205
2010/10/1,嘉義縣,番路鄉,3946,11729,6395,5334
2010/10/1,嘉義縣,大埔鄉,1966,4659,2456,2203
2010/10/1,嘉義縣,阿里山鄉,2062,6237,3345,2892
2010/10/1,臺南市,新營區,27126,78023,38975,39048
2010/10/1,臺南市,永康區,74791,216508,107718,108790
2010/10/1,臺南市,鹽水區,9936,27188,14174,13014
2010/10/1,臺南市,白河區,10952,31473,16514,14959
2010/10/1,臺南市,麻豆區,15067,45849,23453,22396
2010/10/1,臺南市,佳里區,19290,59269,29524,29745
2010/10/1,臺南市,新化區,13691,44102,22594,21508
2010/10/1,臺南市,善化區,14517,43422,21981,21441
2010/10/1,臺南市,學甲區,9529,27915,14258,13657
2010/10/1,臺南市,柳營區,7793,22765,11907,10858
2010/10/1,臺南市,後壁區,8774,25978,13550,12428
2010/10/1,臺南市,東山區,8216,23148,12329,10819
2010/10/1,臺南市,下營區,9084,26153,13553,12600
2010/10/1,臺南市,六甲區,7606,23742,12331,11411
2010/10/1,臺南市,官田區,7605,22296,11412,10884
2010/10/1,臺南市,大內區,4077,10915,5809,5106
2010/10/1,臺南市,西港區,7802,25216,12848,12368
2010/10/1,臺南市,七股區,8001,24821,12976,11845
2010/10/1,臺南市,將軍區,7439,21650,10999,10651
2010/10/1,臺南市,北門區,4378,12475,6352,6123
2010/10/1,臺南市,新市區,10720,34794,17498,17296
2010/10/1,臺南市,安定區,9288,30258,15674,14584
2010/10/1,臺南市,山上區,2716,7890,4151,3739
2010/10/1,臺南市,玉井區,5082,15438,8004,7434
2010/10/1,臺南市,楠西區,3580,10667,5653,5014
2010/10/1,臺南市,南化區,2824,8923,4882,4041
2010/10/1,臺南市,左鎮區,1979,5507,3053,2454
2010/10/1,臺南市,仁德區,24653,69228,35618,33610
2010/10/1,臺南市,歸仁區,20461,65821,33619,32202
2010/10/1,臺南市,關廟區,10696,36050,18692,17358
2010/10/1,臺南市,龍崎區,1602,4393,2380,2013
2010/10/1,高雄市,鳳山區,126654,340791,169924,170867
2010/10/1,高雄市,岡山區,33141,97111,48768,48343
2010/10/1,高雄市,旗山區,13792,39930,20828,19102
2010/10/1,高雄市,美濃區,14118,43074,22490,20584
2010/10/1,高雄市,林園區,24062,70506,36201,34305
2010/10/1,高雄市,大寮區,38159,108936,56594,52342
2010/10/1,高雄市,大樹區,13033,44051,22776,21275
2010/10/1,高雄市,仁武區,25749,71852,37087,34765
2010/10/1,高雄市,大社區,11646,32897,16915,15982
2010/10/1,高雄市,鳥松區,16481,42503,21621,20882
2010/10/1,高雄市,橋頭區,12537,36345,18627,17718
2010/10/1,高雄市,燕巢區,9978,30875,16473,14402
2010/10/1,高雄市,田寮區,3555,8236,4572,3664
2010/10/1,高雄市,阿蓮區,9135,30393,15348,15045
2010/10/1,高雄市,路竹區,16026,53858,27473,26385
2010/10/1,高雄市,湖內區,9519,28820,14857,13963
2010/10/1,高雄市,茄萣區,10121,31501,16423,15078
2010/10/1,高雄市,永安區,5831,14272,7276,6996
2010/10/1,高雄市,彌陀區,6573,20460,10643,9817
2010/10/1,高雄市,梓官區,12023,36780,19094,17686
2010/10/1,高雄市,六龜區,5769,14880,8058,6822
2010/10/1,高雄市,甲仙區,2512,7268,3900,3368
2010/10/1,高雄市,杉林區,4360,11846,6459,5387
2010/10/1,高雄市,內門區,5020,15991,8719,7272
2010/10/1,高雄市,茂林區,573,1865,938,927
2010/10/1,高雄市,桃源區,1362,4814,2557,2257
2010/10/1,高雄市,那瑪夏區,884,3418,1772,1646
2010/10/1,屏東縣,屏東市,72050,211350,105496,105854
2010/10/1,屏東縣,潮州鎮,18107,55464,27920,27544
2010/10/1,屏東縣,東港鎮,15712,50241,25450,24791
2010/10/1,屏東縣,恆春鎮,10764,31201,16028,15173
2010/10/1,屏東縣,萬丹鄉,14273,54019,27933,26086
2010/10/1,屏東縣,長治鄉,9706,30947,16170,14777
2010/10/1,屏東縣,麟洛鄉,3608,11555,5998,5557
2010/10/1,屏東縣,九如鄉,6557,22872,11904,10968
2010/10/1,屏東縣,里港鄉,7845,25987,13324,12663
2010/10/1,屏東縣,鹽埔鄉,7695,27331,14191,13140
2010/10/1,屏東縣,高樹鄉,9543,26835,14334,12501
2010/10/1,屏東縣,萬巒鄉,6414,22000,11592,10408
2010/10/1,屏東縣,內埔鄉,17727,58087,30201,27886
2010/10/1,屏東縣,竹田鄉,5531,18404,9772,8632
2010/10/1,屏東縣,新埤鄉,3355,10743,5705,5038
2010/10/1,屏東縣,枋寮鄉,8472,26673,14039,12634
2010/10/1,屏東縣,新園鄉,11469,38359,19831,18528
2010/10/1,屏東縣,崁頂鄉,4222,17399,8891,8508
2010/10/1,屏東縣,林邊鄉,7182,20904,10786,10118
2010/10/1,屏東縣,南州鄉,3675,11717,6019,5698
2010/10/1,屏東縣,佳冬鄉,7154,21433,11171,10262
2010/10/1,屏東縣,琉球鄉,3972,12336,6850,5486
2010/10/1,屏東縣,車城鄉,3513,9657,5223,4434
2010/10/1,屏東縣,滿州鄉,3044,8479,4661,3818
2010/10/1,屏東縣,枋山鄉,2083,6068,3251,2817
2010/10/1,屏東縣,三地門鄉,2169,7557,3866,3691
2010/10/1,屏東縣,霧臺鄉,977,2968,1566,1402
2010/10/1,屏東縣,瑪家鄉,1887,6548,3410,3138
2010/10/1,屏東縣,泰武鄉,1232,5112,2680,2432
2010/10/1,屏東縣,來義鄉,2159,7765,3995,3770
2010/10/1,屏東縣,春日鄉,1324,4814,2504,2310
2010/10/1,屏東縣,獅子鄉,1465,4887,2564,2323
2010/10/1,屏東縣,牡丹鄉,1874,4984,2593,2391
2010/10/1,臺東縣,臺東市,37956,108940,55260,53680
2010/10/1,臺東縣,成功鎮,5427,15825,8446,7379
2010/10/1,臺東縣,關山鎮,3229,9733,5096,4637
2010/10/1,臺東縣,卑南鄉,6587,18251,9884,8367
2010/10/1,臺東縣,大武鄉,2536,7028,3668,3360
2010/10/1,臺東縣,太麻里鄉,4526,12033,6438,5595
2010/10/1,臺東縣,東河鄉,3546,9359,5194,4165
2010/10/1,臺東縣,長濱鄉,2933,8288,4722,3566
2010/10/1,臺東縣,鹿野鄉,3140,8606,4651,3955
2010/10/1,臺東縣,池上鄉,3256,9210,4874,4336
2010/10/1,臺東縣,綠島鄉,994,3352,1803,1549
2010/10/1,臺東縣,延平鄉,1067,3604,1983,1621
2010/10/1,臺東縣,海端鄉,1094,4498,2447,2051
2010/10/1,臺東縣,達仁鄉,1504,4086,2230,1856
2010/10/1,臺東縣,金峰鄉,1048,3572,1855,1717
2010/10/1,臺東縣,蘭嶼鄉,1430,4447,2303,2144
2010/10/1,花蓮縣,花蓮市,40476,109318,53621,55697
2010/10/1,花蓮縣,鳳林鎮,4459,12007,6341,5666
2010/10/1,花蓮縣,玉里鎮,8914,26935,14598,12337
2010/10/1,花蓮縣,新城鄉,7275,20180,10486,9694
2010/10/1,花蓮縣,吉安鄉,28920,79606,40756,38850
2010/10/1,花蓮縣,壽豐鄉,6834,18698,10135,8563
2010/10/1,花蓮縣,光復鄉,5037,14177,7576,6601
2010/10/1,花蓮縣,豐濱鄉,1812,5087,2820,2267
2010/10/1,花蓮縣,瑞穗鄉,4640,12915,6949,5966
2010/10/1,花蓮縣,富里鄉,4008,11692,6397,5295
2010/10/1,花蓮縣,秀林鄉,4668,15261,7934,7327
2010/10/1,花蓮縣,萬榮鄉,2144,6851,3667,3184
2010/10/1,花蓮縣,卓溪鄉,1661,6365,3543,2822
2010/10/1,澎湖縣,馬公市,20107,56863,28802,28061
2010/10/1,澎湖縣,湖西鄉,4752,13657,7113,6544
2010/10/1,澎湖縣,白沙鄉,3157,9471,4971,4500
2010/10/1,澎湖縣,西嶼鄉,2855,8423,4371,4052
2010/10/1,澎湖縣,望安鄉,1905,4753,2560,2193
2010/10/1,澎湖縣,七美鄉,1238,3544,1864,1680
2010/10/1,基隆市,中正區,22084,55390,28390,27000
2010/10/1,基隆市,七堵區,20072,55223,27989,27234
2010/10/1,基隆市,暖暖區,14333,37943,19252,18691
2010/10/1,基隆市,仁愛區,19741,49673,24521,25152
2010/10/1,基隆市,中山區,19053,50915,26020,24895
2010/10/1,基隆市,安樂區,31791,84155,41928,42227
2010/10/1,基隆市,信義區,20073,51291,25730,25561
2010/10/1,新竹市,東區,68335,196921,97222,99699
2010/10/1,新竹市,北區,50512,145273,71764,73509
2010/10/1,新竹市,香山區,22904,72488,36983,35505
2010/10/1,臺中市,中區,8392,22657,11188,11469
2010/10/1,臺中市,東區,25827,73957,37371,36586
2010/10/1,臺中市,西區,43289,117515,56438,61077
2010/10/1,臺中市,南區,42016,113484,55022,58462
2010/10/1,臺中市,北區,55753,147676,71561,76115
2010/10/1,臺中市,西屯區,72912,206274,100098,106176
2010/10/1,臺中市,南屯區,53102,153454,74173,79281
2010/10/1,臺中市,北屯區,83367,246470,119782,126688
2010/10/1,嘉義市,東區,44119,125369,61240,64129
2010/10/1,嘉義市,西區,50947,147154,72892,74262
2010/10/1,臺南市,東區,70801,194067,93878,100189
2010/10/1,臺南市,南區,43282,126256,63335,62921
2010/10/1,臺南市,北區,48120,131878,65109,66769
2010/10/1,臺南市,安南區,54416,177945,90508,87437
2010/10/1,臺南市,安平區,23111,62480,29948,32532
2010/10/1,臺南市,中西區,30166,79316,39004,40312
2010/10/1,臺北市,松山區,77871,207977,98676,109301
2010/10/1,臺北市,信義區,85853,224560,108208,116352
2010/10/1,臺北市,大安區,116824,311028,146408,164620
2010/10/1,臺北市,中山區,91737,219641,103492,116149
2010/10/1,臺北市,中正區,62282,159350,76892,82458
2010/10/1,臺北市,大同區,47253,124250,61218,63032
2010/10/1,臺北市,萬華區,74091,188557,94007,94550
2010/10/1,臺北市,文山區,97108,261799,126849,134950
2010/10/1,臺北市,南港區,41751,113806,56033,57773
2010/10/1,臺北市,內湖區,96734,269460,129927,139533
2010/10/1,臺北市,士林區,100711,284087,138069,146018
2010/10/1,臺北市,北投區,89602,248556,120606,127950
2010/10/1,高雄市,鹽埕區,11184,27448,13783,13665
2010/10/1,高雄市,鼓山區,52140,131423,64468,66955
2010/10/1,高雄市,左營區,73654,191528,94310,97218
2010/10/1,高雄市,楠梓區,61788,172852,85724,87128
2010/10/1,高雄市,三民區,131565,354161,173406,180755
2010/10/1,高雄市,新興區,22962,55407,27019,28388
2010/10/1,高雄市,前金區,12543,28962,14127,14835
2010/10/1,高雄市,苓雅區,71871,184180,89702,94478
2010/10/1,高雄市,前鎮區,76482,199463,99073,100390
2010/10/1,高雄市,旗津區,10951,29965,15576,14389
2010/10/1,高雄市,小港區,62989,154330,77561,76769
2010/10/1,金門縣,金城鎮,10890,32170,16468,15702
2010/10/1,金門縣,金湖鎮,7247,21156,10902,10254
2010/10/1,金門縣,金沙鎮,5326,15229,7756,7473
2010/10/1,金門縣,金寧鄉,6164,18671,9652,9019
2010/10/1,金門縣,烈嶼鄉,2600,8868,4488,4380
2010/10/1,金門縣,烏坵鄉,135,528,265,263
2010/10/1,連江縣,南竿鄉,1204,5904,3401,2503
2010/10/1,連江縣,北竿鄉,381,1793,1032,761
2010/10/1,連江縣,莒光鄉,240,1182,702,480
2010/10/1,連江縣,東引鄉,275,1052,614,438
2010/11/1,總計,臺灣地區,7894141,23050253,11579246,11471007
2010/11/1,總計,臺灣省,6323434,18904458,9563154,9341304
2010/11/1,總計,新北市,1403596,3896316,1935576,1960740
2010/11/1,總計,宜蘭縣,153883,460558,234742,225816
2010/11/1,總計,桃園市,672791,2001455,1009142,992313
2010/11/1,總計,新竹縣,160959,512541,263846,248695
2010/11/1,總計,苗栗縣,172546,560795,291157,269638
2010/11/1,總計,臺中市,466690,1565499,793166,772333
2010/11/1,總計,彰化縣,363151,1307465,670960,636505
2010/11/1,總計,南投縣,170532,526732,271161,255571
2010/11/1,總計,雲林縣,229472,717763,374828,342935
2010/11/1,總計,嘉義縣,176276,543552,283482,260070
2010/11/1,總計,臺南市,369488,1101853,562380,539473
2010/11/1,總計,高雄市,432950,1243410,636331,607079
2010/11/1,總計,屏東縣,276814,874081,449592,424489
2010/11/1,總計,臺東縣,80338,230729,120805,109924
2010/11/1,總計,花蓮縣,120865,338961,174689,164272
2010/11/1,總計,澎湖縣,34107,96797,49717,47080
2010/11/1,總計,基隆市,147139,384296,193664,190632
2010/11/1,總計,新竹市,141831,415004,206101,208903
2010/11/1,總計,臺中市,384953,1082163,525916,556247
2010/11/1,總計,嘉義市,95071,272422,134069,138353
2010/11/1,總計,臺南市,269982,772066,381830,390236
2010/11/1,總計,臺北市,982268,2615613,1261255,1354358
2010/11/1,總計,高雄市,588439,1530182,754837,775345
2010/11/1,總計,福建省,34522,106925,55456,51469
2010/11/1,總計,金門縣,32419,96981,49708,47273
2010/11/1,總計,連江縣,2103,9944,5748,4196
2010/11/1,新北市,板橋區,194403,554697,274539,280158
2010/11/1,新北市,三重區,140019,390099,194499,195600
2010/11/1,新北市,永和區,89549,234762,112686,122076
2010/11/1,新北市,中和區,155371,414488,204861,209627
2010/11/1,新北市,新莊區,136602,402221,198817,203404
2010/11/1,新北市,新店區,116373,296253,145163,151090
2010/11/1,新北市,土城區,81964,238580,119345,119235
2010/11/1,新北市,蘆洲區,65367,197795,98042,99753
2010/11/1,新北市,汐止區,79203,189508,94179,95329
2010/11/1,新北市,樹林區,59466,175598,88535,87063
2010/11/1,新北市,鶯歌區,27439,86742,43905,42837
2010/11/1,新北市,三峽區,35400,103208,52694,50514
2010/11/1,新北市,淡水區,57351,143439,69844,73595
2010/11/1,新北市,瑞芳區,15826,42503,21741,20762
2010/11/1,新北市,五股區,27323,79873,40562,39311
2010/11/1,新北市,泰山區,26112,76493,38440,38053
2010/11/1,新北市,林口區,30354,82801,40939,41862
2010/11/1,新北市,深坑區,8761,23252,11719,11533
2010/11/1,新北市,石碇區,3316,7963,4455,3508
2010/11/1,新北市,坪林區,2434,6540,3649,2891
2010/11/1,新北市,三芝區,8841,23284,12062,11222
2010/11/1,新北市,石門區,3985,12492,6585,5907
2010/11/1,新北市,八里區,12174,34680,17601,17079
2010/11/1,新北市,平溪區,2392,5368,2993,2375
2010/11/1,新北市,雙溪區,3810,9755,5284,4471
2010/11/1,新北市,貢寮區,4387,13775,7099,6676
2010/11/1,新北市,金山區,6686,22360,11241,11119
2010/11/1,新北市,萬里區,6996,22000,11167,10833
2010/11/1,新北市,烏來區,1692,5787,2930,2857
2010/11/1,宜蘭縣,宜蘭市,33121,95585,47063,48522
2010/11/1,宜蘭縣,羅東鎮,24870,72934,35057,37877
2010/11/1,宜蘭縣,蘇澳鎮,13609,43025,22073,20952
2010/11/1,宜蘭縣,頭城鎮,9688,30930,15980,14950
2010/11/1,宜蘭縣,礁溪鄉,12348,35875,18792,17083
2010/11/1,宜蘭縣,壯圍鄉,8123,25030,13192,11838
2010/11/1,宜蘭縣,員山鄉,10758,32335,17315,15020
2010/11/1,宜蘭縣,冬山鄉,17322,52574,27067,25507
2010/11/1,宜蘭縣,五結鄉,12961,38892,20199,18693
2010/11/1,宜蘭縣,三星鄉,7450,21374,11549,9825
2010/11/1,宜蘭縣,大同鄉,1828,5994,3269,2725
2010/11/1,宜蘭縣,南澳鄉,1805,6010,3186,2824
2010/11/1,桃園市,桃園區,143677,406525,199192,207333
2010/11/1,桃園市,中壢區,126913,369624,184541,185083
2010/11/1,桃園市,平鎮區,66649,207414,104436,102978
2010/11/1,桃園市,八德區,58220,177040,90104,86936
2010/11/1,桃園市,楊梅區,48692,150884,76730,74154
2010/11/1,桃園市,大溪區,29244,92034,47465,44569
2010/11/1,桃園市,蘆竹區,48147,141904,71146,70758
2010/11/1,桃園市,大園區,26130,81945,42564,39381
2010/11/1,桃園市,龜山區,50274,138039,70036,68003
2010/11/1,桃園市,龍潭區,36977,115229,58487,56742
2010/11/1,桃園市,新屋區,14971,49126,26281,22845
2010/11/1,桃園市,觀音區,19186,61015,32174,28841
2010/11/1,桃園市,復興區,3711,10676,5986,4690
2010/11/1,新竹縣,竹北市,46768,141478,70964,70514
2010/11/1,新竹縣,關西鎮,9231,31780,16923,14857
2010/11/1,新竹縣,新埔鎮,10325,35529,18840,16689
2010/11/1,新竹縣,竹東鎮,30626,96819,48805,48014
2010/11/1,新竹縣,湖口鄉,23378,75347,38540,36807
2010/11/1,新竹縣,橫山鄉,4415,14377,7783,6594
2010/11/1,新竹縣,新豐鄉,15725,53219,27468,25751
2010/11/1,新竹縣,芎林鄉,6292,20781,10949,9832
2010/11/1,新竹縣,寶山鄉,4688,14084,7608,6476
2010/11/1,新竹縣,北埔鄉,3094,10131,5507,4624
2010/11/1,新竹縣,峨眉鄉,2016,5999,3318,2681
2010/11/1,新竹縣,尖石鄉,2679,8321,4557,3764
2010/11/1,新竹縣,五峰鄉,1722,4676,2584,2092
2010/11/1,苗栗縣,苗栗市,29149,90642,45690,44952
2010/11/1,苗栗縣,苑裡鎮,13826,48631,25406,23225
2010/11/1,苗栗縣,通霄鎮,11323,37995,20176,17819
2010/11/1,苗栗縣,竹南鎮,24110,78333,39800,38533
2010/11/1,苗栗縣,頭份市,29552,97058,49342,47716
2010/11/1,苗栗縣,後龍鎮,11678,39405,20841,18564
2010/11/1,苗栗縣,卓蘭鎮,5963,18443,9726,8717
2010/11/1,苗栗縣,大湖鄉,5311,16046,8569,7477
2010/11/1,苗栗縣,公館鄉,10189,34750,18248,16502
2010/11/1,苗栗縣,銅鑼鄉,5975,19430,10294,9136
2010/11/1,苗栗縣,南庄鄉,3990,11120,6139,4981
2010/11/1,苗栗縣,頭屋鄉,3520,11595,6134,5461
2010/11/1,苗栗縣,三義鄉,5268,17541,9230,8311
2010/11/1,苗栗縣,西湖鄉,2673,7873,4365,3508
2010/11/1,苗栗縣,造橋鄉,4008,13738,7239,6499
2010/11/1,苗栗縣,三灣鄉,2382,7274,3961,3313
2010/11/1,苗栗縣,獅潭鄉,1691,4933,2746,2187
2010/11/1,苗栗縣,泰安鄉,1938,5988,3251,2737
2010/11/1,臺中市,豐原區,49705,165465,82208,83257
2010/11/1,臺中市,大里區,61564,197460,98019,99441
2010/11/1,臺中市,太平區,54668,172884,86797,86087
2010/11/1,臺中市,東勢區,16954,53287,27646,25641
2010/11/1,臺中市,大甲區,21629,78414,39804,38610
2010/11/1,臺中市,清水區,24933,85613,44184,41429
2010/11/1,臺中市,沙鹿區,23753,81512,41532,39980
2010/11/1,臺中市,梧棲區,15965,55239,28059,27180
2010/11/1,臺中市,后里區,14791,54294,27891,26403
2010/11/1,臺中市,神岡區,17641,63801,32850,30951
2010/11/1,臺中市,潭子區,32417,100324,50028,50296
2010/11/1,臺中市,大雅區,26289,89808,45265,44543
2010/11/1,臺中市,新社區,7343,25636,13431,12205
2010/11/1,臺中市,石岡區,4844,15989,8319,7670
2010/11/1,臺中市,外埔區,8835,32046,16481,15565
2010/11/1,臺中市,大安區,5248,20323,10679,9644
2010/11/1,臺中市,烏日區,20461,68669,34783,33886
2010/11/1,臺中市,大肚區,15849,55752,28613,27139
2010/11/1,臺中市,龍井區,20625,74272,37791,36481
2010/11/1,臺中市,霧峰區,18738,63956,32928,31028
2010/11/1,臺中市,和平區,4438,10755,5858,4897
2010/11/1,彰化縣,彰化市,71725,236482,117795,118687
2010/11/1,彰化縣,鹿港鎮,22284,85296,43724,41572
2010/11/1,彰化縣,和美鎮,24031,89689,45978,43711
2010/11/1,彰化縣,北斗鎮,9920,33526,16980,16546
2010/11/1,彰化縣,員林市,36699,125430,63019,62411
2010/11/1,彰化縣,溪湖鎮,15084,56098,28663,27435
2010/11/1,彰化縣,田中鎮,12518,44081,22908,21173
2010/11/1,彰化縣,二林鎮,14291,54001,27888,26113
2010/11/1,彰化縣,線西鄉,4140,17150,8811,8339
2010/11/1,彰化縣,伸港鄉,8961,35931,18468,17463
2010/11/1,彰化縣,福興鄉,12067,48975,25618,23357
2010/11/1,彰化縣,秀水鄉,9740,39107,20252,18855
2010/11/1,彰化縣,花壇鄉,12977,46212,23826,22386
2010/11/1,彰化縣,芬園鄉,6889,24848,13201,11647
2010/11/1,彰化縣,大村鄉,10238,36635,19097,17538
2010/11/1,彰化縣,埔鹽鄉,8801,34313,17994,16319
2010/11/1,彰化縣,埔心鄉,9917,35331,18323,17008
2010/11/1,彰化縣,永靖鄉,10412,39301,20358,18943
2010/11/1,彰化縣,社頭鄉,12298,44778,23015,21763
2010/11/1,彰化縣,二水鄉,5305,16531,8683,7848
2010/11/1,彰化縣,田尾鄉,7678,28657,14945,13712
2010/11/1,彰化縣,埤頭鄉,8572,31769,16577,15192
2010/11/1,彰化縣,芳苑鄉,9954,36305,19227,17078
2010/11/1,彰化縣,大城鄉,5391,18951,10282,8669
2010/11/1,彰化縣,竹塘鄉,4588,16475,8667,7808
2010/11/1,彰化縣,溪州鄉,8671,31593,16661,14932
2010/11/1,南投縣,南投市,33259,104137,52380,51757
2010/11/1,南投縣,埔里鎮,28287,85133,42972,42161
2010/11/1,南投縣,草屯鎮,30868,99716,50412,49304
2010/11/1,南投縣,竹山鎮,19013,58352,30112,28240
2010/11/1,南投縣,集集鎮,4285,11938,6271,5667
2010/11/1,南投縣,名間鄉,12097,41227,21642,19585
2010/11/1,南投縣,鹿谷鄉,6719,19132,10164,8968
2010/11/1,南投縣,中寮鄉,5615,16202,8807,7395
2010/11/1,南投縣,魚池鄉,5789,17188,9067,8121
2010/11/1,南投縣,國姓鄉,7222,20699,11285,9414
2010/11/1,南投縣,水里鄉,7223,20069,10522,9547
2010/11/1,南投縣,信義鄉,5225,17307,9361,7946
2010/11/1,南投縣,仁愛鄉,4930,15632,8166,7466
2010/11/1,雲林縣,斗六市,34748,106820,53713,53107
2010/11/1,雲林縣,斗南鎮,15230,47139,23964,23175
2010/11/1,雲林縣,虎尾鎮,22471,70011,35641,34370
2010/11/1,雲林縣,西螺鎮,13971,48505,24667,23838
2010/11/1,雲林縣,土庫鎮,8725,30515,15949,14566
2010/11/1,雲林縣,北港鎮,15317,43089,22420,20669
2010/11/1,雲林縣,古坑鄉,10659,34084,18045,16039
2010/11/1,雲林縣,大埤鄉,6630,21224,11374,9850
2010/11/1,雲林縣,莿桐鄉,9009,30496,15986,14510
2010/11/1,雲林縣,林內鄉,5750,19736,10304,9432
2010/11/1,雲林縣,二崙鄉,8782,29706,15915,13791
2010/11/1,雲林縣,崙背鄉,8315,27401,14443,12958
2010/11/1,雲林縣,麥寮鄉,12515,36771,19221,17550
2010/11/1,雲林縣,東勢鄉,5705,16796,9147,7649
2010/11/1,雲林縣,褒忠鄉,4304,14282,7607,6675
2010/11/1,雲林縣,臺西鄉,8946,26255,14117,12138
2010/11/1,雲林縣,元長鄉,9326,28817,15684,13133
2010/11/1,雲林縣,四湖鄉,9068,26740,14588,12152
2010/11/1,雲林縣,口湖鄉,9626,30389,16199,14190
2010/11/1,雲林縣,水林鄉,10375,28987,15844,13143
2010/11/1,嘉義縣,太保市,11276,36636,18886,17750
2010/11/1,嘉義縣,朴子市,14602,44117,22523,21594
2010/11/1,嘉義縣,布袋鎮,10151,30269,15525,14744
2010/11/1,嘉義縣,大林鎮,11215,33663,17275,16388
2010/11/1,嘉義縣,民雄鄉,22777,72529,37255,35274
2010/11/1,嘉義縣,溪口鄉,5385,16301,8686,7615
2010/11/1,嘉義縣,新港鄉,10392,34708,18323,16385
2010/11/1,嘉義縣,六腳鄉,9154,26404,13980,12424
2010/11/1,嘉義縣,東石鄉,9504,27756,14760,12996
2010/11/1,嘉義縣,義竹鄉,7472,21159,10951,10208
2010/11/1,嘉義縣,鹿草鄉,5735,17266,9285,7981
2010/11/1,嘉義縣,水上鄉,17404,52313,27017,25296
2010/11/1,嘉義縣,中埔鄉,15278,47567,24809,22758
2010/11/1,嘉義縣,竹崎鄉,11295,38548,20505,18043
2010/11/1,嘉義縣,梅山鄉,6661,21727,11524,10203
2010/11/1,嘉義縣,番路鄉,3952,11711,6386,5325
2010/11/1,嘉義縣,大埔鄉,1963,4649,2448,2201
2010/11/1,嘉義縣,阿里山鄉,2060,6229,3344,2885
2010/11/1,臺南市,新營區,27166,78020,38977,39043
2010/11/1,臺南市,永康區,74836,216597,107741,108856
2010/11/1,臺南市,鹽水區,9938,27192,14170,13022
2010/11/1,臺南市,白河區,10957,31449,16489,14960
2010/11/1,臺南市,麻豆區,15074,45833,23452,22381
2010/11/1,臺南市,佳里區,19314,59290,29519,29771
2010/11/1,臺南市,新化區,13688,44101,22593,21508
2010/11/1,臺南市,善化區,14537,43443,21989,21454
2010/11/1,臺南市,學甲區,9533,27892,14247,13645
2010/11/1,臺南市,柳營區,7795,22761,11900,10861
2010/11/1,臺南市,後壁區,8780,25945,13538,12407
2010/11/1,臺南市,東山區,8206,23124,12314,10810
2010/11/1,臺南市,下營區,9101,26158,13553,12605
2010/11/1,臺南市,六甲區,7610,23733,12319,11414
2010/11/1,臺南市,官田區,7610,22295,11410,10885
2010/11/1,臺南市,大內區,4074,10911,5815,5096
2010/11/1,臺南市,西港區,7802,25232,12848,12384
2010/11/1,臺南市,七股區,8010,24810,12966,11844
2010/11/1,臺南市,將軍區,7436,21613,10986,10627
2010/11/1,臺南市,北門區,4386,12490,6363,6127
2010/11/1,臺南市,新市區,10729,34771,17495,17276
2010/11/1,臺南市,安定區,9295,30262,15678,14584
2010/11/1,臺南市,山上區,2715,7880,4143,3737
2010/11/1,臺南市,玉井區,5079,15421,7994,7427
2010/11/1,臺南市,楠西區,3578,10670,5654,5016
2010/11/1,臺南市,南化區,2827,8929,4885,4044
2010/11/1,臺南市,左鎮區,1980,5499,3048,2451
2010/11/1,臺南市,仁德區,24664,69282,35632,33650
2010/11/1,臺南市,歸仁區,20460,65806,33592,32214
2010/11/1,臺南市,關廟區,10706,36052,18694,17358
2010/11/1,臺南市,龍崎區,1602,4392,2376,2016
2010/11/1,高雄市,鳳山區,126726,340898,169942,170956
2010/11/1,高雄市,岡山區,33145,97100,48769,48331
2010/11/1,高雄市,旗山區,13790,39884,20804,19080
2010/11/1,高雄市,美濃區,14130,43081,22483,20598
2010/11/1,高雄市,林園區,24078,70506,36198,34308
2010/11/1,高雄市,大寮區,38220,108981,56622,52359
2010/11/1,高雄市,大樹區,13040,44017,22755,21262
2010/11/1,高雄市,仁武區,25825,71955,37129,34826
2010/11/1,高雄市,大社區,11675,32921,16921,16000
2010/11/1,高雄市,鳥松區,16474,42506,21611,20895
2010/11/1,高雄市,橋頭區,12557,36402,18655,17747
2010/11/1,高雄市,燕巢區,9960,30814,16432,14382
2010/11/1,高雄市,田寮區,3553,8233,4570,3663
2010/11/1,高雄市,阿蓮區,9131,30396,15340,15056
2010/11/1,高雄市,路竹區,16022,53833,27456,26377
2010/11/1,高雄市,湖內區,9533,28845,14863,13982
2010/11/1,高雄市,茄萣區,10136,31475,16400,15075
2010/11/1,高雄市,永安區,5838,14285,7277,7008
2010/11/1,高雄市,彌陀區,6582,20453,10631,9822
2010/11/1,高雄市,梓官區,12044,36758,19075,17683
2010/11/1,高雄市,六龜區,5772,14867,8051,6816
2010/11/1,高雄市,甲仙區,2513,7271,3902,3369
2010/11/1,高雄市,杉林區,4363,11842,6453,5389
2010/11/1,高雄市,內門區,5028,15999,8728,7271
2010/11/1,高雄市,茂林區,573,1874,942,932
2010/11/1,高雄市,桃源區,1358,4804,2552,2252
2010/11/1,高雄市,那瑪夏區,884,3410,1770,1640
2010/11/1,屏東縣,屏東市,71996,211183,105400,105783
2010/11/1,屏東縣,潮州鎮,18122,55424,27894,27530
2010/11/1,屏東縣,東港鎮,15724,50190,25425,24765
2010/11/1,屏東縣,恆春鎮,10770,31195,16024,15171
2010/11/1,屏東縣,萬丹鄉,14296,54011,27936,26075
2010/11/1,屏東縣,長治鄉,9714,30940,16157,14783
2010/11/1,屏東縣,麟洛鄉,3609,11541,5991,5550
2010/11/1,屏東縣,九如鄉,6562,22869,11905,10964
2010/11/1,屏東縣,里港鄉,7847,25958,13300,12658
2010/11/1,屏東縣,鹽埔鄉,7701,27324,14182,13142
2010/11/1,屏東縣,高樹鄉,9509,26816,14332,12484
2010/11/1,屏東縣,萬巒鄉,6418,21976,11587,10389
2010/11/1,屏東縣,內埔鄉,17719,57993,30151,27842
2010/11/1,屏東縣,竹田鄉,5555,18420,9793,8627
2010/11/1,屏東縣,新埤鄉,3356,10725,5693,5032
2010/11/1,屏東縣,枋寮鄉,8476,26637,14023,12614
2010/11/1,屏東縣,新園鄉,11482,38340,19825,18515
2010/11/1,屏東縣,崁頂鄉,4227,17379,8876,8503
2010/11/1,屏東縣,林邊鄉,7189,20881,10770,10111
2010/11/1,屏東縣,南州鄉,3671,11707,6012,5695
2010/11/1,屏東縣,佳冬鄉,7147,21402,11148,10254
2010/11/1,屏東縣,琉球鄉,3977,12324,6845,5479
2010/11/1,屏東縣,車城鄉,3518,9647,5216,4431
2010/11/1,屏東縣,滿州鄉,3045,8471,4663,3808
2010/11/1,屏東縣,枋山鄉,2093,6075,3254,2821
2010/11/1,屏東縣,三地門鄉,2171,7570,3874,3696
2010/11/1,屏東縣,霧臺鄉,979,2980,1574,1406
2010/11/1,屏東縣,瑪家鄉,1887,6552,3418,3134
2010/11/1,屏東縣,泰武鄉,1230,5105,2674,2431
2010/11/1,屏東縣,來義鄉,2159,7770,3994,3776
2010/11/1,屏東縣,春日鄉,1325,4815,2507,2308
2010/11/1,屏東縣,獅子鄉,1466,4881,2561,2320
2010/11/1,屏東縣,牡丹鄉,1874,4980,2588,2392
2010/11/1,臺東縣,臺東市,37971,108905,55229,53676
2010/11/1,臺東縣,成功鎮,5430,15807,8438,7369
2010/11/1,臺東縣,關山鎮,3232,9725,5093,4632
2010/11/1,臺東縣,卑南鄉,6595,18242,9874,8368
2010/11/1,臺東縣,大武鄉,2538,7015,3659,3356
2010/11/1,臺東縣,太麻里鄉,4529,12022,6422,5600
2010/11/1,臺東縣,東河鄉,3558,9340,5198,4142
2010/11/1,臺東縣,長濱鄉,2936,8291,4728,3563
2010/11/1,臺東縣,鹿野鄉,3152,8601,4657,3944
2010/11/1,臺東縣,池上鄉,3256,9203,4869,4334
2010/11/1,臺東縣,綠島鄉,996,3353,1806,1547
2010/11/1,臺東縣,延平鄉,1066,3601,1982,1619
2010/11/1,臺東縣,海端鄉,1093,4505,2449,2056
2010/11/1,臺東縣,達仁鄉,1504,4089,2233,1856
2010/11/1,臺東縣,金峰鄉,1047,3564,1852,1712
2010/11/1,臺東縣,蘭嶼鄉,1435,4466,2316,2150
2010/11/1,花蓮縣,花蓮市,40473,109305,53593,55712
2010/11/1,花蓮縣,鳳林鎮,4458,11956,6321,5635
2010/11/1,花蓮縣,玉里鎮,8913,26916,14584,12332
2010/11/1,花蓮縣,新城鄉,7272,20169,10481,9688
2010/11/1,花蓮縣,吉安鄉,28950,79678,40769,38909
2010/11/1,花蓮縣,壽豐鄉,6839,18669,10105,8564
2010/11/1,花蓮縣,光復鄉,5037,14147,7560,6587
2010/11/1,花蓮縣,豐濱鄉,1810,5073,2810,2263
2010/11/1,花蓮縣,瑞穗鄉,4641,12899,6945,5954
2010/11/1,花蓮縣,富里鄉,4007,11677,6387,5290
2010/11/1,花蓮縣,秀林鄉,4663,15252,7927,7325
2010/11/1,花蓮縣,萬榮鄉,2141,6857,3666,3191
2010/11/1,花蓮縣,卓溪鄉,1661,6363,3541,2822
2010/11/1,澎湖縣,馬公市,20187,56956,28848,28108
2010/11/1,澎湖縣,湖西鄉,4770,13647,7111,6536
2010/11/1,澎湖縣,白沙鄉,3153,9469,4971,4498
2010/11/1,澎湖縣,西嶼鄉,2855,8434,4372,4062
2010/11/1,澎湖縣,望安鄉,1903,4752,2556,2196
2010/11/1,澎湖縣,七美鄉,1239,3539,1859,1680
2010/11/1,基隆市,中正區,22074,55325,28338,26987
2010/11/1,基隆市,七堵區,20060,55181,27978,27203
2010/11/1,基隆市,暖暖區,14341,37941,19240,18701
2010/11/1,基隆市,仁愛區,19763,49639,24512,25127
2010/11/1,基隆市,中山區,19062,50877,25991,24886
2010/11/1,基隆市,安樂區,31779,84109,41898,42211
2010/11/1,基隆市,信義區,20060,51224,25707,25517
2010/11/1,新竹市,東區,68357,197057,97229,99828
2010/11/1,新竹市,北區,50536,145328,71818,73510
2010/11/1,新竹市,香山區,22938,72619,37054,35565
2010/11/1,臺中市,中區,8406,22639,11171,11468
2010/11/1,臺中市,東區,25823,73984,37375,36609
2010/11/1,臺中市,西區,43272,117413,56404,61009
2010/11/1,臺中市,南區,42098,113680,55091,58589
2010/11/1,臺中市,北區,55771,147704,71569,76135
2010/11/1,臺中市,西屯區,72978,206511,100204,106307
2010/11/1,臺中市,南屯區,53170,153643,74262,79381
2010/11/1,臺中市,北屯區,83435,246589,119840,126749
2010/11/1,嘉義市,東區,44100,125348,61225,64123
2010/11/1,嘉義市,西區,50971,147074,72844,74230
2010/11/1,臺南市,東區,70786,194068,93899,100169
2010/11/1,臺南市,南區,43327,126293,63348,62945
2010/11/1,臺南市,北區,48139,131939,65125,66814
2010/11/1,臺南市,安南區,54451,177960,90522,87438
2010/11/1,臺南市,安平區,23128,62520,29954,32566
2010/11/1,臺南市,中西區,30151,79286,38982,40304
2010/11/1,臺北市,松山區,77864,208128,98736,109392
2010/11/1,臺北市,信義區,85882,224883,108360,116523
2010/11/1,臺北市,大安區,116874,311340,146564,164776
2010/11/1,臺北市,中山區,91810,219821,103516,116305
2010/11/1,臺北市,中正區,62275,159415,76896,82519
2010/11/1,臺北市,大同區,47332,124419,61312,63107
2010/11/1,臺北市,萬華區,74152,188885,94116,94769
2010/11/1,臺北市,文山區,97056,261887,126830,135057
2010/11/1,臺北市,南港區,41785,113920,56059,57861
2010/11/1,臺北市,內湖區,96797,269748,130033,139715
2010/11/1,臺北市,士林區,100804,284369,138161,146208
2010/11/1,臺北市,北投區,89637,248798,120672,128126
2010/11/1,高雄市,鹽埕區,11173,27434,13756,13678
2010/11/1,高雄市,鼓山區,52185,131578,64520,67058
2010/11/1,高雄市,左營區,73729,191735,94391,97344
2010/11/1,高雄市,楠梓區,61838,172919,85747,87172
2010/11/1,高雄市,三民區,131591,354191,173412,180779
2010/11/1,高雄市,新興區,22970,55413,27005,28408
2010/11/1,高雄市,前金區,12546,28955,14115,14840
2010/11/1,高雄市,苓雅區,71874,184189,89691,94498
2010/11/1,高雄市,前鎮區,76523,199375,99031,100344
2010/11/1,高雄市,旗津區,10949,29969,15582,14387
2010/11/1,高雄市,小港區,63061,154424,77587,76837
2010/11/1,金門縣,金城鎮,10898,32209,16473,15736
2010/11/1,金門縣,金湖鎮,7274,21234,10943,10291
2010/11/1,金門縣,金沙鎮,5335,15266,7763,7503
2010/11/1,金門縣,金寧鄉,6170,18843,9760,9083
2010/11/1,金門縣,烈嶼鄉,2607,8891,4500,4391
2010/11/1,金門縣,烏坵鄉,135,538,269,269
2010/11/1,連江縣,南竿鄉,1208,5914,3400,2514
2010/11/1,連江縣,北竿鄉,381,1794,1031,763
2010/11/1,連江縣,莒光鄉,240,1183,703,480
2010/11/1,連江縣,東引鄉,274,1053,614,439
2010/12/1,總計,新北市,1405348,3897367,1935668,1961699
2010/12/1,總計,臺北市,983237,2618772,1262554,1356218
2010/12/1,總計,臺中市,852788,2648419,1319156,1329263
2010/12/1,總計,臺南市,640132,1873794,944044,929750
2010/12/1,總計,高雄市,1022493,2773483,1390927,1382556
2010/12/1,總計,臺灣省,2998442,9242980,4727261,4515719
2010/12/1,總計,宜蘭縣,154021,460486,234682,225804
2010/12/1,總計,桃園市,673477,2002060,1009274,992786
2010/12/1,總計,新竹縣,161237,513015,264014,249001
2010/12/1,總計,苗栗縣,172725,560968,291177,269791
2010/12/1,總計,彰化縣,363424,1307286,670812,636474
2010/12/1,總計,南投縣,170693,526491,271053,255438
2010/12/1,總計,雲林縣,229669,717653,374746,342907
2010/12/1,總計,嘉義縣,176398,543248,283284,259964
2010/12/1,總計,屏東縣,276889,873509,449267,424242
2010/12/1,總計,臺東縣,80411,230673,120747,109926
2010/12/1,總計,花蓮縣,120903,338805,174584,164221
2010/12/1,總計,澎湖縣,34199,96918,49769,47149
2010/12/1,總計,基隆市,147187,384134,193573,190561
2010/12/1,總計,新竹市,142057,415344,206243,209101
2010/12/1,總計,嘉義市,95152,272390,134036,138354
2010/12/1,總計,福建省,34584,107308,55615,51693
2010/12/1,總計,金門縣,32471,97364,49871,47493
2010/12/1,總計,連江縣,2113,9944,5744,4200
2010/12/1,新北市,板橋區,194540,554596,274411,280185
2010/12/1,新北市,三重區,140187,389968,194375,195593
2010/12/1,新北市,中和區,155413,414356,204719,209637
2010/12/1,新北市,永和區,89528,234536,112579,121957
2010/12/1,新北市,新莊區,136750,402204,198795,203409
2010/12/1,新北市,新店區,116470,296411,145175,151236
2010/12/1,新北市,樹林區,59705,176077,88764,87313
2010/12/1,新北市,鶯歌區,27445,86821,43932,42889
2010/12/1,新北市,三峽區,35521,103450,52805,50645
2010/12/1,新北市,淡水區,57463,143481,69841,73640
2010/12/1,新北市,汐止區,79292,189618,94220,95398
2010/12/1,新北市,瑞芳區,15847,42432,21700,20732
2010/12/1,新北市,土城區,81994,238477,119305,119172
2010/12/1,新北市,蘆洲區,65435,197793,98036,99757
2010/12/1,新北市,五股區,27351,79958,40570,39388
2010/12/1,新北市,泰山區,26141,76470,38447,38023
2010/12/1,新北市,林口區,30556,83165,41094,42071
2010/12/1,新北市,深坑區,8789,23241,11710,11531
2010/12/1,新北市,石碇區,3320,7973,4457,3516
2010/12/1,新北市,坪林區,2434,6537,3647,2890
2010/12/1,新北市,三芝區,8842,23263,12058,11205
2010/12/1,新北市,石門區,4061,12700,6680,6020
2010/12/1,新北市,八里區,12254,34791,17642,17149
2010/12/1,新北市,平溪區,2392,5344,2982,2362
2010/12/1,新北市,雙溪區,3820,9729,5277,4452
2010/12/1,新北市,貢寮區,4393,13776,7098,6678
2010/12/1,新北市,金山區,6695,22380,11247,11133
2010/12/1,新北市,萬里區,7021,22009,11164,10845
2010/12/1,新北市,烏來區,1689,5811,2938,2873
2010/12/1,臺北市,松山區,77919,208434,98868,109566
2010/12/1,臺北市,信義區,85909,225092,108402,116690
2010/12/1,臺北市,大安區,116919,311565,146662,164903
2010/12/1,臺北市,中山區,91897,220126,103598,116528
2010/12/1,臺北市,中正區,62272,159536,76957,82579
2010/12/1,臺北市,大同區,47413,124600,61398,63202
2010/12/1,臺北市,萬華區,74244,189099,94226,94873
2010/12/1,臺北市,文山區,97200,262307,127002,135305
2010/12/1,臺北市,南港區,41813,114023,56063,57960
2010/12/1,臺北市,內湖區,96969,270245,130289,139956
2010/12/1,臺北市,士林區,100928,284539,138216,146323
2010/12/1,臺北市,北投區,89754,249206,120873,128333
2010/12/1,臺中市,中區,8371,22472,11094,11378
2010/12/1,臺中市,東區,25842,73969,37333,36636
2010/12/1,臺中市,南區,42141,113659,55089,58570
2010/12/1,臺中市,西區,43291,117365,56370,60995
2010/12/1,臺中市,北區,55813,147639,71516,76123
2010/12/1,臺中市,西屯區,73079,206536,100144,106392
2010/12/1,臺中市,南屯區,53245,153779,74294,79485
2010/12/1,臺中市,北屯區,83620,246880,119948,126932
2010/12/1,臺中市,豐原區,49790,165433,82157,83276
2010/12/1,臺中市,東勢區,16975,53259,27640,25619
2010/12/1,臺中市,大甲區,21656,78387,39776,38611
2010/12/1,臺中市,清水區,24959,85620,44194,41426
2010/12/1,臺中市,沙鹿區,23807,81534,41536,39998
2010/12/1,臺中市,梧棲區,15978,55262,28057,27205
2010/12/1,臺中市,后里區,14818,54287,27881,26406
2010/12/1,臺中市,神岡區,17659,63753,32819,30934
2010/12/1,臺中市,潭子區,32500,100481,50108,50373
2010/12/1,臺中市,大雅區,26332,89825,45260,44565
2010/12/1,臺中市,新社區,7357,25637,13426,12211
2010/12/1,臺中市,石岡區,4846,15976,8316,7660
2010/12/1,臺中市,外埔區,8849,32051,16492,15559
2010/12/1,臺中市,大安區,5254,20308,10670,9638
2010/12/1,臺中市,烏日區,20501,68709,34806,33903
2010/12/1,臺中市,大肚區,15860,55725,28597,27128
2010/12/1,臺中市,龍井區,20678,74474,37892,36582
2010/12/1,臺中市,霧峰區,18750,63975,32926,31049
2010/12/1,臺中市,太平區,54697,172965,86816,86149
2010/12/1,臺中市,大里區,61684,197716,98144,99572
2010/12/1,臺中市,和平區,4436,10743,5855,4888
2010/12/1,臺南市,新營區,27200,78105,39014,39091
2010/12/1,臺南市,鹽水區,9942,27160,14157,13003
2010/12/1,臺南市,白河區,10963,31395,16470,14925
2010/12/1,臺南市,柳營區,7801,22726,11877,10849
2010/12/1,臺南市,後壁區,8792,25884,13496,12388
2010/12/1,臺南市,東山區,8218,23117,12307,10810
2010/12/1,臺南市,麻豆區,15074,45795,23436,22359
2010/12/1,臺南市,下營區,9108,26119,13528,12591
2010/12/1,臺南市,六甲區,7625,23694,12306,11388
2010/12/1,臺南市,官田區,7605,22212,11367,10845
2010/12/1,臺南市,大內區,4066,10899,5806,5093
2010/12/1,臺南市,佳里區,19341,59269,29507,29762
2010/12/1,臺南市,學甲區,9549,27864,14231,13633
2010/12/1,臺南市,西港區,7812,25200,12833,12367
2010/12/1,臺南市,七股區,8016,24815,12970,11845
2010/12/1,臺南市,將軍區,7444,21579,10964,10615
2010/12/1,臺南市,北門區,4382,12468,6351,6117
2010/12/1,臺南市,新化區,13683,44096,22590,21506
2010/12/1,臺南市,善化區,14562,43477,22002,21475
2010/12/1,臺南市,新市區,10729,34740,17483,17257
2010/12/1,臺南市,安定區,9306,30232,15667,14565
2010/12/1,臺南市,山上區,2711,7864,4130,3734
2010/12/1,臺南市,玉井區,5078,15413,7990,7423
2010/12/1,臺南市,楠西區,3578,10663,5646,5017
2010/12/1,臺南市,南化區,2828,8925,4880,4045
2010/12/1,臺南市,左鎮區,1984,5492,3041,2451
2010/12/1,臺南市,仁德區,24715,69343,35637,33706
2010/12/1,臺南市,歸仁區,20510,65819,33616,32203
2010/12/1,臺南市,關廟區,10721,36026,18690,17336
2010/12/1,臺南市,龍崎區,1601,4382,2366,2016
2010/12/1,臺南市,永康區,74942,216748,107783,108965
2010/12/1,臺南市,東區,70835,194183,93968,100215
2010/12/1,臺南市,南區,43344,126173,63286,62887
2010/12/1,臺南市,北區,48178,131925,65088,66837
2010/12/1,臺南市,安南區,54525,178119,90593,87526
2010/12/1,臺南市,安平區,23180,62602,29986,32616
2010/12/1,臺南市,中西區,30184,79271,38982,40289
2010/12/1,高雄市,鹽埕區,11165,27399,13739,13660
2010/12/1,高雄市,鼓山區,52259,131728,64565,67163
2010/12/1,高雄市,左營區,73869,191991,94513,97478
2010/12/1,高雄市,楠梓區,61898,173053,85821,87232
2010/12/1,高雄市,三民區,131687,354022,173311,180711
2010/12/1,高雄市,新興區,22935,55287,26926,28361
2010/12/1,高雄市,前金區,12535,28859,14066,14793
2010/12/1,高雄市,苓雅區,71812,183948,89553,94395
2010/12/1,高雄市,前鎮區,76509,199144,98885,100259
2010/12/1,高雄市,旗津區,10944,29968,15572,14396
2010/12/1,高雄市,小港區,63258,154548,77635,76913
2010/12/1,高雄市,鳳山區,126899,341120,170037,171083
2010/12/1,高雄市,林園區,24115,70512,36212,34300
2010/12/1,高雄市,大寮區,38277,108984,56600,52384
2010/12/1,高雄市,大樹區,13047,43955,22727,21228
2010/12/1,高雄市,大社區,11689,32941,16923,16018
2010/12/1,高雄市,仁武區,25961,72202,37262,34940
2010/12/1,高雄市,鳥松區,16509,42595,21647,20948
2010/12/1,高雄市,岡山區,33185,97102,48772,48330
2010/12/1,高雄市,橋頭區,12584,36415,18662,17753
2010/12/1,高雄市,燕巢區,9963,30790,16423,14367
2010/12/1,高雄市,田寮區,3558,8214,4569,3645
2010/12/1,高雄市,阿蓮區,9133,30383,15332,15051
2010/12/1,高雄市,路竹區,16041,53791,27418,26373
2010/12/1,高雄市,湖內區,9547,28827,14842,13985
2010/12/1,高雄市,茄萣區,10146,31433,16383,15050
2010/12/1,高雄市,永安區,5837,14301,7278,7023
2010/12/1,高雄市,彌陀區,6606,20433,10635,9798
2010/12/1,高雄市,梓官區,12055,36726,19063,17663
2010/12/1,高雄市,旗山區,13817,39873,20795,19078
2010/12/1,高雄市,美濃區,14154,42993,22438,20555
2010/12/1,高雄市,六龜區,5766,14833,8027,6806
2010/12/1,高雄市,甲仙區,2507,7228,3882,3346
2010/12/1,高雄市,杉林區,4380,11842,6452,5390
2010/12/1,高雄市,內門區,5027,15951,8695,7256
2010/12/1,高雄市,茂林區,574,1874,943,931
2010/12/1,高雄市,桃源區,1360,4817,2556,2261
2010/12/1,高雄市,那瑪夏區,885,3401,1768,1633
2010/12/1,宜蘭縣,宜蘭市,33135,95568,47036,48532
2010/12/1,宜蘭縣,羅東鎮,24893,72958,35058,37900
2010/12/1,宜蘭縣,蘇澳鎮,13616,42986,22041,20945
2010/12/1,宜蘭縣,頭城鎮,9700,30899,15966,14933
2010/12/1,宜蘭縣,礁溪鄉,12350,35876,18799,17077
2010/12/1,宜蘭縣,壯圍鄉,8125,25004,13176,11828
2010/12/1,宜蘭縣,員山鄉,10768,32347,17328,15019
2010/12/1,宜蘭縣,冬山鄉,17352,52635,27096,25539
2010/12/1,宜蘭縣,五結鄉,12978,38850,20167,18683
2010/12/1,宜蘭縣,三星鄉,7471,21362,11556,9806
2010/12/1,宜蘭縣,大同鄉,1826,5987,3268,2719
2010/12/1,宜蘭縣,南澳鄉,1807,6014,3191,2823
2010/12/1,桃園市,桃園區,143821,406851,199321,207530
2010/12/1,桃園市,中壢區,127110,369770,184649,185121
2010/12/1,桃園市,平鎮區,66723,207457,104445,103012
2010/12/1,桃園市,八德區,58258,176868,89957,86911
2010/12/1,桃園市,楊梅區,48756,150926,76705,74221
2010/12/1,桃園市,大溪區,29276,92081,47506,44575
2010/12/1,桃園市,蘆竹區,48225,142120,71248,70872
2010/12/1,桃園市,大園區,26168,81966,42550,39416
2010/12/1,桃園市,龜山區,50262,137996,69974,68022
2010/12/1,桃園市,龍潭區,36959,115166,58455,56711
2010/12/1,桃園市,新屋區,14970,49112,26266,22846
2010/12/1,桃園市,觀音區,19238,61077,32215,28862
2010/12/1,桃園市,復興區,3711,10670,5983,4687
2010/12/1,新竹縣,竹北市,46910,141852,71106,70746
2010/12/1,新竹縣,關西鎮,9243,31775,16913,14862
2010/12/1,新竹縣,新埔鎮,10333,35495,18828,16667
2010/12/1,新竹縣,竹東鎮,30648,96751,48786,47965
2010/12/1,新竹縣,湖口鄉,23431,75408,38571,36837
2010/12/1,新竹縣,橫山鄉,4423,14368,7778,6590
2010/12/1,新竹縣,新豐鄉,15747,53288,27486,25802
2010/12/1,新竹縣,芎林鄉,6292,20778,10954,9824
2010/12/1,新竹縣,寶山鄉,4696,14078,7600,6478
2010/12/1,新竹縣,北埔鄉,3088,10119,5495,4624
2010/12/1,新竹縣,峨眉鄉,2020,5999,3317,2682
2010/12/1,新竹縣,尖石鄉,2687,8439,4600,3839
2010/12/1,新竹縣,五峰鄉,1719,4665,2580,2085
2010/12/1,苗栗縣,苗栗市,29163,90703,45695,45008
2010/12/1,苗栗縣,苑裡鎮,13841,48645,25413,23232
2010/12/1,苗栗縣,通霄鎮,11333,37977,20161,17816
2010/12/1,苗栗縣,竹南鎮,24170,78420,39844,38576
2010/12/1,苗栗縣,頭份市,29589,97150,49361,47789
2010/12/1,苗栗縣,後龍鎮,11691,39389,20840,18549
2010/12/1,苗栗縣,卓蘭鎮,5971,18446,9718,8728
2010/12/1,苗栗縣,大湖鄉,5311,16052,8561,7491
2010/12/1,苗栗縣,公館鄉,10204,34745,18250,16495
2010/12/1,苗栗縣,銅鑼鄉,5968,19401,10281,9120
2010/12/1,苗栗縣,南庄鄉,3993,11117,6133,4984
2010/12/1,苗栗縣,頭屋鄉,3525,11605,6135,5470
2010/12/1,苗栗縣,三義鄉,5272,17548,9238,8310
2010/12/1,苗栗縣,西湖鄉,2671,7869,4364,3505
2010/12/1,苗栗縣,造橋鄉,4014,13727,7233,6494
2010/12/1,苗栗縣,三灣鄉,2383,7264,3956,3308
2010/12/1,苗栗縣,獅潭鄉,1689,4928,2745,2183
2010/12/1,苗栗縣,泰安鄉,1937,5982,3249,2733
2010/12/1,彰化縣,彰化市,71780,236503,117796,118707
2010/12/1,彰化縣,鹿港鎮,22306,85325,43742,41583
2010/12/1,彰化縣,和美鎮,24072,89723,45987,43736
2010/12/1,彰化縣,北斗鎮,9933,33516,16984,16532
2010/12/1,彰化縣,員林市,36722,125476,63043,62433
2010/12/1,彰化縣,溪湖鎮,15094,56119,28665,27454
2010/12/1,彰化縣,田中鎮,12527,44065,22902,21163
2010/12/1,彰化縣,二林鎮,14300,53939,27846,26093
2010/12/1,彰化縣,線西鄉,4140,17138,8811,8327
2010/12/1,彰化縣,伸港鄉,8974,35964,18486,17478
2010/12/1,彰化縣,福興鄉,12079,48945,25604,23341
2010/12/1,彰化縣,秀水鄉,9755,39122,20274,18848
2010/12/1,彰化縣,花壇鄉,12982,46187,23796,22391
2010/12/1,彰化縣,芬園鄉,6869,24814,13185,11629
2010/12/1,彰化縣,大村鄉,10248,36597,19072,17525
2010/12/1,彰化縣,埔鹽鄉,8803,34284,17978,16306
2010/12/1,彰化縣,埔心鄉,9925,35325,18305,17020
2010/12/1,彰化縣,永靖鄉,10412,39269,20346,18923
2010/12/1,彰化縣,社頭鄉,12298,44767,23003,21764
2010/12/1,彰化縣,二水鄉,5311,16520,8667,7853
2010/12/1,彰化縣,田尾鄉,7682,28639,14934,13705
2010/12/1,彰化縣,埤頭鄉,8593,31771,16577,15194
2010/12/1,彰化縣,芳苑鄉,9967,36320,19228,17092
2010/12/1,彰化縣,大城鄉,5395,18936,10278,8658
2010/12/1,彰化縣,竹塘鄉,4591,16470,8657,7813
2010/12/1,彰化縣,溪州鄉,8666,31552,16646,14906
2010/12/1,南投縣,南投市,33294,104083,52368,51715
2010/12/1,南投縣,埔里鎮,28296,85088,42964,42124
2010/12/1,南投縣,草屯鎮,30893,99674,50413,49261
2010/12/1,南投縣,竹山鎮,19042,58338,30094,28244
2010/12/1,南投縣,集集鎮,4289,11920,6263,5657
2010/12/1,南投縣,名間鄉,12113,41218,21627,19591
2010/12/1,南投縣,鹿谷鄉,6745,19100,10147,8953
2010/12/1,南投縣,中寮鄉,5623,16183,8799,7384
2010/12/1,南投縣,魚池鄉,5794,17181,9060,8121
2010/12/1,南投縣,國姓鄉,7213,20668,11262,9406
2010/12/1,南投縣,水里鄉,7237,20063,10526,9537
2010/12/1,南投縣,信義鄉,5228,17314,9361,7953
2010/12/1,南投縣,仁愛鄉,4926,15661,8169,7492
2010/12/1,雲林縣,斗六市,34824,106854,53730,53124
2010/12/1,雲林縣,斗南鎮,15239,47120,23961,23159
2010/12/1,雲林縣,虎尾鎮,22507,70025,35641,34384
2010/12/1,雲林縣,西螺鎮,13980,48502,24658,23844
2010/12/1,雲林縣,土庫鎮,8731,30476,15931,14545
2010/12/1,雲林縣,北港鎮,15331,43059,22393,20666
2010/12/1,雲林縣,古坑鄉,10660,34061,18018,16043
2010/12/1,雲林縣,大埤鄉,6635,21234,11393,9841
2010/12/1,雲林縣,莿桐鄉,9019,30477,15971,14506
2010/12/1,雲林縣,林內鄉,5753,19720,10304,9416
2010/12/1,雲林縣,二崙鄉,8774,29665,15889,13776
2010/12/1,雲林縣,崙背鄉,8312,27350,14419,12931
2010/12/1,雲林縣,麥寮鄉,12546,37029,19334,17695
2010/12/1,雲林縣,東勢鄉,5701,16780,9145,7635
2010/12/1,雲林縣,褒忠鄉,4301,14251,7595,6656
2010/12/1,雲林縣,臺西鄉,8954,26223,14091,12132
2010/12/1,雲林縣,元長鄉,9325,28795,15682,13113
2010/12/1,雲林縣,四湖鄉,9071,26694,14559,12135
2010/12/1,雲林縣,口湖鄉,9631,30392,16209,14183
2010/12/1,雲林縣,水林鄉,10375,28946,15823,13123
2010/12/1,嘉義縣,太保市,11303,36685,18919,17766
2010/12/1,嘉義縣,朴子市,14635,44093,22505,21588
2010/12/1,嘉義縣,布袋鎮,10144,30216,15487,14729
2010/12/1,嘉義縣,大林鎮,11209,33635,17263,16372
2010/12/1,嘉義縣,民雄鄉,22813,72539,37236,35303
2010/12/1,嘉義縣,溪口鄉,5385,16269,8674,7595
2010/12/1,嘉義縣,新港鄉,10402,34676,18297,16379
2010/12/1,嘉義縣,六腳鄉,9155,26379,13974,12405
2010/12/1,嘉義縣,東石鄉,9512,27741,14745,12996
2010/12/1,嘉義縣,義竹鄉,7477,21129,10937,10192
2010/12/1,嘉義縣,鹿草鄉,5733,17232,9265,7967
2010/12/1,嘉義縣,水上鄉,17410,52274,27004,25270
2010/12/1,嘉義縣,中埔鄉,15289,47579,24818,22761
2010/12/1,嘉義縣,竹崎鄉,11309,38608,20544,18064
2010/12/1,嘉義縣,梅山鄉,6646,21634,11463,10171
2010/12/1,嘉義縣,番路鄉,3948,11684,6367,5317
2010/12/1,嘉義縣,大埔鄉,1962,4649,2447,2202
2010/12/1,嘉義縣,阿里山鄉,2066,6226,3339,2887
2010/12/1,屏東縣,屏東市,72009,211027,105294,105733
2010/12/1,屏東縣,潮州鎮,18131,55456,27885,27571
2010/12/1,屏東縣,東港鎮,15723,50141,25404,24737
2010/12/1,屏東縣,恆春鎮,10775,31165,16011,15154
2010/12/1,屏東縣,萬丹鄉,14295,53980,27925,26055
2010/12/1,屏東縣,長治鄉,9714,30944,16166,14778
2010/12/1,屏東縣,麟洛鄉,3602,11516,5982,5534
2010/12/1,屏東縣,九如鄉,6560,22859,11895,10964
2010/12/1,屏東縣,里港鄉,7851,25923,13287,12636
2010/12/1,屏東縣,鹽埔鄉,7704,27317,14178,13139
2010/12/1,屏東縣,高樹鄉,9482,26797,14322,12475
2010/12/1,屏東縣,萬巒鄉,6418,21973,11584,10389
2010/12/1,屏東縣,內埔鄉,17739,57955,30137,27818
2010/12/1,屏東縣,竹田鄉,5569,18425,9793,8632
2010/12/1,屏東縣,新埤鄉,3355,10706,5687,5019
2010/12/1,屏東縣,枋寮鄉,8480,26628,14009,12619
2010/12/1,屏東縣,新園鄉,11495,38300,19799,18501
2010/12/1,屏東縣,崁頂鄉,4232,17379,8888,8491
2010/12/1,屏東縣,林邊鄉,7201,20854,10747,10107
2010/12/1,屏東縣,南州鄉,3667,11700,6001,5699
2010/12/1,屏東縣,佳冬鄉,7150,21377,11140,10237
2010/12/1,屏東縣,琉球鄉,3977,12300,6838,5462
2010/12/1,屏東縣,車城鄉,3517,9625,5204,4421
2010/12/1,屏東縣,滿州鄉,3044,8453,4651,3802
2010/12/1,屏東縣,枋山鄉,2093,6062,3243,2819
2010/12/1,屏東縣,三地門鄉,2176,7573,3874,3699
2010/12/1,屏東縣,霧臺鄉,981,2978,1574,1404
2010/12/1,屏東縣,瑪家鄉,1891,6544,3419,3125
2010/12/1,屏東縣,泰武鄉,1230,5099,2671,2428
2010/12/1,屏東縣,來義鄉,2156,7764,3989,3775
2010/12/1,屏東縣,春日鄉,1330,4821,2510,2311
2010/12/1,屏東縣,獅子鄉,1460,4873,2562,2311
2010/12/1,屏東縣,牡丹鄉,1882,4995,2598,2397
2010/12/1,臺東縣,臺東市,37993,108870,55187,53683
2010/12/1,臺東縣,成功鎮,5433,15810,8435,7375
2010/12/1,臺東縣,關山鎮,3232,9715,5087,4628
2010/12/1,臺東縣,卑南鄉,6603,18231,9862,8369
2010/12/1,臺東縣,大武鄉,2536,7012,3663,3349
2010/12/1,臺東縣,太麻里鄉,4538,12014,6418,5596
2010/12/1,臺東縣,東河鄉,3572,9329,5191,4138
2010/12/1,臺東縣,長濱鄉,2934,8291,4727,3564
2010/12/1,臺東縣,鹿野鄉,3149,8584,4654,3930
2010/12/1,臺東縣,池上鄉,3251,9196,4868,4328
2010/12/1,臺東縣,綠島鄉,1002,3358,1810,1548
2010/12/1,臺東縣,延平鄉,1066,3599,1979,1620
2010/12/1,臺東縣,海端鄉,1094,4510,2451,2059
2010/12/1,臺東縣,達仁鄉,1508,4095,2236,1859
2010/12/1,臺東縣,金峰鄉,1048,3560,1850,1710
2010/12/1,臺東縣,蘭嶼鄉,1452,4499,2329,2170
2010/12/1,花蓮縣,花蓮市,40483,109251,53545,55706
2010/12/1,花蓮縣,鳳林鎮,4462,11957,6321,5636
2010/12/1,花蓮縣,玉里鎮,8901,26879,14563,12316
2010/12/1,花蓮縣,新城鄉,7304,20206,10495,9711
2010/12/1,花蓮縣,吉安鄉,29000,79688,40776,38912
2010/12/1,花蓮縣,壽豐鄉,6825,18660,10092,8568
2010/12/1,花蓮縣,光復鄉,5029,14120,7555,6565
2010/12/1,花蓮縣,豐濱鄉,1806,5065,2805,2260
2010/12/1,花蓮縣,瑞穗鄉,4628,12863,6935,5928
2010/12/1,花蓮縣,富里鄉,4000,11667,6378,5289
2010/12/1,花蓮縣,秀林鄉,4664,15244,7923,7321
2010/12/1,花蓮縣,萬榮鄉,2140,6856,3665,3191
2010/12/1,花蓮縣,卓溪鄉,1661,6349,3531,2818
2010/12/1,澎湖縣,馬公市,20253,57061,28896,28165
2010/12/1,澎湖縣,湖西鄉,4789,13660,7119,6541
2010/12/1,澎湖縣,白沙鄉,3157,9471,4972,4499
2010/12/1,澎湖縣,西嶼鄉,2856,8437,4372,4065
2010/12/1,澎湖縣,望安鄉,1903,4747,2553,2194
2010/12/1,澎湖縣,七美鄉,1241,3542,1857,1685
2010/12/1,基隆市,中正區,22077,55271,28313,26958
2010/12/1,基隆市,七堵區,20068,55161,27972,27189
2010/12/1,基隆市,暖暖區,14375,37958,19257,18701
2010/12/1,基隆市,仁愛區,19775,49581,24482,25099
2010/12/1,基隆市,中山區,19079,50909,25989,24920
2010/12/1,基隆市,安樂區,31738,84017,41860,42157
2010/12/1,基隆市,信義區,20075,51237,25700,25537
2010/12/1,新竹市,東區,68459,197254,97314,99940
2010/12/1,新竹市,北區,50612,145441,71859,73582
2010/12/1,新竹市,香山區,22986,72649,37070,35579
2010/12/1,嘉義市,東區,44115,125297,61168,64129
2010/12/1,嘉義市,西區,51037,147093,72868,74225
2010/12/1,金門縣,金城鎮,10909,32315,16513,15802
2010/12/1,金門縣,金湖鎮,7288,21328,10976,10352
2010/12/1,金門縣,金沙鎮,5340,15324,7788,7536
2010/12/1,金門縣,金寧鄉,6179,18938,9806,9132
2010/12/1,金門縣,烈嶼鄉,2620,8921,4517,4404
2010/12/1,金門縣,烏坵鄉,135,538,271,267
2010/12/1,連江縣,南竿鄉,1211,5904,3387,2517
2010/12/1,連江縣,北竿鄉,384,1801,1035,766
2010/12/1,連江縣,莒光鄉,242,1186,707,479
2010/12/1,連江縣,東引鄉,276,1053,615,438
2011/1/1,總計,新北市,1406060,3897421,1935120,1962301
2011/1/1,總計,臺北市,983906,2622883,1264359,1358524
2011/1/1,總計,臺中市,853518,2649311,1319425,1329886
2011/1/1,總計,臺南市,640531,1873406,943711,929695
2011/1/1,總計,高雄市,1023188,2773433,1390604,1382829
2011/1/1,總計,臺灣省,3000209,9240482,4725507,4514975
2011/1/1,總計,宜蘭縣,154184,460368,234608,225760
2011/1/1,總計,桃園市,674035,2002424,1009343,993081
2011/1/1,總計,新竹縣,161413,513220,264053,249167
2011/1/1,總計,苗栗縣,172860,561016,291163,269853
2011/1/1,總計,彰化縣,363692,1306789,670504,636285
2011/1/1,總計,南投縣,170779,526179,270930,255249
2011/1/1,總計,雲林縣,229739,717131,374457,342674
2011/1/1,總計,嘉義縣,176519,542832,283079,259753
2011/1/1,總計,屏東縣,276955,872893,448905,423988
2011/1/1,總計,臺東縣,80431,230513,120633,109880
2011/1/1,總計,花蓮縣,120927,338634,174424,164210
2011/1/1,總計,澎湖縣,34232,96926,49768,47158
2011/1/1,總計,基隆市,147158,383680,193336,190344
2011/1/1,總計,新竹市,142128,415557,206328,209229
2011/1/1,總計,嘉義市,95157,272320,133976,138344
2011/1/1,總計,福建省,34663,107692,55789,51903
2011/1/1,總計,金門縣,32543,97733,50032,47701
2011/1/1,總計,連江縣,2120,9959,5757,4202
2011/1/1,新北市,板橋區,194537,554386,274242,280144
2011/1/1,新北市,三重區,140247,389831,194269,195562
2011/1/1,新北市,中和區,155425,414219,204552,209667
2011/1/1,新北市,永和區,89497,234296,112429,121867
2011/1/1,新北市,新莊區,136855,402124,198741,203383
2011/1/1,新北市,新店區,116465,296254,144985,151269
2011/1/1,新北市,樹林區,59897,176491,88954,87537
2011/1/1,新北市,鶯歌區,27469,86860,43943,42917
2011/1/1,新北市,三峽區,35588,103599,52866,50733
2011/1/1,新北市,淡水區,57552,143687,69923,73764
2011/1/1,新北市,汐止區,79228,189567,94166,95401
2011/1/1,新北市,瑞芳區,15859,42393,21671,20722
2011/1/1,新北市,土城區,82021,238432,119261,119171
2011/1/1,新北市,蘆洲區,65456,197782,98000,99782
2011/1/1,新北市,五股區,27354,79992,40562,39430
2011/1/1,新北市,泰山區,26148,76512,38467,38045
2011/1/1,新北市,林口區,30669,83529,41287,42242
2011/1/1,新北市,深坑區,8829,23250,11715,11535
2011/1/1,新北市,石碇區,3320,7950,4441,3509
2011/1/1,新北市,坪林區,2438,6530,3640,2890
2011/1/1,新北市,三芝區,8857,23286,12045,11241
2011/1/1,新北市,石門區,4084,12719,6688,6031
2011/1/1,新北市,八里區,12265,34803,17645,17158
2011/1/1,新北市,平溪區,2389,5319,2972,2347
2011/1/1,新北市,雙溪區,3817,9707,5265,4442
2011/1/1,新北市,貢寮區,4381,13720,7055,6665
2011/1/1,新北市,金山區,6701,22372,11241,11131
2011/1/1,新北市,萬里區,7024,21988,11148,10840
2011/1/1,新北市,烏來區,1688,5823,2947,2876
2011/1/1,臺北市,松山區,77967,208769,98992,109777
2011/1/1,臺北市,信義區,85944,225375,108498,116877
2011/1/1,臺北市,大安區,116889,311896,146858,165038
2011/1/1,臺北市,中山區,91980,220573,103763,116810
2011/1/1,臺北市,中正區,62282,159768,77057,82711
2011/1/1,臺北市,大同區,47478,124819,61486,63333
2011/1/1,臺北市,萬華區,74253,189269,94342,94927
2011/1/1,臺北市,文山區,97225,262651,127183,135468
2011/1/1,臺北市,南港區,41848,114258,56172,58086
2011/1/1,臺北市,內湖區,97141,270956,130587,140369
2011/1/1,臺北市,士林區,101040,284976,138380,146596
2011/1/1,臺北市,北投區,89859,249573,121041,128532
2011/1/1,臺中市,中區,8349,22370,11044,11326
2011/1/1,臺中市,東區,25832,73938,37307,36631
2011/1/1,臺中市,南區,42140,113717,55132,58585
2011/1/1,臺中市,西區,43284,117250,56311,60939
2011/1/1,臺中市,北區,55891,147691,71568,76123
2011/1/1,臺中市,西屯區,73150,206667,100172,106495
2011/1/1,臺中市,南屯區,53332,153981,74370,79611
2011/1/1,臺中市,北屯區,83755,247114,120050,127064
2011/1/1,臺中市,豐原區,49809,165432,82133,83299
2011/1/1,臺中市,東勢區,16967,53206,27603,25603
2011/1/1,臺中市,大甲區,21661,78323,39753,38570
2011/1/1,臺中市,清水區,24986,85665,44227,41438
2011/1/1,臺中市,沙鹿區,23837,81617,41549,40068
2011/1/1,臺中市,梧棲區,15974,55238,28040,27198
2011/1/1,臺中市,后里區,14822,54253,27851,26402
2011/1/1,臺中市,神岡區,17687,63773,32817,30956
2011/1/1,臺中市,潭子區,32531,100644,50177,50467
2011/1/1,臺中市,大雅區,26381,89945,45339,44606
2011/1/1,臺中市,新社區,7359,25626,13418,12208
2011/1/1,臺中市,石岡區,4851,15965,8319,7646
2011/1/1,臺中市,外埔區,8850,32034,16488,15546
2011/1/1,臺中市,大安區,5254,20277,10653,9624
2011/1/1,臺中市,烏日區,20538,68754,34814,33940
2011/1/1,臺中市,大肚區,15863,55713,28590,27123
2011/1/1,臺中市,龍井區,20704,74491,37914,36577
2011/1/1,臺中市,霧峰區,18752,63946,32903,31043
2011/1/1,臺中市,太平區,54767,173099,86843,86256
2011/1/1,臺中市,大里區,61758,197842,98192,99650
2011/1/1,臺中市,和平區,4434,10740,5848,4892
2011/1/1,臺南市,新營區,27227,78159,39029,39130
2011/1/1,臺南市,鹽水區,9945,27132,14141,12991
2011/1/1,臺南市,白河區,10953,31337,16433,14904
2011/1/1,臺南市,柳營區,7803,22635,11839,10796
2011/1/1,臺南市,後壁區,8799,25836,13469,12367
2011/1/1,臺南市,東山區,8217,23068,12272,10796
2011/1/1,臺南市,麻豆區,15077,45783,23402,22381
2011/1/1,臺南市,下營區,9109,26079,13505,12574
2011/1/1,臺南市,六甲區,7631,23665,12299,11366
2011/1/1,臺南市,官田區,7606,22203,11360,10843
2011/1/1,臺南市,大內區,4065,10864,5790,5074
2011/1/1,臺南市,佳里區,19364,59302,29518,29784
2011/1/1,臺南市,學甲區,9560,27816,14218,13598
2011/1/1,臺南市,西港區,7813,25171,12824,12347
2011/1/1,臺南市,七股區,8015,24804,12965,11839
2011/1/1,臺南市,將軍區,7439,21524,10947,10577
2011/1/1,臺南市,北門區,4378,12430,6332,6098
2011/1/1,臺南市,新化區,13687,44098,22583,21515
2011/1/1,臺南市,善化區,14593,43498,22012,21486
2011/1/1,臺南市,新市區,10740,34705,17459,17246
2011/1/1,臺南市,安定區,9306,30185,15652,14533
2011/1/1,臺南市,山上區,2714,7850,4127,3723
2011/1/1,臺南市,玉井區,5078,15409,7991,7418
2011/1/1,臺南市,楠西區,3573,10644,5632,5012
2011/1/1,臺南市,南化區,2830,8917,4876,4041
2011/1/1,臺南市,左鎮區,1982,5475,3032,2443
2011/1/1,臺南市,仁德區,24731,69353,35630,33723
2011/1/1,臺南市,歸仁區,20536,65813,33611,32202
2011/1/1,臺南市,關廟區,10720,35976,18666,17310
2011/1/1,臺南市,龍崎區,1602,4382,2366,2016
2011/1/1,臺南市,永康區,75058,217001,107873,109128
2011/1/1,臺南市,東區,70854,194162,93947,100215
2011/1/1,臺南市,南區,43351,126100,63254,62846
2011/1/1,臺南市,北區,48216,131956,65109,66847
2011/1/1,臺南市,安南區,54601,178197,90617,87580
2011/1/1,臺南市,安平區,23174,62586,29980,32606
2011/1/1,臺南市,中西區,30184,79291,38951,40340
2011/1/1,高雄市,鹽埕區,11162,27371,13716,13655
2011/1/1,高雄市,鼓山區,52305,131730,64571,67159
2011/1/1,高雄市,左營區,73916,192040,94472,97568
2011/1/1,高雄市,楠梓區,61951,173132,85862,87270
2011/1/1,高雄市,三民區,131663,353673,173074,180599
2011/1/1,高雄市,新興區,22935,55247,26892,28355
2011/1/1,高雄市,前金區,12527,28837,14023,14814
2011/1/1,高雄市,苓雅區,71795,183742,89439,94303
2011/1/1,高雄市,前鎮區,76523,199015,98796,100219
2011/1/1,高雄市,旗津區,10967,29972,15573,14399
2011/1/1,高雄市,小港區,63330,154511,77614,76897
2011/1/1,高雄市,鳳山區,127012,341533,170209,171324
2011/1/1,高雄市,林園區,24136,70464,36183,34281
2011/1/1,高雄市,大寮區,38326,108973,56563,52410
2011/1/1,高雄市,大樹區,13054,43938,22729,21209
2011/1/1,高雄市,大社區,11715,33008,16948,16060
2011/1/1,高雄市,仁武區,26046,72453,37370,35083
2011/1/1,高雄市,鳥松區,16553,42716,21700,21016
2011/1/1,高雄市,岡山區,33190,97097,48747,48350
2011/1/1,高雄市,橋頭區,12614,36473,18706,17767
2011/1/1,高雄市,燕巢區,9984,30785,16407,14378
2011/1/1,高雄市,田寮區,3551,8194,4553,3641
2011/1/1,高雄市,阿蓮區,9154,30374,15326,15048
2011/1/1,高雄市,路竹區,16045,53787,27418,26369
2011/1/1,高雄市,湖內區,9545,28802,14828,13974
2011/1/1,高雄市,茄萣區,10134,31425,16386,15039
2011/1/1,高雄市,永安區,5842,14297,7267,7030
2011/1/1,高雄市,彌陀區,6625,20427,10637,9790
2011/1/1,高雄市,梓官區,12057,36722,19067,17655
2011/1/1,高雄市,旗山區,13830,39876,20796,19080
2011/1/1,高雄市,美濃區,14172,42931,22427,20504
2011/1/1,高雄市,六龜區,5774,14811,8013,6798
2011/1/1,高雄市,甲仙區,2512,7222,3881,3341
2011/1/1,高雄市,杉林區,4401,11873,6476,5397
2011/1/1,高雄市,內門區,5028,15920,8684,7236
2011/1/1,高雄市,茂林區,574,1870,941,929
2011/1/1,高雄市,桃源區,1357,4812,2555,2257
2011/1/1,高雄市,那瑪夏區,883,3380,1755,1625
2011/1/1,宜蘭縣,宜蘭市,33132,95499,47008,48491
2011/1/1,宜蘭縣,羅東鎮,24903,72904,35009,37895
2011/1/1,宜蘭縣,蘇澳鎮,13621,42909,21999,20910
2011/1/1,宜蘭縣,頭城鎮,9705,30867,15951,14916
2011/1/1,宜蘭縣,礁溪鄉,12369,35887,18795,17092
2011/1/1,宜蘭縣,壯圍鄉,8137,24975,13152,11823
2011/1/1,宜蘭縣,員山鄉,10792,32372,17346,15026
2011/1/1,宜蘭縣,冬山鄉,17377,52731,27138,25593
2011/1/1,宜蘭縣,五結鄉,13012,38880,20193,18687
2011/1/1,宜蘭縣,三星鄉,7502,21343,11559,9784
2011/1/1,宜蘭縣,大同鄉,1825,5996,3273,2723
2011/1/1,宜蘭縣,南澳鄉,1809,6005,3185,2820
2011/1/1,桃園市,桃園區,143949,406928,199337,207591
2011/1/1,桃園市,中壢區,127222,369890,184694,185196
2011/1/1,桃園市,平鎮區,66834,207586,104480,103106
2011/1/1,桃園市,八德區,58295,176883,89963,86920
2011/1/1,桃園市,楊梅區,48821,150945,76726,74219
2011/1/1,桃園市,大溪區,29283,92090,47501,44589
2011/1/1,桃園市,蘆竹區,48288,142156,71301,70855
2011/1/1,桃園市,大園區,26195,81985,42541,39444
2011/1/1,桃園市,龜山區,50247,137987,69940,68047
2011/1/1,桃園市,龍潭區,36964,115135,58421,56714
2011/1/1,桃園市,新屋區,14978,49063,26235,22828
2011/1/1,桃園市,觀音區,19254,61112,32225,28887
2011/1/1,桃園市,復興區,3705,10664,5979,4685
2011/1/1,新竹縣,竹北市,47028,142172,71240,70932
2011/1/1,新竹縣,關西鎮,9249,31752,16894,14858
2011/1/1,新竹縣,新埔鎮,10336,35446,18798,16648
2011/1/1,新竹縣,竹東鎮,30639,96670,48754,47916
2011/1/1,新竹縣,湖口鄉,23442,75430,38583,36847
2011/1/1,新竹縣,橫山鄉,4426,14338,7753,6585
2011/1/1,新竹縣,新豐鄉,15770,53303,27487,25816
2011/1/1,新竹縣,芎林鄉,6295,20722,10937,9785
2011/1/1,新竹縣,寶山鄉,4708,14086,7603,6483
2011/1/1,新竹縣,北埔鄉,3088,10114,5488,4626
2011/1/1,新竹縣,峨眉鄉,2021,5989,3313,2676
2011/1/1,新竹縣,尖石鄉,2692,8532,4632,3900
2011/1/1,新竹縣,五峰鄉,1719,4666,2571,2095
2011/1/1,苗栗縣,苗栗市,29169,90682,45699,44983
2011/1/1,苗栗縣,苑裡鎮,13855,48661,25404,23257
2011/1/1,苗栗縣,通霄鎮,11339,37933,20131,17802
2011/1/1,苗栗縣,竹南鎮,24216,78506,39878,38628
2011/1/1,苗栗縣,頭份市,29614,97250,49397,47853
2011/1/1,苗栗縣,後龍鎮,11705,39363,20832,18531
2011/1/1,苗栗縣,卓蘭鎮,5965,18438,9720,8718
2011/1/1,苗栗縣,大湖鄉,5311,16059,8556,7503
2011/1/1,苗栗縣,公館鄉,10215,34746,18236,16510
2011/1/1,苗栗縣,銅鑼鄉,5967,19355,10260,9095
2011/1/1,苗栗縣,南庄鄉,3991,11084,6125,4959
2011/1/1,苗栗縣,頭屋鄉,3530,11610,6140,5470
2011/1/1,苗栗縣,三義鄉,5279,17544,9240,8304
2011/1/1,苗栗縣,西湖鄉,2671,7860,4361,3499
2011/1/1,苗栗縣,造橋鄉,4019,13745,7230,6515
2011/1/1,苗栗縣,三灣鄉,2388,7260,3955,3305
2011/1/1,苗栗縣,獅潭鄉,1687,4911,2738,2173
2011/1/1,苗栗縣,泰安鄉,1939,6009,3261,2748
2011/1/1,彰化縣,彰化市,71824,236471,117766,118705
2011/1/1,彰化縣,鹿港鎮,22330,85351,43755,41596
2011/1/1,彰化縣,和美鎮,24117,89786,45984,43802
2011/1/1,彰化縣,北斗鎮,9940,33492,16964,16528
2011/1/1,彰化縣,員林市,36753,125462,63038,62424
2011/1/1,彰化縣,溪湖鎮,15115,56098,28657,27441
2011/1/1,彰化縣,田中鎮,12529,44001,22860,21141
2011/1/1,彰化縣,二林鎮,14304,53902,27825,26077
2011/1/1,彰化縣,線西鄉,4147,17149,8822,8327
2011/1/1,彰化縣,伸港鄉,8980,35955,18480,17475
2011/1/1,彰化縣,福興鄉,12077,48870,25565,23305
2011/1/1,彰化縣,秀水鄉,9766,39121,20270,18851
2011/1/1,彰化縣,花壇鄉,12986,46144,23775,22369
2011/1/1,彰化縣,芬園鄉,6870,24804,13182,11622
2011/1/1,彰化縣,大村鄉,10250,36545,19039,17506
2011/1/1,彰化縣,埔鹽鄉,8814,34302,17985,16317
2011/1/1,彰化縣,埔心鄉,9939,35319,18301,17018
2011/1/1,彰化縣,永靖鄉,10422,39251,20333,18918
2011/1/1,彰化縣,社頭鄉,12309,44742,22990,21752
2011/1/1,彰化縣,二水鄉,5313,16496,8658,7838
2011/1/1,彰化縣,田尾鄉,7677,28631,14926,13705
2011/1/1,彰化縣,埤頭鄉,8601,31762,16573,15189
2011/1/1,彰化縣,芳苑鄉,9967,36245,19203,17042
2011/1/1,彰化縣,大城鄉,5405,18952,10290,8662
2011/1/1,彰化縣,竹塘鄉,4589,16444,8652,7792
2011/1/1,彰化縣,溪州鄉,8668,31494,16611,14883
2011/1/1,南投縣,南投市,33298,104059,52383,51676
2011/1/1,南投縣,埔里鎮,28310,85022,42951,42071
2011/1/1,南投縣,草屯鎮,30919,99667,50405,49262
2011/1/1,南投縣,竹山鎮,19070,58340,30087,28253
2011/1/1,南投縣,集集鎮,4281,11898,6245,5653
2011/1/1,南投縣,名間鄉,12113,41194,21614,19580
2011/1/1,南投縣,鹿谷鄉,6770,19098,10146,8952
2011/1/1,南投縣,中寮鄉,5620,16168,8794,7374
2011/1/1,南投縣,魚池鄉,5792,17149,9042,8107
2011/1/1,南投縣,國姓鄉,7216,20637,11251,9386
2011/1/1,南投縣,水里鄉,7225,20024,10514,9510
2011/1/1,南投縣,信義鄉,5234,17280,9337,7943
2011/1/1,南投縣,仁愛鄉,4931,15643,8161,7482
2011/1/1,雲林縣,斗六市,34863,106901,53782,53119
2011/1/1,雲林縣,斗南鎮,15243,47103,23955,23148
2011/1/1,雲林縣,虎尾鎮,22542,69996,35630,34366
2011/1/1,雲林縣,西螺鎮,13991,48459,24645,23814
2011/1/1,雲林縣,土庫鎮,8739,30448,15912,14536
2011/1/1,雲林縣,北港鎮,15327,42988,22376,20612
2011/1/1,雲林縣,古坑鄉,10648,34028,17979,16049
2011/1/1,雲林縣,大埤鄉,6635,21199,11373,9826
2011/1/1,雲林縣,莿桐鄉,9031,30428,15940,14488
2011/1/1,雲林縣,林內鄉,5751,19706,10288,9418
2011/1/1,雲林縣,二崙鄉,8778,29635,15872,13763
2011/1/1,雲林縣,崙背鄉,8312,27309,14396,12913
2011/1/1,雲林縣,麥寮鄉,12562,37158,19389,17769
2011/1/1,雲林縣,東勢鄉,5698,16748,9126,7622
2011/1/1,雲林縣,褒忠鄉,4298,14223,7578,6645
2011/1/1,雲林縣,臺西鄉,8944,26164,14059,12105
2011/1/1,雲林縣,元長鄉,9315,28737,15655,13082
2011/1/1,雲林縣,四湖鄉,9067,26664,14534,12130
2011/1/1,雲林縣,口湖鄉,9622,30348,16180,14168
2011/1/1,雲林縣,水林鄉,10373,28889,15788,13101
2011/1/1,嘉義縣,太保市,11330,36675,18914,17761
2011/1/1,嘉義縣,朴子市,14650,44053,22479,21574
2011/1/1,嘉義縣,布袋鎮,10144,30155,15453,14702
2011/1/1,嘉義縣,大林鎮,11210,33614,17260,16354
2011/1/1,嘉義縣,民雄鄉,22837,72527,37245,35282
2011/1/1,嘉義縣,溪口鄉,5389,16247,8669,7578
2011/1/1,嘉義縣,新港鄉,10404,34641,18272,16369
2011/1/1,嘉義縣,六腳鄉,9156,26351,13963,12388
2011/1/1,嘉義縣,東石鄉,9517,27724,14743,12981
2011/1/1,嘉義縣,義竹鄉,7480,21079,10913,10166
2011/1/1,嘉義縣,鹿草鄉,5738,17212,9250,7962
2011/1/1,嘉義縣,水上鄉,17404,52195,26958,25237
2011/1/1,嘉義縣,中埔鄉,15321,47622,24837,22785
2011/1/1,嘉義縣,竹崎鄉,11322,38592,20530,18062
2011/1/1,嘉義縣,梅山鄉,6648,21596,11453,10143
2011/1/1,嘉義縣,番路鄉,3943,11670,6355,5315
2011/1/1,嘉義縣,大埔鄉,1958,4642,2445,2197
2011/1/1,嘉義縣,阿里山鄉,2068,6237,3340,2897
2011/1/1,屏東縣,屏東市,72035,210941,105213,105728
2011/1/1,屏東縣,潮州鎮,18137,55477,27908,27569
2011/1/1,屏東縣,東港鎮,15719,50143,25411,24732
2011/1/1,屏東縣,恆春鎮,10781,31152,15992,15160
2011/1/1,屏東縣,萬丹鄉,14310,53982,27915,26067
2011/1/1,屏東縣,長治鄉,9721,30919,16155,14764
2011/1/1,屏東縣,麟洛鄉,3597,11501,5977,5524
2011/1/1,屏東縣,九如鄉,6569,22855,11887,10968
2011/1/1,屏東縣,里港鄉,7854,25887,13275,12612
2011/1/1,屏東縣,鹽埔鄉,7714,27306,14170,13136
2011/1/1,屏東縣,高樹鄉,9457,26753,14295,12458
2011/1/1,屏東縣,萬巒鄉,6416,21939,11559,10380
2011/1/1,屏東縣,內埔鄉,17733,57878,30107,27771
2011/1/1,屏東縣,竹田鄉,5571,18394,9771,8623
2011/1/1,屏東縣,新埤鄉,3358,10709,5692,5017
2011/1/1,屏東縣,枋寮鄉,8485,26575,13973,12602
2011/1/1,屏東縣,新園鄉,11496,38222,19759,18463
2011/1/1,屏東縣,崁頂鄉,4236,17363,8882,8481
2011/1/1,屏東縣,林邊鄉,7202,20821,10728,10093
2011/1/1,屏東縣,南州鄉,3665,11678,5989,5689
2011/1/1,屏東縣,佳冬鄉,7155,21370,11140,10230
2011/1/1,屏東縣,琉球鄉,3980,12291,6829,5462
2011/1/1,屏東縣,車城鄉,3519,9608,5195,4413
2011/1/1,屏東縣,滿州鄉,3045,8441,4646,3795
2011/1/1,屏東縣,枋山鄉,2093,6058,3239,2819
2011/1/1,屏東縣,三地門鄉,2174,7577,3876,3701
2011/1/1,屏東縣,霧臺鄉,983,2988,1580,1408
2011/1/1,屏東縣,瑪家鄉,1894,6545,3419,3126
2011/1/1,屏東縣,泰武鄉,1232,5101,2670,2431
2011/1/1,屏東縣,來義鄉,2155,7739,3982,3757
2011/1/1,屏東縣,春日鄉,1327,4828,2512,2316
2011/1/1,屏東縣,獅子鄉,1459,4856,2558,2298
2011/1/1,屏東縣,牡丹鄉,1883,4996,2601,2395
2011/1/1,臺東縣,臺東市,38010,108816,55155,53661
2011/1/1,臺東縣,成功鎮,5434,15800,8426,7374
2011/1/1,臺東縣,關山鎮,3233,9708,5091,4617
2011/1/1,臺東縣,卑南鄉,6612,18222,9840,8382
2011/1/1,臺東縣,大武鄉,2529,6986,3654,3332
2011/1/1,臺東縣,太麻里鄉,4538,11988,6406,5582
2011/1/1,臺東縣,東河鄉,3571,9317,5190,4127
2011/1/1,臺東縣,長濱鄉,2938,8284,4720,3564
2011/1/1,臺東縣,鹿野鄉,3144,8575,4645,3930
2011/1/1,臺東縣,池上鄉,3257,9178,4860,4318
2011/1/1,臺東縣,綠島鄉,1001,3355,1802,1553
2011/1/1,臺東縣,延平鄉,1065,3587,1973,1614
2011/1/1,臺東縣,海端鄉,1095,4514,2450,2064
2011/1/1,臺東縣,達仁鄉,1504,4098,2231,1867
2011/1/1,臺東縣,金峰鄉,1046,3566,1856,1710
2011/1/1,臺東縣,蘭嶼鄉,1454,4519,2334,2185
2011/1/1,花蓮縣,花蓮市,40497,109185,53497,55688
2011/1/1,花蓮縣,鳳林鎮,4459,11927,6308,5619
2011/1/1,花蓮縣,玉里鎮,8894,26833,14528,12305
2011/1/1,花蓮縣,新城鄉,7302,20193,10480,9713
2011/1/1,花蓮縣,吉安鄉,29020,79765,40797,38968
2011/1/1,花蓮縣,壽豐鄉,6833,18661,10085,8576
2011/1/1,花蓮縣,光復鄉,5024,14087,7527,6560
2011/1/1,花蓮縣,豐濱鄉,1806,5043,2791,2252
2011/1/1,花蓮縣,瑞穗鄉,4638,12855,6928,5927
2011/1/1,花蓮縣,富里鄉,3996,11651,6373,5278
2011/1/1,花蓮縣,秀林鄉,4663,15231,7917,7314
2011/1/1,花蓮縣,萬榮鄉,2134,6857,3662,3195
2011/1/1,花蓮縣,卓溪鄉,1661,6346,3531,2815
2011/1/1,澎湖縣,馬公市,20279,57076,28899,28177
2011/1/1,澎湖縣,湖西鄉,4795,13658,7125,6533
2011/1/1,澎湖縣,白沙鄉,3151,9444,4951,4493
2011/1/1,澎湖縣,西嶼鄉,2857,8441,4371,4070
2011/1/1,澎湖縣,望安鄉,1908,4747,2554,2193
2011/1/1,澎湖縣,七美鄉,1242,3560,1868,1692
2011/1/1,基隆市,中正區,22066,55217,28259,26958
2011/1/1,基隆市,七堵區,20077,55143,27969,27174
2011/1/1,基隆市,暖暖區,14376,37927,19235,18692
2011/1/1,基隆市,仁愛區,19747,49469,24432,25037
2011/1/1,基隆市,中山區,19080,50794,25939,24855
2011/1/1,基隆市,安樂區,31733,83931,41831,42100
2011/1/1,基隆市,信義區,20079,51199,25671,25528
2011/1/1,新竹市,東區,68517,197376,97381,99995
2011/1/1,新竹市,北區,50598,145462,71827,73635
2011/1/1,新竹市,香山區,23013,72719,37120,35599
2011/1/1,嘉義市,東區,44112,125261,61133,64128
2011/1/1,嘉義市,西區,51045,147059,72843,74216
2011/1/1,金門縣,金城鎮,10931,32447,16563,15884
2011/1/1,金門縣,金湖鎮,7304,21401,10999,10402
2011/1/1,金門縣,金沙鎮,5358,15372,7812,7560
2011/1/1,金門縣,金寧鄉,6191,19011,9855,9156
2011/1/1,金門縣,烈嶼鄉,2624,8958,4527,4431
2011/1/1,金門縣,烏坵鄉,135,544,276,268
2011/1/1,連江縣,南竿鄉,1216,5913,3395,2518
2011/1/1,連江縣,北竿鄉,384,1795,1031,764
2011/1/1,連江縣,莒光鄉,243,1189,708,481
2011/1/1,連江縣,東引鄉,277,1062,623,439
2011/2/1,總計,新北市,1407106,3897888,1934965,1962923
2011/2/1,總計,臺北市,984431,2624791,1265280,1359511
2011/2/1,總計,臺中市,854346,2649892,1319470,1330422
2011/2/1,總計,臺南市,640980,1873176,943486,929690
2011/2/1,總計,高雄市,1023848,2772929,1390167,1382762
2011/2/1,總計,臺灣省,3001966,9237875,4723686,4514189
2011/2/1,總計,宜蘭縣,154293,460220,234543,225677
2011/2/1,總計,桃園市,674543,2002480,1009197,993283
2011/2/1,總計,新竹縣,161666,513513,264139,249374
2011/2/1,總計,苗栗縣,172978,560890,291077,269813
2011/2/1,總計,彰化縣,363922,1306423,670259,636164
2011/2/1,總計,南投縣,170890,525940,270769,255171
2011/2/1,總計,雲林縣,229849,716827,374281,342546
2011/2/1,總計,嘉義縣,176550,542288,282775,259513
2011/2/1,總計,屏東縣,277049,872262,448582,423680
2011/2/1,總計,臺東縣,80435,230314,120498,109816
2011/2/1,總計,花蓮縣,120956,338481,174313,164168
2011/2/1,總計,澎湖縣,34233,96854,49721,47133
2011/2/1,總計,基隆市,147152,383352,193173,190179
2011/2/1,總計,新竹市,142231,415797,206428,209369
2011/2/1,總計,嘉義市,95219,272234,133931,138303
2011/2/1,總計,福建省,34726,107906,55855,52051
2011/2/1,總計,金門縣,32601,97969,50109,47860
2011/2/1,總計,連江縣,2125,9937,5746,4191
2011/2/1,新北市,板橋區,194626,554386,274141,280245
2011/2/1,新北市,三重區,140313,389701,194157,195544
2011/2/1,新北市,中和區,155475,414276,204538,209738
2011/2/1,新北市,永和區,89510,234207,112395,121812
2011/2/1,新北市,新莊區,136949,402081,198619,203462
2011/2/1,新北市,新店區,116505,296203,144929,151274
2011/2/1,新北市,樹林區,60019,176681,89047,87634
2011/2/1,新北市,鶯歌區,27518,86917,43983,42934
2011/2/1,新北市,三峽區,35666,103710,52919,50791
2011/2/1,新北市,淡水區,57707,143905,70021,73884
2011/2/1,新北市,汐止區,79224,189511,94118,95393
2011/2/1,新北市,瑞芳區,15859,42316,21625,20691
2011/2/1,新北市,土城區,82056,238448,119236,119212
2011/2/1,新北市,蘆洲區,65492,197772,98000,99772
2011/2/1,新北市,五股區,27359,79983,40543,39440
2011/2/1,新北市,泰山區,26173,76545,38492,38053
2011/2/1,新北市,林口區,30801,83795,41413,42382
2011/2/1,新北市,深坑區,8849,23265,11723,11542
2011/2/1,新北市,石碇區,3321,7929,4428,3501
2011/2/1,新北市,坪林區,2441,6529,3637,2892
2011/2/1,新北市,三芝區,8866,23265,12038,11227
2011/2/1,新北市,石門區,4086,12731,6693,6038
2011/2/1,新北市,八里區,12278,34850,17674,17176
2011/2/1,新北市,平溪區,2389,5307,2967,2340
2011/2/1,新北市,雙溪區,3816,9684,5257,4427
2011/2/1,新北市,貢寮區,4387,13713,7056,6657
2011/2/1,新北市,金山區,6704,22359,11222,11137
2011/2/1,新北市,萬里區,7031,21983,11141,10842
2011/2/1,新北市,烏來區,1686,5836,2953,2883
2011/2/1,臺北市,松山區,77979,208909,99077,109832
2011/2/1,臺北市,信義區,85929,225485,108548,116937
2011/2/1,臺北市,大安區,116951,312111,146987,165124
2011/2/1,臺北市,中山區,92068,220781,103839,116942
2011/2/1,臺北市,中正區,62303,159850,77119,82731
2011/2/1,臺北市,大同區,47545,124971,61553,63418
2011/2/1,臺北市,萬華區,74282,189381,94376,95005
2011/2/1,臺北市,文山區,97251,262852,127301,135551
2011/2/1,臺北市,南港區,41875,114309,56173,58136
2011/2/1,臺北市,內湖區,97270,271402,130813,140589
2011/2/1,臺北市,士林區,101078,285085,138409,146676
2011/2/1,臺北市,北投區,89900,249655,121085,128570
2011/2/1,臺中市,中區,8331,22306,11013,11293
2011/2/1,臺中市,東區,25824,73885,37261,36624
2011/2/1,臺中市,南區,42162,113725,55131,58594
2011/2/1,臺中市,西區,43276,117224,56296,60928
2011/2/1,臺中市,北區,55935,147637,71519,76118
2011/2/1,臺中市,西屯區,73254,206871,100273,106598
2011/2/1,臺中市,南屯區,53376,153997,74358,79639
2011/2/1,臺中市,北屯區,83929,247320,120164,127156
2011/2/1,臺中市,豐原區,49839,165384,82085,83299
2011/2/1,臺中市,東勢區,16970,53161,27574,25587
2011/2/1,臺中市,大甲區,21660,78341,39725,38616
2011/2/1,臺中市,清水區,25028,85711,44255,41456
2011/2/1,臺中市,沙鹿區,23889,81778,41608,40170
2011/2/1,臺中市,梧棲區,15989,55211,28022,27189
2011/2/1,臺中市,后里區,14827,54196,27827,26369
2011/2/1,臺中市,神岡區,17708,63779,32803,30976
2011/2/1,臺中市,潭子區,32566,100688,50195,50493
2011/2/1,臺中市,大雅區,26387,89949,45340,44609
2011/2/1,臺中市,新社區,7363,25628,13414,12214
2011/2/1,臺中市,石岡區,4857,15950,8310,7640
2011/2/1,臺中市,外埔區,8860,32028,16497,15531
2011/2/1,臺中市,大安區,5267,20251,10636,9615
2011/2/1,臺中市,烏日區,20578,68741,34797,33944
2011/2/1,臺中市,大肚區,15872,55734,28594,27140
2011/2/1,臺中市,龍井區,20724,74382,37844,36538
2011/2/1,臺中市,霧峰區,18765,63977,32893,31084
2011/2/1,臺中市,太平區,54830,173187,86873,86314
2011/2/1,臺中市,大里區,61854,198143,98346,99797
2011/2/1,臺中市,和平區,4426,10708,5817,4891
2011/2/1,臺南市,新營區,27253,78253,39059,39194
2011/2/1,臺南市,鹽水區,9951,27089,14116,12973
2011/2/1,臺南市,白河區,10956,31275,16395,14880
2011/2/1,臺南市,柳營區,7795,22611,11826,10785
2011/2/1,臺南市,後壁區,8811,25814,13465,12349
2011/2/1,臺南市,東山區,8213,23017,12236,10781
2011/2/1,臺南市,麻豆區,15075,45763,23387,22376
2011/2/1,臺南市,下營區,9102,26030,13485,12545
2011/2/1,臺南市,六甲區,7643,23643,12290,11353
2011/2/1,臺南市,官田區,7606,22180,11352,10828
2011/2/1,臺南市,大內區,4064,10849,5780,5069
2011/2/1,臺南市,佳里區,19373,59288,29518,29770
2011/2/1,臺南市,學甲區,9561,27776,14200,13576
2011/2/1,臺南市,西港區,7815,25144,12813,12331
2011/2/1,臺南市,七股區,8019,24789,12957,11832
2011/2/1,臺南市,將軍區,7432,21499,10935,10564
2011/2/1,臺南市,北門區,4380,12413,6335,6078
2011/2/1,臺南市,新化區,13688,44069,22574,21495
2011/2/1,臺南市,善化區,14602,43517,22019,21498
2011/2/1,臺南市,新市區,10754,34698,17450,17248
2011/2/1,臺南市,安定區,9324,30165,15645,14520
2011/2/1,臺南市,山上區,2711,7831,4123,3708
2011/2/1,臺南市,玉井區,5085,15377,7977,7400
2011/2/1,臺南市,楠西區,3570,10609,5617,4992
2011/2/1,臺南市,南化區,2823,8892,4865,4027
2011/2/1,臺南市,左鎮區,1977,5476,3039,2437
2011/2/1,臺南市,仁德區,24763,69407,35644,33763
2011/2/1,臺南市,歸仁區,20543,65836,33610,32226
2011/2/1,臺南市,關廟區,10716,35922,18644,17278
2011/2/1,臺南市,龍崎區,1601,4399,2374,2025
2011/2/1,臺南市,永康區,75164,217194,107949,109245
2011/2/1,臺南市,東區,70942,194212,93956,100256
2011/2/1,臺南市,南區,43358,126055,63225,62830
2011/2/1,臺南市,北區,48233,131856,65035,66821
2011/2/1,臺南市,安南區,54650,178288,90644,87644
2011/2/1,臺南市,安平區,23188,62574,29964,32610
2011/2/1,臺南市,中西區,30239,79366,38983,40383
2011/2/1,高雄市,鹽埕區,11155,27353,13715,13638
2011/2/1,高雄市,鼓山區,52314,131686,64538,67148
2011/2/1,高雄市,左營區,73942,192068,94489,97579
2011/2/1,高雄市,楠梓區,61998,173174,85893,87281
2011/2/1,高雄市,三民區,131643,353352,172844,180508
2011/2/1,高雄市,新興區,22911,55115,26816,28299
2011/2/1,高雄市,前金區,12541,28788,13996,14792
2011/2/1,高雄市,苓雅區,71792,183529,89321,94208
2011/2/1,高雄市,前鎮區,76513,198843,98685,100158
2011/2/1,高雄市,旗津區,10976,29959,15574,14385
2011/2/1,高雄市,小港區,63391,154533,77631,76902
2011/2/1,高雄市,鳳山區,127192,341855,170297,171558
2011/2/1,高雄市,林園區,24163,70448,36165,34283
2011/2/1,高雄市,大寮區,38382,109011,56599,52412
2011/2/1,高雄市,大樹區,13065,43918,22719,21199
2011/2/1,高雄市,大社區,11723,33052,16973,16079
2011/2/1,高雄市,仁武區,26133,72665,37485,35180
2011/2/1,高雄市,鳥松區,16561,42725,21702,21023
2011/2/1,高雄市,岡山區,33231,97126,48750,48376
2011/2/1,高雄市,橋頭區,12640,36503,18714,17789
2011/2/1,高雄市,燕巢區,9991,30787,16414,14373
2011/2/1,高雄市,田寮區,3551,8164,4540,3624
2011/2/1,高雄市,阿蓮區,9162,30364,15315,15049
2011/2/1,高雄市,路竹區,16058,53764,27394,26370
2011/2/1,高雄市,湖內區,9570,28780,14821,13959
2011/2/1,高雄市,茄萣區,10137,31389,16374,15015
2011/2/1,高雄市,永安區,5845,14279,7262,7017
2011/2/1,高雄市,彌陀區,6634,20438,10627,9811
2011/2/1,高雄市,梓官區,12057,36662,19046,17616
2011/2/1,高雄市,旗山區,13848,39878,20797,19081
2011/2/1,高雄市,美濃區,14186,42916,22428,20488
2011/2/1,高雄市,六龜區,5769,14761,7982,6779
2011/2/1,高雄市,甲仙區,2508,7201,3867,3334
2011/2/1,高雄市,杉林區,4419,11903,6492,5411
2011/2/1,高雄市,內門區,5030,15901,8667,7234
2011/2/1,高雄市,茂林區,577,1870,940,930
2011/2/1,高雄市,桃源區,1360,4801,2548,2253
2011/2/1,高雄市,那瑪夏區,880,3368,1747,1621
2011/2/1,宜蘭縣,宜蘭市,33146,95454,46961,48493
2011/2/1,宜蘭縣,羅東鎮,24926,72983,35039,37944
2011/2/1,宜蘭縣,蘇澳鎮,13625,42849,21965,20884
2011/2/1,宜蘭縣,頭城鎮,9706,30839,15943,14896
2011/2/1,宜蘭縣,礁溪鄉,12390,35897,18796,17101
2011/2/1,宜蘭縣,壯圍鄉,8142,24923,13128,11795
2011/2/1,宜蘭縣,員山鄉,10789,32382,17356,15026
2011/2/1,宜蘭縣,冬山鄉,17395,52683,27139,25544
2011/2/1,宜蘭縣,五結鄉,13031,38880,20207,18673
2011/2/1,宜蘭縣,三星鄉,7501,21326,11546,9780
2011/2/1,宜蘭縣,大同鄉,1826,5988,3265,2723
2011/2/1,宜蘭縣,南澳鄉,1816,6016,3198,2818
2011/2/1,桃園市,桃園區,144121,407000,199319,207681
2011/2/1,桃園市,中壢區,127320,369957,184709,185248
2011/2/1,桃園市,平鎮區,66873,207567,104461,103106
2011/2/1,桃園市,八德區,58326,176886,89912,86974
2011/2/1,桃園市,楊梅區,48863,150935,76724,74211
2011/2/1,桃園市,大溪區,29290,92083,47498,44585
2011/2/1,桃園市,蘆竹區,48350,142219,71325,70894
2011/2/1,桃園市,大園區,26201,81970,42527,39443
2011/2/1,桃園市,龜山區,50282,137983,69928,68055
2011/2/1,桃園市,龍潭區,36975,115079,58369,56710
2011/2/1,桃園市,新屋區,14976,49018,26216,22802
2011/2/1,桃園市,觀音區,19266,61131,32236,28895
2011/2/1,桃園市,復興區,3700,10652,5973,4679
2011/2/1,新竹縣,竹北市,47187,142452,71365,71087
2011/2/1,新竹縣,關西鎮,9257,31736,16887,14849
2011/2/1,新竹縣,新埔鎮,10350,35470,18803,16667
2011/2/1,新竹縣,竹東鎮,30649,96637,48720,47917
2011/2/1,新竹縣,湖口鄉,23477,75493,38603,36890
2011/2/1,新竹縣,橫山鄉,4426,14336,7748,6588
2011/2/1,新竹縣,新豐鄉,15785,53303,27482,25821
2011/2/1,新竹縣,芎林鄉,6293,20704,10928,9776
2011/2/1,新竹縣,寶山鄉,4713,14093,7609,6484
2011/2/1,新竹縣,北埔鄉,3093,10095,5474,4621
2011/2/1,新竹縣,峨眉鄉,2024,5997,3316,2681
2011/2/1,新竹縣,尖石鄉,2696,8543,4640,3903
2011/2/1,新竹縣,五峰鄉,1716,4654,2564,2090
2011/2/1,苗栗縣,苗栗市,29182,90678,45665,45013
2011/2/1,苗栗縣,苑裡鎮,13855,48609,25385,23224
2011/2/1,苗栗縣,通霄鎮,11343,37897,20110,17787
2011/2/1,苗栗縣,竹南鎮,24244,78539,39902,38637
2011/2/1,苗栗縣,頭份市,29668,97301,49424,47877
2011/2/1,苗栗縣,後龍鎮,11703,39329,20814,18515
2011/2/1,苗栗縣,卓蘭鎮,5961,18422,9714,8708
2011/2/1,苗栗縣,大湖鄉,5311,16043,8550,7493
2011/2/1,苗栗縣,公館鄉,10220,34732,18223,16509
2011/2/1,苗栗縣,銅鑼鄉,5970,19364,10274,9090
2011/2/1,苗栗縣,南庄鄉,4000,11078,6122,4956
2011/2/1,苗栗縣,頭屋鄉,3535,11626,6143,5483
2011/2/1,苗栗縣,三義鄉,5281,17531,9237,8294
2011/2/1,苗栗縣,西湖鄉,2669,7846,4350,3496
2011/2/1,苗栗縣,造橋鄉,4018,13727,7216,6511
2011/2/1,苗栗縣,三灣鄉,2393,7270,3960,3310
2011/2/1,苗栗縣,獅潭鄉,1685,4896,2734,2162
2011/2/1,苗栗縣,泰安鄉,1940,6002,3254,2748
2011/2/1,彰化縣,彰化市,71876,236424,117705,118719
2011/2/1,彰化縣,鹿港鎮,22352,85347,43754,41593
2011/2/1,彰化縣,和美鎮,24145,89784,45973,43811
2011/2/1,彰化縣,北斗鎮,9954,33515,16968,16547
2011/2/1,彰化縣,員林市,36773,125459,63038,62421
2011/2/1,彰化縣,溪湖鎮,15121,56088,28654,27434
2011/2/1,彰化縣,田中鎮,12534,43985,22865,21120
2011/2/1,彰化縣,二林鎮,14310,53869,27810,26059
2011/2/1,彰化縣,線西鄉,4145,17137,8816,8321
2011/2/1,彰化縣,伸港鄉,8985,35951,18479,17472
2011/2/1,彰化縣,福興鄉,12086,48850,25551,23299
2011/2/1,彰化縣,秀水鄉,9777,39135,20275,18860
2011/2/1,彰化縣,花壇鄉,12992,46125,23747,22378
2011/2/1,彰化縣,芬園鄉,6868,24778,13172,11606
2011/2/1,彰化縣,大村鄉,10267,36573,19065,17508
2011/2/1,彰化縣,埔鹽鄉,8821,34264,17968,16296
2011/2/1,彰化縣,埔心鄉,9944,35319,18287,17032
2011/2/1,彰化縣,永靖鄉,10432,39201,20308,18893
2011/2/1,彰化縣,社頭鄉,12312,44697,22964,21733
2011/2/1,彰化縣,二水鄉,5310,16491,8654,7837
2011/2/1,彰化縣,田尾鄉,7684,28624,14912,13712
2011/2/1,彰化縣,埤頭鄉,8599,31742,16558,15184
2011/2/1,彰化縣,芳苑鄉,9975,36221,19186,17035
2011/2/1,彰化縣,大城鄉,5409,18933,10285,8648
2011/2/1,彰化縣,竹塘鄉,4587,16431,8652,7779
2011/2/1,彰化縣,溪州鄉,8664,31480,16613,14867
2011/2/1,南投縣,南投市,33322,104048,52379,51669
2011/2/1,南投縣,埔里鎮,28320,84946,42897,42049
2011/2/1,南投縣,草屯鎮,30936,99625,50362,49263
2011/2/1,南投縣,竹山鎮,19079,58304,30072,28232
2011/2/1,南投縣,集集鎮,4288,11883,6238,5645
2011/2/1,南投縣,名間鄉,12125,41187,21613,19574
2011/2/1,南投縣,鹿谷鄉,6782,19101,10152,8949
2011/2/1,南投縣,中寮鄉,5624,16139,8779,7360
2011/2/1,南投縣,魚池鄉,5798,17170,9042,8128
2011/2/1,南投縣,國姓鄉,7224,20616,11245,9371
2011/2/1,南投縣,水里鄉,7221,20017,10504,9513
2011/2/1,南投縣,信義鄉,5243,17273,9327,7946
2011/2/1,南投縣,仁愛鄉,4928,15631,8159,7472
2011/2/1,雲林縣,斗六市,34879,106915,53791,53124
2011/2/1,雲林縣,斗南鎮,15257,47075,23951,23124
2011/2/1,雲林縣,虎尾鎮,22571,70027,35637,34390
2011/2/1,雲林縣,西螺鎮,14008,48415,24626,23789
2011/2/1,雲林縣,土庫鎮,8740,30405,15888,14517
2011/2/1,雲林縣,北港鎮,15339,42971,22369,20602
2011/2/1,雲林縣,古坑鄉,10652,33984,17966,16018
2011/2/1,雲林縣,大埤鄉,6640,21162,11362,9800
2011/2/1,雲林縣,莿桐鄉,9037,30438,15947,14491
2011/2/1,雲林縣,林內鄉,5759,19698,10275,9423
2011/2/1,雲林縣,二崙鄉,8778,29611,15868,13743
2011/2/1,雲林縣,崙背鄉,8309,27257,14355,12902
2011/2/1,雲林縣,麥寮鄉,12590,37358,19463,17895
2011/2/1,雲林縣,東勢鄉,5698,16716,9109,7607
2011/2/1,雲林縣,褒忠鄉,4295,14207,7566,6641
2011/2/1,雲林縣,臺西鄉,8933,26127,14032,12095
2011/2/1,雲林縣,元長鄉,9318,28710,15640,13070
2011/2/1,雲林縣,四湖鄉,9066,26635,14531,12104
2011/2/1,雲林縣,口湖鄉,9610,30270,16134,14136
2011/2/1,雲林縣,水林鄉,10370,28846,15771,13075
2011/2/1,嘉義縣,太保市,11340,36659,18905,17754
2011/2/1,嘉義縣,朴子市,14652,44084,22493,21591
2011/2/1,嘉義縣,布袋鎮,10134,30049,15396,14653
2011/2/1,嘉義縣,大林鎮,11211,33541,17228,16313
2011/2/1,嘉義縣,民雄鄉,22835,72525,37231,35294
2011/2/1,嘉義縣,溪口鄉,5390,16218,8654,7564
2011/2/1,嘉義縣,新港鄉,10404,34628,18257,16371
2011/2/1,嘉義縣,六腳鄉,9150,26270,13914,12356
2011/2/1,嘉義縣,東石鄉,9515,27663,14714,12949
2011/2/1,嘉義縣,義竹鄉,7479,21052,10906,10146
2011/2/1,嘉義縣,鹿草鄉,5741,17201,9254,7947
2011/2/1,嘉義縣,水上鄉,17402,52140,26936,25204
2011/2/1,嘉義縣,中埔鄉,15349,47612,24816,22796
2011/2/1,嘉義縣,竹崎鄉,11321,38556,20511,18045
2011/2/1,嘉義縣,梅山鄉,6656,21564,11433,10131
2011/2/1,嘉義縣,番路鄉,3948,11646,6340,5306
2011/2/1,嘉義縣,大埔鄉,1956,4648,2449,2199
2011/2/1,嘉義縣,阿里山鄉,2067,6232,3338,2894
2011/2/1,屏東縣,屏東市,72024,210821,105133,105688
2011/2/1,屏東縣,潮州鎮,18158,55487,27907,27580
2011/2/1,屏東縣,東港鎮,15744,50149,25408,24741
2011/2/1,屏東縣,恆春鎮,10794,31143,15977,15166
2011/2/1,屏東縣,萬丹鄉,14319,53938,27894,26044
2011/2/1,屏東縣,長治鄉,9733,30897,16152,14745
2011/2/1,屏東縣,麟洛鄉,3595,11515,5981,5534
2011/2/1,屏東縣,九如鄉,6565,22833,11872,10961
2011/2/1,屏東縣,里港鄉,7863,25873,13266,12607
2011/2/1,屏東縣,鹽埔鄉,7717,27287,14160,13127
2011/2/1,屏東縣,高樹鄉,9440,26721,14284,12437
2011/2/1,屏東縣,萬巒鄉,6409,21926,11554,10372
2011/2/1,屏東縣,內埔鄉,17743,57837,30094,27743
2011/2/1,屏東縣,竹田鄉,5573,18368,9756,8612
2011/2/1,屏東縣,新埤鄉,3362,10687,5679,5008
2011/2/1,屏東縣,枋寮鄉,8480,26523,13957,12566
2011/2/1,屏東縣,新園鄉,11510,38164,19729,18435
2011/2/1,屏東縣,崁頂鄉,4238,17328,8871,8457
2011/2/1,屏東縣,林邊鄉,7197,20776,10707,10069
2011/2/1,屏東縣,南州鄉,3663,11659,5976,5683
2011/2/1,屏東縣,佳冬鄉,7157,21340,11136,10204
2011/2/1,屏東縣,琉球鄉,3982,12281,6827,5454
2011/2/1,屏東縣,車城鄉,3518,9608,5192,4416
2011/2/1,屏東縣,滿州鄉,3048,8429,4646,3783
2011/2/1,屏東縣,枋山鄉,2097,6050,3233,2817
2011/2/1,屏東縣,三地門鄉,2177,7580,3879,3701
2011/2/1,屏東縣,霧臺鄉,984,2976,1575,1401
2011/2/1,屏東縣,瑪家鄉,1895,6540,3414,3126
2011/2/1,屏東縣,泰武鄉,1233,5093,2665,2428
2011/2/1,屏東縣,來義鄉,2158,7728,3973,3755
2011/2/1,屏東縣,春日鄉,1330,4838,2520,2318
2011/2/1,屏東縣,獅子鄉,1460,4871,2565,2306
2011/2/1,屏東縣,牡丹鄉,1883,4996,2600,2396
2011/2/1,臺東縣,臺東市,38005,108791,55122,53669
2011/2/1,臺東縣,成功鎮,5430,15757,8402,7355
2011/2/1,臺東縣,關山鎮,3230,9694,5085,4609
2011/2/1,臺東縣,卑南鄉,6617,18193,9815,8378
2011/2/1,臺東縣,大武鄉,2525,6957,3642,3315
2011/2/1,臺東縣,太麻里鄉,4537,11979,6398,5581
2011/2/1,臺東縣,東河鄉,3585,9309,5188,4121
2011/2/1,臺東縣,長濱鄉,2930,8261,4704,3557
2011/2/1,臺東縣,鹿野鄉,3138,8543,4632,3911
2011/2/1,臺東縣,池上鄉,3260,9162,4855,4307
2011/2/1,臺東縣,綠島鄉,1000,3346,1791,1555
2011/2/1,臺東縣,延平鄉,1069,3595,1977,1618
2011/2/1,臺東縣,海端鄉,1094,4503,2444,2059
2011/2/1,臺東縣,達仁鄉,1506,4098,2232,1866
2011/2/1,臺東縣,金峰鄉,1046,3581,1864,1717
2011/2/1,臺東縣,蘭嶼鄉,1463,4545,2347,2198
2011/2/1,花蓮縣,花蓮市,40483,109062,53443,55619
2011/2/1,花蓮縣,鳳林鎮,4457,11929,6305,5624
2011/2/1,花蓮縣,玉里鎮,8895,26783,14487,12296
2011/2/1,花蓮縣,新城鄉,7321,20251,10506,9745
2011/2/1,花蓮縣,吉安鄉,29035,79834,40807,39027
2011/2/1,花蓮縣,壽豐鄉,6834,18649,10087,8562
2011/2/1,花蓮縣,光復鄉,5028,14089,7528,6561
2011/2/1,花蓮縣,豐濱鄉,1806,5035,2789,2246
2011/2/1,花蓮縣,瑞穗鄉,4639,12831,6917,5914
2011/2/1,花蓮縣,富里鄉,4000,11624,6360,5264
2011/2/1,花蓮縣,秀林鄉,4663,15220,7906,7314
2011/2/1,花蓮縣,萬榮鄉,2134,6829,3648,3181
2011/2/1,花蓮縣,卓溪鄉,1661,6345,3530,2815
2011/2/1,澎湖縣,馬公市,20279,57045,28869,28176
2011/2/1,澎湖縣,湖西鄉,4801,13652,7126,6526
2011/2/1,澎湖縣,白沙鄉,3156,9437,4948,4489
2011/2/1,澎湖縣,西嶼鄉,2854,8432,4364,4068
2011/2/1,澎湖縣,望安鄉,1903,4742,2556,2186
2011/2/1,澎湖縣,七美鄉,1240,3546,1858,1688
2011/2/1,基隆市,中正區,22036,55140,28231,26909
2011/2/1,基隆市,七堵區,20088,55089,27953,27136
2011/2/1,基隆市,暖暖區,14382,37945,19232,18713
2011/2/1,基隆市,仁愛區,19742,49404,24410,24994
2011/2/1,基隆市,中山區,19074,50730,25905,24825
2011/2/1,基隆市,安樂區,31744,83862,41791,42071
2011/2/1,基隆市,信義區,20086,51182,25651,25531
2011/2/1,新竹市,東區,68573,197521,97444,100077
2011/2/1,新竹市,北區,50617,145527,71850,73677
2011/2/1,新竹市,香山區,23041,72749,37134,35615
2011/2/1,嘉義市,東區,44131,125210,61115,64095
2011/2/1,嘉義市,西區,51088,147024,72816,74208
2011/2/1,金門縣,金城鎮,10953,32532,16585,15947
2011/2/1,金門縣,金湖鎮,7312,21438,11017,10421
2011/2/1,金門縣,金沙鎮,5373,15445,7845,7600
2011/2/1,金門縣,金寧鄉,6200,19020,9849,9171
2011/2/1,金門縣,烈嶼鄉,2628,8987,4537,4450
2011/2/1,金門縣,烏坵鄉,135,547,276,271
2011/2/1,連江縣,南竿鄉,1217,5892,3382,2510
2011/2/1,連江縣,北竿鄉,388,1799,1032,767
2011/2/1,連江縣,莒光鄉,243,1177,705,472
2011/2/1,連江縣,東引鄉,277,1069,627,442
2011/3/1,總計,新北市,1409664,3898230,1934653,1963577
2011/3/1,總計,臺北市,986124,2627677,1266557,1361120
2011/3/1,總計,臺中市,856019,2651152,1319809,1331343
2011/3/1,總計,臺南市,641806,1872933,943151,929782
2011/3/1,總計,高雄市,1025181,2772834,1389882,1382952
2011/3/1,總計,臺灣省,3006189,9234896,4721489,4513407
2011/3/1,總計,宜蘭縣,154620,460036,234394,225642
2011/3/1,總計,桃園市,675666,2002925,1009370,993555
2011/3/1,總計,新竹縣,162028,513838,264208,249630
2011/3/1,總計,苗栗縣,173256,560802,290988,269814
2011/3/1,總計,彰化縣,364353,1305744,669848,635896
2011/3/1,總計,南投縣,171100,525553,270539,255014
2011/3/1,總計,雲林縣,230107,716457,374047,342410
2011/3/1,總計,嘉義縣,176789,541637,282420,259217
2011/3/1,總計,屏東縣,277289,871462,448111,423351
2011/3/1,總計,臺東縣,80529,230140,120364,109776
2011/3/1,總計,花蓮縣,121078,338276,174144,164132
2011/3/1,總計,澎湖縣,34301,96789,49691,47098
2011/3/1,總計,基隆市,147198,382865,192848,190017
2011/3/1,總計,新竹市,142537,416191,206637,209554
2011/3/1,總計,嘉義市,95338,272181,133880,138301
2011/3/1,總計,福建省,34812,108156,55949,52207
2011/3/1,總計,金門縣,32679,98186,50181,48005
2011/3/1,總計,連江縣,2133,9970,5768,4202
2011/3/1,新北市,板橋區,194870,554186,273937,280249
2011/3/1,新北市,三重區,140594,389558,194088,195470
2011/3/1,新北市,中和區,155579,413896,204260,209636
2011/3/1,新北市,永和區,89613,234203,112374,121829
2011/3/1,新北市,新莊區,137207,402229,198668,203561
2011/3/1,新北市,新店區,116616,296087,144835,151252
2011/3/1,新北市,樹林區,60227,177023,89205,87818
2011/3/1,新北市,鶯歌區,27562,86966,44004,42962
2011/3/1,新北市,三峽區,35827,103940,53030,50910
2011/3/1,新北市,淡水區,57999,144245,70154,74091
2011/3/1,新北市,汐止區,79312,189503,94090,95413
2011/3/1,新北市,瑞芳區,15871,42238,21573,20665
2011/3/1,新北市,土城區,82202,238447,119206,119241
2011/3/1,新北市,蘆洲區,65595,197686,97958,99728
2011/3/1,新北市,五股區,27380,79960,40535,39425
2011/3/1,新北市,泰山區,26217,76601,38510,38091
2011/3/1,新北市,林口區,31032,84106,41530,42576
2011/3/1,新北市,深坑區,8870,23307,11755,11552
2011/3/1,新北市,石碇區,3326,7913,4417,3496
2011/3/1,新北市,坪林區,2448,6544,3642,2902
2011/3/1,新北市,三芝區,8873,23246,12024,11222
2011/3/1,新北市,石門區,4104,12742,6690,6052
2011/3/1,新北市,八里區,12305,34865,17676,17189
2011/3/1,新北市,平溪區,2395,5278,2951,2327
2011/3/1,新北市,雙溪區,3810,9651,5242,4409
2011/3/1,新北市,貢寮區,4396,13683,7036,6647
2011/3/1,新北市,金山區,6709,22357,11206,11151
2011/3/1,新北市,萬里區,7031,21946,11114,10832
2011/3/1,新北市,烏來區,1694,5824,2943,2881
2011/3/1,臺北市,松山區,78062,209128,99165,109963
2011/3/1,臺北市,信義區,86009,225642,108609,117033
2011/3/1,臺北市,大安區,117092,312378,147085,165293
2011/3/1,臺北市,中山區,92261,221110,103996,117114
2011/3/1,臺北市,中正區,62429,160058,77220,82838
2011/3/1,臺北市,大同區,47725,125238,61650,63588
2011/3/1,臺北市,萬華區,74370,189450,94376,95074
2011/3/1,臺北市,文山區,97393,263212,127495,135717
2011/3/1,臺北市,南港區,41917,114393,56229,58164
2011/3/1,臺北市,內湖區,97594,271877,131050,140827
2011/3/1,臺北市,士林區,101256,285305,138458,146847
2011/3/1,臺北市,北投區,90016,249886,121224,128662
2011/3/1,臺中市,中區,8328,22276,10993,11283
2011/3/1,臺中市,東區,25840,73797,37230,36567
2011/3/1,臺中市,南區,42247,113737,55150,58587
2011/3/1,臺中市,西區,43318,117105,56246,60859
2011/3/1,臺中市,北區,56028,147727,71524,76203
2011/3/1,臺中市,西屯區,73440,207074,100383,106691
2011/3/1,臺中市,南屯區,53460,154034,74346,79688
2011/3/1,臺中市,北屯區,84230,247788,120343,127445
2011/3/1,臺中市,豐原區,49882,165347,82066,83281
2011/3/1,臺中市,東勢區,16974,53135,27561,25574
2011/3/1,臺中市,大甲區,21684,78336,39724,38612
2011/3/1,臺中市,清水區,25043,85682,44220,41462
2011/3/1,臺中市,沙鹿區,24005,81976,41710,40266
2011/3/1,臺中市,梧棲區,16012,55281,28042,27239
2011/3/1,臺中市,后里區,14858,54175,27797,26378
2011/3/1,臺中市,神岡區,17726,63806,32794,31012
2011/3/1,臺中市,潭子區,32651,100800,50232,50568
2011/3/1,臺中市,大雅區,26416,90014,45374,44640
2011/3/1,臺中市,新社區,7355,25573,13378,12195
2011/3/1,臺中市,石岡區,4849,15944,8295,7649
2011/3/1,臺中市,外埔區,8882,32019,16483,15536
2011/3/1,臺中市,大安區,5269,20211,10616,9595
2011/3/1,臺中市,烏日區,20667,68839,34867,33972
2011/3/1,臺中市,大肚區,15896,55758,28619,27139
2011/3/1,臺中市,龍井區,20744,74314,37788,36526
2011/3/1,臺中市,霧峰區,18803,63953,32885,31068
2011/3/1,臺中市,太平區,54979,173347,86914,86433
2011/3/1,臺中市,大里區,62004,198389,98410,99979
2011/3/1,臺中市,和平區,4429,10715,5819,4896
2011/3/1,臺南市,新營區,27292,78433,39106,39327
2011/3/1,臺南市,鹽水區,9947,27033,14089,12944
2011/3/1,臺南市,白河區,10962,31236,16376,14860
2011/3/1,臺南市,柳營區,7800,22549,11801,10748
2011/3/1,臺南市,後壁區,8807,25745,13439,12306
2011/3/1,臺南市,東山區,8223,22951,12182,10769
2011/3/1,臺南市,麻豆區,15074,45754,23378,22376
2011/3/1,臺南市,下營區,9109,26002,13463,12539
2011/3/1,臺南市,六甲區,7648,23611,12278,11333
2011/3/1,臺南市,官田區,7613,22125,11321,10804
2011/3/1,臺南市,大內區,4064,10842,5769,5073
2011/3/1,臺南市,佳里區,19418,59267,29503,29764
2011/3/1,臺南市,學甲區,9565,27747,14187,13560
2011/3/1,臺南市,西港區,7819,25121,12802,12319
2011/3/1,臺南市,七股區,8009,24782,12958,11824
2011/3/1,臺南市,將軍區,7438,21455,10910,10545
2011/3/1,臺南市,北門區,4376,12377,6313,6064
2011/3/1,臺南市,新化區,13705,44010,22551,21459
2011/3/1,臺南市,善化區,14642,43588,22056,21532
2011/3/1,臺南市,新市區,10772,34701,17448,17253
2011/3/1,臺南市,安定區,9338,30155,15637,14518
2011/3/1,臺南市,山上區,2712,7811,4122,3689
2011/3/1,臺南市,玉井區,5083,15347,7961,7386
2011/3/1,臺南市,楠西區,3575,10582,5611,4971
2011/3/1,臺南市,南化區,2829,8877,4860,4017
2011/3/1,臺南市,左鎮區,1972,5452,3030,2422
2011/3/1,臺南市,仁德區,24782,69406,35642,33764
2011/3/1,臺南市,歸仁區,20568,65850,33613,32237
2011/3/1,臺南市,關廟區,10712,35853,18605,17248
2011/3/1,臺南市,龍崎區,1600,4389,2368,2021
2011/3/1,臺南市,永康區,75373,217420,107976,109444
2011/3/1,臺南市,東區,71038,194234,93952,100282
2011/3/1,臺南市,南區,43394,126049,63226,62823
2011/3/1,臺南市,北區,48281,131812,65006,66806
2011/3/1,臺南市,安南區,54810,178452,90721,87731
2011/3/1,臺南市,安平區,23220,62633,29984,32649
2011/3/1,臺南市,中西區,30236,79282,38907,40375
2011/3/1,高雄市,鹽埕區,11164,27343,13707,13636
2011/3/1,高雄市,鼓山區,52386,131768,64574,67194
2011/3/1,高雄市,左營區,74030,192216,94544,97672
2011/3/1,高雄市,楠梓區,62039,173221,85905,87316
2011/3/1,高雄市,三民區,131751,353097,172703,180394
2011/3/1,高雄市,新興區,22895,55017,26747,28270
2011/3/1,高雄市,前金區,12540,28719,13963,14756
2011/3/1,高雄市,苓雅區,71848,183244,89184,94060
2011/3/1,高雄市,前鎮區,76610,198726,98620,100106
2011/3/1,高雄市,旗津區,10983,29915,15545,14370
2011/3/1,高雄市,小港區,63413,154458,77596,76862
2011/3/1,高雄市,鳳山區,127520,342250,170442,171808
2011/3/1,高雄市,林園區,24162,70430,36135,34295
2011/3/1,高雄市,大寮區,38462,109108,56661,52447
2011/3/1,高雄市,大樹區,13080,43899,22699,21200
2011/3/1,高雄市,大社區,11741,33091,16984,16107
2011/3/1,高雄市,仁武區,26241,72962,37605,35357
2011/3/1,高雄市,鳥松區,16642,42797,21736,21061
2011/3/1,高雄市,岡山區,33276,97120,48755,48365
2011/3/1,高雄市,橋頭區,12676,36551,18739,17812
2011/3/1,高雄市,燕巢區,10014,30830,16429,14401
2011/3/1,高雄市,田寮區,3545,8143,4534,3609
2011/3/1,高雄市,阿蓮區,9169,30357,15297,15060
2011/3/1,高雄市,路竹區,16083,53702,27375,26327
2011/3/1,高雄市,湖內區,9593,28795,14821,13974
2011/3/1,高雄市,茄萣區,10147,31359,16350,15009
2011/3/1,高雄市,永安區,5845,14247,7239,7008
2011/3/1,高雄市,彌陀區,6636,20382,10596,9786
2011/3/1,高雄市,梓官區,12086,36695,19056,17639
2011/3/1,高雄市,旗山區,13853,39847,20776,19071
2011/3/1,高雄市,美濃區,14194,42869,22382,20487
2011/3/1,高雄市,六龜區,5767,14698,7955,6743
2011/3/1,高雄市,甲仙區,2511,7165,3845,3320
2011/3/1,高雄市,杉林區,4433,11909,6500,5409
2011/3/1,高雄市,內門區,5026,15866,8651,7215
2011/3/1,高雄市,茂林區,575,1859,934,925
2011/3/1,高雄市,桃源區,1363,4808,2556,2252
2011/3/1,高雄市,那瑪夏區,882,3371,1742,1629
2011/3/1,宜蘭縣,宜蘭市,33197,95565,46994,48571
2011/3/1,宜蘭縣,羅東鎮,24994,72957,35017,37940
2011/3/1,宜蘭縣,蘇澳鎮,13642,42787,21929,20858
2011/3/1,宜蘭縣,頭城鎮,9725,30777,15917,14860
2011/3/1,宜蘭縣,礁溪鄉,12417,35873,18777,17096
2011/3/1,宜蘭縣,壯圍鄉,8153,24886,13120,11766
2011/3/1,宜蘭縣,員山鄉,10817,32343,17331,15012
2011/3/1,宜蘭縣,冬山鄉,17434,52661,27112,25549
2011/3/1,宜蘭縣,五結鄉,13066,38858,20196,18662
2011/3/1,宜蘭縣,三星鄉,7521,21333,11539,9794
2011/3/1,宜蘭縣,大同鄉,1834,5978,3260,2718
2011/3/1,宜蘭縣,南澳鄉,1820,6018,3202,2816
2011/3/1,桃園市,桃園區,144440,407273,199457,207816
2011/3/1,桃園市,中壢區,127497,370087,184736,185351
2011/3/1,桃園市,平鎮區,67025,207699,104551,103148
2011/3/1,桃園市,八德區,58466,176906,89913,86993
2011/3/1,桃園市,楊梅區,48960,151013,76771,74242
2011/3/1,桃園市,大溪區,29299,92003,47422,44581
2011/3/1,桃園市,蘆竹區,48406,142212,71347,70865
2011/3/1,桃園市,大園區,26212,81969,42526,39443
2011/3/1,桃園市,龜山區,50362,137941,69891,68050
2011/3/1,桃園市,龍潭區,37020,115021,58333,56688
2011/3/1,桃園市,新屋區,14993,49001,26199,22802
2011/3/1,桃園市,觀音區,19284,61149,32252,28897
2011/3/1,桃園市,復興區,3702,10651,5972,4679
2011/3/1,新竹縣,竹北市,47413,142806,71508,71298
2011/3/1,新竹縣,關西鎮,9261,31718,16880,14838
2011/3/1,新竹縣,新埔鎮,10369,35474,18792,16682
2011/3/1,新竹縣,竹東鎮,30663,96571,48669,47902
2011/3/1,新竹縣,湖口鄉,23514,75597,38641,36956
2011/3/1,新竹縣,橫山鄉,4433,14318,7737,6581
2011/3/1,新竹縣,新豐鄉,15824,53320,27482,25838
2011/3/1,新竹縣,芎林鄉,6288,20671,10914,9757
2011/3/1,新竹縣,寶山鄉,4718,14097,7613,6484
2011/3/1,新竹縣,北埔鄉,3095,10081,5461,4620
2011/3/1,新竹縣,峨眉鄉,2029,5976,3303,2673
2011/3/1,新竹縣,尖石鄉,2701,8555,4647,3908
2011/3/1,新竹縣,五峰鄉,1720,4654,2561,2093
2011/3/1,苗栗縣,苗栗市,29233,90704,45663,45041
2011/3/1,苗栗縣,苑裡鎮,13864,48557,25371,23186
2011/3/1,苗栗縣,通霄鎮,11351,37857,20072,17785
2011/3/1,苗栗縣,竹南鎮,24294,78599,39940,38659
2011/3/1,苗栗縣,頭份市,29751,97401,49460,47941
2011/3/1,苗栗縣,後龍鎮,11721,39283,20797,18486
2011/3/1,苗栗縣,卓蘭鎮,5975,18417,9709,8708
2011/3/1,苗栗縣,大湖鄉,5322,16036,8545,7491
2011/3/1,苗栗縣,公館鄉,10222,34722,18208,16514
2011/3/1,苗栗縣,銅鑼鄉,5977,19359,10271,9088
2011/3/1,苗栗縣,南庄鄉,4009,11091,6128,4963
2011/3/1,苗栗縣,頭屋鄉,3533,11588,6115,5473
2011/3/1,苗栗縣,三義鄉,5283,17522,9239,8283
2011/3/1,苗栗縣,西湖鄉,2668,7840,4348,3492
2011/3/1,苗栗縣,造橋鄉,4032,13714,7204,6510
2011/3/1,苗栗縣,三灣鄉,2399,7254,3951,3303
2011/3/1,苗栗縣,獅潭鄉,1683,4883,2728,2155
2011/3/1,苗栗縣,泰安鄉,1939,5975,3239,2736
2011/3/1,彰化縣,彰化市,71991,236380,117677,118703
2011/3/1,彰化縣,鹿港鎮,22372,85350,43751,41599
2011/3/1,彰化縣,和美鎮,24221,89858,45992,43866
2011/3/1,彰化縣,北斗鎮,9973,33513,16966,16547
2011/3/1,彰化縣,員林市,36787,125414,63037,62377
2011/3/1,彰化縣,溪湖鎮,15151,56130,28669,27461
2011/3/1,彰化縣,田中鎮,12536,43885,22800,21085
2011/3/1,彰化縣,二林鎮,14329,53833,27798,26035
2011/3/1,彰化縣,線西鄉,4140,17088,8795,8293
2011/3/1,彰化縣,伸港鄉,8997,35929,18475,17454
2011/3/1,彰化縣,福興鄉,12101,48850,25543,23307
2011/3/1,彰化縣,秀水鄉,9800,39167,20280,18887
2011/3/1,彰化縣,花壇鄉,13007,46090,23751,22339
2011/3/1,彰化縣,芬園鄉,6871,24735,13128,11607
2011/3/1,彰化縣,大村鄉,10292,36572,19061,17511
2011/3/1,彰化縣,埔鹽鄉,8828,34220,17948,16272
2011/3/1,彰化縣,埔心鄉,9949,35286,18264,17022
2011/3/1,彰化縣,永靖鄉,10436,39148,20288,18860
2011/3/1,彰化縣,社頭鄉,12319,44670,22938,21732
2011/3/1,彰化縣,二水鄉,5312,16484,8645,7839
2011/3/1,彰化縣,田尾鄉,7688,28583,14893,13690
2011/3/1,彰化縣,埤頭鄉,8612,31705,16531,15174
2011/3/1,彰化縣,芳苑鄉,9977,36100,19125,16975
2011/3/1,彰化縣,大城鄉,5411,18880,10256,8624
2011/3/1,彰化縣,竹塘鄉,4583,16403,8634,7769
2011/3/1,彰化縣,溪州鄉,8670,31471,16603,14868
2011/3/1,南投縣,南投市,33359,104013,52347,51666
2011/3/1,南投縣,埔里鎮,28358,84961,42903,42058
2011/3/1,南投縣,草屯鎮,30993,99557,50336,49221
2011/3/1,南投縣,竹山鎮,19102,58238,30026,28212
2011/3/1,南投縣,集集鎮,4293,11865,6232,5633
2011/3/1,南投縣,名間鄉,12151,41161,21604,19557
2011/3/1,南投縣,鹿谷鄉,6802,19064,10134,8930
2011/3/1,南投縣,中寮鄉,5626,16121,8765,7356
2011/3/1,南投縣,魚池鄉,5780,17132,9030,8102
2011/3/1,南投縣,國姓鄉,7225,20585,11222,9363
2011/3/1,南投縣,水里鄉,7241,19977,10484,9493
2011/3/1,南投縣,信義鄉,5244,17260,9316,7944
2011/3/1,南投縣,仁愛鄉,4926,15619,8140,7479
2011/3/1,雲林縣,斗六市,34952,107002,53810,53192
2011/3/1,雲林縣,斗南鎮,15274,47076,23949,23127
2011/3/1,雲林縣,虎尾鎮,22616,70025,35628,34397
2011/3/1,雲林縣,西螺鎮,14020,48431,24614,23817
2011/3/1,雲林縣,土庫鎮,8757,30408,15897,14511
2011/3/1,雲林縣,北港鎮,15379,42949,22368,20581
2011/3/1,雲林縣,古坑鄉,10651,33899,17922,15977
2011/3/1,雲林縣,大埤鄉,6651,21114,11335,9779
2011/3/1,雲林縣,莿桐鄉,9057,30377,15917,14460
2011/3/1,雲林縣,林內鄉,5767,19694,10275,9419
2011/3/1,雲林縣,二崙鄉,8759,29565,15851,13714
2011/3/1,雲林縣,崙背鄉,8313,27194,14328,12866
2011/3/1,雲林縣,麥寮鄉,12629,37527,19532,17995
2011/3/1,雲林縣,東勢鄉,5700,16662,9076,7586
2011/3/1,雲林縣,褒忠鄉,4298,14163,7540,6623
2011/3/1,雲林縣,臺西鄉,8927,26104,14032,12072
2011/3/1,雲林縣,元長鄉,9319,28680,15628,13052
2011/3/1,雲林縣,四湖鄉,9059,26609,14502,12107
2011/3/1,雲林縣,口湖鄉,9608,30217,16103,14114
2011/3/1,雲林縣,水林鄉,10371,28761,15740,13021
2011/3/1,嘉義縣,太保市,11376,36676,18907,17769
2011/3/1,嘉義縣,朴子市,14693,44116,22489,21627
2011/3/1,嘉義縣,布袋鎮,10135,29991,15372,14619
2011/3/1,嘉義縣,大林鎮,11226,33471,17201,16270
2011/3/1,嘉義縣,民雄鄉,22882,72553,37254,35299
2011/3/1,嘉義縣,溪口鄉,5392,16184,8630,7554
2011/3/1,嘉義縣,新港鄉,10415,34566,18223,16343
2011/3/1,嘉義縣,六腳鄉,9146,26211,13883,12328
2011/3/1,嘉義縣,東石鄉,9521,27537,14642,12895
2011/3/1,嘉義縣,義竹鄉,7480,21013,10893,10120
2011/3/1,嘉義縣,鹿草鄉,5752,17172,9238,7934
2011/3/1,嘉義縣,水上鄉,17402,52050,26883,25167
2011/3/1,嘉義縣,中埔鄉,15377,47519,24779,22740
2011/3/1,嘉義縣,竹崎鄉,11335,38515,20505,18010
2011/3/1,嘉義縣,梅山鄉,6680,21546,11413,10133
2011/3/1,嘉義縣,番路鄉,3958,11647,6334,5313
2011/3/1,嘉義縣,大埔鄉,1952,4631,2436,2195
2011/3/1,嘉義縣,阿里山鄉,2067,6239,3338,2901
2011/3/1,屏東縣,屏東市,72051,210611,105002,105609
2011/3/1,屏東縣,潮州鎮,18163,55497,27915,27582
2011/3/1,屏東縣,東港鎮,15769,50120,25369,24751
2011/3/1,屏東縣,恆春鎮,10802,31101,15952,15149
2011/3/1,屏東縣,萬丹鄉,14327,53918,27901,26017
2011/3/1,屏東縣,長治鄉,9739,30871,16136,14735
2011/3/1,屏東縣,麟洛鄉,3593,11500,5968,5532
2011/3/1,屏東縣,九如鄉,6577,22814,11871,10943
2011/3/1,屏東縣,里港鄉,7877,25868,13274,12594
2011/3/1,屏東縣,鹽埔鄉,7728,27258,14138,13120
2011/3/1,屏東縣,高樹鄉,9435,26666,14244,12422
2011/3/1,屏東縣,萬巒鄉,6417,21894,11545,10349
2011/3/1,屏東縣,內埔鄉,17778,57875,30103,27772
2011/3/1,屏東縣,竹田鄉,5581,18338,9731,8607
2011/3/1,屏東縣,新埤鄉,3367,10668,5673,4995
2011/3/1,屏東縣,枋寮鄉,8479,26478,13923,12555
2011/3/1,屏東縣,新園鄉,11525,38109,19705,18404
2011/3/1,屏東縣,崁頂鄉,4246,17292,8838,8454
2011/3/1,屏東縣,林邊鄉,7208,20739,10680,10059
2011/3/1,屏東縣,南州鄉,3665,11663,5978,5685
2011/3/1,屏東縣,佳冬鄉,7164,21316,11118,10198
2011/3/1,屏東縣,琉球鄉,3990,12268,6827,5441
2011/3/1,屏東縣,車城鄉,3513,9595,5181,4414
2011/3/1,屏東縣,滿州鄉,3045,8387,4625,3762
2011/3/1,屏東縣,枋山鄉,2100,6039,3240,2799
2011/3/1,屏東縣,三地門鄉,2194,7603,3893,3710
2011/3/1,屏東縣,霧臺鄉,987,2979,1573,1406
2011/3/1,屏東縣,瑪家鄉,1901,6539,3421,3118
2011/3/1,屏東縣,泰武鄉,1233,5086,2664,2422
2011/3/1,屏東縣,來義鄉,2159,7716,3957,3759
2011/3/1,屏東縣,春日鄉,1332,4838,2521,2317
2011/3/1,屏東縣,獅子鄉,1463,4845,2561,2284
2011/3/1,屏東縣,牡丹鄉,1881,4971,2584,2387
2011/3/1,臺東縣,臺東市,38058,108798,55086,53712
2011/3/1,臺東縣,成功鎮,5423,15722,8373,7349
2011/3/1,臺東縣,關山鎮,3230,9681,5072,4609
2011/3/1,臺東縣,卑南鄉,6628,18202,9835,8367
2011/3/1,臺東縣,大武鄉,2526,6938,3636,3302
2011/3/1,臺東縣,太麻里鄉,4536,11958,6384,5574
2011/3/1,臺東縣,東河鄉,3592,9292,5174,4118
2011/3/1,臺東縣,長濱鄉,2935,8232,4688,3544
2011/3/1,臺東縣,鹿野鄉,3140,8526,4629,3897
2011/3/1,臺東縣,池上鄉,3263,9147,4842,4305
2011/3/1,臺東縣,綠島鄉,1004,3357,1797,1560
2011/3/1,臺東縣,延平鄉,1072,3578,1969,1609
2011/3/1,臺東縣,海端鄉,1095,4490,2437,2053
2011/3/1,臺東縣,達仁鄉,1507,4090,2230,1860
2011/3/1,臺東縣,金峰鄉,1052,3572,1861,1711
2011/3/1,臺東縣,蘭嶼鄉,1468,4557,2351,2206
2011/3/1,花蓮縣,花蓮市,40505,108926,53345,55581
2011/3/1,花蓮縣,鳳林鎮,4448,11895,6281,5614
2011/3/1,花蓮縣,玉里鎮,8904,26764,14473,12291
2011/3/1,花蓮縣,新城鄉,7342,20250,10488,9762
2011/3/1,花蓮縣,吉安鄉,29099,79941,40874,39067
2011/3/1,花蓮縣,壽豐鄉,6836,18653,10081,8572
2011/3/1,花蓮縣,光復鄉,5028,14063,7512,6551
2011/3/1,花蓮縣,豐濱鄉,1803,5011,2777,2234
2011/3/1,花蓮縣,瑞穗鄉,4644,12806,6903,5903
2011/3/1,花蓮縣,富里鄉,4005,11609,6346,5263
2011/3/1,花蓮縣,秀林鄉,4668,15211,7903,7308
2011/3/1,花蓮縣,萬榮鄉,2134,6818,3636,3182
2011/3/1,花蓮縣,卓溪鄉,1662,6329,3525,2804
2011/3/1,澎湖縣,馬公市,20337,57042,28856,28186
2011/3/1,澎湖縣,湖西鄉,4797,13635,7117,6518
2011/3/1,澎湖縣,白沙鄉,3162,9418,4953,4465
2011/3/1,澎湖縣,西嶼鄉,2859,8409,4349,4060
2011/3/1,澎湖縣,望安鄉,1903,4728,2557,2171
2011/3/1,澎湖縣,七美鄉,1243,3557,1859,1698
2011/3/1,基隆市,中正區,22051,55058,28179,26879
2011/3/1,基隆市,七堵區,20077,55003,27882,27121
2011/3/1,基隆市,暖暖區,14410,37969,19253,18716
2011/3/1,基隆市,仁愛區,19753,49312,24350,24962
2011/3/1,基隆市,中山區,19080,50630,25836,24794
2011/3/1,基隆市,安樂區,31733,83819,41762,42057
2011/3/1,基隆市,信義區,20094,51074,25586,25488
2011/3/1,新竹市,東區,68734,197809,97604,100205
2011/3/1,新竹市,北區,50702,145568,71853,73715
2011/3/1,新竹市,香山區,23101,72814,37180,35634
2011/3/1,嘉義市,東區,44158,125102,61060,64042
2011/3/1,嘉義市,西區,51180,147079,72820,74259
2011/3/1,金門縣,金城鎮,10981,32596,16600,15996
2011/3/1,金門縣,金湖鎮,7329,21464,11014,10450
2011/3/1,金門縣,金沙鎮,5384,15492,7864,7628
2011/3/1,金門縣,金寧鄉,6218,19076,9877,9199
2011/3/1,金門縣,烈嶼鄉,2632,9007,4550,4457
2011/3/1,金門縣,烏坵鄉,135,551,276,275
2011/3/1,連江縣,南竿鄉,1221,5908,3399,2509
2011/3/1,連江縣,北竿鄉,392,1815,1034,781
2011/3/1,連江縣,莒光鄉,243,1172,701,471
2011/3/1,連江縣,東引鄉,277,1075,634,441
2011/4/1,總計,新北市,1412330,3900199,1935259,1964940
2011/4/1,總計,臺北市,987697,2630285,1267640,1362645
2011/4/1,總計,臺中市,857431,2652435,1320323,1332112
2011/4/1,總計,臺南市,642606,1873193,943119,930074
2011/4/1,總計,高雄市,1026340,2772981,1389663,1383318
2011/4/1,總計,臺灣省,3009580,9232596,4719838,4512758
2011/4/1,總計,宜蘭縣,154751,459746,234251,225495
2011/4/1,總計,桃園市,676785,2003618,1009580,994038
2011/4/1,總計,新竹縣,162375,514228,264325,249903
2011/4/1,總計,苗栗縣,173411,560791,290924,269867
2011/4/1,總計,彰化縣,364692,1305243,669491,635752
2011/4/1,總計,南投縣,171293,525286,270342,254944
2011/4/1,總計,雲林縣,230248,716101,373814,342287
2011/4/1,總計,嘉義縣,176925,541148,282205,258943
2011/4/1,總計,屏東縣,277424,870567,447609,422958
2011/4/1,總計,臺東縣,80559,229949,120235,109714
2011/4/1,總計,花蓮縣,121295,338048,174011,164037
2011/4/1,總計,澎湖縣,34308,96676,49642,47034
2011/4/1,總計,基隆市,147274,382551,192700,189851
2011/4/1,總計,新竹市,142786,416426,206807,209619
2011/4/1,總計,嘉義市,95454,272218,133902,138316
2011/4/1,總計,福建省,34937,108632,56123,52509
2011/4/1,總計,金門縣,32796,98641,50344,48297
2011/4/1,總計,連江縣,2141,9991,5779,4212
2011/4/1,新北市,板橋區,195077,554165,273898,280267
2011/4/1,新北市,三重區,140837,389553,194049,195504
2011/4/1,新北市,中和區,155820,414005,204251,209754
2011/4/1,新北市,永和區,89753,234146,112347,121799
2011/4/1,新北市,新莊區,137508,402468,198742,203726
2011/4/1,新北市,新店區,116777,296192,144815,151377
2011/4/1,新北市,樹林區,60519,177349,89354,87995
2011/4/1,新北市,鶯歌區,27619,87059,44052,43007
2011/4/1,新北市,三峽區,35949,104185,53122,51063
2011/4/1,新北市,淡水區,58217,144546,70285,74261
2011/4/1,新北市,汐止區,79451,189661,94149,95512
2011/4/1,新北市,瑞芳區,15872,42191,21532,20659
2011/4/1,新北市,土城區,82292,238468,119228,119240
2011/4/1,新北市,蘆洲區,65666,197707,97968,99739
2011/4/1,新北市,五股區,27390,79943,40524,39419
2011/4/1,新北市,泰山區,26255,76703,38535,38168
2011/4/1,新北市,林口區,31235,84420,41679,42741
2011/4/1,新北市,深坑區,8911,23382,11774,11608
2011/4/1,新北市,石碇區,3317,7881,4401,3480
2011/4/1,新北市,坪林區,2450,6538,3635,2903
2011/4/1,新北市,三芝區,8895,23257,12029,11228
2011/4/1,新北市,石門區,4114,12749,6690,6059
2011/4/1,新北市,八里區,12357,34942,17709,17233
2011/4/1,新北市,平溪區,2397,5275,2954,2321
2011/4/1,新北市,雙溪區,3814,9645,5246,4399
2011/4/1,新北市,貢寮區,4401,13675,7035,6640
2011/4/1,新北市,金山區,6721,22366,11208,11158
2011/4/1,新北市,萬里區,7026,21921,11111,10810
2011/4/1,新北市,烏來區,1690,5807,2937,2870
2011/4/1,臺北市,松山區,78161,209386,99284,110102
2011/4/1,臺北市,信義區,86121,225670,108622,117048
2011/4/1,臺北市,大安區,117195,312571,147117,165454
2011/4/1,臺北市,中山區,92436,221461,104173,117288
2011/4/1,臺北市,中正區,62555,160342,77305,83037
2011/4/1,臺北市,大同區,47831,125472,61762,63710
2011/4/1,臺北市,萬華區,74417,189344,94273,95071
2011/4/1,臺北市,文山區,97556,263536,127663,135873
2011/4/1,臺北市,南港區,42029,114597,56341,58256
2011/4/1,臺北市,內湖區,97807,272284,131215,141069
2011/4/1,臺北市,士林區,101401,285493,138557,146936
2011/4/1,臺北市,北投區,90188,250129,121328,128801
2011/4/1,臺中市,中區,8333,22252,10974,11278
2011/4/1,臺中市,東區,25853,73765,37236,36529
2011/4/1,臺中市,南區,42281,113765,55156,58609
2011/4/1,臺中市,西區,43387,117138,56251,60887
2011/4/1,臺中市,北區,56105,147646,71452,76194
2011/4/1,臺中市,西屯區,73655,207340,100508,106832
2011/4/1,臺中市,南屯區,53588,154266,74479,79787
2011/4/1,臺中市,北屯區,84506,248227,120516,127711
2011/4/1,臺中市,豐原區,49942,165358,82055,83303
2011/4/1,臺中市,東勢區,16994,53091,27552,25539
2011/4/1,臺中市,大甲區,21711,78389,39753,38636
2011/4/1,臺中市,清水區,25060,85672,44215,41457
2011/4/1,臺中市,沙鹿區,24091,82108,41762,40346
2011/4/1,臺中市,梧棲區,16036,55274,28027,27247
2011/4/1,臺中市,后里區,14870,54166,27788,26378
2011/4/1,臺中市,神岡區,17741,63796,32790,31006
2011/4/1,臺中市,潭子區,32682,100834,50235,50599
2011/4/1,臺中市,大雅區,26451,90084,45378,44706
2011/4/1,臺中市,新社區,7357,25551,13368,12183
2011/4/1,臺中市,石岡區,4854,15916,8289,7627
2011/4/1,臺中市,外埔區,8887,32010,16461,15549
2011/4/1,臺中市,大安區,5271,20157,10592,9565
2011/4/1,臺中市,烏日區,20699,68924,34886,34038
2011/4/1,臺中市,大肚區,15908,55706,28612,27094
2011/4/1,臺中市,龍井區,20765,74303,37771,36532
2011/4/1,臺中市,霧峰區,18813,63941,32880,31061
2011/4/1,臺中市,太平區,55000,173354,86947,86407
2011/4/1,臺中市,大里區,62162,198701,98580,100121
2011/4/1,臺中市,和平區,4429,10701,5810,4891
2011/4/1,臺南市,新營區,27322,78501,39132,39369
2011/4/1,臺南市,鹽水區,9961,27024,14077,12947
2011/4/1,臺南市,白河區,10968,31193,16357,14836
2011/4/1,臺南市,柳營區,7801,22506,11780,10726
2011/4/1,臺南市,後壁區,8810,25717,13417,12300
2011/4/1,臺南市,東山區,8224,22943,12179,10764
2011/4/1,臺南市,麻豆區,15076,45756,23369,22387
2011/4/1,臺南市,下營區,9108,25970,13454,12516
2011/4/1,臺南市,六甲區,7654,23579,12267,11312
2011/4/1,臺南市,官田區,7609,22075,11287,10788
2011/4/1,臺南市,大內區,4063,10815,5761,5054
2011/4/1,臺南市,佳里區,19436,59251,29487,29764
2011/4/1,臺南市,學甲區,9571,27700,14160,13540
2011/4/1,臺南市,西港區,7817,25097,12783,12314
2011/4/1,臺南市,七股區,8010,24797,12962,11835
2011/4/1,臺南市,將軍區,7433,21425,10897,10528
2011/4/1,臺南市,北門區,4383,12347,6298,6049
2011/4/1,臺南市,新化區,13711,44046,22563,21483
2011/4/1,臺南市,善化區,14671,43583,22051,21532
2011/4/1,臺南市,新市區,10801,34714,17447,17267
2011/4/1,臺南市,安定區,9352,30167,15643,14524
2011/4/1,臺南市,山上區,2712,7788,4106,3682
2011/4/1,臺南市,玉井區,5081,15325,7939,7386
2011/4/1,臺南市,楠西區,3569,10567,5604,4963
2011/4/1,臺南市,南化區,2831,8860,4855,4005
2011/4/1,臺南市,左鎮區,1971,5430,3019,2411
2011/4/1,臺南市,仁德區,24830,69458,35662,33796
2011/4/1,臺南市,歸仁區,20609,65872,33615,32257
2011/4/1,臺南市,關廟區,10722,35859,18599,17260
2011/4/1,臺南市,龍崎區,1599,4384,2367,2017
2011/4/1,臺南市,永康區,75546,217750,108123,109627
2011/4/1,臺南市,東區,71107,194231,93935,100296
2011/4/1,臺南市,南區,43436,126023,63200,62823
2011/4/1,臺南市,北區,48364,131871,64998,66873
2011/4/1,臺南市,安南區,54917,178556,90776,87780
2011/4/1,臺南市,安平區,23273,62775,30048,32727
2011/4/1,臺南市,中西區,30258,79238,38902,40336
2011/4/1,高雄市,鹽埕區,11172,27291,13668,13623
2011/4/1,高雄市,鼓山區,52459,131736,64508,67228
2011/4/1,高雄市,左營區,74161,192323,94571,97752
2011/4/1,高雄市,楠梓區,62081,173288,85948,87340
2011/4/1,高雄市,三民區,131889,353069,172643,180426
2011/4/1,高雄市,新興區,22880,54984,26727,28257
2011/4/1,高雄市,前金區,12545,28702,13947,14755
2011/4/1,高雄市,苓雅區,71871,183097,89109,93988
2011/4/1,高雄市,前鎮區,76668,198621,98540,100081
2011/4/1,高雄市,旗津區,10991,29887,15540,14347
2011/4/1,高雄市,小港區,63470,154404,77562,76842
2011/4/1,高雄市,鳳山區,127706,342801,170601,172200
2011/4/1,高雄市,林園區,24173,70401,36121,34280
2011/4/1,高雄市,大寮區,38511,109066,56645,52421
2011/4/1,高雄市,大樹區,13085,43864,22672,21192
2011/4/1,高雄市,大社區,11770,33091,16991,16100
2011/4/1,高雄市,仁武區,26351,73175,37716,35459
2011/4/1,高雄市,鳥松區,16682,42791,21726,21065
2011/4/1,高雄市,岡山區,33323,97183,48798,48385
2011/4/1,高雄市,橋頭區,12714,36645,18769,17876
2011/4/1,高雄市,燕巢區,10034,30837,16442,14395
2011/4/1,高雄市,田寮區,3543,8129,4527,3602
2011/4/1,高雄市,阿蓮區,9185,30331,15290,15041
2011/4/1,高雄市,路竹區,16101,53696,27362,26334
2011/4/1,高雄市,湖內區,9609,28785,14814,13971
2011/4/1,高雄市,茄萣區,10148,31309,16320,14989
2011/4/1,高雄市,永安區,5846,14223,7237,6986
2011/4/1,高雄市,彌陀區,6639,20356,10576,9780
2011/4/1,高雄市,梓官區,12103,36652,19046,17606
2011/4/1,高雄市,旗山區,13857,39823,20750,19073
2011/4/1,高雄市,美濃區,14203,42831,22360,20471
2011/4/1,高雄市,六龜區,5769,14653,7929,6724
2011/4/1,高雄市,甲仙區,2507,7140,3830,3310
2011/4/1,高雄市,杉林區,4442,11930,6510,5420
2011/4/1,高雄市,內門區,5031,15842,8642,7200
2011/4/1,高雄市,茂林區,577,1853,930,923
2011/4/1,高雄市,桃源區,1361,4810,2558,2252
2011/4/1,高雄市,那瑪夏區,883,3362,1738,1624
2011/4/1,宜蘭縣,宜蘭市,33222,95503,46973,48530
2011/4/1,宜蘭縣,羅東鎮,25026,72976,35029,37947
2011/4/1,宜蘭縣,蘇澳鎮,13648,42702,21888,20814
2011/4/1,宜蘭縣,頭城鎮,9730,30737,15903,14834
2011/4/1,宜蘭縣,礁溪鄉,12423,35884,18780,17104
2011/4/1,宜蘭縣,壯圍鄉,8147,24844,13101,11743
2011/4/1,宜蘭縣,員山鄉,10830,32305,17304,15001
2011/4/1,宜蘭縣,冬山鄉,17461,52668,27104,25564
2011/4/1,宜蘭縣,五結鄉,13086,38849,20206,18643
2011/4/1,宜蘭縣,三星鄉,7526,21302,11512,9790
2011/4/1,宜蘭縣,大同鄉,1831,5974,3255,2719
2011/4/1,宜蘭縣,南澳鄉,1821,6002,3196,2806
2011/4/1,桃園市,桃園區,144814,407757,199713,208044
2011/4/1,桃園市,中壢區,127763,370376,184831,185545
2011/4/1,桃園市,平鎮區,67118,207715,104557,103158
2011/4/1,桃園市,八德區,58510,176843,89869,86974
2011/4/1,桃園市,楊梅區,49038,151044,76758,74286
2011/4/1,桃園市,大溪區,29306,92004,47372,44632
2011/4/1,桃園市,蘆竹區,48525,142306,71365,70941
2011/4/1,桃園市,大園區,26268,81987,42528,39459
2011/4/1,桃園市,龜山區,50429,137910,69857,68053
2011/4/1,桃園市,龍潭區,37029,114955,58332,56623
2011/4/1,桃園市,新屋區,14992,48950,26181,22769
2011/4/1,桃園市,觀音區,19296,61172,32279,28893
2011/4/1,桃園市,復興區,3697,10599,5938,4661
2011/4/1,新竹縣,竹北市,47630,143314,71726,71588
2011/4/1,新竹縣,關西鎮,9274,31707,16871,14836
2011/4/1,新竹縣,新埔鎮,10379,35452,18778,16674
2011/4/1,新竹縣,竹東鎮,30717,96614,48673,47941
2011/4/1,新竹縣,湖口鄉,23542,75565,38629,36936
2011/4/1,新竹縣,橫山鄉,4428,14301,7734,6567
2011/4/1,新竹縣,新豐鄉,15852,53346,27472,25874
2011/4/1,新竹縣,芎林鄉,6285,20632,10881,9751
2011/4/1,新竹縣,寶山鄉,4727,14081,7599,6482
2011/4/1,新竹縣,北埔鄉,3093,10081,5467,4614
2011/4/1,新竹縣,峨眉鄉,2032,5961,3302,2659
2011/4/1,新竹縣,尖石鄉,2701,8530,4643,3887
2011/4/1,新竹縣,五峰鄉,1715,4644,2550,2094
2011/4/1,苗栗縣,苗栗市,29249,90689,45650,45039
2011/4/1,苗栗縣,苑裡鎮,13860,48535,25353,23182
2011/4/1,苗栗縣,通霄鎮,11364,37813,20043,17770
2011/4/1,苗栗縣,竹南鎮,24340,78688,39979,38709
2011/4/1,苗栗縣,頭份市,29831,97555,49524,48031
2011/4/1,苗栗縣,後龍鎮,11719,39214,20750,18464
2011/4/1,苗栗縣,卓蘭鎮,5964,18379,9689,8690
2011/4/1,苗栗縣,大湖鄉,5322,16023,8532,7491
2011/4/1,苗栗縣,公館鄉,10230,34730,18208,16522
2011/4/1,苗栗縣,銅鑼鄉,5970,19340,10265,9075
2011/4/1,苗栗縣,南庄鄉,4004,11086,6122,4964
2011/4/1,苗栗縣,頭屋鄉,3535,11583,6112,5471
2011/4/1,苗栗縣,三義鄉,5290,17527,9239,8288
2011/4/1,苗栗縣,西湖鄉,2672,7826,4343,3483
2011/4/1,苗栗縣,造橋鄉,4036,13713,7201,6512
2011/4/1,苗栗縣,三灣鄉,2402,7244,3947,3297
2011/4/1,苗栗縣,獅潭鄉,1679,4871,2721,2150
2011/4/1,苗栗縣,泰安鄉,1944,5975,3246,2729
2011/4/1,彰化縣,彰化市,72104,236471,117675,118796
2011/4/1,彰化縣,鹿港鎮,22404,85321,43727,41594
2011/4/1,彰化縣,和美鎮,24256,89853,45987,43866
2011/4/1,彰化縣,北斗鎮,9985,33500,16973,16527
2011/4/1,彰化縣,員林市,36823,125406,63031,62375
2011/4/1,彰化縣,溪湖鎮,15171,56134,28670,27464
2011/4/1,彰化縣,田中鎮,12546,43867,22808,21059
2011/4/1,彰化縣,二林鎮,14340,53813,27783,26030
2011/4/1,彰化縣,線西鄉,4138,17093,8804,8289
2011/4/1,彰化縣,伸港鄉,9009,35915,18458,17457
2011/4/1,彰化縣,福興鄉,12112,48788,25516,23272
2011/4/1,彰化縣,秀水鄉,9816,39146,20263,18883
2011/4/1,彰化縣,花壇鄉,13019,46053,23736,22317
2011/4/1,彰化縣,芬園鄉,6870,24749,13131,11618
2011/4/1,彰化縣,大村鄉,10299,36538,19041,17497
2011/4/1,彰化縣,埔鹽鄉,8827,34169,17919,16250
2011/4/1,彰化縣,埔心鄉,9955,35276,18263,17013
2011/4/1,彰化縣,永靖鄉,10434,39111,20264,18847
2011/4/1,彰化縣,社頭鄉,12318,44621,22898,21723
2011/4/1,彰化縣,二水鄉,5317,16470,8630,7840
2011/4/1,彰化縣,田尾鄉,7693,28536,14867,13669
2011/4/1,彰化縣,埤頭鄉,8619,31675,16520,15155
2011/4/1,彰化縣,芳苑鄉,9981,36055,19083,16972
2011/4/1,彰化縣,大城鄉,5408,18845,10241,8604
2011/4/1,彰化縣,竹塘鄉,4583,16392,8629,7763
2011/4/1,彰化縣,溪州鄉,8665,31446,16574,14872
2011/4/1,南投縣,南投市,33416,104067,52375,51692
2011/4/1,南投縣,埔里鎮,28391,84973,42895,42078
2011/4/1,南投縣,草屯鎮,31018,99461,50282,49179
2011/4/1,南投縣,竹山鎮,19140,58179,29976,28203
2011/4/1,南投縣,集集鎮,4297,11844,6212,5632
2011/4/1,南投縣,名間鄉,12162,41144,21591,19553
2011/4/1,南投縣,鹿谷鄉,6819,19055,10126,8929
2011/4/1,南投縣,中寮鄉,5630,16079,8746,7333
2011/4/1,南投縣,魚池鄉,5780,17115,9021,8094
2011/4/1,南投縣,國姓鄉,7217,20534,11192,9342
2011/4/1,南投縣,水里鄉,7250,19975,10480,9495
2011/4/1,南投縣,信義鄉,5245,17238,9308,7930
2011/4/1,南投縣,仁愛鄉,4928,15622,8138,7484
2011/4/1,雲林縣,斗六市,34992,107030,53811,53219
2011/4/1,雲林縣,斗南鎮,15298,47070,23942,23128
2011/4/1,雲林縣,虎尾鎮,22639,70025,35626,34399
2011/4/1,雲林縣,西螺鎮,14030,48389,24587,23802
2011/4/1,雲林縣,土庫鎮,8757,30380,15879,14501
2011/4/1,雲林縣,北港鎮,15390,42927,22357,20570
2011/4/1,雲林縣,古坑鄉,10663,33865,17901,15964
2011/4/1,雲林縣,大埤鄉,6648,21070,11307,9763
2011/4/1,雲林縣,莿桐鄉,9065,30359,15914,14445
2011/4/1,雲林縣,林內鄉,5776,19705,10277,9428
2011/4/1,雲林縣,二崙鄉,8752,29529,15831,13698
2011/4/1,雲林縣,崙背鄉,8314,27172,14315,12857
2011/4/1,雲林縣,麥寮鄉,12666,37666,19574,18092
2011/4/1,雲林縣,東勢鄉,5686,16604,9054,7550
2011/4/1,雲林縣,褒忠鄉,4294,14145,7534,6611
2011/4/1,雲林縣,臺西鄉,8908,26047,14000,12047
2011/4/1,雲林縣,元長鄉,9324,28635,15608,13027
2011/4/1,雲林縣,四湖鄉,9054,26568,14486,12082
2011/4/1,雲林縣,口湖鄉,9618,30192,16086,14106
2011/4/1,雲林縣,水林鄉,10374,28723,15725,12998
2011/4/1,嘉義縣,太保市,11404,36680,18907,17773
2011/4/1,嘉義縣,朴子市,14725,44145,22501,21644
2011/4/1,嘉義縣,布袋鎮,10131,29904,15331,14573
2011/4/1,嘉義縣,大林鎮,11239,33460,17205,16255
2011/4/1,嘉義縣,民雄鄉,22909,72533,37242,35291
2011/4/1,嘉義縣,溪口鄉,5388,16165,8623,7542
2011/4/1,嘉義縣,新港鄉,10414,34550,18220,16330
2011/4/1,嘉義縣,六腳鄉,9148,26159,13855,12304
2011/4/1,嘉義縣,東石鄉,9513,27465,14613,12852
2011/4/1,嘉義縣,義竹鄉,7471,20953,10863,10090
2011/4/1,嘉義縣,鹿草鄉,5763,17136,9223,7913
2011/4/1,嘉義縣,水上鄉,17417,52014,26859,25155
2011/4/1,嘉義縣,中埔鄉,15395,47486,24780,22706
2011/4/1,嘉義縣,竹崎鄉,11350,38502,20501,18001
2011/4/1,嘉義縣,梅山鄉,6677,21519,11397,10122
2011/4/1,嘉義縣,番路鄉,3960,11630,6322,5308
2011/4/1,嘉義縣,大埔鄉,1946,4617,2431,2186
2011/4/1,嘉義縣,阿里山鄉,2075,6230,3332,2898
2011/4/1,屏東縣,屏東市,72122,210534,104958,105576
2011/4/1,屏東縣,潮州鎮,18177,55491,27906,27585
2011/4/1,屏東縣,東港鎮,15783,50084,25360,24724
2011/4/1,屏東縣,恆春鎮,10809,31080,15936,15144
2011/4/1,屏東縣,萬丹鄉,14339,53867,27881,25986
2011/4/1,屏東縣,長治鄉,9744,30844,16114,14730
2011/4/1,屏東縣,麟洛鄉,3587,11468,5940,5528
2011/4/1,屏東縣,九如鄉,6581,22788,11849,10939
2011/4/1,屏東縣,里港鄉,7875,25836,13258,12578
2011/4/1,屏東縣,鹽埔鄉,7731,27233,14140,13093
2011/4/1,屏東縣,高樹鄉,9429,26642,14236,12406
2011/4/1,屏東縣,萬巒鄉,6422,21879,11538,10341
2011/4/1,屏東縣,內埔鄉,17798,57846,30075,27771
2011/4/1,屏東縣,竹田鄉,5573,18292,9711,8581
2011/4/1,屏東縣,新埤鄉,3364,10646,5659,4987
2011/4/1,屏東縣,枋寮鄉,8475,26429,13886,12543
2011/4/1,屏東縣,新園鄉,11525,38071,19684,18387
2011/4/1,屏東縣,崁頂鄉,4248,17220,8803,8417
2011/4/1,屏東縣,林邊鄉,7213,20709,10673,10036
2011/4/1,屏東縣,南州鄉,3667,11641,5964,5677
2011/4/1,屏東縣,佳冬鄉,7154,21265,11085,10180
2011/4/1,屏東縣,琉球鄉,3987,12227,6800,5427
2011/4/1,屏東縣,車城鄉,3514,9563,5159,4404
2011/4/1,屏東縣,滿州鄉,3042,8356,4611,3745
2011/4/1,屏東縣,枋山鄉,2101,6033,3241,2792
2011/4/1,屏東縣,三地門鄉,2198,7584,3885,3699
2011/4/1,屏東縣,霧臺鄉,992,2963,1563,1400
2011/4/1,屏東縣,瑪家鄉,1904,6543,3423,3120
2011/4/1,屏東縣,泰武鄉,1231,5083,2664,2419
2011/4/1,屏東縣,來義鄉,2166,7720,3959,3761
2011/4/1,屏東縣,春日鄉,1329,4838,2517,2321
2011/4/1,屏東縣,獅子鄉,1463,4838,2560,2278
2011/4/1,屏東縣,牡丹鄉,1881,4954,2571,2383
2011/4/1,臺東縣,臺東市,38075,108731,55041,53690
2011/4/1,臺東縣,成功鎮,5437,15712,8364,7348
2011/4/1,臺東縣,關山鎮,3228,9667,5067,4600
2011/4/1,臺東縣,卑南鄉,6631,18200,9844,8356
2011/4/1,臺東縣,大武鄉,2526,6927,3629,3298
2011/4/1,臺東縣,太麻里鄉,4545,11955,6381,5574
2011/4/1,臺東縣,東河鄉,3589,9276,5160,4116
2011/4/1,臺東縣,長濱鄉,2927,8206,4671,3535
2011/4/1,臺東縣,鹿野鄉,3136,8516,4622,3894
2011/4/1,臺東縣,池上鄉,3257,9115,4824,4291
2011/4/1,臺東縣,綠島鄉,1006,3368,1802,1566
2011/4/1,臺東縣,延平鄉,1068,3571,1962,1609
2011/4/1,臺東縣,海端鄉,1097,4467,2425,2042
2011/4/1,臺東縣,達仁鄉,1506,4080,2223,1857
2011/4/1,臺東縣,金峰鄉,1053,3568,1858,1710
2011/4/1,臺東縣,蘭嶼鄉,1478,4590,2362,2228
2011/4/1,花蓮縣,花蓮市,40627,108923,53342,55581
2011/4/1,花蓮縣,鳳林鎮,4439,11876,6272,5604
2011/4/1,花蓮縣,玉里鎮,8904,26717,14446,12271
2011/4/1,花蓮縣,新城鄉,7352,20225,10477,9748
2011/4/1,花蓮縣,吉安鄉,29198,80005,40898,39107
2011/4/1,花蓮縣,壽豐鄉,6828,18630,10073,8557
2011/4/1,花蓮縣,光復鄉,5029,13997,7475,6522
2011/4/1,花蓮縣,豐濱鄉,1799,4990,2769,2221
2011/4/1,花蓮縣,瑞穗鄉,4650,12779,6892,5887
2011/4/1,花蓮縣,富里鄉,4010,11598,6334,5264
2011/4/1,花蓮縣,秀林鄉,4672,15203,7898,7305
2011/4/1,花蓮縣,萬榮鄉,2128,6790,3621,3169
2011/4/1,花蓮縣,卓溪鄉,1659,6315,3514,2801
2011/4/1,澎湖縣,馬公市,20355,57040,28858,28182
2011/4/1,澎湖縣,湖西鄉,4785,13579,7084,6495
2011/4/1,澎湖縣,白沙鄉,3161,9385,4944,4441
2011/4/1,澎湖縣,西嶼鄉,2868,8407,4346,4061
2011/4/1,澎湖縣,望安鄉,1898,4708,2548,2160
2011/4/1,澎湖縣,七美鄉,1241,3557,1862,1695
2011/4/1,基隆市,中正區,22040,54937,28106,26831
2011/4/1,基隆市,七堵區,20106,54996,27882,27114
2011/4/1,基隆市,暖暖區,14406,37941,19242,18699
2011/4/1,基隆市,仁愛區,19769,49304,24340,24964
2011/4/1,基隆市,中山區,19071,50526,25799,24727
2011/4/1,基隆市,安樂區,31762,83772,41745,42027
2011/4/1,基隆市,信義區,20120,51075,25586,25489
2011/4/1,新竹市,東區,68847,197981,97715,100266
2011/4/1,新竹市,北區,50808,145618,71888,73730
2011/4/1,新竹市,香山區,23131,72827,37204,35623
2011/4/1,嘉義市,東區,44202,125149,61085,64064
2011/4/1,嘉義市,西區,51252,147069,72817,74252
2011/4/1,金門縣,金城鎮,11020,32765,16665,16100
2011/4/1,金門縣,金湖鎮,7357,21592,11053,10539
2011/4/1,金門縣,金沙鎮,5406,15547,7887,7660
2011/4/1,金門縣,金寧鄉,6234,19152,9901,9251
2011/4/1,金門縣,烈嶼鄉,2644,9035,4563,4472
2011/4/1,金門縣,烏坵鄉,135,550,275,275
2011/4/1,連江縣,南竿鄉,1229,5919,3402,2517
2011/4/1,連江縣,北竿鄉,393,1823,1037,786
2011/4/1,連江縣,莒光鄉,243,1174,704,470
2011/4/1,連江縣,東引鄉,276,1075,636,439
2011/5/1,總計,新北市,1415209,3901959,1935807,1966152
2011/5/1,總計,臺北市,989544,2633044,1268856,1364188
2011/5/1,總計,臺中市,858862,2653698,1320677,1333021
2011/5/1,總計,臺南市,643366,1873368,943072,930296
2011/5/1,總計,高雄市,1027870,2772850,1389423,1383427
2011/5/1,總計,臺灣省,3013248,9230340,4718338,4512002
2011/5/1,總計,宜蘭縣,154909,459505,234086,225419
2011/5/1,總計,桃園市,677973,2004407,1009822,994585
2011/5/1,總計,新竹縣,162836,514728,264537,250191
2011/5/1,總計,苗栗縣,173655,560766,290899,269867
2011/5/1,總計,彰化縣,365086,1304675,669219,635456
2011/5/1,總計,南投縣,171392,524845,270121,254724
2011/5/1,總計,雲林縣,230323,715770,373595,342175
2011/5/1,總計,嘉義縣,177055,540664,281990,258674
2011/5/1,總計,屏東縣,277549,869617,447116,422501
2011/5/1,總計,臺東縣,80625,229703,120081,109622
2011/5/1,總計,花蓮縣,121375,337758,173831,163927
2011/5/1,總計,澎湖縣,34323,96628,49601,47027
2011/5/1,總計,基隆市,147380,382136,192513,189623
2011/5/1,總計,新竹市,143221,416962,207065,209897
2011/5/1,總計,嘉義市,95546,272176,133862,138314
2011/5/1,總計,福建省,35117,109269,56347,52922
2011/5/1,總計,金門縣,32965,99278,50562,48716
2011/5/1,總計,連江縣,2152,9991,5785,4206
2011/5/1,新北市,板橋區,195397,554271,273905,280366
2011/5/1,新北市,三重區,141086,389674,194071,195603
2011/5/1,新北市,中和區,155969,414012,204235,209777
2011/5/1,新北市,永和區,89802,233854,112155,121699
2011/5/1,新北市,新莊區,137787,402578,198790,203788
2011/5/1,新北市,新店區,116916,296125,144767,151358
2011/5/1,新北市,樹林區,60788,177714,89564,88150
2011/5/1,新北市,鶯歌區,27693,87135,44079,43056
2011/5/1,新北市,三峽區,36106,104449,53177,51272
2011/5/1,新北市,淡水區,58484,144895,70434,74461
2011/5/1,新北市,汐止區,79562,189701,94134,95567
2011/5/1,新北市,瑞芳區,15890,42202,21538,20664
2011/5/1,新北市,土城區,82448,238598,119298,119300
2011/5/1,新北市,蘆洲區,65794,197808,97986,99822
2011/5/1,新北市,五股區,27458,79988,40549,39439
2011/5/1,新北市,泰山區,26296,76741,38545,38196
2011/5/1,新北市,林口區,31479,84749,41865,42884
2011/5/1,新北市,深坑區,8944,23388,11782,11606
2011/5/1,新北市,石碇區,3321,7890,4400,3490
2011/5/1,新北市,坪林區,2452,6548,3641,2907
2011/5/1,新北市,三芝區,8906,23274,12034,11240
2011/5/1,新北市,石門區,4122,12767,6701,6066
2011/5/1,新北市,八里區,12410,35005,17721,17284
2011/5/1,新北市,平溪區,2402,5257,2944,2313
2011/5/1,新北市,雙溪區,3816,9628,5238,4390
2011/5/1,新北市,貢寮區,4400,13639,7026,6613
2011/5/1,新北市,金山區,6744,22350,11200,11150
2011/5/1,新北市,萬里區,7044,21936,11110,10826
2011/5/1,新北市,烏來區,1693,5783,2918,2865
2011/5/1,臺北市,松山區,78263,209450,99308,110142
2011/5/1,臺北市,信義區,86182,225745,108665,117080
2011/5/1,臺北市,大安區,117327,312782,147172,165610
2011/5/1,臺北市,中山區,92691,221776,104322,117454
2011/5/1,臺北市,中正區,62708,160609,77447,83162
2011/5/1,臺北市,大同區,47963,125669,61849,63820
2011/5/1,臺北市,萬華區,74503,189364,94258,95106
2011/5/1,臺北市,文山區,97746,263903,127789,136114
2011/5/1,臺北市,南港區,42161,114758,56436,58322
2011/5/1,臺北市,內湖區,98080,272823,131462,141361
2011/5/1,臺北市,士林區,101559,285737,138666,147071
2011/5/1,臺北市,北投區,90361,250428,121482,128946
2011/5/1,臺中市,中區,8300,22160,10937,11223
2011/5/1,臺中市,東區,25893,73744,37179,36565
2011/5/1,臺中市,南區,42391,113956,55242,58714
2011/5/1,臺中市,西區,43446,117221,56301,60920
2011/5/1,臺中市,北區,56118,147533,71399,76134
2011/5/1,臺中市,西屯區,73923,207814,100673,107141
2011/5/1,臺中市,南屯區,53734,154375,74502,79873
2011/5/1,臺中市,北屯區,84731,248509,120641,127868
2011/5/1,臺中市,豐原區,49992,165337,82029,83308
2011/5/1,臺中市,東勢區,16993,53046,27514,25532
2011/5/1,臺中市,大甲區,21732,78340,39743,38597
2011/5/1,臺中市,清水區,25092,85664,44184,41480
2011/5/1,臺中市,沙鹿區,24170,82238,41834,40404
2011/5/1,臺中市,梧棲區,16054,55267,28023,27244
2011/5/1,臺中市,后里區,14886,54130,27762,26368
2011/5/1,臺中市,神岡區,17758,63833,32805,31028
2011/5/1,臺中市,潭子區,32735,100886,50260,50626
2011/5/1,臺中市,大雅區,26504,90155,45390,44765
2011/5/1,臺中市,新社區,7353,25546,13359,12187
2011/5/1,臺中市,石岡區,4852,15896,8281,7615
2011/5/1,臺中市,外埔區,8896,31958,16436,15522
2011/5/1,臺中市,大安區,5276,20141,10581,9560
2011/5/1,臺中市,烏日區,20742,68980,34905,34075
2011/5/1,臺中市,大肚區,15927,55710,28586,27124
2011/5/1,臺中市,龍井區,20778,74268,37752,36516
2011/5/1,臺中市,霧峰區,18838,63954,32890,31064
2011/5/1,臺中市,太平區,55056,173429,86980,86449
2011/5/1,臺中市,大里區,62266,198930,98695,100235
2011/5/1,臺中市,和平區,4426,10678,5794,4884
2011/5/1,臺南市,新營區,27366,78493,39116,39377
2011/5/1,臺南市,鹽水區,9972,26989,14059,12930
2011/5/1,臺南市,白河區,10979,31193,16345,14848
2011/5/1,臺南市,柳營區,7802,22473,11759,10714
2011/5/1,臺南市,後壁區,8815,25685,13408,12277
2011/5/1,臺南市,東山區,8219,22902,12155,10747
2011/5/1,臺南市,麻豆區,15085,45754,23375,22379
2011/5/1,臺南市,下營區,9102,25944,13444,12500
2011/5/1,臺南市,六甲區,7660,23563,12258,11305
2011/5/1,臺南市,官田區,7617,22051,11275,10776
2011/5/1,臺南市,大內區,4060,10798,5749,5049
2011/5/1,臺南市,佳里區,19461,59247,29490,29757
2011/5/1,臺南市,學甲區,9570,27666,14145,13521
2011/5/1,臺南市,西港區,7816,25061,12760,12301
2011/5/1,臺南市,七股區,8011,24789,12960,11829
2011/5/1,臺南市,將軍區,7434,21384,10870,10514
2011/5/1,臺南市,北門區,4389,12324,6280,6044
2011/5/1,臺南市,新化區,13730,44053,22568,21485
2011/5/1,臺南市,善化區,14717,43618,22062,21556
2011/5/1,臺南市,新市區,10830,34756,17468,17288
2011/5/1,臺南市,安定區,9376,30202,15653,14549
2011/5/1,臺南市,山上區,2715,7779,4099,3680
2011/5/1,臺南市,玉井區,5080,15293,7923,7370
2011/5/1,臺南市,楠西區,3563,10536,5585,4951
2011/5/1,臺南市,南化區,2834,8837,4844,3993
2011/5/1,臺南市,左鎮區,1970,5431,3019,2412
2011/5/1,臺南市,仁德區,24859,69579,35715,33864
2011/5/1,臺南市,歸仁區,20641,65847,33597,32250
2011/5/1,臺南市,關廟區,10716,35802,18571,17231
2011/5/1,臺南市,龍崎區,1598,4376,2361,2015
2011/5/1,臺南市,永康區,75726,218085,108287,109798
2011/5/1,臺南市,東區,71148,194102,93855,100247
2011/5/1,臺南市,南區,43511,126077,63211,62866
2011/5/1,臺南市,北區,48393,131928,64991,66937
2011/5/1,臺南市,安南區,55020,178717,90858,87859
2011/5/1,臺南市,安平區,23324,62917,30119,32798
2011/5/1,臺南市,中西區,30257,79117,38838,40279
2011/5/1,高雄市,鹽埕區,11168,27249,13646,13603
2011/5/1,高雄市,鼓山區,52566,131844,64548,67296
2011/5/1,高雄市,左營區,74330,192466,94602,97864
2011/5/1,高雄市,楠梓區,62201,173463,86015,87448
2011/5/1,高雄市,三民區,132004,352833,172541,180292
2011/5/1,高雄市,新興區,22872,54880,26681,28199
2011/5/1,高雄市,前金區,12539,28657,13925,14732
2011/5/1,高雄市,苓雅區,71878,182840,88952,93888
2011/5/1,高雄市,前鎮區,76693,198453,98463,99990
2011/5/1,高雄市,旗津區,10983,29844,15518,14326
2011/5/1,高雄市,小港區,63621,154511,77606,76905
2011/5/1,高雄市,鳳山區,128018,342996,170619,172377
2011/5/1,高雄市,林園區,24195,70378,36102,34276
2011/5/1,高雄市,大寮區,38588,109072,56661,52411
2011/5/1,高雄市,大樹區,13096,43823,22656,21167
2011/5/1,高雄市,大社區,11798,33129,17019,16110
2011/5/1,高雄市,仁武區,26461,73393,37831,35562
2011/5/1,高雄市,鳥松區,16725,42910,21765,21145
2011/5/1,高雄市,岡山區,33348,97148,48752,48396
2011/5/1,高雄市,橋頭區,12773,36661,18769,17892
2011/5/1,高雄市,燕巢區,10060,30841,16457,14384
2011/5/1,高雄市,田寮區,3535,8113,4516,3597
2011/5/1,高雄市,阿蓮區,9199,30308,15293,15015
2011/5/1,高雄市,路竹區,16124,53681,27344,26337
2011/5/1,高雄市,湖內區,9627,28795,14830,13965
2011/5/1,高雄市,茄萣區,10158,31267,16296,14971
2011/5/1,高雄市,永安區,5845,14221,7238,6983
2011/5/1,高雄市,彌陀區,6657,20316,10553,9763
2011/5/1,高雄市,梓官區,12133,36656,19043,17613
2011/5/1,高雄市,旗山區,13859,39808,20726,19082
2011/5/1,高雄市,美濃區,14223,42811,22352,20459
2011/5/1,高雄市,六龜區,5774,14644,7932,6712
2011/5/1,高雄市,甲仙區,2509,7118,3821,3297
2011/5/1,高雄市,杉林區,4452,11925,6516,5409
2011/5/1,高雄市,內門區,5034,15804,8628,7176
2011/5/1,高雄市,茂林區,575,1847,926,921
2011/5/1,高雄市,桃源區,1365,4787,2541,2246
2011/5/1,高雄市,那瑪夏區,884,3358,1740,1618
2011/5/1,宜蘭縣,宜蘭市,33257,95441,46933,48508
2011/5/1,宜蘭縣,羅東鎮,25075,72984,35011,37973
2011/5/1,宜蘭縣,蘇澳鎮,13645,42649,21848,20801
2011/5/1,宜蘭縣,頭城鎮,9734,30704,15873,14831
2011/5/1,宜蘭縣,礁溪鄉,12448,35902,18785,17117
2011/5/1,宜蘭縣,壯圍鄉,8147,24812,13081,11731
2011/5/1,宜蘭縣,員山鄉,10848,32298,17302,14996
2011/5/1,宜蘭縣,冬山鄉,17479,52709,27136,25573
2011/5/1,宜蘭縣,五結鄉,13098,38793,20184,18609
2011/5/1,宜蘭縣,三星鄉,7525,21274,11504,9770
2011/5/1,宜蘭縣,大同鄉,1826,5948,3242,2706
2011/5/1,宜蘭縣,南澳鄉,1827,5991,3187,2804
2011/5/1,桃園市,桃園區,145156,408084,199825,208259
2011/5/1,桃園市,中壢區,127951,370522,184891,185631
2011/5/1,桃園市,平鎮區,67236,207816,104588,103228
2011/5/1,桃園市,八德區,58620,176883,89840,87043
2011/5/1,桃園市,楊梅區,49170,151156,76823,74333
2011/5/1,桃園市,大溪區,29325,91933,47333,44600
2011/5/1,桃園市,蘆竹區,48636,142463,71441,71022
2011/5/1,桃園市,大園區,26301,82035,42556,39479
2011/5/1,桃園市,龜山區,50499,137889,69838,68051
2011/5/1,桃園市,龍潭區,37063,114950,58332,56618
2011/5/1,桃園市,新屋區,14995,48888,26144,22744
2011/5/1,桃園市,觀音區,19335,61224,32297,28927
2011/5/1,桃園市,復興區,3686,10564,5914,4650
2011/5/1,新竹縣,竹北市,47903,143828,71980,71848
2011/5/1,新竹縣,關西鎮,9285,31668,16845,14823
2011/5/1,新竹縣,新埔鎮,10402,35402,18749,16653
2011/5/1,新竹縣,竹東鎮,30759,96686,48705,47981
2011/5/1,新竹縣,湖口鄉,23578,75659,38654,37005
2011/5/1,新竹縣,橫山鄉,4430,14269,7710,6559
2011/5/1,新竹縣,新豐鄉,15891,53393,27484,25909
2011/5/1,新竹縣,芎林鄉,6290,20630,10878,9752
2011/5/1,新竹縣,寶山鄉,4748,14070,7599,6471
2011/5/1,新竹縣,北埔鄉,3096,10063,5470,4593
2011/5/1,新竹縣,峨眉鄉,2032,5938,3287,2651
2011/5/1,新竹縣,尖石鄉,2707,8505,4635,3870
2011/5/1,新竹縣,五峰鄉,1715,4617,2541,2076
2011/5/1,苗栗縣,苗栗市,29271,90709,45653,45056
2011/5/1,苗栗縣,苑裡鎮,13877,48522,25343,23179
2011/5/1,苗栗縣,通霄鎮,11380,37775,20025,17750
2011/5/1,苗栗縣,竹南鎮,24398,78774,40030,38744
2011/5/1,苗栗縣,頭份市,29920,97653,49569,48084
2011/5/1,苗栗縣,後龍鎮,11727,39150,20707,18443
2011/5/1,苗栗縣,卓蘭鎮,5967,18338,9676,8662
2011/5/1,苗栗縣,大湖鄉,5330,15996,8512,7484
2011/5/1,苗栗縣,公館鄉,10243,34734,18215,16519
2011/5/1,苗栗縣,銅鑼鄉,5977,19350,10265,9085
2011/5/1,苗栗縣,南庄鄉,4004,11106,6127,4979
2011/5/1,苗栗縣,頭屋鄉,3527,11558,6097,5461
2011/5/1,苗栗縣,三義鄉,5291,17524,9235,8289
2011/5/1,苗栗縣,西湖鄉,2682,7817,4340,3477
2011/5/1,苗栗縣,造橋鄉,4035,13697,7197,6500
2011/5/1,苗栗縣,三灣鄉,2398,7250,3952,3298
2011/5/1,苗栗縣,獅潭鄉,1682,4865,2719,2146
2011/5/1,苗栗縣,泰安鄉,1946,5948,3237,2711
2011/5/1,彰化縣,彰化市,72187,236461,117676,118785
2011/5/1,彰化縣,鹿港鎮,22424,85296,43720,41576
2011/5/1,彰化縣,和美鎮,24299,89908,46027,43881
2011/5/1,彰化縣,北斗鎮,9990,33478,16958,16520
2011/5/1,彰化縣,員林市,36897,125362,63016,62346
2011/5/1,彰化縣,溪湖鎮,15203,56105,28670,27435
2011/5/1,彰化縣,田中鎮,12545,43800,22788,21012
2011/5/1,彰化縣,二林鎮,14358,53800,27763,26037
2011/5/1,彰化縣,線西鄉,4139,17089,8807,8282
2011/5/1,彰化縣,伸港鄉,9016,35899,18446,17453
2011/5/1,彰化縣,福興鄉,12135,48766,25504,23262
2011/5/1,彰化縣,秀水鄉,9838,39150,20251,18899
2011/5/1,彰化縣,花壇鄉,13031,46037,23713,22324
2011/5/1,彰化縣,芬園鄉,6876,24770,13139,11631
2011/5/1,彰化縣,大村鄉,10314,36497,19029,17468
2011/5/1,彰化縣,埔鹽鄉,8834,34105,17899,16206
2011/5/1,彰化縣,埔心鄉,9965,35250,18232,17018
2011/5/1,彰化縣,永靖鄉,10435,39097,20260,18837
2011/5/1,彰化縣,社頭鄉,12329,44583,22879,21704
2011/5/1,彰化縣,二水鄉,5320,16452,8618,7834
2011/5/1,彰化縣,田尾鄉,7693,28531,14865,13666
2011/5/1,彰化縣,埤頭鄉,8628,31630,16505,15125
2011/5/1,彰化縣,芳苑鄉,9974,36015,19065,16950
2011/5/1,彰化縣,大城鄉,5402,18802,10214,8588
2011/5/1,彰化縣,竹塘鄉,4589,16383,8619,7764
2011/5/1,彰化縣,溪州鄉,8665,31409,16556,14853
2011/5/1,南投縣,南投市,33454,104081,52363,51718
2011/5/1,南投縣,埔里鎮,28398,84911,42849,42062
2011/5/1,南投縣,草屯鎮,31050,99365,50242,49123
2011/5/1,南投縣,竹山鎮,19146,58120,29946,28174
2011/5/1,南投縣,集集鎮,4304,11840,6214,5626
2011/5/1,南投縣,名間鄉,12167,41097,21579,19518
2011/5/1,南投縣,鹿谷鄉,6827,19006,10093,8913
2011/5/1,南投縣,中寮鄉,5625,16053,8736,7317
2011/5/1,南投縣,魚池鄉,5777,17090,9013,8077
2011/5/1,南投縣,國姓鄉,7224,20523,11190,9333
2011/5/1,南投縣,水里鄉,7252,19952,10474,9478
2011/5/1,南投縣,信義鄉,5241,17185,9284,7901
2011/5/1,南投縣,仁愛鄉,4927,15622,8138,7484
2011/5/1,雲林縣,斗六市,35016,107008,53814,53194
2011/5/1,雲林縣,斗南鎮,15298,47022,23917,23105
2011/5/1,雲林縣,虎尾鎮,22668,70056,35647,34409
2011/5/1,雲林縣,西螺鎮,14045,48392,24572,23820
2011/5/1,雲林縣,土庫鎮,8744,30369,15859,14510
2011/5/1,雲林縣,北港鎮,15415,42908,22339,20569
2011/5/1,雲林縣,古坑鄉,10670,33843,17887,15956
2011/5/1,雲林縣,大埤鄉,6654,21035,11284,9751
2011/5/1,雲林縣,莿桐鄉,9063,30295,15869,14426
2011/5/1,雲林縣,林內鄉,5768,19792,10320,9472
2011/5/1,雲林縣,二崙鄉,8739,29491,15812,13679
2011/5/1,雲林縣,崙背鄉,8309,27136,14290,12846
2011/5/1,雲林縣,麥寮鄉,12707,37805,19634,18171
2011/5/1,雲林縣,東勢鄉,5685,16571,9037,7534
2011/5/1,雲林縣,褒忠鄉,4295,14139,7538,6601
2011/5/1,雲林縣,臺西鄉,8901,26000,13972,12028
2011/5/1,雲林縣,元長鄉,9326,28587,15585,13002
2011/5/1,雲林縣,四湖鄉,9044,26511,14460,12051
2011/5/1,雲林縣,口湖鄉,9606,30147,16066,14081
2011/5/1,雲林縣,水林鄉,10370,28663,15693,12970
2011/5/1,嘉義縣,太保市,11425,36734,18933,17801
2011/5/1,嘉義縣,朴子市,14755,44185,22509,21676
2011/5/1,嘉義縣,布袋鎮,10131,29848,15306,14542
2011/5/1,嘉義縣,大林鎮,11238,33426,17183,16243
2011/5/1,嘉義縣,民雄鄉,22931,72478,37224,35254
2011/5/1,嘉義縣,溪口鄉,5391,16149,8624,7525
2011/5/1,嘉義縣,新港鄉,10425,34525,18217,16308
2011/5/1,嘉義縣,六腳鄉,9154,26106,13839,12267
2011/5/1,嘉義縣,東石鄉,9508,27401,14587,12814
2011/5/1,嘉義縣,義竹鄉,7467,20905,10843,10062
2011/5/1,嘉義縣,鹿草鄉,5763,17099,9201,7898
2011/5/1,嘉義縣,水上鄉,17432,51981,26853,25128
2011/5/1,嘉義縣,中埔鄉,15394,47426,24727,22699
2011/5/1,嘉義縣,竹崎鄉,11365,38471,20486,17985
2011/5/1,嘉義縣,梅山鄉,6684,21483,11386,10097
2011/5/1,嘉義縣,番路鄉,3971,11625,6319,5306
2011/5/1,嘉義縣,大埔鄉,1942,4602,2420,2182
2011/5/1,嘉義縣,阿里山鄉,2079,6220,3333,2887
2011/5/1,屏東縣,屏東市,72153,210352,104845,105507
2011/5/1,屏東縣,潮州鎮,18206,55483,27893,27590
2011/5/1,屏東縣,東港鎮,15799,50002,25326,24676
2011/5/1,屏東縣,恆春鎮,10812,31024,15919,15105
2011/5/1,屏東縣,萬丹鄉,14349,53853,27865,25988
2011/5/1,屏東縣,長治鄉,9743,30810,16094,14716
2011/5/1,屏東縣,麟洛鄉,3595,11449,5936,5513
2011/5/1,屏東縣,九如鄉,6589,22813,11857,10956
2011/5/1,屏東縣,里港鄉,7877,25799,13237,12562
2011/5/1,屏東縣,鹽埔鄉,7724,27198,14121,13077
2011/5/1,屏東縣,高樹鄉,9419,26574,14203,12371
2011/5/1,屏東縣,萬巒鄉,6422,21832,11512,10320
2011/5/1,屏東縣,內埔鄉,17809,57793,30037,27756
2011/5/1,屏東縣,竹田鄉,5582,18296,9726,8570
2011/5/1,屏東縣,新埤鄉,3363,10638,5651,4987
2011/5/1,屏東縣,枋寮鄉,8475,26368,13857,12511
2011/5/1,屏東縣,新園鄉,11530,38036,19667,18369
2011/5/1,屏東縣,崁頂鄉,4246,17166,8774,8392
2011/5/1,屏東縣,林邊鄉,7222,20678,10657,10021
2011/5/1,屏東縣,南州鄉,3667,11617,5948,5669
2011/5/1,屏東縣,佳冬鄉,7153,21249,11078,10171
2011/5/1,屏東縣,琉球鄉,3993,12216,6792,5424
2011/5/1,屏東縣,車城鄉,3511,9543,5154,4389
2011/5/1,屏東縣,滿州鄉,3043,8328,4599,3729
2011/5/1,屏東縣,枋山鄉,2100,6018,3234,2784
2011/5/1,屏東縣,三地門鄉,2198,7576,3877,3699
2011/5/1,屏東縣,霧臺鄉,991,2969,1568,1401
2011/5/1,屏東縣,瑪家鄉,1908,6547,3430,3117
2011/5/1,屏東縣,泰武鄉,1232,5066,2662,2404
2011/5/1,屏東縣,來義鄉,2162,7693,3946,3747
2011/5/1,屏東縣,春日鄉,1326,4832,2515,2317
2011/5/1,屏東縣,獅子鄉,1466,4853,2571,2282
2011/5/1,屏東縣,牡丹鄉,1884,4946,2565,2381
2011/5/1,臺東縣,臺東市,38125,108709,55035,53674
2011/5/1,臺東縣,成功鎮,5439,15700,8359,7341
2011/5/1,臺東縣,關山鎮,3230,9664,5061,4603
2011/5/1,臺東縣,卑南鄉,6626,18163,9805,8358
2011/5/1,臺東縣,大武鄉,2521,6903,3613,3290
2011/5/1,臺東縣,太麻里鄉,4545,11905,6359,5546
2011/5/1,臺東縣,東河鄉,3594,9264,5154,4110
2011/5/1,臺東縣,長濱鄉,2927,8176,4655,3521
2011/5/1,臺東縣,鹿野鄉,3134,8497,4607,3890
2011/5/1,臺東縣,池上鄉,3257,9090,4812,4278
2011/5/1,臺東縣,綠島鄉,1020,3389,1814,1575
2011/5/1,臺東縣,延平鄉,1068,3557,1956,1601
2011/5/1,臺東縣,海端鄉,1097,4462,2427,2035
2011/5/1,臺東縣,達仁鄉,1501,4061,2205,1856
2011/5/1,臺東縣,金峰鄉,1051,3560,1848,1712
2011/5/1,臺東縣,蘭嶼鄉,1490,4603,2371,2232
2011/5/1,花蓮縣,花蓮市,40663,108946,53364,55582
2011/5/1,花蓮縣,鳳林鎮,4434,11865,6273,5592
2011/5/1,花蓮縣,玉里鎮,8894,26682,14406,12276
2011/5/1,花蓮縣,新城鄉,7350,20177,10446,9731
2011/5/1,花蓮縣,吉安鄉,29260,80016,40901,39115
2011/5/1,花蓮縣,壽豐鄉,6837,18609,10053,8556
2011/5/1,花蓮縣,光復鄉,5032,13945,7449,6496
2011/5/1,花蓮縣,豐濱鄉,1798,4978,2762,2216
2011/5/1,花蓮縣,瑞穗鄉,4652,12755,6879,5876
2011/5/1,花蓮縣,富里鄉,4006,11561,6312,5249
2011/5/1,花蓮縣,秀林鄉,4663,15171,7877,7294
2011/5/1,花蓮縣,萬榮鄉,2128,6771,3608,3163
2011/5/1,花蓮縣,卓溪鄉,1658,6282,3501,2781
2011/5/1,澎湖縣,馬公市,20365,56992,28824,28168
2011/5/1,澎湖縣,湖西鄉,4789,13575,7077,6498
2011/5/1,澎湖縣,白沙鄉,3166,9395,4948,4447
2011/5/1,澎湖縣,西嶼鄉,2864,8409,4344,4065
2011/5/1,澎湖縣,望安鄉,1897,4688,2537,2151
2011/5/1,澎湖縣,七美鄉,1242,3569,1871,1698
2011/5/1,基隆市,中正區,22050,54882,28082,26800
2011/5/1,基隆市,七堵區,20143,54989,27882,27107
2011/5/1,基隆市,暖暖區,14413,37936,19244,18692
2011/5/1,基隆市,仁愛區,19800,49254,24312,24942
2011/5/1,基隆市,中山區,19088,50457,25763,24694
2011/5/1,基隆市,安樂區,31779,83663,41704,41959
2011/5/1,基隆市,信義區,20107,50955,25526,25429
2011/5/1,新竹市,東區,69051,198290,97883,100407
2011/5/1,新竹市,北區,50971,145745,71941,73804
2011/5/1,新竹市,香山區,23199,72927,37241,35686
2011/5/1,嘉義市,東區,44236,125114,61073,64041
2011/5/1,嘉義市,西區,51310,147062,72789,74273
2011/5/1,金門縣,金城鎮,11088,33012,16755,16257
2011/5/1,金門縣,金湖鎮,7394,21768,11125,10643
2011/5/1,金門縣,金沙鎮,5432,15643,7921,7722
2011/5/1,金門縣,金寧鄉,6258,19206,9907,9299
2011/5/1,金門縣,烈嶼鄉,2658,9093,4576,4517
2011/5/1,金門縣,烏坵鄉,135,556,278,278
2011/5/1,連江縣,南竿鄉,1235,5907,3392,2515
2011/5/1,連江縣,北竿鄉,397,1834,1049,785
2011/5/1,連江縣,莒光鄉,243,1171,708,463
2011/5/1,連江縣,東引鄉,277,1079,636,443
2011/6/1,總計,新北市,1418021,3903745,1936087,1967658
2011/6/1,總計,臺北市,991169,2635766,1269999,1365767
2011/6/1,總計,臺中市,860512,2655456,1321467,1333989
2011/6/1,總計,臺南市,644201,1874724,943593,931131
2011/6/1,總計,高雄市,1029122,2772461,1388972,1383489
2011/6/1,總計,臺灣省,3016803,9228624,4716873,4511751
2011/6/1,總計,宜蘭縣,155006,459349,233962,225387
2011/6/1,總計,桃園市,679262,2005795,1010409,995386
2011/6/1,總計,新竹縣,163231,515044,264630,250414
2011/6/1,總計,苗栗縣,173859,560813,290903,269910
2011/6/1,總計,彰化縣,365452,1304216,668870,635346
2011/6/1,總計,南投縣,171507,524426,269902,254524
2011/6/1,總計,雲林縣,230475,715288,373304,341984
2011/6/1,總計,嘉義縣,177203,540059,281639,258420
2011/6/1,總計,屏東縣,277715,868827,446641,422186
2011/6/1,總計,臺東縣,80663,229420,119917,109503
2011/6/1,總計,花蓮縣,121455,337557,173712,163845
2011/6/1,總計,澎湖縣,34377,96597,49590,47007
2011/6/1,總計,基隆市,147494,381770,192346,189424
2011/6/1,總計,新竹市,143482,417335,207212,210123
2011/6/1,總計,嘉義市,95622,272128,133836,138292
2011/6/1,總計,福建省,35232,109701,56514,53187
2011/6/1,總計,金門縣,33074,99691,50715,48976
2011/6/1,總計,連江縣,2158,10010,5799,4211
2011/6/1,新北市,板橋區,195792,554410,273881,280529
2011/6/1,新北市,三重區,141308,389734,194062,195672
2011/6/1,新北市,中和區,156185,414025,204260,209765
2011/6/1,新北市,永和區,89858,233643,112013,121630
2011/6/1,新北市,新莊區,138089,402974,198913,204061
2011/6/1,新北市,新店區,117110,296106,144703,151403
2011/6/1,新北市,樹林區,61051,178042,89675,88367
2011/6/1,新北市,鶯歌區,27772,87260,44093,43167
2011/6/1,新北市,三峽區,36222,104629,53228,51401
2011/6/1,新北市,淡水區,58655,145096,70512,74584
2011/6/1,新北市,汐止區,79657,189768,94149,95619
2011/6/1,新北市,瑞芳區,15894,42208,21534,20674
2011/6/1,新北市,土城區,82603,238698,119338,119360
2011/6/1,新北市,蘆洲區,65937,197828,97922,99906
2011/6/1,新北市,五股區,27496,79981,40526,39455
2011/6/1,新北市,泰山區,26337,76782,38551,38231
2011/6/1,新北市,林口區,31675,85004,41982,43022
2011/6/1,新北市,深坑區,8960,23437,11820,11617
2011/6/1,新北市,石碇區,3321,7868,4394,3474
2011/6/1,新北市,坪林區,2456,6542,3642,2900
2011/6/1,新北市,三芝區,8936,23362,12070,11292
2011/6/1,新北市,石門區,4126,12726,6672,6054
2011/6/1,新北市,八里區,12457,35081,17754,17327
2011/6/1,新北市,平溪區,2402,5244,2938,2306
2011/6/1,新北市,雙溪區,3816,9630,5232,4398
2011/6/1,新北市,貢寮區,4407,13589,6999,6590
2011/6/1,新北市,金山區,6750,22317,11179,11138
2011/6/1,新北市,萬里區,7051,21963,11122,10841
2011/6/1,新北市,烏來區,1698,5798,2923,2875
2011/6/1,臺北市,松山區,78353,209674,99387,110287
2011/6/1,臺北市,信義區,86228,225794,108667,117127
2011/6/1,臺北市,大安區,117496,312994,147275,165719
2011/6/1,臺北市,中山區,92862,222004,104382,117622
2011/6/1,臺北市,中正區,62762,160877,77579,83298
2011/6/1,臺北市,大同區,48067,125875,61941,63934
2011/6/1,臺北市,萬華區,74657,189561,94357,95204
2011/6/1,臺北市,文山區,97952,264229,127915,136314
2011/6/1,臺北市,南港區,42245,114985,56522,58463
2011/6/1,臺北市,內湖區,98348,273261,131635,141626
2011/6/1,臺北市,士林區,101694,285821,138703,147118
2011/6/1,臺北市,北投區,90505,250691,121636,129055
2011/6/1,臺中市,中區,8282,22076,10886,11190
2011/6/1,臺中市,東區,25925,73780,37184,36596
2011/6/1,臺中市,南區,42531,114250,55379,58871
2011/6/1,臺中市,西區,43499,117183,56257,60926
2011/6/1,臺中市,北區,56131,147441,71338,76103
2011/6/1,臺中市,西屯區,74167,208214,100820,107394
2011/6/1,臺中市,南屯區,53910,154594,74636,79958
2011/6/1,臺中市,北屯區,84961,248706,120743,127963
2011/6/1,臺中市,豐原區,50050,165407,82083,83324
2011/6/1,臺中市,東勢區,17019,52984,27482,25502
2011/6/1,臺中市,大甲區,21757,78323,39727,38596
2011/6/1,臺中市,清水區,25131,85707,44201,41506
2011/6/1,臺中市,沙鹿區,24232,82349,41883,40466
2011/6/1,臺中市,梧棲區,16072,55291,28034,27257
2011/6/1,臺中市,后里區,14903,54114,27745,26369
2011/6/1,臺中市,神岡區,17797,63844,32804,31040
2011/6/1,臺中市,潭子區,32797,101033,50321,50712
2011/6/1,臺中市,大雅區,26566,90266,45466,44800
2011/6/1,臺中市,新社區,7352,25541,13351,12190
2011/6/1,臺中市,石岡區,4851,15857,8267,7590
2011/6/1,臺中市,外埔區,8907,31969,16446,15523
2011/6/1,臺中市,大安區,5282,20122,10570,9552
2011/6/1,臺中市,烏日區,20803,69076,34967,34109
2011/6/1,臺中市,大肚區,15933,55701,28586,27115
2011/6/1,臺中市,龍井區,20821,74285,37768,36517
2011/6/1,臺中市,霧峰區,18849,63910,32859,31051
2011/6/1,臺中市,太平區,55158,173550,87029,86521
2011/6/1,臺中市,大里區,62396,199191,98840,100351
2011/6/1,臺中市,和平區,4430,10692,5795,4897
2011/6/1,臺南市,新營區,27384,78528,39131,39397
2011/6/1,臺南市,鹽水區,9977,26977,14058,12919
2011/6/1,臺南市,白河區,10969,31154,16320,14834
2011/6/1,臺南市,柳營區,7792,22457,11741,10716
2011/6/1,臺南市,後壁區,8822,25683,13402,12281
2011/6/1,臺南市,東山區,8222,22871,12144,10727
2011/6/1,臺南市,麻豆區,15108,45753,23369,22384
2011/6/1,臺南市,下營區,9107,25945,13453,12492
2011/6/1,臺南市,六甲區,7674,23579,12262,11317
2011/6/1,臺南市,官田區,7614,22045,11275,10770
2011/6/1,臺南市,大內區,4063,10797,5750,5047
2011/6/1,臺南市,佳里區,19466,59227,29470,29757
2011/6/1,臺南市,學甲區,9574,27682,14160,13522
2011/6/1,臺南市,西港區,7831,25090,12776,12314
2011/6/1,臺南市,七股區,8017,24800,12962,11838
2011/6/1,臺南市,將軍區,7445,21365,10868,10497
2011/6/1,臺南市,北門區,4391,12310,6266,6044
2011/6/1,臺南市,新化區,13741,44050,22565,21485
2011/6/1,臺南市,善化區,14757,43710,22097,21613
2011/6/1,臺南市,新市區,10866,34849,17507,17342
2011/6/1,臺南市,安定區,9388,30227,15663,14564
2011/6/1,臺南市,山上區,2717,7779,4100,3679
2011/6/1,臺南市,玉井區,5075,15289,7912,7377
2011/6/1,臺南市,楠西區,3562,10522,5576,4946
2011/6/1,臺南市,南化區,2834,8834,4845,3989
2011/6/1,臺南市,左鎮區,1971,5418,3011,2407
2011/6/1,臺南市,仁德區,24901,69672,35745,33927
2011/6/1,臺南市,歸仁區,20669,65928,33632,32296
2011/6/1,臺南市,關廟區,10715,35812,18574,17238
2011/6/1,臺南市,龍崎區,1595,4364,2355,2009
2011/6/1,臺南市,永康區,75950,218664,108569,110095
2011/6/1,臺南市,東區,71194,194093,93852,100241
2011/6/1,臺南市,南區,43594,126246,63260,62986
2011/6/1,臺南市,北區,48420,131944,64985,66959
2011/6/1,臺南市,安南區,55136,178923,90971,87952
2011/6/1,臺南市,安平區,23378,63051,30170,32881
2011/6/1,臺南市,中西區,30282,79086,38797,40289
2011/6/1,高雄市,鹽埕區,11142,27125,13588,13537
2011/6/1,高雄市,鼓山區,52648,131966,64556,67410
2011/6/1,高雄市,左營區,74451,192678,94687,97991
2011/6/1,高雄市,楠梓區,62247,173457,85997,87460
2011/6/1,高雄市,三民區,132161,352729,172431,180298
2011/6/1,高雄市,新興區,22861,54816,26639,28177
2011/6/1,高雄市,前金區,12532,28584,13880,14704
2011/6/1,高雄市,苓雅區,71902,182658,88834,93824
2011/6/1,高雄市,前鎮區,76749,198206,98365,99841
2011/6/1,高雄市,旗津區,10987,29821,15498,14323
2011/6/1,高雄市,小港區,63808,154629,77634,76995
2011/6/1,高雄市,鳳山區,128264,343329,170777,172552
2011/6/1,高雄市,林園區,24241,70283,36037,34246
2011/6/1,高雄市,大寮區,38652,109024,56626,52398
2011/6/1,高雄市,大樹區,13097,43771,22625,21146
2011/6/1,高雄市,大社區,11811,33140,17029,16111
2011/6/1,高雄市,仁武區,26573,73686,37982,35704
2011/6/1,高雄市,鳥松區,16751,42946,21782,21164
2011/6/1,高雄市,岡山區,33397,97097,48713,48384
2011/6/1,高雄市,橋頭區,12810,36726,18795,17931
2011/6/1,高雄市,燕巢區,10066,30858,16473,14385
2011/6/1,高雄市,田寮區,3531,8097,4504,3593
2011/6/1,高雄市,阿蓮區,9197,30279,15277,15002
2011/6/1,高雄市,路竹區,16139,53619,27323,26296
2011/6/1,高雄市,湖內區,9639,28758,14812,13946
2011/6/1,高雄市,茄萣區,10164,31158,16246,14912
2011/6/1,高雄市,永安區,5838,14211,7230,6981
2011/6/1,高雄市,彌陀區,6654,20302,10537,9765
2011/6/1,高雄市,梓官區,12141,36641,19046,17595
2011/6/1,高雄市,旗山區,13848,39767,20697,19070
2011/6/1,高雄市,美濃區,14235,42757,22320,20437
2011/6/1,高雄市,六龜區,5774,14612,7913,6699
2011/6/1,高雄市,甲仙區,2505,7089,3809,3280
2011/6/1,高雄市,杉林區,4454,11932,6517,5415
2011/6/1,高雄市,內門區,5036,15758,8608,7150
2011/6/1,高雄市,茂林區,575,1848,930,918
2011/6/1,高雄市,桃源區,1360,4761,2521,2240
2011/6/1,高雄市,那瑪夏區,882,3343,1734,1609
2011/6/1,宜蘭縣,宜蘭市,33277,95404,46906,48498
2011/6/1,宜蘭縣,羅東鎮,25071,72953,34996,37957
2011/6/1,宜蘭縣,蘇澳鎮,13649,42621,21836,20785
2011/6/1,宜蘭縣,頭城鎮,9737,30658,15843,14815
2011/6/1,宜蘭縣,礁溪鄉,12461,35915,18800,17115
2011/6/1,宜蘭縣,壯圍鄉,8153,24803,13089,11714
2011/6/1,宜蘭縣,員山鄉,10864,32325,17296,15029
2011/6/1,宜蘭縣,冬山鄉,17498,52743,27129,25614
2011/6/1,宜蘭縣,五結鄉,13112,38759,20164,18595
2011/6/1,宜蘭縣,三星鄉,7529,21257,11487,9770
2011/6/1,宜蘭縣,大同鄉,1829,5941,3242,2699
2011/6/1,宜蘭縣,南澳鄉,1826,5970,3174,2796
2011/6/1,桃園市,桃園區,145416,408304,199895,208409
2011/6/1,桃園市,中壢區,128181,370779,184959,185820
2011/6/1,桃園市,平鎮區,67396,207953,104689,103264
2011/6/1,桃園市,八德區,58754,177020,89892,87128
2011/6/1,桃園市,楊梅區,49325,151384,76948,74436
2011/6/1,桃園市,大溪區,29334,91918,47332,44586
2011/6/1,桃園市,蘆竹區,48803,142794,71593,71201
2011/6/1,桃園市,大園區,26311,81994,42557,39437
2011/6/1,桃園市,龜山區,50569,137957,69836,68121
2011/6/1,桃園市,龍潭區,37112,114950,58334,56616
2011/6/1,桃園市,新屋區,15007,48876,26158,22718
2011/6/1,桃園市,觀音區,19373,61299,32309,28990
2011/6/1,桃園市,復興區,3681,10567,5907,4660
2011/6/1,新竹縣,竹北市,48149,144234,72165,72069
2011/6/1,新竹縣,關西鎮,9290,31635,16827,14808
2011/6/1,新竹縣,新埔鎮,10407,35356,18734,16622
2011/6/1,新竹縣,竹東鎮,30798,96665,48678,47987
2011/6/1,新竹縣,湖口鄉,23613,75712,38674,37038
2011/6/1,新竹縣,橫山鄉,4427,14258,7703,6555
2011/6/1,新竹縣,新豐鄉,15921,53379,27473,25906
2011/6/1,新竹縣,芎林鄉,6307,20622,10859,9763
2011/6/1,新竹縣,寶山鄉,4760,14071,7600,6471
2011/6/1,新竹縣,北埔鄉,3094,10055,5463,4592
2011/6/1,新竹縣,峨眉鄉,2035,5934,3282,2652
2011/6/1,新竹縣,尖石鄉,2709,8499,4631,3868
2011/6/1,新竹縣,五峰鄉,1721,4624,2541,2083
2011/6/1,苗栗縣,苗栗市,29280,90671,45627,45044
2011/6/1,苗栗縣,苑裡鎮,13894,48506,25325,23181
2011/6/1,苗栗縣,通霄鎮,11382,37716,19990,17726
2011/6/1,苗栗縣,竹南鎮,24454,78921,40104,38817
2011/6/1,苗栗縣,頭份市,29998,97721,49591,48130
2011/6/1,苗栗縣,後龍鎮,11739,39116,20685,18431
2011/6/1,苗栗縣,卓蘭鎮,5962,18328,9673,8655
2011/6/1,苗栗縣,大湖鄉,5340,15996,8509,7487
2011/6/1,苗栗縣,公館鄉,10251,34773,18232,16541
2011/6/1,苗栗縣,銅鑼鄉,5985,19354,10271,9083
2011/6/1,苗栗縣,南庄鄉,4012,11086,6122,4964
2011/6/1,苗栗縣,頭屋鄉,3528,11548,6095,5453
2011/6/1,苗栗縣,三義鄉,5296,17520,9233,8287
2011/6/1,苗栗縣,西湖鄉,2682,7823,4346,3477
2011/6/1,苗栗縣,造橋鄉,4035,13702,7204,6498
2011/6/1,苗栗縣,三灣鄉,2393,7241,3949,3292
2011/6/1,苗栗縣,獅潭鄉,1682,4864,2721,2143
2011/6/1,苗栗縣,泰安鄉,1946,5927,3226,2701
2011/6/1,彰化縣,彰化市,72264,236447,117636,118811
2011/6/1,彰化縣,鹿港鎮,22455,85275,43711,41564
2011/6/1,彰化縣,和美鎮,24332,89942,46054,43888
2011/6/1,彰化縣,北斗鎮,10007,33488,16958,16530
2011/6/1,彰化縣,員林市,36929,125279,62981,62298
2011/6/1,彰化縣,溪湖鎮,15203,56035,28626,27409
2011/6/1,彰化縣,田中鎮,12550,43800,22760,21040
2011/6/1,彰化縣,二林鎮,14374,53730,27729,26001
2011/6/1,彰化縣,線西鄉,4139,17058,8787,8271
2011/6/1,彰化縣,伸港鄉,9027,35915,18449,17466
2011/6/1,彰化縣,福興鄉,12150,48763,25487,23276
2011/6/1,彰化縣,秀水鄉,9847,39158,20279,18879
2011/6/1,彰化縣,花壇鄉,13041,45991,23678,22313
2011/6/1,彰化縣,芬園鄉,6876,24730,13116,11614
2011/6/1,彰化縣,大村鄉,10327,36485,19015,17470
2011/6/1,彰化縣,埔鹽鄉,8851,34109,17888,16221
2011/6/1,彰化縣,埔心鄉,9980,35269,18238,17031
2011/6/1,彰化縣,永靖鄉,10448,39091,20272,18819
2011/6/1,彰化縣,社頭鄉,12349,44529,22859,21670
2011/6/1,彰化縣,二水鄉,5323,16450,8621,7829
2011/6/1,彰化縣,田尾鄉,7695,28521,14858,13663
2011/6/1,彰化縣,埤頭鄉,8639,31606,16488,15118
2011/6/1,彰化縣,芳苑鄉,9976,35988,19029,16959
2011/6/1,彰化縣,大城鄉,5407,18791,10203,8588
2011/6/1,彰化縣,竹塘鄉,4593,16379,8614,7765
2011/6/1,彰化縣,溪州鄉,8670,31387,16534,14853
2011/6/1,南投縣,南投市,33475,104069,52340,51729
2011/6/1,南投縣,埔里鎮,28431,84894,42840,42054
2011/6/1,南投縣,草屯鎮,31084,99336,50235,49101
2011/6/1,南投縣,竹山鎮,19174,58082,29937,28145
2011/6/1,南投縣,集集鎮,4305,11812,6191,5621
2011/6/1,南投縣,名間鄉,12168,41024,21539,19485
2011/6/1,南投縣,鹿谷鄉,6835,18964,10068,8896
2011/6/1,南投縣,中寮鄉,5625,16046,8736,7310
2011/6/1,南投縣,魚池鄉,5767,17035,8982,8053
2011/6/1,南投縣,國姓鄉,7228,20514,11185,9329
2011/6/1,南投縣,水里鄉,7248,19927,10455,9472
2011/6/1,南投縣,信義鄉,5240,17165,9281,7884
2011/6/1,南投縣,仁愛鄉,4927,15558,8113,7445
2011/6/1,雲林縣,斗六市,35061,107012,53795,53217
2011/6/1,雲林縣,斗南鎮,15328,47012,23894,23118
2011/6/1,雲林縣,虎尾鎮,22699,70062,35648,34414
2011/6/1,雲林縣,西螺鎮,14063,48299,24558,23741
2011/6/1,雲林縣,土庫鎮,8756,30341,15863,14478
2011/6/1,雲林縣,北港鎮,15433,42885,22321,20564
2011/6/1,雲林縣,古坑鄉,10668,33818,17869,15949
2011/6/1,雲林縣,大埤鄉,6655,20986,11261,9725
2011/6/1,雲林縣,莿桐鄉,9071,30306,15870,14436
2011/6/1,雲林縣,林內鄉,5774,19785,10314,9471
2011/6/1,雲林縣,二崙鄉,8729,29470,15788,13682
2011/6/1,雲林縣,崙背鄉,8306,27099,14262,12837
2011/6/1,雲林縣,麥寮鄉,12731,37922,19691,18231
2011/6/1,雲林縣,東勢鄉,5692,16541,9030,7511
2011/6/1,雲林縣,褒忠鄉,4290,14116,7512,6604
2011/6/1,雲林縣,臺西鄉,8890,25942,13939,12003
2011/6/1,雲林縣,元長鄉,9323,28555,15571,12984
2011/6/1,雲林縣,四湖鄉,9035,26479,14443,12036
2011/6/1,雲林縣,口湖鄉,9606,30075,16022,14053
2011/6/1,雲林縣,水林鄉,10365,28583,15653,12930
2011/6/1,嘉義縣,太保市,11435,36685,18901,17784
2011/6/1,嘉義縣,朴子市,14781,44165,22493,21672
2011/6/1,嘉義縣,布袋鎮,10142,29801,15290,14511
2011/6/1,嘉義縣,大林鎮,11238,33397,17165,16232
2011/6/1,嘉義縣,民雄鄉,22957,72460,37212,35248
2011/6/1,嘉義縣,溪口鄉,5393,16141,8625,7516
2011/6/1,嘉義縣,新港鄉,10430,34504,18201,16303
2011/6/1,嘉義縣,六腳鄉,9154,26084,13819,12265
2011/6/1,嘉義縣,東石鄉,9502,27293,14516,12777
2011/6/1,嘉義縣,義竹鄉,7472,20844,10815,10029
2011/6/1,嘉義縣,鹿草鄉,5775,17117,9205,7912
2011/6/1,嘉義縣,水上鄉,17453,51898,26802,25096
2011/6/1,嘉義縣,中埔鄉,15419,47383,24705,22678
2011/6/1,嘉義縣,竹崎鄉,11374,38442,20468,17974
2011/6/1,嘉義縣,梅山鄉,6684,21430,11362,10068
2011/6/1,嘉義縣,番路鄉,3969,11597,6309,5288
2011/6/1,嘉義縣,大埔鄉,1944,4605,2423,2182
2011/6/1,嘉義縣,阿里山鄉,2081,6213,3328,2885
2011/6/1,屏東縣,屏東市,72218,210275,104743,105532
2011/6/1,屏東縣,潮州鎮,18236,55471,27879,27592
2011/6/1,屏東縣,東港鎮,15823,49960,25298,24662
2011/6/1,屏東縣,恆春鎮,10826,30987,15907,15080
2011/6/1,屏東縣,萬丹鄉,14359,53774,27823,25951
2011/6/1,屏東縣,長治鄉,9750,30796,16100,14696
2011/6/1,屏東縣,麟洛鄉,3595,11437,5931,5506
2011/6/1,屏東縣,九如鄉,6593,22797,11846,10951
2011/6/1,屏東縣,里港鄉,7874,25785,13236,12549
2011/6/1,屏東縣,鹽埔鄉,7727,27172,14105,13067
2011/6/1,屏東縣,高樹鄉,9417,26532,14177,12355
2011/6/1,屏東縣,萬巒鄉,6419,21819,11515,10304
2011/6/1,屏東縣,內埔鄉,17837,57745,29997,27748
2011/6/1,屏東縣,竹田鄉,5584,18288,9722,8566
2011/6/1,屏東縣,新埤鄉,3365,10607,5639,4968
2011/6/1,屏東縣,枋寮鄉,8479,26351,13844,12507
2011/6/1,屏東縣,新園鄉,11534,38001,19660,18341
2011/6/1,屏東縣,崁頂鄉,4255,17150,8764,8386
2011/6/1,屏東縣,林邊鄉,7190,20600,10614,9986
2011/6/1,屏東縣,南州鄉,3673,11612,5951,5661
2011/6/1,屏東縣,佳冬鄉,7139,21197,11050,10147
2011/6/1,屏東縣,琉球鄉,3990,12189,6782,5407
2011/6/1,屏東縣,車城鄉,3504,9527,5142,4385
2011/6/1,屏東縣,滿州鄉,3045,8316,4593,3723
2011/6/1,屏東縣,枋山鄉,2104,6001,3221,2780
2011/6/1,屏東縣,三地門鄉,2204,7572,3872,3700
2011/6/1,屏東縣,霧臺鄉,991,2969,1567,1402
2011/6/1,屏東縣,瑪家鄉,1909,6540,3425,3115
2011/6/1,屏東縣,泰武鄉,1235,5057,2654,2403
2011/6/1,屏東縣,來義鄉,2163,7691,3948,3743
2011/6/1,屏東縣,春日鄉,1325,4837,2517,2320
2011/6/1,屏東縣,獅子鄉,1468,4848,2566,2282
2011/6/1,屏東縣,牡丹鄉,1884,4924,2553,2371
2011/6/1,臺東縣,臺東市,38169,108648,54991,53657
2011/6/1,臺東縣,成功鎮,5431,15688,8338,7350
2011/6/1,臺東縣,關山鎮,3226,9650,5056,4594
2011/6/1,臺東縣,卑南鄉,6633,18144,9782,8362
2011/6/1,臺東縣,大武鄉,2514,6886,3610,3276
2011/6/1,臺東縣,太麻里鄉,4547,11885,6349,5536
2011/6/1,臺東縣,東河鄉,3600,9254,5153,4101
2011/6/1,臺東縣,長濱鄉,2927,8144,4646,3498
2011/6/1,臺東縣,鹿野鄉,3130,8470,4597,3873
2011/6/1,臺東縣,池上鄉,3260,9067,4802,4265
2011/6/1,臺東縣,綠島鄉,1018,3376,1803,1573
2011/6/1,臺東縣,延平鄉,1067,3562,1962,1600
2011/6/1,臺東縣,海端鄉,1097,4448,2418,2030
2011/6/1,臺東縣,達仁鄉,1501,4037,2191,1846
2011/6/1,臺東縣,金峰鄉,1052,3564,1851,1713
2011/6/1,臺東縣,蘭嶼鄉,1491,4597,2368,2229
2011/6/1,花蓮縣,花蓮市,40691,108938,53339,55599
2011/6/1,花蓮縣,鳳林鎮,4430,11833,6246,5587
2011/6/1,花蓮縣,玉里鎮,8894,26635,14380,12255
2011/6/1,花蓮縣,新城鄉,7350,20156,10447,9709
2011/6/1,花蓮縣,吉安鄉,29319,80072,40923,39149
2011/6/1,花蓮縣,壽豐鄉,6841,18594,10049,8545
2011/6/1,花蓮縣,光復鄉,5027,13912,7437,6475
2011/6/1,花蓮縣,豐濱鄉,1796,4956,2750,2206
2011/6/1,花蓮縣,瑞穗鄉,4658,12746,6879,5867
2011/6/1,花蓮縣,富里鄉,4011,11535,6290,5245
2011/6/1,花蓮縣,秀林鄉,4662,15167,7881,7286
2011/6/1,花蓮縣,萬榮鄉,2122,6755,3601,3154
2011/6/1,花蓮縣,卓溪鄉,1654,6258,3490,2768
2011/6/1,澎湖縣,馬公市,20370,56923,28790,28133
2011/6/1,澎湖縣,湖西鄉,4815,13608,7098,6510
2011/6/1,澎湖縣,白沙鄉,3171,9394,4942,4452
2011/6/1,澎湖縣,西嶼鄉,2874,8404,4342,4062
2011/6/1,澎湖縣,望安鄉,1899,4687,2539,2148
2011/6/1,澎湖縣,七美鄉,1248,3581,1879,1702
2011/6/1,基隆市,中正區,22054,54790,28049,26741
2011/6/1,基隆市,七堵區,20166,54956,27860,27096
2011/6/1,基隆市,暖暖區,14441,37929,19247,18682
2011/6/1,基隆市,仁愛區,19810,49183,24281,24902
2011/6/1,基隆市,中山區,19099,50420,25761,24659
2011/6/1,基隆市,安樂區,31793,83560,41649,41911
2011/6/1,基隆市,信義區,20131,50932,25499,25433
2011/6/1,新竹市,東區,69183,198469,97960,100509
2011/6/1,新竹市,北區,51055,145832,71975,73857
2011/6/1,新竹市,香山區,23244,73034,37277,35757
2011/6/1,嘉義市,東區,44271,125089,61055,64034
2011/6/1,嘉義市,西區,51351,147039,72781,74258
2011/6/1,金門縣,金城鎮,11131,33123,16807,16316
2011/6/1,金門縣,金湖鎮,7422,21934,11201,10733
2011/6/1,金門縣,金沙鎮,5445,15726,7956,7770
2011/6/1,金門縣,金寧鄉,6276,19220,9890,9330
2011/6/1,金門縣,烈嶼鄉,2665,9135,4585,4550
2011/6/1,金門縣,烏坵鄉,135,553,276,277
2011/6/1,連江縣,南竿鄉,1241,5923,3401,2522
2011/6/1,連江縣,北竿鄉,398,1839,1053,786
2011/6/1,連江縣,莒光鄉,242,1173,710,463
2011/6/1,連江縣,東引鄉,277,1075,635,440
2011/7/1,總計,新北市,1420869,3906117,1937044,1969073
2011/7/1,總計,臺北市,992657,2637866,1270843,1367023
2011/7/1,總計,臺中市,862055,2657253,1322169,1335084
2011/7/1,總計,臺南市,645132,1875491,943866,931625
2011/7/1,總計,高雄市,1030368,2772647,1388859,1383788
2011/7/1,總計,臺灣省,3021113,9228465,4716379,4512086
2011/7/1,總計,宜蘭縣,155246,459358,233943,225415
2011/7/1,總計,桃園市,680802,2007536,1011165,996371
2011/7/1,總計,新竹縣,163678,515619,264931,250688
2011/7/1,總計,苗栗縣,174080,560940,290905,270035
2011/7/1,總計,彰化縣,365933,1304097,668783,635314
2011/7/1,總計,南投縣,171721,524126,269723,254403
2011/7/1,總計,雲林縣,230705,714876,373115,341761
2011/7/1,總計,嘉義縣,177293,539667,281466,258201
2011/7/1,總計,屏東縣,277924,868138,446222,421916
2011/7/1,總計,臺東縣,80684,229199,119759,109440
2011/7/1,總計,花蓮縣,121497,337382,173592,163790
2011/7/1,總計,澎湖縣,34441,96658,49602,47056
2011/7/1,總計,基隆市,147643,381321,192143,189178
2011/7/1,總計,新竹市,143766,417554,207270,210284
2011/7/1,總計,嘉義市,95700,271994,133760,138234
2011/7/1,總計,福建省,35349,110239,56720,53519
2011/7/1,總計,金門縣,33184,100248,50941,49307
2011/7/1,總計,連江縣,2165,9991,5779,4212
2011/7/1,新北市,板橋區,196183,554566,273857,280709
2011/7/1,新北市,三重區,141554,389839,194065,195774
2011/7/1,新北市,中和區,156415,414080,204279,209801
2011/7/1,新北市,永和區,89894,233338,111904,121434
2011/7/1,新北市,新莊區,138302,403124,198977,204147
2011/7/1,新北市,新店區,117292,296234,144757,151477
2011/7/1,新北市,樹林區,61310,178384,89864,88520
2011/7/1,新北市,鶯歌區,27833,87313,44114,43199
2011/7/1,新北市,三峽區,36365,104872,53335,51537
2011/7/1,新北市,淡水區,58882,145398,70637,74761
2011/7/1,新北市,汐止區,79835,190061,94277,95784
2011/7/1,新北市,瑞芳區,15899,42182,21515,20667
2011/7/1,新北市,土城區,82775,238757,119367,119390
2011/7/1,新北市,蘆洲區,66067,197950,97986,99964
2011/7/1,新北市,五股區,27563,80142,40592,39550
2011/7/1,新北市,泰山區,26348,76845,38581,38264
2011/7/1,新北市,林口區,31874,85335,42147,43188
2011/7/1,新北市,深坑區,8986,23449,11823,11626
2011/7/1,新北市,石碇區,3315,7854,4387,3467
2011/7/1,新北市,坪林區,2458,6532,3640,2892
2011/7/1,新北市,三芝區,8941,23363,12057,11306
2011/7/1,新北市,石門區,4129,12761,6694,6067
2011/7/1,新北市,八里區,12492,35180,17802,17378
2011/7/1,新北市,平溪區,2401,5233,2928,2305
2011/7/1,新北市,雙溪區,3814,9611,5217,4394
2011/7/1,新北市,貢寮區,4411,13568,6987,6581
2011/7/1,新北市,金山區,6754,22323,11184,11139
2011/7/1,新北市,萬里區,7080,22016,11141,10875
2011/7/1,新北市,烏來區,1697,5807,2930,2877
2011/7/1,臺北市,松山區,78411,209688,99388,110300
2011/7/1,臺北市,信義區,86372,225974,108722,117252
2011/7/1,臺北市,大安區,117591,313012,147244,165768
2011/7/1,臺北市,中山區,93032,222317,104483,117834
2011/7/1,臺北市,中正區,62803,160880,77568,83312
2011/7/1,臺北市,大同區,48114,125920,61947,63973
2011/7/1,臺北市,萬華區,74747,189723,94416,95307
2011/7/1,臺北市,文山區,98249,264664,128164,136500
2011/7/1,臺北市,南港區,42326,115093,56564,58529
2011/7/1,臺北市,內湖區,98618,273709,131868,141841
2011/7/1,臺北市,士林區,101811,285986,138743,147243
2011/7/1,臺北市,北投區,90583,250900,121736,129164
2011/7/1,臺中市,中區,8274,21987,10838,11149
2011/7/1,臺中市,東區,25962,73795,37192,36603
2011/7/1,臺中市,南區,42623,114372,55425,58947
2011/7/1,臺中市,西區,43545,117195,56278,60917
2011/7/1,臺中市,北區,56202,147476,71381,76095
2011/7/1,臺中市,西屯區,74434,208662,101020,107642
2011/7/1,臺中市,南屯區,54023,154892,74765,80127
2011/7/1,臺中市,北屯區,85176,248914,120812,128102
2011/7/1,臺中市,豐原區,50118,165427,82084,83343
2011/7/1,臺中市,東勢區,17031,52950,27464,25486
2011/7/1,臺中市,大甲區,21773,78267,39677,38590
2011/7/1,臺中市,清水區,25157,85690,44191,41499
2011/7/1,臺中市,沙鹿區,24316,82467,41965,40502
2011/7/1,臺中市,梧棲區,16104,55401,28058,27343
2011/7/1,臺中市,后里區,14930,54143,27745,26398
2011/7/1,臺中市,神岡區,17807,63858,32809,31049
2011/7/1,臺中市,潭子區,32856,101215,50409,50806
2011/7/1,臺中市,大雅區,26619,90317,45477,44840
2011/7/1,臺中市,新社區,7350,25549,13356,12193
2011/7/1,臺中市,石岡區,4855,15830,8248,7582
2011/7/1,臺中市,外埔區,8919,31942,16439,15503
2011/7/1,臺中市,大安區,5285,20108,10561,9547
2011/7/1,臺中市,烏日區,20831,69055,34959,34096
2011/7/1,臺中市,大肚區,15961,55680,28586,27094
2011/7/1,臺中市,龍井區,20855,74320,37785,36535
2011/7/1,臺中市,霧峰區,18852,63884,32829,31055
2011/7/1,臺中市,太平區,55231,173694,87076,86618
2011/7/1,臺中市,大里區,62531,199474,98944,100530
2011/7/1,臺中市,和平區,4435,10689,5796,4893
2011/7/1,臺南市,新營區,27412,78498,39113,39385
2011/7/1,臺南市,鹽水區,9975,26947,14051,12896
2011/7/1,臺南市,白河區,10963,31108,16287,14821
2011/7/1,臺南市,柳營區,7789,22464,11744,10720
2011/7/1,臺南市,後壁區,8831,25665,13397,12268
2011/7/1,臺南市,東山區,8233,22848,12136,10712
2011/7/1,臺南市,麻豆區,15125,45770,23369,22401
2011/7/1,臺南市,下營區,9107,25924,13441,12483
2011/7/1,臺南市,六甲區,7673,23573,12260,11313
2011/7/1,臺南市,官田區,7617,22043,11269,10774
2011/7/1,臺南市,大內區,4062,10781,5741,5040
2011/7/1,臺南市,佳里區,19467,59228,29472,29756
2011/7/1,臺南市,學甲區,9581,27683,14166,13517
2011/7/1,臺南市,西港區,7846,25105,12780,12325
2011/7/1,臺南市,七股區,8033,24768,12943,11825
2011/7/1,臺南市,將軍區,7433,21347,10862,10485
2011/7/1,臺南市,北門區,4381,12284,6245,6039
2011/7/1,臺南市,新化區,13756,44069,22565,21504
2011/7/1,臺南市,善化區,14799,43748,22116,21632
2011/7/1,臺南市,新市區,10891,34899,17532,17367
2011/7/1,臺南市,安定區,9409,30254,15682,14572
2011/7/1,臺南市,山上區,2719,7770,4093,3677
2011/7/1,臺南市,玉井區,5073,15268,7893,7375
2011/7/1,臺南市,楠西區,3561,10505,5570,4935
2011/7/1,臺南市,南化區,2834,8831,4844,3987
2011/7/1,臺南市,左鎮區,1974,5412,3009,2403
2011/7/1,臺南市,仁德區,24930,69853,35827,34026
2011/7/1,臺南市,歸仁區,20716,65971,33666,32305
2011/7/1,臺南市,關廟區,10722,35773,18558,17215
2011/7/1,臺南市,龍崎區,1593,4349,2348,2001
2011/7/1,臺南市,永康區,76187,219156,108809,110347
2011/7/1,臺南市,東區,71244,193986,93760,100226
2011/7/1,臺南市,南區,43667,126262,63276,62986
2011/7/1,臺南市,北區,48500,132031,65016,67015
2011/7/1,臺南市,安南區,55288,179072,91041,88031
2011/7/1,臺南市,安平區,23483,63273,30261,33012
2011/7/1,臺南市,中西區,30258,78973,38724,40249
2011/7/1,高雄市,鹽埕區,11145,27071,13564,13507
2011/7/1,高雄市,鼓山區,52761,132183,64615,67568
2011/7/1,高雄市,左營區,74541,192866,94756,98110
2011/7/1,高雄市,楠梓區,62329,173472,86006,87466
2011/7/1,高雄市,三民區,132292,352562,172380,180182
2011/7/1,高雄市,新興區,22841,54742,26576,28166
2011/7/1,高雄市,前金區,12542,28513,13867,14646
2011/7/1,高雄市,苓雅區,71901,182375,88674,93701
2011/7/1,高雄市,前鎮區,76790,198138,98327,99811
2011/7/1,高雄市,旗津區,10984,29810,15472,14338
2011/7/1,高雄市,小港區,63879,154537,77575,76962
2011/7/1,高雄市,鳳山區,128560,343857,170998,172859
2011/7/1,高雄市,林園區,24262,70228,36008,34220
2011/7/1,高雄市,大寮區,38717,109104,56639,52465
2011/7/1,高雄市,大樹區,13100,43685,22571,21114
2011/7/1,高雄市,大社區,11838,33150,17027,16123
2011/7/1,高雄市,仁武區,26662,73863,38083,35780
2011/7/1,高雄市,鳥松區,16777,42976,21804,21172
2011/7/1,高雄市,岡山區,33467,97165,48749,48416
2011/7/1,高雄市,橋頭區,12834,36791,18828,17963
2011/7/1,高雄市,燕巢區,10093,30920,16498,14422
2011/7/1,高雄市,田寮區,3527,8093,4499,3594
2011/7/1,高雄市,阿蓮區,9206,30265,15263,15002
2011/7/1,高雄市,路竹區,16164,53615,27334,26281
2011/7/1,高雄市,湖內區,9658,28762,14803,13959
2011/7/1,高雄市,茄萣區,10168,31119,16226,14893
2011/7/1,高雄市,永安區,5834,14165,7203,6962
2011/7/1,高雄市,彌陀區,6651,20299,10534,9765
2011/7/1,高雄市,梓官區,12128,36587,19010,17577
2011/7/1,高雄市,旗山區,13860,39737,20670,19067
2011/7/1,高雄市,美濃區,14262,42760,22336,20424
2011/7/1,高雄市,六龜區,5775,14571,7892,6679
2011/7/1,高雄市,甲仙區,2502,7079,3800,3279
2011/7/1,高雄市,杉林區,4460,11921,6505,5416
2011/7/1,高雄市,內門區,5042,15726,8591,7135
2011/7/1,高雄市,茂林區,574,1850,930,920
2011/7/1,高雄市,桃源區,1361,4758,2517,2241
2011/7/1,高雄市,那瑪夏區,881,3332,1729,1603
2011/7/1,宜蘭縣,宜蘭市,33324,95406,46881,48525
2011/7/1,宜蘭縣,羅東鎮,25121,72970,34992,37978
2011/7/1,宜蘭縣,蘇澳鎮,13659,42603,21829,20774
2011/7/1,宜蘭縣,頭城鎮,9751,30674,15860,14814
2011/7/1,宜蘭縣,礁溪鄉,12480,35963,18824,17139
2011/7/1,宜蘭縣,壯圍鄉,8158,24787,13086,11701
2011/7/1,宜蘭縣,員山鄉,10869,32290,17280,15010
2011/7/1,宜蘭縣,冬山鄉,17540,52835,27173,25662
2011/7/1,宜蘭縣,五結鄉,13125,38726,20145,18581
2011/7/1,宜蘭縣,三星鄉,7565,21240,11485,9755
2011/7/1,宜蘭縣,大同鄉,1824,5917,3226,2691
2011/7/1,宜蘭縣,南澳鄉,1830,5947,3162,2785
2011/7/1,桃園市,桃園區,145796,408752,200136,208616
2011/7/1,桃園市,中壢區,128542,371185,185107,186078
2011/7/1,桃園市,平鎮區,67561,208082,104739,103343
2011/7/1,桃園市,八德區,58880,177114,89929,87185
2011/7/1,桃園市,楊梅區,49455,151669,77078,74591
2011/7/1,桃園市,大溪區,29415,92017,47385,44632
2011/7/1,桃園市,蘆竹區,48887,142963,71673,71290
2011/7/1,桃園市,大園區,26347,82003,42553,39450
2011/7/1,桃園市,龜山區,50642,138006,69829,68177
2011/7/1,桃園市,龍潭區,37160,115005,58370,56635
2011/7/1,桃園市,新屋區,15022,48812,26131,22681
2011/7/1,桃園市,觀音區,19410,61355,32331,29024
2011/7/1,桃園市,復興區,3685,10573,5904,4669
2011/7/1,新竹縣,竹北市,48407,144720,72421,72299
2011/7/1,新竹縣,關西鎮,9294,31612,16817,14795
2011/7/1,新竹縣,新埔鎮,10418,35330,18707,16623
2011/7/1,新竹縣,竹東鎮,30853,96673,48714,47959
2011/7/1,新竹縣,湖口鄉,23649,75748,38690,37058
2011/7/1,新竹縣,橫山鄉,4433,14251,7699,6552
2011/7/1,新竹縣,新豐鄉,15963,53471,27511,25960
2011/7/1,新竹縣,芎林鄉,6312,20635,10861,9774
2011/7/1,新竹縣,寶山鄉,4771,14058,7590,6468
2011/7/1,新竹縣,北埔鄉,3102,10050,5464,4586
2011/7/1,新竹縣,峨眉鄉,2038,5929,3277,2652
2011/7/1,新竹縣,尖石鄉,2710,8504,4630,3874
2011/7/1,新竹縣,五峰鄉,1728,4638,2550,2088
2011/7/1,苗栗縣,苗栗市,29328,90741,45653,45088
2011/7/1,苗栗縣,苑裡鎮,13900,48510,25331,23179
2011/7/1,苗栗縣,通霄鎮,11392,37696,19959,17737
2011/7/1,苗栗縣,竹南鎮,24516,79010,40131,38879
2011/7/1,苗栗縣,頭份市,30066,97861,49652,48209
2011/7/1,苗栗縣,後龍鎮,11748,39074,20662,18412
2011/7/1,苗栗縣,卓蘭鎮,5970,18330,9675,8655
2011/7/1,苗栗縣,大湖鄉,5342,15988,8510,7478
2011/7/1,苗栗縣,公館鄉,10260,34723,18193,16530
2011/7/1,苗栗縣,銅鑼鄉,5985,19347,10265,9082
2011/7/1,苗栗縣,南庄鄉,4003,11077,6115,4962
2011/7/1,苗栗縣,頭屋鄉,3531,11540,6091,5449
2011/7/1,苗栗縣,三義鄉,5309,17519,9230,8289
2011/7/1,苗栗縣,西湖鄉,2680,7807,4337,3470
2011/7/1,苗栗縣,造橋鄉,4027,13690,7210,6480
2011/7/1,苗栗縣,三灣鄉,2396,7237,3947,3290
2011/7/1,苗栗縣,獅潭鄉,1679,4856,2717,2139
2011/7/1,苗栗縣,泰安鄉,1948,5934,3227,2707
2011/7/1,彰化縣,彰化市,72419,236516,117698,118818
2011/7/1,彰化縣,鹿港鎮,22479,85289,43730,41559
2011/7/1,彰化縣,和美鎮,24391,90003,46068,43935
2011/7/1,彰化縣,北斗鎮,10016,33481,16962,16519
2011/7/1,彰化縣,員林市,36971,125245,62963,62282
2011/7/1,彰化縣,溪湖鎮,15227,56025,28601,27424
2011/7/1,彰化縣,田中鎮,12565,43818,22760,21058
2011/7/1,彰化縣,二林鎮,14383,53716,27729,25987
2011/7/1,彰化縣,線西鄉,4141,17062,8792,8270
2011/7/1,彰化縣,伸港鄉,9044,35915,18453,17462
2011/7/1,彰化縣,福興鄉,12164,48750,25468,23282
2011/7/1,彰化縣,秀水鄉,9859,39155,20278,18877
2011/7/1,彰化縣,花壇鄉,13061,45978,23662,22316
2011/7/1,彰化縣,芬園鄉,6876,24745,13130,11615
2011/7/1,彰化縣,大村鄉,10342,36509,19029,17480
2011/7/1,彰化縣,埔鹽鄉,8851,34072,17859,16213
2011/7/1,彰化縣,埔心鄉,9998,35272,18240,17032
2011/7/1,彰化縣,永靖鄉,10457,39084,20269,18815
2011/7/1,彰化縣,社頭鄉,12366,44526,22857,21669
2011/7/1,彰化縣,二水鄉,5325,16454,8622,7832
2011/7/1,彰化縣,田尾鄉,7700,28478,14839,13639
2011/7/1,彰化縣,埤頭鄉,8654,31572,16469,15103
2011/7/1,彰化縣,芳苑鄉,9979,35952,19015,16937
2011/7/1,彰化縣,大城鄉,5403,18754,10178,8576
2011/7/1,彰化縣,竹塘鄉,4593,16361,8594,7767
2011/7/1,彰化縣,溪州鄉,8669,31365,16518,14847
2011/7/1,南投縣,南投市,33502,103955,52282,51673
2011/7/1,南投縣,埔里鎮,28473,84859,42820,42039
2011/7/1,南投縣,草屯鎮,31144,99390,50235,49155
2011/7/1,南投縣,竹山鎮,19205,58050,29916,28134
2011/7/1,南投縣,集集鎮,4304,11791,6176,5615
2011/7/1,南投縣,名間鄉,12178,41025,21541,19484
2011/7/1,南投縣,鹿谷鄉,6865,18963,10065,8898
2011/7/1,南投縣,中寮鄉,5633,16040,8732,7308
2011/7/1,南投縣,魚池鄉,5766,17008,8972,8036
2011/7/1,南投縣,國姓鄉,7223,20464,11162,9302
2011/7/1,南投縣,水里鄉,7253,19897,10442,9455
2011/7/1,南投縣,信義鄉,5248,17140,9275,7865
2011/7/1,南投縣,仁愛鄉,4927,15544,8105,7439
2011/7/1,雲林縣,斗六市,35119,107002,53782,53220
2011/7/1,雲林縣,斗南鎮,15347,46982,23890,23092
2011/7/1,雲林縣,虎尾鎮,22739,70094,35675,34419
2011/7/1,雲林縣,西螺鎮,14074,48264,24573,23691
2011/7/1,雲林縣,土庫鎮,8777,30346,15860,14486
2011/7/1,雲林縣,北港鎮,15437,42795,22275,20520
2011/7/1,雲林縣,古坑鄉,10682,33786,17843,15943
2011/7/1,雲林縣,大埤鄉,6658,20965,11243,9722
2011/7/1,雲林縣,莿桐鄉,9078,30305,15865,14440
2011/7/1,雲林縣,林內鄉,5773,19743,10290,9453
2011/7/1,雲林縣,二崙鄉,8734,29435,15769,13666
2011/7/1,雲林縣,崙背鄉,8313,27046,14238,12808
2011/7/1,雲林縣,麥寮鄉,12750,38052,19756,18296
2011/7/1,雲林縣,東勢鄉,5696,16524,9013,7511
2011/7/1,雲林縣,褒忠鄉,4297,14109,7512,6597
2011/7/1,雲林縣,臺西鄉,8899,25911,13921,11990
2011/7/1,雲林縣,元長鄉,9334,28506,15553,12953
2011/7/1,雲林縣,四湖鄉,9028,26435,14418,12017
2011/7/1,雲林縣,口湖鄉,9607,30038,16014,14024
2011/7/1,雲林縣,水林鄉,10363,28538,15625,12913
2011/7/1,嘉義縣,太保市,11448,36686,18891,17795
2011/7/1,嘉義縣,朴子市,14786,44125,22477,21648
2011/7/1,嘉義縣,布袋鎮,10139,29765,15276,14489
2011/7/1,嘉義縣,大林鎮,11240,33378,17153,16225
2011/7/1,嘉義縣,民雄鄉,22993,72447,37207,35240
2011/7/1,嘉義縣,溪口鄉,5393,16121,8625,7496
2011/7/1,嘉義縣,新港鄉,10429,34444,18176,16268
2011/7/1,嘉義縣,六腳鄉,9154,26048,13799,12249
2011/7/1,嘉義縣,東石鄉,9510,27285,14521,12764
2011/7/1,嘉義縣,義竹鄉,7469,20797,10791,10006
2011/7/1,嘉義縣,鹿草鄉,5783,17098,9203,7895
2011/7/1,嘉義縣,水上鄉,17452,51923,26817,25106
2011/7/1,嘉義縣,中埔鄉,15429,47369,24697,22672
2011/7/1,嘉義縣,竹崎鄉,11383,38398,20445,17953
2011/7/1,嘉義縣,梅山鄉,6692,21394,11343,10051
2011/7/1,嘉義縣,番路鄉,3971,11579,6299,5280
2011/7/1,嘉義縣,大埔鄉,1943,4596,2419,2177
2011/7/1,嘉義縣,阿里山鄉,2079,6214,3327,2887
2011/7/1,屏東縣,屏東市,72257,210147,104641,105506
2011/7/1,屏東縣,潮州鎮,18289,55465,27879,27586
2011/7/1,屏東縣,東港鎮,15806,49882,25274,24608
2011/7/1,屏東縣,恆春鎮,10833,30952,15886,15066
2011/7/1,屏東縣,萬丹鄉,14372,53742,27804,25938
2011/7/1,屏東縣,長治鄉,9763,30796,16091,14705
2011/7/1,屏東縣,麟洛鄉,3603,11450,5940,5510
2011/7/1,屏東縣,九如鄉,6601,22807,11842,10965
2011/7/1,屏東縣,里港鄉,7878,25740,13217,12523
2011/7/1,屏東縣,鹽埔鄉,7736,27141,14094,13047
2011/7/1,屏東縣,高樹鄉,9407,26512,14157,12355
2011/7/1,屏東縣,萬巒鄉,6417,21778,11493,10285
2011/7/1,屏東縣,內埔鄉,17886,57752,30010,27742
2011/7/1,屏東縣,竹田鄉,5584,18268,9711,8557
2011/7/1,屏東縣,新埤鄉,3363,10595,5637,4958
2011/7/1,屏東縣,枋寮鄉,8488,26341,13848,12493
2011/7/1,屏東縣,新園鄉,11555,37966,19632,18334
2011/7/1,屏東縣,崁頂鄉,4265,17129,8744,8385
2011/7/1,屏東縣,林邊鄉,7163,20541,10581,9960
2011/7/1,屏東縣,南州鄉,3671,11598,5943,5655
2011/7/1,屏東縣,佳冬鄉,7143,21150,11026,10124
2011/7/1,屏東縣,琉球鄉,3995,12187,6780,5407
2011/7/1,屏東縣,車城鄉,3509,9513,5138,4375
2011/7/1,屏東縣,滿州鄉,3048,8301,4579,3722
2011/7/1,屏東縣,枋山鄉,2103,5985,3210,2775
2011/7/1,屏東縣,三地門鄉,2208,7581,3877,3704
2011/7/1,屏東縣,霧臺鄉,993,2969,1567,1402
2011/7/1,屏東縣,瑪家鄉,1911,6526,3414,3112
2011/7/1,屏東縣,泰武鄉,1232,5047,2648,2399
2011/7/1,屏東縣,來義鄉,2167,7690,3943,3747
2011/7/1,屏東縣,春日鄉,1325,4828,2506,2322
2011/7/1,屏東縣,獅子鄉,1467,4840,2558,2282
2011/7/1,屏東縣,牡丹鄉,1886,4919,2552,2367
2011/7/1,臺東縣,臺東市,38170,108604,54949,53655
2011/7/1,臺東縣,成功鎮,5434,15668,8321,7347
2011/7/1,臺東縣,關山鎮,3226,9628,5043,4585
2011/7/1,臺東縣,卑南鄉,6635,18127,9777,8350
2011/7/1,臺東縣,大武鄉,2510,6854,3591,3263
2011/7/1,臺東縣,太麻里鄉,4546,11877,6340,5537
2011/7/1,臺東縣,東河鄉,3600,9258,5148,4110
2011/7/1,臺東縣,長濱鄉,2931,8103,4623,3480
2011/7/1,臺東縣,鹿野鄉,3131,8463,4585,3878
2011/7/1,臺東縣,池上鄉,3258,9036,4794,4242
2011/7/1,臺東縣,綠島鄉,1021,3392,1812,1580
2011/7/1,臺東縣,延平鄉,1067,3564,1961,1603
2011/7/1,臺東縣,海端鄉,1097,4444,2415,2029
2011/7/1,臺東縣,達仁鄉,1502,4015,2183,1832
2011/7/1,臺東縣,金峰鄉,1059,3563,1849,1714
2011/7/1,臺東縣,蘭嶼鄉,1497,4603,2368,2235
2011/7/1,花蓮縣,花蓮市,40684,108810,53258,55552
2011/7/1,花蓮縣,鳳林鎮,4431,11810,6236,5574
2011/7/1,花蓮縣,玉里鎮,8893,26571,14358,12213
2011/7/1,花蓮縣,新城鄉,7331,20133,10425,9708
2011/7/1,花蓮縣,吉安鄉,29371,80208,40961,39247
2011/7/1,花蓮縣,壽豐鄉,6849,18615,10066,8549
2011/7/1,花蓮縣,光復鄉,5032,13905,7435,6470
2011/7/1,花蓮縣,豐濱鄉,1798,4940,2739,2201
2011/7/1,花蓮縣,瑞穗鄉,4656,12713,6866,5847
2011/7/1,花蓮縣,富里鄉,4017,11521,6284,5237
2011/7/1,花蓮縣,秀林鄉,4655,15160,7880,7280
2011/7/1,花蓮縣,萬榮鄉,2121,6748,3598,3150
2011/7/1,花蓮縣,卓溪鄉,1659,6248,3486,2762
2011/7/1,澎湖縣,馬公市,20422,56950,28785,28165
2011/7/1,澎湖縣,湖西鄉,4828,13639,7115,6524
2011/7/1,澎湖縣,白沙鄉,3172,9403,4944,4459
2011/7/1,澎湖縣,西嶼鄉,2874,8410,4337,4073
2011/7/1,澎湖縣,望安鄉,1893,4669,2536,2133
2011/7/1,澎湖縣,七美鄉,1252,3587,1885,1702
2011/7/1,基隆市,中正區,22073,54684,27976,26708
2011/7/1,基隆市,七堵區,20206,54918,27836,27082
2011/7/1,基隆市,暖暖區,14483,37927,19258,18669
2011/7/1,基隆市,仁愛區,19821,49052,24221,24831
2011/7/1,基隆市,中山區,19110,50412,25779,24633
2011/7/1,基隆市,安樂區,31805,83432,41592,41840
2011/7/1,基隆市,信義區,20145,50896,25481,25415
2011/7/1,新竹市,東區,69307,198557,97994,100563
2011/7/1,新竹市,北區,51144,145821,71946,73875
2011/7/1,新竹市,香山區,23315,73176,37330,35846
2011/7/1,嘉義市,東區,44298,124960,60991,63969
2011/7/1,嘉義市,西區,51402,147034,72769,74265
2011/7/1,金門縣,金城鎮,11168,33305,16894,16411
2011/7/1,金門縣,金湖鎮,7449,22023,11218,10805
2011/7/1,金門縣,金沙鎮,5459,15836,8004,7832
2011/7/1,金門縣,金寧鄉,6297,19329,9940,9389
2011/7/1,金門縣,烈嶼鄉,2676,9199,4609,4590
2011/7/1,金門縣,烏坵鄉,135,556,276,280
2011/7/1,連江縣,南竿鄉,1247,5909,3388,2521
2011/7/1,連江縣,北竿鄉,398,1837,1049,788
2011/7/1,連江縣,莒光鄉,243,1168,705,463
2011/7/1,連江縣,東引鄉,277,1077,637,440
2011/8/1,總計,新北市,1424158,3908632,1937887,1970745
2011/8/1,總計,臺北市,994840,2639064,1271417,1367647
2011/8/1,總計,臺中市,863770,2658735,1322745,1335990
2011/8/1,總計,臺南市,646041,1875637,943827,931810
2011/8/1,總計,高雄市,1031840,2772838,1388742,1384096
2011/8/1,總計,臺灣省,3026326,9227628,4715350,4512278
2011/8/1,總計,宜蘭縣,155497,459347,233916,225431
2011/8/1,總計,桃園市,682710,2008845,1011706,997139
2011/8/1,總計,新竹縣,164208,516143,265178,250965
2011/8/1,總計,苗栗縣,174348,561226,290974,270252
2011/8/1,總計,彰化縣,366489,1303741,668521,635220
2011/8/1,總計,南投縣,171869,523805,269524,254281
2011/8/1,總計,雲林縣,230906,714539,372896,341643
2011/8/1,總計,嘉義縣,177427,539162,281102,258060
2011/8/1,總計,屏東縣,278260,867113,445703,421410
2011/8/1,總計,臺東縣,80697,228890,119588,109302
2011/8/1,總計,花蓮縣,121604,337193,173497,163696
2011/8/1,總計,澎湖縣,34473,96642,49589,47053
2011/8/1,總計,基隆市,147776,381056,191943,189113
2011/8/1,總計,新竹市,144239,417966,207480,210486
2011/8/1,總計,嘉義市,95823,271960,133733,138227
2011/8/1,總計,福建省,35545,111104,57108,53996
2011/8/1,總計,金門縣,33372,101094,51321,49773
2011/8/1,總計,連江縣,2173,10010,5787,4223
2011/8/1,新北市,板橋區,196611,554755,273867,280888
2011/8/1,新北市,三重區,141855,390084,194167,195917
2011/8/1,新北市,中和區,156725,414198,204299,209899
2011/8/1,新北市,永和區,89978,233021,111787,121234
2011/8/1,新北市,新莊區,138584,403404,199039,204365
2011/8/1,新北市,新店區,117571,296370,144804,151566
2011/8/1,新北市,樹林區,61587,178787,90049,88738
2011/8/1,新北市,鶯歌區,27863,87362,44133,43229
2011/8/1,新北市,三峽區,36513,105108,53456,51652
2011/8/1,新北市,淡水區,59152,145785,70828,74957
2011/8/1,新北市,汐止區,80031,190247,94346,95901
2011/8/1,新北市,瑞芳區,15902,42159,21486,20673
2011/8/1,新北市,土城區,82896,238776,119322,119454
2011/8/1,新北市,蘆洲區,66196,198007,97981,100026
2011/8/1,新北市,五股區,27609,80219,40616,39603
2011/8/1,新北市,泰山區,26387,76838,38565,38273
2011/8/1,新北市,林口區,32077,85608,42287,43321
2011/8/1,新北市,深坑區,9030,23517,11847,11670
2011/8/1,新北市,石碇區,3316,7867,4385,3482
2011/8/1,新北市,坪林區,2466,6535,3639,2896
2011/8/1,新北市,三芝區,8942,23365,12051,11314
2011/8/1,新北市,石門區,4137,12789,6709,6080
2011/8/1,新北市,八里區,12539,35234,17822,17412
2011/8/1,新北市,平溪區,2400,5231,2926,2305
2011/8/1,新北市,雙溪區,3814,9589,5198,4391
2011/8/1,新北市,貢寮區,4414,13547,6980,6567
2011/8/1,新北市,金山區,6763,22331,11178,11153
2011/8/1,新北市,萬里區,7100,22091,11184,10907
2011/8/1,新北市,烏來區,1700,5808,2936,2872
2011/8/1,臺北市,松山區,78519,209503,99299,110204
2011/8/1,臺北市,信義區,86532,226046,108768,117278
2011/8/1,臺北市,大安區,117748,312774,147162,165612
2011/8/1,臺北市,中山區,93383,222656,104650,118006
2011/8/1,臺北市,中正區,62862,160799,77529,83270
2011/8/1,臺北市,大同區,48123,125824,61891,63933
2011/8/1,臺北市,萬華區,74880,189887,94483,95404
2011/8/1,臺北市,文山區,98616,265061,128313,136748
2011/8/1,臺北市,南港區,42489,115303,56658,58645
2011/8/1,臺北市,內湖區,98926,274032,131998,142034
2011/8/1,臺北市,士林區,101971,286131,138871,147260
2011/8/1,臺北市,北投區,90791,251048,121795,129253
2011/8/1,臺中市,中區,8283,21884,10776,11108
2011/8/1,臺中市,東區,26011,73853,37225,36628
2011/8/1,臺中市,南區,42754,114641,55531,59110
2011/8/1,臺中市,西區,43550,116998,56138,60860
2011/8/1,臺中市,北區,56318,147464,71381,76083
2011/8/1,臺中市,西屯區,74635,208937,101103,107834
2011/8/1,臺中市,南屯區,54185,155101,74887,80214
2011/8/1,臺中市,北屯區,85363,249073,120893,128180
2011/8/1,臺中市,豐原區,50203,165419,82064,83355
2011/8/1,臺中市,東勢區,17044,52932,27453,25479
2011/8/1,臺中市,大甲區,21802,78197,39630,38567
2011/8/1,臺中市,清水區,25186,85665,44186,41479
2011/8/1,臺中市,沙鹿區,24426,82695,42080,40615
2011/8/1,臺中市,梧棲區,16140,55410,28072,27338
2011/8/1,臺中市,后里區,14963,54138,27735,26403
2011/8/1,臺中市,神岡區,17818,63872,32811,31061
2011/8/1,臺中市,潭子區,32938,101384,50475,50909
2011/8/1,臺中市,大雅區,26641,90415,45518,44897
2011/8/1,臺中市,新社區,7357,25514,13329,12185
2011/8/1,臺中市,石岡區,4863,15834,8239,7595
2011/8/1,臺中市,外埔區,8928,31962,16448,15514
2011/8/1,臺中市,大安區,5300,20106,10563,9543
2011/8/1,臺中市,烏日區,20885,69140,35006,34134
2011/8/1,臺中市,大肚區,15998,55691,28588,27103
2011/8/1,臺中市,龍井區,20879,74286,37773,36513
2011/8/1,臺中市,霧峰區,18866,63867,32800,31067
2011/8/1,臺中市,太平區,55294,173824,87169,86655
2011/8/1,臺中市,大里區,62706,199732,99079,100653
2011/8/1,臺中市,和平區,4434,10701,5793,4908
2011/8/1,臺南市,新營區,27483,78462,39081,39381
2011/8/1,臺南市,鹽水區,9983,26939,14038,12901
2011/8/1,臺南市,白河區,10965,31074,16278,14796
2011/8/1,臺南市,柳營區,7793,22461,11754,10707
2011/8/1,臺南市,後壁區,8823,25639,13379,12260
2011/8/1,臺南市,東山區,8235,22834,12118,10716
2011/8/1,臺南市,麻豆區,15130,45686,23337,22349
2011/8/1,臺南市,下營區,9118,25881,13417,12464
2011/8/1,臺南市,六甲區,7683,23585,12269,11316
2011/8/1,臺南市,官田區,7616,21991,11254,10737
2011/8/1,臺南市,大內區,4060,10752,5730,5022
2011/8/1,臺南市,佳里區,19503,59226,29458,29768
2011/8/1,臺南市,學甲區,9580,27664,14152,13512
2011/8/1,臺南市,西港區,7852,25133,12790,12343
2011/8/1,臺南市,七股區,8046,24743,12927,11816
2011/8/1,臺南市,將軍區,7432,21314,10850,10464
2011/8/1,臺南市,北門區,4378,12260,6236,6024
2011/8/1,臺南市,新化區,13768,44007,22524,21483
2011/8/1,臺南市,善化區,14860,43845,22154,21691
2011/8/1,臺南市,新市區,10902,34934,17561,17373
2011/8/1,臺南市,安定區,9419,30241,15665,14576
2011/8/1,臺南市,山上區,2721,7778,4097,3681
2011/8/1,臺南市,玉井區,5082,15274,7888,7386
2011/8/1,臺南市,楠西區,3565,10477,5555,4922
2011/8/1,臺南市,南化區,2827,8821,4835,3986
2011/8/1,臺南市,左鎮區,1974,5393,2994,2399
2011/8/1,臺南市,仁德區,24979,69938,35861,34077
2011/8/1,臺南市,歸仁區,20774,65996,33677,32319
2011/8/1,臺南市,關廟區,10728,35761,18559,17202
2011/8/1,臺南市,龍崎區,1593,4343,2349,1994
2011/8/1,臺南市,永康區,76404,219640,109047,110593
2011/8/1,臺南市,東區,71315,193871,93698,100173
2011/8/1,臺南市,南區,43701,126209,63226,62983
2011/8/1,臺南市,北區,48557,132076,65025,67051
2011/8/1,臺南市,安南區,55406,179180,91092,88088
2011/8/1,臺南市,安平區,23546,63372,30308,33064
2011/8/1,臺南市,中西區,30240,78837,38644,40193
2011/8/1,高雄市,鹽埕區,11139,26986,13513,13473
2011/8/1,高雄市,鼓山區,52905,132393,64690,67703
2011/8/1,高雄市,左營區,74635,192973,94771,98202
2011/8/1,高雄市,楠梓區,62414,173477,85986,87491
2011/8/1,高雄市,三民區,132449,352395,172349,180046
2011/8/1,高雄市,新興區,22851,54663,26521,28142
2011/8/1,高雄市,前金區,12547,28480,13864,14616
2011/8/1,高雄市,苓雅區,71962,182195,88552,93643
2011/8/1,高雄市,前鎮區,76815,197991,98230,99761
2011/8/1,高雄市,旗津區,10986,29768,15469,14299
2011/8/1,高雄市,小港區,63930,154472,77531,76941
2011/8/1,高雄市,鳳山區,128836,344269,171196,173073
2011/8/1,高雄市,林園區,24342,70292,36044,34248
2011/8/1,高雄市,大寮區,38766,109108,56620,52488
2011/8/1,高雄市,大樹區,13113,43701,22583,21118
2011/8/1,高雄市,大社區,11869,33202,17036,16166
2011/8/1,高雄市,仁武區,26802,74123,38213,35910
2011/8/1,高雄市,鳥松區,16828,43092,21845,21247
2011/8/1,高雄市,岡山區,33500,97216,48750,48466
2011/8/1,高雄市,橋頭區,12867,36805,18834,17971
2011/8/1,高雄市,燕巢區,10125,30901,16505,14396
2011/8/1,高雄市,田寮區,3524,8082,4487,3595
2011/8/1,高雄市,阿蓮區,9207,30235,15251,14984
2011/8/1,高雄市,路竹區,16173,53572,27319,26253
2011/8/1,高雄市,湖內區,9680,28769,14798,13971
2011/8/1,高雄市,茄萣區,10173,31090,16195,14895
2011/8/1,高雄市,永安區,5829,14159,7201,6958
2011/8/1,高雄市,彌陀區,6666,20297,10528,9769
2011/8/1,高雄市,梓官區,12128,36604,19016,17588
2011/8/1,高雄市,旗山區,13866,39637,20617,19020
2011/8/1,高雄市,美濃區,14299,42759,22335,20424
2011/8/1,高雄市,六龜區,5785,14546,7874,6672
2011/8/1,高雄市,甲仙區,2505,7066,3786,3280
2011/8/1,高雄市,杉林區,4458,11919,6506,5413
2011/8/1,高雄市,內門區,5046,15705,8571,7134
2011/8/1,高雄市,茂林區,576,1838,927,911
2011/8/1,高雄市,桃源區,1361,4739,2509,2230
2011/8/1,高雄市,那瑪夏區,883,3319,1720,1599
2011/8/1,宜蘭縣,宜蘭市,33358,95401,46875,48526
2011/8/1,宜蘭縣,羅東鎮,25154,72882,34927,37955
2011/8/1,宜蘭縣,蘇澳鎮,13676,42588,21823,20765
2011/8/1,宜蘭縣,頭城鎮,9762,30647,15846,14801
2011/8/1,宜蘭縣,礁溪鄉,12487,35992,18826,17166
2011/8/1,宜蘭縣,壯圍鄉,8170,24755,13076,11679
2011/8/1,宜蘭縣,員山鄉,10893,32303,17286,15017
2011/8/1,宜蘭縣,冬山鄉,17597,52887,27206,25681
2011/8/1,宜蘭縣,五結鄉,13162,38786,20178,18608
2011/8/1,宜蘭縣,三星鄉,7584,21250,11490,9760
2011/8/1,宜蘭縣,大同鄉,1824,5916,3223,2693
2011/8/1,宜蘭縣,南澳鄉,1830,5940,3160,2780
2011/8/1,桃園市,桃園區,146266,409132,200290,208842
2011/8/1,桃園市,中壢區,128927,371335,185180,186155
2011/8/1,桃園市,平鎮區,67789,208337,104868,103469
2011/8/1,桃園市,八德區,59012,177136,89916,87220
2011/8/1,桃園市,楊梅區,49612,151837,77130,74707
2011/8/1,桃園市,大溪區,29453,91923,47345,44578
2011/8/1,桃園市,蘆竹區,49062,143166,71728,71438
2011/8/1,桃園市,大園區,26397,82002,42547,39455
2011/8/1,桃園市,龜山區,50785,138144,69916,68228
2011/8/1,桃園市,龍潭區,37232,115033,58388,56645
2011/8/1,桃園市,新屋區,15024,48758,26109,22649
2011/8/1,桃園市,觀音區,19468,61441,32373,29068
2011/8/1,桃園市,復興區,3683,10601,5916,4685
2011/8/1,新竹縣,竹北市,48732,145240,72653,72587
2011/8/1,新竹縣,關西鎮,9303,31601,16819,14782
2011/8/1,新竹縣,新埔鎮,10437,35299,18693,16606
2011/8/1,新竹縣,竹東鎮,30913,96610,48675,47935
2011/8/1,新竹縣,湖口鄉,23689,75771,38685,37086
2011/8/1,新竹縣,橫山鄉,4439,14238,7692,6546
2011/8/1,新竹縣,新豐鄉,16004,53540,27567,25973
2011/8/1,新竹縣,芎林鄉,6329,20664,10883,9781
2011/8/1,新竹縣,寶山鄉,4777,14051,7588,6463
2011/8/1,新竹縣,北埔鄉,3107,10038,5461,4577
2011/8/1,新竹縣,峨眉鄉,2037,5919,3267,2652
2011/8/1,新竹縣,尖石鄉,2709,8518,4635,3883
2011/8/1,新竹縣,五峰鄉,1732,4654,2560,2094
2011/8/1,苗栗縣,苗栗市,29389,90784,45658,45126
2011/8/1,苗栗縣,苑裡鎮,13908,48528,25336,23192
2011/8/1,苗栗縣,通霄鎮,11396,37687,19940,17747
2011/8/1,苗栗縣,竹南鎮,24584,79192,40214,38978
2011/8/1,苗栗縣,頭份市,30143,97973,49689,48284
2011/8/1,苗栗縣,後龍鎮,11743,39033,20642,18391
2011/8/1,苗栗縣,卓蘭鎮,5978,18365,9697,8668
2011/8/1,苗栗縣,大湖鄉,5343,15967,8497,7470
2011/8/1,苗栗縣,公館鄉,10283,34770,18209,16561
2011/8/1,苗栗縣,銅鑼鄉,5988,19346,10261,9085
2011/8/1,苗栗縣,南庄鄉,4004,11041,6096,4945
2011/8/1,苗栗縣,頭屋鄉,3537,11525,6087,5438
2011/8/1,苗栗縣,三義鄉,5320,17529,9238,8291
2011/8/1,苗栗縣,西湖鄉,2684,7806,4334,3472
2011/8/1,苗栗縣,造橋鄉,4022,13680,7201,6479
2011/8/1,苗栗縣,三灣鄉,2395,7234,3942,3292
2011/8/1,苗栗縣,獅潭鄉,1681,4841,2709,2132
2011/8/1,苗栗縣,泰安鄉,1950,5925,3224,2701
2011/8/1,彰化縣,彰化市,72526,236492,117684,118808
2011/8/1,彰化縣,鹿港鎮,22534,85361,43757,41604
2011/8/1,彰化縣,和美鎮,24471,90056,46102,43954
2011/8/1,彰化縣,北斗鎮,10045,33429,16941,16488
2011/8/1,彰化縣,員林市,37041,125203,62916,62287
2011/8/1,彰化縣,溪湖鎮,15248,55970,28564,27406
2011/8/1,彰化縣,田中鎮,12576,43800,22743,21057
2011/8/1,彰化縣,二林鎮,14399,53730,27739,25991
2011/8/1,彰化縣,線西鄉,4146,17046,8782,8264
2011/8/1,彰化縣,伸港鄉,9041,35869,18417,17452
2011/8/1,彰化縣,福興鄉,12179,48726,25454,23272
2011/8/1,彰化縣,秀水鄉,9877,39177,20295,18882
2011/8/1,彰化縣,花壇鄉,13087,46029,23679,22350
2011/8/1,彰化縣,芬園鄉,6876,24721,13122,11599
2011/8/1,彰化縣,大村鄉,10344,36510,19020,17490
2011/8/1,彰化縣,埔鹽鄉,8860,34077,17867,16210
2011/8/1,彰化縣,埔心鄉,10016,35283,18246,17037
2011/8/1,彰化縣,永靖鄉,10469,39039,20250,18789
2011/8/1,彰化縣,社頭鄉,12372,44514,22829,21685
2011/8/1,彰化縣,二水鄉,5338,16424,8615,7809
2011/8/1,彰化縣,田尾鄉,7705,28440,14814,13626
2011/8/1,彰化縣,埤頭鄉,8664,31549,16449,15100
2011/8/1,彰化縣,芳苑鄉,9998,35905,18984,16921
2011/8/1,彰化縣,大城鄉,5401,18696,10149,8547
2011/8/1,彰化縣,竹塘鄉,4595,16366,8600,7766
2011/8/1,彰化縣,溪州鄉,8681,31329,16503,14826
2011/8/1,南投縣,南投市,33537,103919,52245,51674
2011/8/1,南投縣,埔里鎮,28484,84810,42800,42010
2011/8/1,南投縣,草屯鎮,31186,99330,50207,49123
2011/8/1,南投縣,竹山鎮,19246,58061,29935,28126
2011/8/1,南投縣,集集鎮,4298,11773,6162,5611
2011/8/1,南投縣,名間鄉,12193,41014,21529,19485
2011/8/1,南投縣,鹿谷鄉,6890,18960,10057,8903
2011/8/1,南投縣,中寮鄉,5630,16017,8715,7302
2011/8/1,南投縣,魚池鄉,5758,16992,8965,8027
2011/8/1,南投縣,國姓鄉,7225,20426,11139,9287
2011/8/1,南投縣,水里鄉,7245,19849,10406,9443
2011/8/1,南投縣,信義鄉,5256,17124,9268,7856
2011/8/1,南投縣,仁愛鄉,4921,15530,8096,7434
2011/8/1,雲林縣,斗六市,35171,107027,53774,53253
2011/8/1,雲林縣,斗南鎮,15357,46946,23869,23077
2011/8/1,雲林縣,虎尾鎮,22779,70104,35673,34431
2011/8/1,雲林縣,西螺鎮,14088,48207,24547,23660
2011/8/1,雲林縣,土庫鎮,8798,30331,15856,14475
2011/8/1,雲林縣,北港鎮,15459,42701,22222,20479
2011/8/1,雲林縣,古坑鄉,10676,33742,17817,15925
2011/8/1,雲林縣,大埤鄉,6658,20940,11239,9701
2011/8/1,雲林縣,莿桐鄉,9083,30309,15877,14432
2011/8/1,雲林縣,林內鄉,5776,19731,10281,9450
2011/8/1,雲林縣,二崙鄉,8734,29428,15764,13664
2011/8/1,雲林縣,崙背鄉,8317,27007,14225,12782
2011/8/1,雲林縣,麥寮鄉,12773,38228,19840,18388
2011/8/1,雲林縣,東勢鄉,5703,16488,8994,7494
2011/8/1,雲林縣,褒忠鄉,4292,14087,7501,6586
2011/8/1,雲林縣,臺西鄉,8892,25852,13899,11953
2011/8/1,雲林縣,元長鄉,9354,28493,15542,12951
2011/8/1,雲林縣,四湖鄉,9032,26435,14404,12031
2011/8/1,雲林縣,口湖鄉,9604,29986,15976,14010
2011/8/1,雲林縣,水林鄉,10360,28497,15596,12901
2011/8/1,嘉義縣,太保市,11472,36712,18899,17813
2011/8/1,嘉義縣,朴子市,14803,44073,22447,21626
2011/8/1,嘉義縣,布袋鎮,10147,29761,15261,14500
2011/8/1,嘉義縣,大林鎮,11242,33326,17111,16215
2011/8/1,嘉義縣,民雄鄉,23018,72446,37180,35266
2011/8/1,嘉義縣,溪口鄉,5393,16087,8605,7482
2011/8/1,嘉義縣,新港鄉,10426,34374,18133,16241
2011/8/1,嘉義縣,六腳鄉,9154,26030,13787,12243
2011/8/1,嘉義縣,東石鄉,9512,27276,14502,12774
2011/8/1,嘉義縣,義竹鄉,7478,20771,10786,9985
2011/8/1,嘉義縣,鹿草鄉,5784,17073,9187,7886
2011/8/1,嘉義縣,水上鄉,17455,51849,26768,25081
2011/8/1,嘉義縣,中埔鄉,15463,47345,24680,22665
2011/8/1,嘉義縣,竹崎鄉,11396,38320,20404,17916
2011/8/1,嘉義縣,梅山鄉,6697,21368,11332,10036
2011/8/1,嘉義縣,番路鄉,3972,11584,6304,5280
2011/8/1,嘉義縣,大埔鄉,1939,4569,2404,2165
2011/8/1,嘉義縣,阿里山鄉,2076,6198,3312,2886
2011/8/1,屏東縣,屏東市,72371,210009,104592,105417
2011/8/1,屏東縣,潮州鎮,18313,55458,27887,27571
2011/8/1,屏東縣,東港鎮,15817,49808,25219,24589
2011/8/1,屏東縣,恆春鎮,10842,30888,15843,15045
2011/8/1,屏東縣,萬丹鄉,14398,53708,27791,25917
2011/8/1,屏東縣,長治鄉,9769,30755,16074,14681
2011/8/1,屏東縣,麟洛鄉,3601,11423,5925,5498
2011/8/1,屏東縣,九如鄉,6610,22791,11841,10950
2011/8/1,屏東縣,里港鄉,7895,25701,13197,12504
2011/8/1,屏東縣,鹽埔鄉,7740,27093,14069,13024
2011/8/1,屏東縣,高樹鄉,9410,26468,14130,12338
2011/8/1,屏東縣,萬巒鄉,6422,21735,11464,10271
2011/8/1,屏東縣,內埔鄉,17914,57688,29982,27706
2011/8/1,屏東縣,竹田鄉,5586,18236,9690,8546
2011/8/1,屏東縣,新埤鄉,3374,10578,5632,4946
2011/8/1,屏東縣,枋寮鄉,8503,26331,13845,12486
2011/8/1,屏東縣,新園鄉,11582,37923,19610,18313
2011/8/1,屏東縣,崁頂鄉,4279,17074,8706,8368
2011/8/1,屏東縣,林邊鄉,7156,20466,10541,9925
2011/8/1,屏東縣,南州鄉,3673,11579,5935,5644
2011/8/1,屏東縣,佳冬鄉,7142,21129,11016,10113
2011/8/1,屏東縣,琉球鄉,4000,12171,6774,5397
2011/8/1,屏東縣,車城鄉,3510,9487,5122,4365
2011/8/1,屏東縣,滿州鄉,3050,8284,4572,3712
2011/8/1,屏東縣,枋山鄉,2105,5968,3204,2764
2011/8/1,屏東縣,三地門鄉,2214,7567,3865,3702
2011/8/1,屏東縣,霧臺鄉,995,2965,1560,1405
2011/8/1,屏東縣,瑪家鄉,1912,6529,3414,3115
2011/8/1,屏東縣,泰武鄉,1231,5048,2644,2404
2011/8/1,屏東縣,來義鄉,2174,7682,3944,3738
2011/8/1,屏東縣,春日鄉,1324,4841,2512,2329
2011/8/1,屏東縣,獅子鄉,1468,4814,2547,2267
2011/8/1,屏東縣,牡丹鄉,1880,4916,2556,2360
2011/8/1,臺東縣,臺東市,38169,108436,54871,53565
2011/8/1,臺東縣,成功鎮,5433,15631,8295,7336
2011/8/1,臺東縣,關山鎮,3222,9614,5041,4573
2011/8/1,臺東縣,卑南鄉,6647,18141,9761,8380
2011/8/1,臺東縣,大武鄉,2519,6825,3578,3247
2011/8/1,臺東縣,太麻里鄉,4541,11882,6339,5543
2011/8/1,臺東縣,東河鄉,3604,9254,5157,4097
2011/8/1,臺東縣,長濱鄉,2927,8094,4618,3476
2011/8/1,臺東縣,鹿野鄉,3135,8450,4570,3880
2011/8/1,臺東縣,池上鄉,3257,9037,4790,4247
2011/8/1,臺東縣,綠島鄉,1021,3394,1808,1586
2011/8/1,臺東縣,延平鄉,1065,3558,1959,1599
2011/8/1,臺東縣,海端鄉,1098,4420,2404,2016
2011/8/1,臺東縣,達仁鄉,1498,3984,2175,1809
2011/8/1,臺東縣,金峰鄉,1057,3553,1847,1706
2011/8/1,臺東縣,蘭嶼鄉,1504,4617,2375,2242
2011/8/1,花蓮縣,花蓮市,40737,108845,53281,55564
2011/8/1,花蓮縣,鳳林鎮,4435,11792,6234,5558
2011/8/1,花蓮縣,玉里鎮,8887,26550,14343,12207
2011/8/1,花蓮縣,新城鄉,7330,20111,10424,9687
2011/8/1,花蓮縣,吉安鄉,29433,80263,40980,39283
2011/8/1,花蓮縣,壽豐鄉,6851,18570,10031,8539
2011/8/1,花蓮縣,光復鄉,5030,13878,7410,6468
2011/8/1,花蓮縣,豐濱鄉,1799,4924,2737,2187
2011/8/1,花蓮縣,瑞穗鄉,4648,12674,6849,5825
2011/8/1,花蓮縣,富里鄉,4022,11497,6264,5233
2011/8/1,花蓮縣,秀林鄉,4655,15128,7862,7266
2011/8/1,花蓮縣,萬榮鄉,2117,6737,3603,3134
2011/8/1,花蓮縣,卓溪鄉,1660,6224,3479,2745
2011/8/1,澎湖縣,馬公市,20441,56955,28789,28166
2011/8/1,澎湖縣,湖西鄉,4829,13646,7118,6528
2011/8/1,澎湖縣,白沙鄉,3174,9403,4942,4461
2011/8/1,澎湖縣,西嶼鄉,2868,8393,4328,4065
2011/8/1,澎湖縣,望安鄉,1897,4668,2540,2128
2011/8/1,澎湖縣,七美鄉,1264,3577,1872,1705
2011/8/1,基隆市,中正區,22085,54605,27939,26666
2011/8/1,基隆市,七堵區,20222,54928,27823,27105
2011/8/1,基隆市,暖暖區,14509,37954,19262,18692
2011/8/1,基隆市,仁愛區,19823,48949,24144,24805
2011/8/1,基隆市,中山區,19138,50410,25764,24646
2011/8/1,基隆市,安樂區,31823,83295,41520,41775
2011/8/1,基隆市,信義區,20176,50915,25491,25424
2011/8/1,新竹市,東區,69532,198752,98107,100645
2011/8/1,新竹市,北區,51312,145908,71959,73949
2011/8/1,新竹市,香山區,23395,73306,37414,35892
2011/8/1,嘉義市,東區,44348,124898,60966,63932
2011/8/1,嘉義市,西區,51475,147062,72767,74295
2011/8/1,金門縣,金城鎮,11234,33542,16999,16543
2011/8/1,金門縣,金湖鎮,7490,22221,11318,10903
2011/8/1,金門縣,金沙鎮,5491,15987,8066,7921
2011/8/1,金門縣,金寧鄉,6340,19519,10032,9487
2011/8/1,金門縣,烈嶼鄉,2682,9262,4625,4637
2011/8/1,金門縣,烏坵鄉,135,563,281,282
2011/8/1,連江縣,南竿鄉,1254,5920,3390,2530
2011/8/1,連江縣,北竿鄉,399,1847,1052,795
2011/8/1,連江縣,莒光鄉,245,1166,705,461
2011/8/1,連江縣,東引鄉,275,1077,640,437
2011/9/1,總計,新北市,1428514,3910086,1938052,1972034
2011/9/1,總計,臺北市,997735,2640099,1271879,1368220
2011/9/1,總計,臺中市,865627,2659828,1323232,1336596
2011/9/1,總計,臺南市,647290,1876031,943858,932173
2011/9/1,總計,高雄市,1033956,2773157,1388639,1384518
2011/9/1,總計,臺灣省,3033226,9226624,4714447,4512177
2011/9/1,總計,宜蘭縣,156024,459332,233870,225462
2011/9/1,總計,桃園市,684796,2010168,1012387,997781
2011/9/1,總計,新竹縣,164928,516650,265447,251203
2011/9/1,總計,苗栗縣,174729,561295,290963,270332
2011/9/1,總計,彰化縣,367195,1303192,668135,635057
2011/9/1,總計,南投縣,171987,523491,269370,254121
2011/9/1,總計,雲林縣,231204,714245,372732,341513
2011/9/1,總計,嘉義縣,177599,538779,280885,257894
2011/9/1,總計,屏東縣,278539,866145,445149,420996
2011/9/1,總計,臺東縣,80772,228631,119413,109218
2011/9/1,總計,花蓮縣,121712,336978,173338,163640
2011/9/1,總計,澎湖縣,34713,96779,49585,47194
2011/9/1,總計,基隆市,148054,380647,191765,188882
2011/9/1,總計,新竹市,145005,418534,207792,210742
2011/9/1,總計,嘉義市,95969,271758,133616,138142
2011/9/1,總計,福建省,35713,112122,57597,54525
2011/9/1,總計,金門縣,33536,102064,51787,50277
2011/9/1,總計,連江縣,2177,10058,5810,4248
2011/9/1,新北市,板橋區,197243,554699,273802,280897
2011/9/1,新北市,三重區,142297,390098,194095,196003
2011/9/1,新北市,中和區,157232,414403,204308,210095
2011/9/1,新北市,永和區,90061,232558,111561,120997
2011/9/1,新北市,新莊區,138881,403361,199005,204356
2011/9/1,新北市,新店區,117888,296360,144752,151608
2011/9/1,新北市,樹林區,61938,179202,90202,89000
2011/9/1,新北市,鶯歌區,27899,87455,44152,43303
2011/9/1,新北市,三峽區,36652,105222,53510,51712
2011/9/1,新北市,淡水區,59544,146182,70996,75186
2011/9/1,新北市,汐止區,80316,190399,94403,95996
2011/9/1,新北市,瑞芳區,15923,42122,21466,20656
2011/9/1,新北市,土城區,83095,238812,119271,119541
2011/9/1,新北市,蘆洲區,66334,198082,97991,100091
2011/9/1,新北市,五股區,27706,80317,40660,39657
2011/9/1,新北市,泰山區,26440,76825,38524,38301
2011/9/1,新北市,林口區,32284,85892,42430,43462
2011/9/1,新北市,深坑區,9052,23513,11846,11667
2011/9/1,新北市,石碇區,3325,7871,4386,3485
2011/9/1,新北市,坪林區,2467,6537,3639,2898
2011/9/1,新北市,三芝區,8963,23346,12046,11300
2011/9/1,新北市,石門區,4139,12790,6707,6083
2011/9/1,新北市,八里區,12605,35317,17857,17460
2011/9/1,新北市,平溪區,2399,5230,2921,2309
2011/9/1,新北市,雙溪區,3812,9582,5191,4391
2011/9/1,新北市,貢寮區,4427,13544,6976,6568
2011/9/1,新北市,金山區,6781,22369,11194,11175
2011/9/1,新北市,萬里區,7112,22146,11209,10937
2011/9/1,新北市,烏來區,1699,5852,2952,2900
2011/9/1,臺北市,松山區,78637,209159,99106,110053
2011/9/1,臺北市,信義區,86771,226014,108775,117239
2011/9/1,臺北市,大安區,117896,312310,146956,165354
2011/9/1,臺北市,中山區,93767,222953,104807,118146
2011/9/1,臺北市,中正區,62959,160714,77461,83253
2011/9/1,臺北市,大同區,48297,126066,62065,64001
2011/9/1,臺北市,萬華區,75108,190089,94547,95542
2011/9/1,臺北市,文山區,98979,265431,128442,136989
2011/9/1,臺北市,南港區,42738,115584,56779,58805
2011/9/1,臺北市,內湖區,99362,274473,132194,142279
2011/9/1,臺北市,士林區,102204,286010,138824,147186
2011/9/1,臺北市,北投區,91017,251296,121923,129373
2011/9/1,臺中市,中區,8252,21758,10741,11017
2011/9/1,臺中市,東區,26071,73839,37222,36617
2011/9/1,臺中市,南區,42923,114810,55616,59194
2011/9/1,臺中市,西區,43665,117050,56164,60886
2011/9/1,臺中市,北區,56428,147347,71312,76035
2011/9/1,臺中市,西屯區,74864,209216,101208,108008
2011/9/1,臺中市,南屯區,54323,155236,74989,80247
2011/9/1,臺中市,北屯區,85555,249232,120926,128306
2011/9/1,臺中市,豐原區,50281,165378,82046,83332
2011/9/1,臺中市,東勢區,17052,52907,27438,25469
2011/9/1,臺中市,大甲區,21851,78105,39592,38513
2011/9/1,臺中市,清水區,25223,85618,44159,41459
2011/9/1,臺中市,沙鹿區,24548,82874,42189,40685
2011/9/1,臺中市,梧棲區,16180,55450,28089,27361
2011/9/1,臺中市,后里區,14960,54098,27715,26383
2011/9/1,臺中市,神岡區,17836,63878,32821,31057
2011/9/1,臺中市,潭子區,32991,101495,50494,51001
2011/9/1,臺中市,大雅區,26689,90456,45539,44917
2011/9/1,臺中市,新社區,7366,25496,13311,12185
2011/9/1,臺中市,石岡區,4870,15817,8221,7596
2011/9/1,臺中市,外埔區,8949,31988,16456,15532
2011/9/1,臺中市,大安區,5310,20107,10567,9540
2011/9/1,臺中市,烏日區,20939,69185,35012,34173
2011/9/1,臺中市,大肚區,16011,55670,28572,27098
2011/9/1,臺中市,龍井區,20940,74357,37807,36550
2011/9/1,臺中市,霧峰區,18876,63887,32815,31072
2011/9/1,臺中市,太平區,55389,173943,87237,86706
2011/9/1,臺中市,大里區,62854,199933,99179,100754
2011/9/1,臺中市,和平區,4431,10698,5795,4903
2011/9/1,臺南市,新營區,27545,78396,39048,39348
2011/9/1,臺南市,鹽水區,9999,26935,14027,12908
2011/9/1,臺南市,白河區,10966,31036,16251,14785
2011/9/1,臺南市,柳營區,7796,22478,11762,10716
2011/9/1,臺南市,後壁區,8831,25632,13362,12270
2011/9/1,臺南市,東山區,8238,22814,12108,10706
2011/9/1,臺南市,麻豆區,15153,45634,23302,22332
2011/9/1,臺南市,下營區,9122,25859,13399,12460
2011/9/1,臺南市,六甲區,7682,23536,12244,11292
2011/9/1,臺南市,官田區,7638,22013,11269,10744
2011/9/1,臺南市,大內區,4051,10731,5717,5014
2011/9/1,臺南市,佳里區,19540,59176,29424,29752
2011/9/1,臺南市,學甲區,9578,27643,14145,13498
2011/9/1,臺南市,西港區,7854,25108,12766,12342
2011/9/1,臺南市,七股區,8049,24679,12889,11790
2011/9/1,臺南市,將軍區,7423,21293,10841,10452
2011/9/1,臺南市,北門區,4387,12281,6250,6031
2011/9/1,臺南市,新化區,13798,44036,22528,21508
2011/9/1,臺南市,善化區,14915,43905,22182,21723
2011/9/1,臺南市,新市區,10935,34992,17584,17408
2011/9/1,臺南市,安定區,9427,30252,15672,14580
2011/9/1,臺南市,山上區,2727,7760,4084,3676
2011/9/1,臺南市,玉井區,5081,15253,7870,7383
2011/9/1,臺南市,楠西區,3562,10459,5542,4917
2011/9/1,臺南市,南化區,2827,8812,4832,3980
2011/9/1,臺南市,左鎮區,1980,5389,2995,2394
2011/9/1,臺南市,仁德區,25039,70032,35898,34134
2011/9/1,臺南市,歸仁區,20833,66003,33693,32310
2011/9/1,臺南市,關廟區,10737,35743,18552,17191
2011/9/1,臺南市,龍崎區,1592,4341,2344,1997
2011/9/1,臺南市,永康區,76688,220063,109262,110801
2011/9/1,臺南市,東區,71384,193767,93605,100162
2011/9/1,臺南市,南區,43767,126219,63223,62996
2011/9/1,臺南市,北區,48678,132064,65007,67057
2011/9/1,臺南市,安南區,55600,179490,91210,88280
2011/9/1,臺南市,安平區,23605,63436,30367,33069
2011/9/1,臺南市,中西區,30263,78771,38604,40167
2011/9/1,高雄市,鹽埕區,11095,26815,13436,13379
2011/9/1,高雄市,鼓山區,53086,132531,64755,67776
2011/9/1,高雄市,左營區,74887,193189,94860,98329
2011/9/1,高雄市,楠梓區,62573,173679,86088,87591
2011/9/1,高雄市,三民區,132677,352243,172228,180015
2011/9/1,高雄市,新興區,22879,54543,26444,28099
2011/9/1,高雄市,前金區,12563,28469,13865,14604
2011/9/1,高雄市,苓雅區,72031,181965,88420,93545
2011/9/1,高雄市,前鎮區,76964,197956,98182,99774
2011/9/1,高雄市,旗津區,10985,29799,15470,14329
2011/9/1,高雄市,小港區,64081,154528,77581,76947
2011/9/1,高雄市,鳳山區,129139,344534,171243,173291
2011/9/1,高雄市,林園區,24476,70340,36051,34289
2011/9/1,高雄市,大寮區,38850,109115,56613,52502
2011/9/1,高雄市,大樹區,13128,43696,22584,21112
2011/9/1,高雄市,大社區,11888,33228,17036,16192
2011/9/1,高雄市,仁武區,26952,74417,38374,36043
2011/9/1,高雄市,鳥松區,16886,43132,21858,21274
2011/9/1,高雄市,岡山區,33557,97245,48726,48519
2011/9/1,高雄市,橋頭區,12867,36779,18816,17963
2011/9/1,高雄市,燕巢區,10141,30900,16510,14390
2011/9/1,高雄市,田寮區,3524,8066,4479,3587
2011/9/1,高雄市,阿蓮區,9218,30224,15257,14967
2011/9/1,高雄市,路竹區,16163,53489,27280,26209
2011/9/1,高雄市,湖內區,9736,28848,14834,14014
2011/9/1,高雄市,茄萣區,10182,31062,16178,14884
2011/9/1,高雄市,永安區,5826,14118,7176,6942
2011/9/1,高雄市,彌陀區,6670,20277,10517,9760
2011/9/1,高雄市,梓官區,12125,36574,19011,17563
2011/9/1,高雄市,旗山區,13869,39552,20573,18979
2011/9/1,高雄市,美濃區,14306,42748,22328,20420
2011/9/1,高雄市,六龜區,5790,14554,7881,6673
2011/9/1,高雄市,甲仙區,2509,7042,3776,3266
2011/9/1,高雄市,杉林區,4461,11911,6500,5411
2011/9/1,高雄市,內門區,5043,15704,8568,7136
2011/9/1,高雄市,茂林區,577,1835,920,915
2011/9/1,高雄市,桃源區,1366,4740,2505,2235
2011/9/1,高雄市,那瑪夏區,886,3310,1716,1594
2011/9/1,宜蘭縣,宜蘭市,33585,95609,46956,48653
2011/9/1,宜蘭縣,羅東鎮,25195,72830,34903,37927
2011/9/1,宜蘭縣,蘇澳鎮,13693,42535,21792,20743
2011/9/1,宜蘭縣,頭城鎮,9826,30624,15824,14800
2011/9/1,宜蘭縣,礁溪鄉,12544,35988,18836,17152
2011/9/1,宜蘭縣,壯圍鄉,8174,24690,13053,11637
2011/9/1,宜蘭縣,員山鄉,10912,32269,17270,14999
2011/9/1,宜蘭縣,冬山鄉,17640,52892,27194,25698
2011/9/1,宜蘭縣,五結鄉,13197,38798,20172,18626
2011/9/1,宜蘭縣,三星鄉,7600,21217,11472,9745
2011/9/1,宜蘭縣,大同鄉,1825,5926,3224,2702
2011/9/1,宜蘭縣,南澳鄉,1833,5954,3174,2780
2011/9/1,桃園市,桃園區,146789,409494,200474,209020
2011/9/1,桃園市,中壢區,129472,371684,185363,186321
2011/9/1,桃園市,平鎮區,67941,208380,104890,103490
2011/9/1,桃園市,八德區,59148,177226,89960,87266
2011/9/1,桃園市,楊梅區,49810,152013,77214,74799
2011/9/1,桃園市,大溪區,29539,91971,47388,44583
2011/9/1,桃園市,蘆竹區,49281,143441,71873,71568
2011/9/1,桃園市,大園區,26430,82037,42542,39495
2011/9/1,桃園市,龜山區,50875,138144,69930,68214
2011/9/1,桃園市,龍潭區,37287,114939,58346,56593
2011/9/1,桃園市,新屋區,15027,48692,26083,22609
2011/9/1,桃園市,觀音區,19519,61533,32401,29132
2011/9/1,桃園市,復興區,3678,10614,5923,4691
2011/9/1,新竹縣,竹北市,49195,145911,73009,72902
2011/9/1,新竹縣,關西鎮,9312,31558,16805,14753
2011/9/1,新竹縣,新埔鎮,10455,35287,18693,16594
2011/9/1,新竹縣,竹東鎮,31007,96515,48629,47886
2011/9/1,新竹縣,湖口鄉,23747,75814,38705,37109
2011/9/1,新竹縣,橫山鄉,4448,14223,7689,6534
2011/9/1,新竹縣,新豐鄉,16044,53510,27535,25975
2011/9/1,新竹縣,芎林鄉,6324,20604,10848,9756
2011/9/1,新竹縣,寶山鄉,4800,14077,7602,6475
2011/9/1,新竹縣,北埔鄉,3112,10022,5455,4567
2011/9/1,新竹縣,峨眉鄉,2037,5926,3274,2652
2011/9/1,新竹縣,尖石鄉,2714,8558,4651,3907
2011/9/1,新竹縣,五峰鄉,1733,4645,2552,2093
2011/9/1,苗栗縣,苗栗市,29447,90787,45656,45131
2011/9/1,苗栗縣,苑裡鎮,13946,48512,25315,23197
2011/9/1,苗栗縣,通霄鎮,11403,37641,19904,17737
2011/9/1,苗栗縣,竹南鎮,24698,79311,40293,39018
2011/9/1,苗栗縣,頭份市,30280,98120,49750,48370
2011/9/1,苗栗縣,後龍鎮,11748,38998,20624,18374
2011/9/1,苗栗縣,卓蘭鎮,5981,18364,9688,8676
2011/9/1,苗栗縣,大湖鄉,5346,15943,8480,7463
2011/9/1,苗栗縣,公館鄉,10287,34773,18207,16566
2011/9/1,苗栗縣,銅鑼鄉,5994,19349,10256,9093
2011/9/1,苗栗縣,南庄鄉,4004,11017,6080,4937
2011/9/1,苗栗縣,頭屋鄉,3538,11526,6092,5434
2011/9/1,苗栗縣,三義鄉,5320,17486,9219,8267
2011/9/1,苗栗縣,西湖鄉,2687,7814,4341,3473
2011/9/1,苗栗縣,造橋鄉,4024,13683,7207,6476
2011/9/1,苗栗縣,三灣鄉,2398,7215,3931,3284
2011/9/1,苗栗縣,獅潭鄉,1679,4833,2705,2128
2011/9/1,苗栗縣,泰安鄉,1949,5923,3215,2708
2011/9/1,彰化縣,彰化市,72714,236480,117625,118855
2011/9/1,彰化縣,鹿港鎮,22591,85342,43733,41609
2011/9/1,彰化縣,和美鎮,24573,90084,46115,43969
2011/9/1,彰化縣,北斗鎮,10052,33400,16929,16471
2011/9/1,彰化縣,員林市,37111,125098,62851,62247
2011/9/1,彰化縣,溪湖鎮,15294,55930,28546,27384
2011/9/1,彰化縣,田中鎮,12596,43731,22698,21033
2011/9/1,彰化縣,二林鎮,14421,53674,27708,25966
2011/9/1,彰化縣,線西鄉,4151,17024,8778,8246
2011/9/1,彰化縣,伸港鄉,9067,35906,18435,17471
2011/9/1,彰化縣,福興鄉,12189,48677,25415,23262
2011/9/1,彰化縣,秀水鄉,9898,39205,20303,18902
2011/9/1,彰化縣,花壇鄉,13130,46064,23699,22365
2011/9/1,彰化縣,芬園鄉,6875,24698,13103,11595
2011/9/1,彰化縣,大村鄉,10363,36532,19031,17501
2011/9/1,彰化縣,埔鹽鄉,8868,34080,17867,16213
2011/9/1,彰化縣,埔心鄉,10025,35263,18212,17051
2011/9/1,彰化縣,永靖鄉,10472,38981,20234,18747
2011/9/1,彰化縣,社頭鄉,12381,44455,22812,21643
2011/9/1,彰化縣,二水鄉,5337,16389,8604,7785
2011/9/1,彰化縣,田尾鄉,7717,28426,14798,13628
2011/9/1,彰化縣,埤頭鄉,8672,31526,16436,15090
2011/9/1,彰化縣,芳苑鄉,10000,35870,18969,16901
2011/9/1,彰化縣,大城鄉,5397,18678,10133,8545
2011/9/1,彰化縣,竹塘鄉,4604,16334,8587,7747
2011/9/1,彰化縣,溪州鄉,8697,31345,16514,14831
2011/9/1,南投縣,南投市,33533,103776,52175,51601
2011/9/1,南投縣,埔里鎮,28500,84729,42768,41961
2011/9/1,南投縣,草屯鎮,31234,99293,50196,49097
2011/9/1,南投縣,竹山鎮,19285,58031,29921,28110
2011/9/1,南投縣,集集鎮,4301,11754,6148,5606
2011/9/1,南投縣,名間鄉,12203,41042,21537,19505
2011/9/1,南投縣,鹿谷鄉,6905,18965,10067,8898
2011/9/1,南投縣,中寮鄉,5635,16018,8720,7298
2011/9/1,南投縣,魚池鄉,5747,16984,8958,8026
2011/9/1,南投縣,國姓鄉,7224,20416,11131,9285
2011/9/1,南投縣,水里鄉,7232,19806,10373,9433
2011/9/1,南投縣,信義鄉,5265,17139,9274,7865
2011/9/1,南投縣,仁愛鄉,4923,15538,8102,7436
2011/9/1,雲林縣,斗六市,35239,107015,53740,53275
2011/9/1,雲林縣,斗南鎮,15376,46925,23860,23065
2011/9/1,雲林縣,虎尾鎮,22797,70119,35654,34465
2011/9/1,雲林縣,西螺鎮,14111,48155,24527,23628
2011/9/1,雲林縣,土庫鎮,8814,30300,15833,14467
2011/9/1,雲林縣,北港鎮,15488,42642,22195,20447
2011/9/1,雲林縣,古坑鄉,10680,33694,17802,15892
2011/9/1,雲林縣,大埤鄉,6662,20922,11236,9686
2011/9/1,雲林縣,莿桐鄉,9101,30311,15897,14414
2011/9/1,雲林縣,林內鄉,5785,19706,10278,9428
2011/9/1,雲林縣,二崙鄉,8739,29413,15761,13652
2011/9/1,雲林縣,崙背鄉,8324,26958,14201,12757
2011/9/1,雲林縣,麥寮鄉,12801,38567,19991,18576
2011/9/1,雲林縣,東勢鄉,5712,16463,8974,7489
2011/9/1,雲林縣,褒忠鄉,4299,14058,7496,6562
2011/9/1,雲林縣,臺西鄉,8902,25806,13868,11938
2011/9/1,雲林縣,元長鄉,9360,28461,15529,12932
2011/9/1,雲林縣,四湖鄉,9052,26399,14386,12013
2011/9/1,雲林縣,口湖鄉,9606,29958,15966,13992
2011/9/1,雲林縣,水林鄉,10356,28373,15538,12835
2011/9/1,嘉義縣,太保市,11499,36713,18896,17817
2011/9/1,嘉義縣,朴子市,14810,43962,22386,21576
2011/9/1,嘉義縣,布袋鎮,10155,29718,15240,14478
2011/9/1,嘉義縣,大林鎮,11253,33276,17091,16185
2011/9/1,嘉義縣,民雄鄉,23055,72433,37182,35251
2011/9/1,嘉義縣,溪口鄉,5397,16072,8599,7473
2011/9/1,嘉義縣,新港鄉,10427,34320,18095,16225
2011/9/1,嘉義縣,六腳鄉,9163,26027,13779,12248
2011/9/1,嘉義縣,東石鄉,9511,27261,14496,12765
2011/9/1,嘉義縣,義竹鄉,7471,20708,10757,9951
2011/9/1,嘉義縣,鹿草鄉,5785,17046,9173,7873
2011/9/1,嘉義縣,水上鄉,17460,51863,26760,25103
2011/9/1,嘉義縣,中埔鄉,15502,47326,24678,22648
2011/9/1,嘉義縣,竹崎鄉,11410,38301,20404,17897
2011/9/1,嘉義縣,梅山鄉,6708,21388,11333,10055
2011/9/1,嘉義縣,番路鄉,3978,11591,6309,5282
2011/9/1,嘉義縣,大埔鄉,1940,4568,2399,2169
2011/9/1,嘉義縣,阿里山鄉,2075,6206,3308,2898
2011/9/1,屏東縣,屏東市,72419,209743,104488,105255
2011/9/1,屏東縣,潮州鎮,18347,55370,27826,27544
2011/9/1,屏東縣,東港鎮,15828,49724,25161,24563
2011/9/1,屏東縣,恆春鎮,10872,30884,15823,15061
2011/9/1,屏東縣,萬丹鄉,14404,53618,27750,25868
2011/9/1,屏東縣,長治鄉,9774,30718,16051,14667
2011/9/1,屏東縣,麟洛鄉,3609,11430,5923,5507
2011/9/1,屏東縣,九如鄉,6613,22763,11827,10936
2011/9/1,屏東縣,里港鄉,7908,25721,13193,12528
2011/9/1,屏東縣,鹽埔鄉,7749,27065,14058,13007
2011/9/1,屏東縣,高樹鄉,9412,26406,14101,12305
2011/9/1,屏東縣,萬巒鄉,6428,21677,11431,10246
2011/9/1,屏東縣,內埔鄉,17950,57650,29964,27686
2011/9/1,屏東縣,竹田鄉,5592,18228,9679,8549
2011/9/1,屏東縣,新埤鄉,3375,10582,5625,4957
2011/9/1,屏東縣,枋寮鄉,8517,26300,13827,12473
2011/9/1,屏東縣,新園鄉,11590,37882,19586,18296
2011/9/1,屏東縣,崁頂鄉,4289,17093,8718,8375
2011/9/1,屏東縣,林邊鄉,7155,20392,10512,9880
2011/9/1,屏東縣,南州鄉,3675,11563,5923,5640
2011/9/1,屏東縣,佳冬鄉,7142,21106,11002,10104
2011/9/1,屏東縣,琉球鄉,4003,12162,6761,5401
2011/9/1,屏東縣,車城鄉,3513,9470,5112,4358
2011/9/1,屏東縣,滿州鄉,3053,8264,4565,3699
2011/9/1,屏東縣,枋山鄉,2103,5945,3195,2750
2011/9/1,屏東縣,三地門鄉,2218,7556,3858,3698
2011/9/1,屏東縣,霧臺鄉,994,2958,1557,1401
2011/9/1,屏東縣,瑪家鄉,1921,6544,3414,3130
2011/9/1,屏東縣,泰武鄉,1236,5064,2654,2410
2011/9/1,屏東縣,來義鄉,2178,7692,3954,3738
2011/9/1,屏東縣,春日鄉,1325,4839,2504,2335
2011/9/1,屏東縣,獅子鄉,1466,4812,2547,2265
2011/9/1,屏東縣,牡丹鄉,1881,4924,2560,2364
2011/9/1,臺東縣,臺東市,38215,108377,54829,53548
2011/9/1,臺東縣,成功鎮,5439,15583,8270,7313
2011/9/1,臺東縣,關山鎮,3220,9591,5033,4558
2011/9/1,臺東縣,卑南鄉,6652,18106,9749,8357
2011/9/1,臺東縣,大武鄉,2522,6810,3569,3241
2011/9/1,臺東縣,太麻里鄉,4542,11859,6330,5529
2011/9/1,臺東縣,東河鄉,3596,9212,5125,4087
2011/9/1,臺東縣,長濱鄉,2933,8092,4618,3474
2011/9/1,臺東縣,鹿野鄉,3130,8439,4557,3882
2011/9/1,臺東縣,池上鄉,3258,9027,4774,4253
2011/9/1,臺東縣,綠島鄉,1029,3410,1812,1598
2011/9/1,臺東縣,延平鄉,1065,3563,1960,1603
2011/9/1,臺東縣,海端鄉,1100,4414,2398,2016
2011/9/1,臺東縣,達仁鄉,1501,3971,2170,1801
2011/9/1,臺東縣,金峰鄉,1056,3533,1835,1698
2011/9/1,臺東縣,蘭嶼鄉,1514,4644,2384,2260
2011/9/1,花蓮縣,花蓮市,40758,108756,53229,55527
2011/9/1,花蓮縣,鳳林鎮,4434,11764,6215,5549
2011/9/1,花蓮縣,玉里鎮,8896,26529,14340,12189
2011/9/1,花蓮縣,新城鄉,7335,20141,10442,9699
2011/9/1,花蓮縣,吉安鄉,29511,80300,40990,39310
2011/9/1,花蓮縣,壽豐鄉,6850,18534,10009,8525
2011/9/1,花蓮縣,光復鄉,5031,13848,7385,6463
2011/9/1,花蓮縣,豐濱鄉,1796,4912,2730,2182
2011/9/1,花蓮縣,瑞穗鄉,4644,12643,6831,5812
2011/9/1,花蓮縣,富里鄉,4014,11454,6243,5211
2011/9/1,花蓮縣,秀林鄉,4668,15139,7861,7278
2011/9/1,花蓮縣,萬榮鄉,2114,6728,3595,3133
2011/9/1,花蓮縣,卓溪鄉,1661,6230,3468,2762
2011/9/1,澎湖縣,馬公市,20663,57081,28801,28280
2011/9/1,澎湖縣,湖西鄉,4839,13672,7132,6540
2011/9/1,澎湖縣,白沙鄉,3179,9413,4940,4473
2011/9/1,澎湖縣,西嶼鄉,2865,8375,4315,4060
2011/9/1,澎湖縣,望安鄉,1901,4668,2528,2140
2011/9/1,澎湖縣,七美鄉,1266,3570,1869,1701
2011/9/1,基隆市,中正區,22158,54546,27923,26623
2011/9/1,基隆市,七堵區,20262,54828,27792,27036
2011/9/1,基隆市,暖暖區,14590,37999,19268,18731
2011/9/1,基隆市,仁愛區,19817,48847,24094,24753
2011/9/1,基隆市,中山區,19190,50421,25775,24646
2011/9/1,基隆市,安樂區,31823,83116,41458,41658
2011/9/1,基隆市,信義區,20214,50890,25455,25435
2011/9/1,新竹市,東區,69984,199060,98311,100749
2011/9/1,新竹市,北區,51505,146009,72009,74000
2011/9/1,新竹市,香山區,23516,73465,37472,35993
2011/9/1,嘉義市,東區,44391,124687,60879,63808
2011/9/1,嘉義市,西區,51578,147071,72737,74334
2011/9/1,金門縣,金城鎮,11302,33764,17094,16670
2011/9/1,金門縣,金湖鎮,7526,22382,11398,10984
2011/9/1,金門縣,金沙鎮,5509,16075,8102,7973
2011/9/1,金門縣,金寧鄉,6374,19938,10252,9686
2011/9/1,金門縣,烈嶼鄉,2690,9343,4661,4682
2011/9/1,金門縣,烏坵鄉,135,562,280,282
2011/9/1,連江縣,南竿鄉,1255,5965,3414,2551
2011/9/1,連江縣,北竿鄉,401,1849,1050,799
2011/9/1,連江縣,莒光鄉,246,1165,704,461
2011/9/1,連江縣,東引鄉,275,1079,642,437
2011/10/1,總計,新北市,1429486,3911833,1938446,1973387
2011/10/1,總計,臺北市,998283,2643136,1273131,1370005
2011/10/1,總計,臺中市,866588,2661290,1323788,1337502
2011/10/1,總計,臺南市,647699,1876312,943923,932389
2011/10/1,總計,高雄市,1034299,2773526,1388598,1384928
2011/10/1,總計,臺灣省,3035603,9226597,4714212,4512385
2011/10/1,總計,宜蘭縣,156204,459296,233845,225451
2011/10/1,總計,桃園市,685235,2010987,1012708,998279
2011/10/1,總計,新竹縣,165200,517114,265687,251427
2011/10/1,總計,苗栗縣,174942,561523,291059,270464
2011/10/1,總計,彰化縣,367466,1303054,668056,634998
2011/10/1,總計,南投縣,172137,523176,269209,253967
2011/10/1,總計,雲林縣,231351,714078,372627,341451
2011/10/1,總計,嘉義縣,177725,538436,280719,257717
2011/10/1,總計,屏東縣,278626,865515,444762,420753
2011/10/1,總計,臺東縣,80825,228454,119303,109151
2011/10/1,總計,花蓮縣,121733,336885,173287,163598
2011/10/1,總計,澎湖縣,34931,97007,49772,47235
2011/10/1,總計,基隆市,148074,380501,191717,188784
2011/10/1,總計,新竹市,145191,418927,207946,210981
2011/10/1,總計,嘉義市,95963,271644,133515,138129
2011/10/1,總計,福建省,35845,112911,57948,54963
2011/10/1,總計,金門縣,33661,102827,52127,50700
2011/10/1,總計,連江縣,2184,10084,5821,4263
2011/10/1,新北市,板橋區,197454,554816,273741,281075
2011/10/1,新北市,三重區,142343,390101,194074,196027
2011/10/1,新北市,中和區,157332,414598,204365,210233
2011/10/1,新北市,永和區,90001,232408,111480,120928
2011/10/1,新北市,新莊區,138960,403532,199035,204497
2011/10/1,新北市,新店區,117889,296422,144729,151693
2011/10/1,新北市,樹林區,62012,179386,90264,89122
2011/10/1,新北市,鶯歌區,27943,87533,44186,43347
2011/10/1,新北市,三峽區,36720,105413,53588,51825
2011/10/1,新北市,淡水區,59627,146390,71072,75318
2011/10/1,新北市,汐止區,80308,190439,94370,96069
2011/10/1,新北市,瑞芳區,15940,42103,21461,20642
2011/10/1,新北市,土城區,83138,238886,119290,119596
2011/10/1,新北市,蘆洲區,66397,198152,98012,100140
2011/10/1,新北市,五股區,27732,80437,40722,39715
2011/10/1,新北市,泰山區,26486,76911,38587,38324
2011/10/1,新北市,林口區,32364,86116,42517,43599
2011/10/1,新北市,深坑區,9056,23498,11833,11665
2011/10/1,新北市,石碇區,3337,7892,4395,3497
2011/10/1,新北市,坪林區,2467,6554,3643,2911
2011/10/1,新北市,三芝區,8956,23335,12033,11302
2011/10/1,新北市,石門區,4145,12801,6709,6092
2011/10/1,新北市,八里區,12618,35325,17859,17466
2011/10/1,新北市,平溪區,2398,5225,2918,2307
2011/10/1,新北市,雙溪區,3809,9576,5187,4389
2011/10/1,新北市,貢寮區,4430,13549,6987,6562
2011/10/1,新北市,金山區,6790,22398,11201,11197
2011/10/1,新北市,萬里區,7120,22168,11227,10941
2011/10/1,新北市,烏來區,1714,5869,2961,2908
2011/10/1,臺北市,松山區,78699,209428,99195,110233
2011/10/1,臺北市,信義區,86747,226184,108828,117356
2011/10/1,臺北市,大安區,117940,312637,147065,165572
2011/10/1,臺北市,中山區,93792,223266,104912,118354
2011/10/1,臺北市,中正區,63025,160933,77560,83373
2011/10/1,臺北市,大同區,48362,126211,62104,64107
2011/10/1,臺北市,萬華區,75139,190280,94611,95669
2011/10/1,臺北市,文山區,99011,265724,128619,137105
2011/10/1,臺北市,南港區,42774,115725,56880,58845
2011/10/1,臺北市,內湖區,99436,274760,132308,142452
2011/10/1,臺北市,士林區,102294,286413,139010,147403
2011/10/1,臺北市,北投區,91064,251575,122039,129536
2011/10/1,臺中市,中區,8240,21739,10754,10985
2011/10/1,臺中市,東區,26092,73865,37226,36639
2011/10/1,臺中市,南區,42968,114931,55673,59258
2011/10/1,臺中市,西區,43716,117120,56173,60947
2011/10/1,臺中市,北區,56460,147421,71337,76084
2011/10/1,臺中市,西屯區,74927,209232,101184,108048
2011/10/1,臺中市,南屯區,54409,155417,75044,80373
2011/10/1,臺中市,北屯區,85606,249480,121022,128458
2011/10/1,臺中市,豐原區,50373,165423,82068,83355
2011/10/1,臺中市,東勢區,17059,52850,27422,25428
2011/10/1,臺中市,大甲區,21872,78068,39586,38482
2011/10/1,臺中市,清水區,25244,85622,44160,41462
2011/10/1,臺中市,沙鹿區,24614,83034,42228,40806
2011/10/1,臺中市,梧棲區,16200,55464,28107,27357
2011/10/1,臺中市,后里區,14967,54059,27700,26359
2011/10/1,臺中市,神岡區,17864,63863,32820,31043
2011/10/1,臺中市,潭子區,33025,101618,50548,51070
2011/10/1,臺中市,大雅區,26696,90500,45558,44942
2011/10/1,臺中市,新社區,7362,25495,13319,12176
2011/10/1,臺中市,石岡區,4871,15822,8233,7589
2011/10/1,臺中市,外埔區,8956,31982,16458,15524
2011/10/1,臺中市,大安區,5311,20110,10568,9542
2011/10/1,臺中市,烏日區,20972,69148,35010,34138
2011/10/1,臺中市,大肚區,16022,55682,28578,27104
2011/10/1,臺中市,龍井區,20972,74477,37835,36642
2011/10/1,臺中市,霧峰區,18905,63913,32815,31098
2011/10/1,臺中市,太平區,55480,174051,87265,86786
2011/10/1,臺中市,大里區,62982,200208,99312,100896
2011/10/1,臺中市,和平區,4423,10696,5785,4911
2011/10/1,臺南市,新營區,27561,78394,39029,39365
2011/10/1,臺南市,鹽水區,10003,26937,14024,12913
2011/10/1,臺南市,白河區,10974,31023,16253,14770
2011/10/1,臺南市,柳營區,7802,22469,11764,10705
2011/10/1,臺南市,後壁區,8830,25605,13339,12266
2011/10/1,臺南市,東山區,8233,22811,12095,10716
2011/10/1,臺南市,麻豆區,15153,45614,23280,22334
2011/10/1,臺南市,下營區,9119,25860,13386,12474
2011/10/1,臺南市,六甲區,7684,23530,12245,11285
2011/10/1,臺南市,官田區,7643,22009,11265,10744
2011/10/1,臺南市,大內區,4045,10702,5707,4995
2011/10/1,臺南市,佳里區,19548,59210,29430,29780
2011/10/1,臺南市,學甲區,9576,27621,14133,13488
2011/10/1,臺南市,西港區,7859,25077,12751,12326
2011/10/1,臺南市,七股區,8055,24641,12876,11765
2011/10/1,臺南市,將軍區,7426,21288,10837,10451
2011/10/1,臺南市,北門區,4392,12266,6244,6022
2011/10/1,臺南市,新化區,13817,44034,22537,21497
2011/10/1,臺南市,善化區,14937,43954,22209,21745
2011/10/1,臺南市,新市區,10945,34995,17587,17408
2011/10/1,臺南市,安定區,9441,30281,15690,14591
2011/10/1,臺南市,山上區,2731,7758,4090,3668
2011/10/1,臺南市,玉井區,5082,15218,7866,7352
2011/10/1,臺南市,楠西區,3562,10471,5555,4916
2011/10/1,臺南市,南化區,2827,8819,4832,3987
2011/10/1,臺南市,左鎮區,1981,5375,2989,2386
2011/10/1,臺南市,仁德區,25055,70096,35909,34187
2011/10/1,臺南市,歸仁區,20839,66016,33688,32328
2011/10/1,臺南市,關廟區,10750,35704,18534,17170
2011/10/1,臺南市,龍崎區,1592,4330,2342,1988
2011/10/1,臺南市,永康區,76820,220329,109430,110899
2011/10/1,臺南市,東區,71381,193734,93560,100174
2011/10/1,臺南市,南區,43764,126137,63191,62946
2011/10/1,臺南市,北區,48694,132115,65021,67094
2011/10/1,臺南市,安南區,55695,179665,91260,88405
2011/10/1,臺南市,安平區,23621,63501,30413,33088
2011/10/1,臺南市,中西區,30262,78723,38562,40161
2011/10/1,高雄市,鹽埕區,11069,26753,13402,13351
2011/10/1,高雄市,鼓山區,53101,132629,64816,67813
2011/10/1,高雄市,左營區,74862,193269,94873,98396
2011/10/1,高雄市,楠梓區,62610,173790,86128,87662
2011/10/1,高雄市,三民區,132662,352116,172140,179976
2011/10/1,高雄市,新興區,22836,54445,26406,28039
2011/10/1,高雄市,前金區,12545,28453,13857,14596
2011/10/1,高雄市,苓雅區,72018,181852,88380,93472
2011/10/1,高雄市,前鎮區,76950,197855,98118,99737
2011/10/1,高雄市,旗津區,10992,29791,15451,14340
2011/10/1,高雄市,小港區,64151,154651,77609,77042
2011/10/1,高雄市,鳳山區,129200,344772,171301,173471
2011/10/1,高雄市,林園區,24529,70375,36063,34312
2011/10/1,高雄市,大寮區,38907,109181,56662,52519
2011/10/1,高雄市,大樹區,13127,43675,22549,21126
2011/10/1,高雄市,大社區,11891,33258,17048,16210
2011/10/1,高雄市,仁武區,27044,74645,38488,36157
2011/10/1,高雄市,鳥松區,16891,43144,21866,21278
2011/10/1,高雄市,岡山區,33583,97304,48732,48572
2011/10/1,高雄市,橋頭區,12874,36774,18816,17958
2011/10/1,高雄市,燕巢區,10123,30896,16489,14407
2011/10/1,高雄市,田寮區,3522,8055,4470,3585
2011/10/1,高雄市,阿蓮區,9216,30197,15245,14952
2011/10/1,高雄市,路竹區,16165,53482,27278,26204
2011/10/1,高雄市,湖內區,9749,28841,14836,14005
2011/10/1,高雄市,茄萣區,10179,31033,16149,14884
2011/10/1,高雄市,永安區,5817,14119,7175,6944
2011/10/1,高雄市,彌陀區,6677,20260,10516,9744
2011/10/1,高雄市,梓官區,12144,36601,19019,17582
2011/10/1,高雄市,旗山區,13859,39502,20551,18951
2011/10/1,高雄市,美濃區,14312,42712,22310,20402
2011/10/1,高雄市,六龜區,5760,14476,7827,6649
2011/10/1,高雄市,甲仙區,2498,7008,3758,3250
2011/10/1,高雄市,杉林區,4558,12077,6592,5485
2011/10/1,高雄市,內門區,5051,15703,8565,7138
2011/10/1,高雄市,茂林區,576,1833,919,914
2011/10/1,高雄市,桃源區,1368,4719,2493,2226
2011/10/1,高雄市,那瑪夏區,883,3280,1701,1579
2011/10/1,宜蘭縣,宜蘭市,33631,95624,46981,48643
2011/10/1,宜蘭縣,羅東鎮,25205,72841,34904,37937
2011/10/1,宜蘭縣,蘇澳鎮,13699,42480,21769,20711
2011/10/1,宜蘭縣,頭城鎮,9824,30605,15811,14794
2011/10/1,宜蘭縣,礁溪鄉,12556,35962,18815,17147
2011/10/1,宜蘭縣,壯圍鄉,8179,24705,13049,11656
2011/10/1,宜蘭縣,員山鄉,10935,32263,17283,14980
2011/10/1,宜蘭縣,冬山鄉,17695,52924,27211,25713
2011/10/1,宜蘭縣,五結鄉,13206,38803,20156,18647
2011/10/1,宜蘭縣,三星鄉,7615,21216,11475,9741
2011/10/1,宜蘭縣,大同鄉,1824,5935,3233,2702
2011/10/1,宜蘭縣,南澳鄉,1835,5938,3158,2780
2011/10/1,桃園市,桃園區,146798,409624,200505,209119
2011/10/1,桃園市,中壢區,129667,371832,185443,186389
2011/10/1,桃園市,平鎮區,67956,208458,104892,103566
2011/10/1,桃園市,八德區,59161,177242,89960,87282
2011/10/1,桃園市,楊梅區,49881,152144,77325,74819
2011/10/1,桃園市,大溪區,29566,91997,47407,44590
2011/10/1,桃園市,蘆竹區,49326,143633,71949,71684
2011/10/1,桃園市,大園區,26432,82011,42526,39485
2011/10/1,桃園市,龜山區,50891,138225,69924,68301
2011/10/1,桃園市,龍潭區,37289,114923,58339,56584
2011/10/1,桃園市,新屋區,15036,48664,26072,22592
2011/10/1,桃園市,觀音區,19552,61609,32435,29174
2011/10/1,桃園市,復興區,3680,10625,5931,4694
2011/10/1,新竹縣,竹北市,49330,146308,73208,73100
2011/10/1,新竹縣,關西鎮,9318,31556,16803,14753
2011/10/1,新竹縣,新埔鎮,10464,35267,18689,16578
2011/10/1,新竹縣,竹東鎮,31073,96527,48636,47891
2011/10/1,新竹縣,湖口鄉,23772,75857,38712,37145
2011/10/1,新竹縣,橫山鄉,4451,14207,7681,6526
2011/10/1,新竹縣,新豐鄉,16071,53590,27570,26020
2011/10/1,新竹縣,芎林鄉,6326,20552,10831,9721
2011/10/1,新竹縣,寶山鄉,4797,14060,7607,6453
2011/10/1,新竹縣,北埔鄉,3111,10009,5450,4559
2011/10/1,新竹縣,峨眉鄉,2040,5916,3269,2647
2011/10/1,新竹縣,尖石鄉,2715,8624,4684,3940
2011/10/1,新竹縣,五峰鄉,1732,4641,2547,2094
2011/10/1,苗栗縣,苗栗市,29491,90810,45666,45144
2011/10/1,苗栗縣,苑裡鎮,13956,48492,25304,23188
2011/10/1,苗栗縣,通霄鎮,11407,37652,19895,17757
2011/10/1,苗栗縣,竹南鎮,24732,79428,40353,39075
2011/10/1,苗栗縣,頭份市,30327,98218,49803,48415
2011/10/1,苗栗縣,後龍鎮,11762,38986,20615,18371
2011/10/1,苗栗縣,卓蘭鎮,5983,18389,9695,8694
2011/10/1,苗栗縣,大湖鄉,5350,15915,8464,7451
2011/10/1,苗栗縣,公館鄉,10306,34786,18212,16574
2011/10/1,苗栗縣,銅鑼鄉,6002,19368,10277,9091
2011/10/1,苗栗縣,南庄鄉,4008,11015,6076,4939
2011/10/1,苗栗縣,頭屋鄉,3540,11501,6075,5426
2011/10/1,苗栗縣,三義鄉,5322,17488,9212,8276
2011/10/1,苗栗縣,西湖鄉,2685,7817,4343,3474
2011/10/1,苗栗縣,造橋鄉,4040,13690,7219,6471
2011/10/1,苗栗縣,三灣鄉,2397,7204,3925,3279
2011/10/1,苗栗縣,獅潭鄉,1684,4838,2709,2129
2011/10/1,苗栗縣,泰安鄉,1950,5926,3216,2710
2011/10/1,彰化縣,彰化市,72766,236513,117638,118875
2011/10/1,彰化縣,鹿港鎮,22614,85360,43738,41622
2011/10/1,彰化縣,和美鎮,24596,90117,46124,43993
2011/10/1,彰化縣,北斗鎮,10052,33376,16918,16458
2011/10/1,彰化縣,員林市,37131,125057,62848,62209
2011/10/1,彰化縣,溪湖鎮,15299,55914,28532,27382
2011/10/1,彰化縣,田中鎮,12603,43696,22696,21000
2011/10/1,彰化縣,二林鎮,14429,53611,27694,25917
2011/10/1,彰化縣,線西鄉,4150,17011,8768,8243
2011/10/1,彰化縣,伸港鄉,9085,35934,18443,17491
2011/10/1,彰化縣,福興鄉,12201,48667,25398,23269
2011/10/1,彰化縣,秀水鄉,9900,39199,20297,18902
2011/10/1,彰化縣,花壇鄉,13135,46026,23679,22347
2011/10/1,彰化縣,芬園鄉,6878,24678,13094,11584
2011/10/1,彰化縣,大村鄉,10370,36561,19056,17505
2011/10/1,彰化縣,埔鹽鄉,8885,34090,17867,16223
2011/10/1,彰化縣,埔心鄉,10049,35316,18233,17083
2011/10/1,彰化縣,永靖鄉,10471,38935,20209,18726
2011/10/1,彰化縣,社頭鄉,12392,44444,22800,21644
2011/10/1,彰化縣,二水鄉,5338,16401,8609,7792
2011/10/1,彰化縣,田尾鄉,7718,28406,14791,13615
2011/10/1,彰化縣,埤頭鄉,8679,31519,16440,15079
2011/10/1,彰化縣,芳苑鄉,10012,35842,18948,16894
2011/10/1,彰化縣,大城鄉,5393,18666,10130,8536
2011/10/1,彰化縣,竹塘鄉,4606,16364,8595,7769
2011/10/1,彰化縣,溪州鄉,8714,31351,16511,14840
2011/10/1,南投縣,南投市,33579,103750,52167,51583
2011/10/1,南投縣,埔里鎮,28510,84695,42741,41954
2011/10/1,南投縣,草屯鎮,31291,99254,50173,49081
2011/10/1,南投縣,竹山鎮,19316,58013,29906,28107
2011/10/1,南投縣,集集鎮,4307,11748,6142,5606
2011/10/1,南投縣,名間鄉,12204,40986,21518,19468
2011/10/1,南投縣,鹿谷鄉,6922,18956,10063,8893
2011/10/1,南投縣,中寮鄉,5639,16021,8715,7306
2011/10/1,南投縣,魚池鄉,5740,16942,8942,8000
2011/10/1,南投縣,國姓鄉,7212,20397,11112,9285
2011/10/1,南投縣,水里鄉,7231,19765,10359,9406
2011/10/1,南投縣,信義鄉,5263,17089,9255,7834
2011/10/1,南投縣,仁愛鄉,4923,15560,8116,7444
2011/10/1,雲林縣,斗六市,35265,107069,53764,53305
2011/10/1,雲林縣,斗南鎮,15376,46888,23838,23050
2011/10/1,雲林縣,虎尾鎮,22807,70080,35632,34448
2011/10/1,雲林縣,西螺鎮,14122,48124,24516,23608
2011/10/1,雲林縣,土庫鎮,8836,30295,15838,14457
2011/10/1,雲林縣,北港鎮,15502,42594,22159,20435
2011/10/1,雲林縣,古坑鄉,10691,33699,17806,15893
2011/10/1,雲林縣,大埤鄉,6663,20911,11231,9680
2011/10/1,雲林縣,莿桐鄉,9103,30289,15885,14404
2011/10/1,雲林縣,林內鄉,5787,19659,10251,9408
2011/10/1,雲林縣,二崙鄉,8742,29365,15735,13630
2011/10/1,雲林縣,崙背鄉,8317,26934,14190,12744
2011/10/1,雲林縣,麥寮鄉,12843,38894,20149,18745
2011/10/1,雲林縣,東勢鄉,5725,16432,8956,7476
2011/10/1,雲林縣,褒忠鄉,4299,14039,7493,6546
2011/10/1,雲林縣,臺西鄉,8904,25738,13846,11892
2011/10/1,雲林縣,元長鄉,9359,28426,15509,12917
2011/10/1,雲林縣,四湖鄉,9056,26369,14360,12009
2011/10/1,雲林縣,口湖鄉,9603,29930,15949,13981
2011/10/1,雲林縣,水林鄉,10351,28343,15520,12823
2011/10/1,嘉義縣,太保市,11517,36703,18901,17802
2011/10/1,嘉義縣,朴子市,14832,43925,22359,21566
2011/10/1,嘉義縣,布袋鎮,10164,29717,15242,14475
2011/10/1,嘉義縣,大林鎮,11265,33261,17088,16173
2011/10/1,嘉義縣,民雄鄉,23083,72451,37178,35273
2011/10/1,嘉義縣,溪口鄉,5392,16053,8583,7470
2011/10/1,嘉義縣,新港鄉,10435,34269,18076,16193
2011/10/1,嘉義縣,六腳鄉,9146,25965,13748,12217
2011/10/1,嘉義縣,東石鄉,9504,27260,14494,12766
2011/10/1,嘉義縣,義竹鄉,7475,20678,10738,9940
2011/10/1,嘉義縣,鹿草鄉,5791,17027,9161,7866
2011/10/1,嘉義縣,水上鄉,17465,51816,26746,25070
2011/10/1,嘉義縣,中埔鄉,15518,47294,24669,22625
2011/10/1,嘉義縣,竹崎鄉,11419,38261,20378,17883
2011/10/1,嘉義縣,梅山鄉,6717,21373,11329,10044
2011/10/1,嘉義縣,番路鄉,3983,11603,6319,5284
2011/10/1,嘉義縣,大埔鄉,1942,4569,2401,2168
2011/10/1,嘉義縣,阿里山鄉,2077,6211,3309,2902
2011/10/1,屏東縣,屏東市,72420,209596,104419,105177
2011/10/1,屏東縣,潮州鎮,18349,55352,27827,27525
2011/10/1,屏東縣,東港鎮,15826,49638,25101,24537
2011/10/1,屏東縣,恆春鎮,10879,30880,15822,15058
2011/10/1,屏東縣,萬丹鄉,14409,53545,27707,25838
2011/10/1,屏東縣,長治鄉,9782,30708,16054,14654
2011/10/1,屏東縣,麟洛鄉,3612,11418,5914,5504
2011/10/1,屏東縣,九如鄉,6614,22749,11813,10936
2011/10/1,屏東縣,里港鄉,7913,25750,13198,12552
2011/10/1,屏東縣,鹽埔鄉,7752,27059,14061,12998
2011/10/1,屏東縣,高樹鄉,9417,26378,14079,12299
2011/10/1,屏東縣,萬巒鄉,6435,21671,11418,10253
2011/10/1,屏東縣,內埔鄉,17979,57638,29938,27700
2011/10/1,屏東縣,竹田鄉,5593,18203,9660,8543
2011/10/1,屏東縣,新埤鄉,3375,10570,5616,4954
2011/10/1,屏東縣,枋寮鄉,8508,26272,13810,12462
2011/10/1,屏東縣,新園鄉,11595,37850,19578,18272
2011/10/1,屏東縣,崁頂鄉,4295,17053,8700,8353
2011/10/1,屏東縣,林邊鄉,7141,20344,10481,9863
2011/10/1,屏東縣,南州鄉,3679,11545,5914,5631
2011/10/1,屏東縣,佳冬鄉,7142,21081,10992,10089
2011/10/1,屏東縣,琉球鄉,4013,12167,6759,5408
2011/10/1,屏東縣,車城鄉,3506,9443,5099,4344
2011/10/1,屏東縣,滿州鄉,3051,8260,4561,3699
2011/10/1,屏東縣,枋山鄉,2104,5945,3200,2745
2011/10/1,屏東縣,三地門鄉,2224,7555,3859,3696
2011/10/1,屏東縣,霧臺鄉,992,2958,1557,1401
2011/10/1,屏東縣,瑪家鄉,1924,6545,3412,3133
2011/10/1,屏東縣,泰武鄉,1241,5075,2656,2419
2011/10/1,屏東縣,來義鄉,2182,7690,3947,3743
2011/10/1,屏東縣,春日鄉,1324,4841,2509,2332
2011/10/1,屏東縣,獅子鄉,1466,4819,2547,2272
2011/10/1,屏東縣,牡丹鄉,1884,4917,2554,2363
2011/10/1,臺東縣,臺東市,38240,108315,54793,53522
2011/10/1,臺東縣,成功鎮,5437,15560,8256,7304
2011/10/1,臺東縣,關山鎮,3220,9583,5028,4555
2011/10/1,臺東縣,卑南鄉,6653,18074,9726,8348
2011/10/1,臺東縣,大武鄉,2523,6815,3576,3239
2011/10/1,臺東縣,太麻里鄉,4542,11846,6322,5524
2011/10/1,臺東縣,東河鄉,3616,9225,5137,4088
2011/10/1,臺東縣,長濱鄉,2933,8075,4607,3468
2011/10/1,臺東縣,鹿野鄉,3132,8421,4550,3871
2011/10/1,臺東縣,池上鄉,3255,9008,4760,4248
2011/10/1,臺東縣,綠島鄉,1029,3405,1802,1603
2011/10/1,臺東縣,延平鄉,1063,3557,1959,1598
2011/10/1,臺東縣,海端鄉,1100,4414,2398,2016
2011/10/1,臺東縣,達仁鄉,1504,3958,2164,1794
2011/10/1,臺東縣,金峰鄉,1057,3534,1831,1703
2011/10/1,臺東縣,蘭嶼鄉,1521,4664,2394,2270
2011/10/1,花蓮縣,花蓮市,40756,108740,53219,55521
2011/10/1,花蓮縣,鳳林鎮,4425,11740,6197,5543
2011/10/1,花蓮縣,玉里鎮,8897,26495,14324,12171
2011/10/1,花蓮縣,新城鄉,7346,20157,10452,9705
2011/10/1,花蓮縣,吉安鄉,29520,80350,41022,39328
2011/10/1,花蓮縣,壽豐鄉,6850,18527,9999,8528
2011/10/1,花蓮縣,光復鄉,5040,13851,7388,6463
2011/10/1,花蓮縣,豐濱鄉,1789,4891,2720,2171
2011/10/1,花蓮縣,瑞穗鄉,4640,12616,6815,5801
2011/10/1,花蓮縣,富里鄉,4014,11430,6232,5198
2011/10/1,花蓮縣,秀林鄉,4676,15132,7856,7276
2011/10/1,花蓮縣,萬榮鄉,2119,6730,3598,3132
2011/10/1,花蓮縣,卓溪鄉,1661,6226,3465,2761
2011/10/1,澎湖縣,馬公市,20868,57298,28988,28310
2011/10/1,澎湖縣,湖西鄉,4856,13698,7146,6552
2011/10/1,澎湖縣,白沙鄉,3180,9405,4934,4471
2011/10/1,澎湖縣,西嶼鄉,2861,8375,4316,4059
2011/10/1,澎湖縣,望安鄉,1899,4660,2520,2140
2011/10/1,澎湖縣,七美鄉,1267,3571,1868,1703
2011/10/1,基隆市,中正區,22169,54557,27944,26613
2011/10/1,基隆市,七堵區,20258,54788,27778,27010
2011/10/1,基隆市,暖暖區,14588,37987,19266,18721
2011/10/1,基隆市,仁愛區,19823,48798,24074,24724
2011/10/1,基隆市,中山區,19196,50383,25747,24636
2011/10/1,基隆市,安樂區,31814,82987,41388,41599
2011/10/1,基隆市,信義區,20226,51001,25520,25481
2011/10/1,新竹市,東區,70075,199350,98435,100915
2011/10/1,新竹市,北區,51552,146073,72037,74036
2011/10/1,新竹市,香山區,23564,73504,37474,36030
2011/10/1,嘉義市,東區,44371,124629,60841,63788
2011/10/1,嘉義市,西區,51592,147015,72674,74341
2011/10/1,金門縣,金城鎮,11349,33920,17157,16763
2011/10/1,金門縣,金湖鎮,7550,22498,11454,11044
2011/10/1,金門縣,金沙鎮,5522,16170,8142,8028
2011/10/1,金門縣,金寧鄉,6400,20262,10409,9853
2011/10/1,金門縣,烈嶼鄉,2705,9414,4684,4730
2011/10/1,金門縣,烏坵鄉,135,563,281,282
2011/10/1,連江縣,南竿鄉,1259,5985,3427,2558
2011/10/1,連江縣,北竿鄉,403,1851,1050,801
2011/10/1,連江縣,莒光鄉,246,1170,706,464
2011/10/1,連江縣,東引鄉,276,1078,638,440
2011/11/1,總計,新北市,1430320,3913595,1938920,1974675
2011/11/1,總計,臺北市,999072,2647122,1274740,1372382
2011/11/1,總計,臺中市,867282,2662770,1324375,1338395
2011/11/1,總計,臺南市,648030,1876706,943920,932786
2011/11/1,總計,高雄市,1034753,2773855,1388493,1385362
2011/11/1,總計,臺灣省,3037477,9227128,4714062,4513066
2011/11/1,總計,宜蘭縣,156290,459227,233772,225455
2011/11/1,總計,桃園市,685881,2012174,1013223,998951
2011/11/1,總計,新竹縣,165327,517309,265748,251561
2011/11/1,總計,苗栗縣,175186,561833,291174,270659
2011/11/1,總計,彰化縣,367669,1303062,668006,635056
2011/11/1,總計,南投縣,172194,522963,269073,253890
2011/11/1,總計,雲林縣,231466,713756,372487,341269
2011/11/1,總計,嘉義縣,177815,538209,280585,257624
2011/11/1,總計,屏東縣,278685,864979,444403,420576
2011/11/1,總計,臺東縣,80820,228430,119303,109127
2011/11/1,總計,花蓮縣,121786,336836,173268,163568
2011/11/1,總計,澎湖縣,34990,97091,49825,47266
2011/11/1,總計,基隆市,148032,380281,191573,188708
2011/11/1,總計,新竹市,145325,419384,208147,211237
2011/11/1,總計,嘉義市,96011,271594,133475,138119
2011/11/1,總計,福建省,35935,113444,58194,55250
2011/11/1,總計,金門縣,33747,103340,52353,50987
2011/11/1,總計,連江縣,2188,10104,5841,4263
2011/11/1,新北市,板橋區,197594,554973,273720,281253
2011/11/1,新北市,三重區,142452,390190,194082,196108
2011/11/1,新北市,中和區,157396,414792,204470,210322
2011/11/1,新北市,永和區,89977,232372,111437,120935
2011/11/1,新北市,新莊區,139011,403790,199123,204667
2011/11/1,新北市,新店區,117913,296472,144723,151749
2011/11/1,新北市,樹林區,62060,179600,90357,89243
2011/11/1,新北市,鶯歌區,27961,87598,44207,43391
2011/11/1,新北市,三峽區,36754,105483,53633,51850
2011/11/1,新北市,淡水區,59711,146470,71097,75373
2011/11/1,新北市,汐止區,80318,190513,94391,96122
2011/11/1,新北市,瑞芳區,15933,42040,21423,20617
2011/11/1,新北市,土城區,83205,238983,119300,119683
2011/11/1,新北市,蘆洲區,66411,198236,98022,100214
2011/11/1,新北市,五股區,27756,80487,40747,39740
2011/11/1,新北市,泰山區,26520,76966,38592,38374
2011/11/1,新北市,林口區,32407,86374,42621,43753
2011/11/1,新北市,深坑區,9067,23503,11839,11664
2011/11/1,新北市,石碇區,3335,7883,4383,3500
2011/11/1,新北市,坪林區,2463,6541,3638,2903
2011/11/1,新北市,三芝區,8961,23351,12045,11306
2011/11/1,新北市,石門區,4151,12812,6708,6104
2011/11/1,新北市,八里區,12665,35386,17875,17511
2011/11/1,新北市,平溪區,2396,5205,2911,2294
2011/11/1,新北市,雙溪區,3804,9559,5176,4383
2011/11/1,新北市,貢寮區,4434,13540,6986,6554
2011/11/1,新北市,金山區,6803,22412,11212,11200
2011/11/1,新北市,萬里區,7129,22161,11224,10937
2011/11/1,新北市,烏來區,1733,5903,2978,2925
2011/11/1,臺北市,松山區,78738,209757,99339,110418
2011/11/1,臺北市,信義區,86785,226433,108902,117531
2011/11/1,臺北市,大安區,118011,313237,147295,165942
2011/11/1,臺北市,中山區,93910,223743,105071,118672
2011/11/1,臺北市,中正區,63061,161149,77654,83495
2011/11/1,臺北市,大同區,48415,126405,62177,64228
2011/11/1,臺北市,萬華區,75172,190568,94731,95837
2011/11/1,臺北市,文山區,99080,266078,128770,137308
2011/11/1,臺北市,南港區,42856,115961,56981,58980
2011/11/1,臺北市,內湖區,99500,275199,132495,142704
2011/11/1,臺北市,士林區,102389,286717,139162,147555
2011/11/1,臺北市,北投區,91155,251875,122163,129712
2011/11/1,臺中市,中區,8226,21662,10727,10935
2011/11/1,臺中市,東區,26110,73913,37210,36703
2011/11/1,臺中市,南區,43028,115001,55715,59286
2011/11/1,臺中市,西區,43775,117220,56218,61002
2011/11/1,臺中市,北區,56492,147565,71387,76178
2011/11/1,臺中市,西屯區,74988,209399,101258,108141
2011/11/1,臺中市,南屯區,54465,155586,75127,80459
2011/11/1,臺中市,北屯區,85627,249521,121000,128521
2011/11/1,臺中市,豐原區,50389,165516,82114,83402
2011/11/1,臺中市,東勢區,17068,52843,27426,25417
2011/11/1,臺中市,大甲區,21877,78121,39612,38509
2011/11/1,臺中市,清水區,25257,85618,44157,41461
2011/11/1,臺中市,沙鹿區,24684,83179,42299,40880
2011/11/1,臺中市,梧棲區,16209,55514,28134,27380
2011/11/1,臺中市,后里區,14975,54048,27701,26347
2011/11/1,臺中市,神岡區,17873,63874,32829,31045
2011/11/1,臺中市,潭子區,33060,101732,50606,51126
2011/11/1,臺中市,大雅區,26711,90521,45564,44957
2011/11/1,臺中市,新社區,7371,25488,13314,12174
2011/11/1,臺中市,石岡區,4868,15816,8221,7595
2011/11/1,臺中市,外埔區,8969,31982,16445,15537
2011/11/1,臺中市,大安區,5312,20088,10552,9536
2011/11/1,臺中市,烏日區,20975,69160,35015,34145
2011/11/1,臺中市,大肚區,16038,55726,28593,27133
2011/11/1,臺中市,龍井區,20980,74564,37884,36680
2011/11/1,臺中市,霧峰區,18899,63872,32781,31091
2011/11/1,臺中市,太平區,55540,174145,87315,86830
2011/11/1,臺中市,大里區,63093,200395,99385,101010
2011/11/1,臺中市,和平區,4423,10701,5786,4915
2011/11/1,臺南市,新營區,27557,78442,39048,39394
2011/11/1,臺南市,鹽水區,10005,26899,14003,12896
2011/11/1,臺南市,白河區,10967,30996,16231,14765
2011/11/1,臺南市,柳營區,7804,22455,11760,10695
2011/11/1,臺南市,後壁區,8842,25596,13330,12266
2011/11/1,臺南市,東山區,8229,22782,12088,10694
2011/11/1,臺南市,麻豆區,15149,45601,23271,22330
2011/11/1,臺南市,下營區,9124,25840,13375,12465
2011/11/1,臺南市,六甲區,7682,23524,12241,11283
2011/11/1,臺南市,官田區,7637,21986,11252,10734
2011/11/1,臺南市,大內區,4040,10691,5699,4992
2011/11/1,臺南市,佳里區,19550,59196,29398,29798
2011/11/1,臺南市,學甲區,9579,27602,14132,13470
2011/11/1,臺南市,西港區,7863,25079,12750,12329
2011/11/1,臺南市,七股區,8056,24655,12889,11766
2011/11/1,臺南市,將軍區,7422,21280,10840,10440
2011/11/1,臺南市,北門區,4391,12252,6235,6017
2011/11/1,臺南市,新化區,13826,44032,22533,21499
2011/11/1,臺南市,善化區,14962,43990,22225,21765
2011/11/1,臺南市,新市區,10951,35005,17596,17409
2011/11/1,臺南市,安定區,9454,30284,15694,14590
2011/11/1,臺南市,山上區,2730,7757,4090,3667
2011/11/1,臺南市,玉井區,5094,15224,7871,7353
2011/11/1,臺南市,楠西區,3556,10453,5544,4909
2011/11/1,臺南市,南化區,2825,8804,4818,3986
2011/11/1,臺南市,左鎮區,1981,5369,2987,2382
2011/11/1,臺南市,仁德區,25059,70152,35929,34223
2011/11/1,臺南市,歸仁區,20874,66072,33714,32358
2011/11/1,臺南市,關廟區,10749,35653,18505,17148
2011/11/1,臺南市,龍崎區,1591,4324,2338,1986
2011/11/1,臺南市,永康區,76936,220606,109535,111071
2011/11/1,臺南市,東區,71345,193645,93494,100151
2011/11/1,臺南市,南區,43776,126189,63210,62979
2011/11/1,臺南市,北區,48713,132129,64983,67146
2011/11/1,臺南市,安南區,55784,179858,91330,88528
2011/11/1,臺南市,安平區,23652,63557,30427,33130
2011/11/1,臺南市,中西區,30275,78727,38555,40172
2011/11/1,高雄市,鹽埕區,11054,26722,13383,13339
2011/11/1,高雄市,鼓山區,53137,132743,64845,67898
2011/11/1,高雄市,左營區,74881,193335,94872,98463
2011/11/1,高雄市,楠梓區,62617,173831,86135,87696
2011/11/1,高雄市,三民區,132672,352124,172124,180000
2011/11/1,高雄市,新興區,22821,54395,26366,28029
2011/11/1,高雄市,前金區,12525,28469,13859,14610
2011/11/1,高雄市,苓雅區,71985,181720,88279,93441
2011/11/1,高雄市,前鎮區,76947,197772,98099,99673
2011/11/1,高雄市,旗津區,10995,29786,15433,14353
2011/11/1,高雄市,小港區,64227,154717,77622,77095
2011/11/1,高雄市,鳳山區,129287,344961,171366,173595
2011/11/1,高雄市,林園區,24589,70440,36074,34366
2011/11/1,高雄市,大寮區,38937,109169,56618,52551
2011/11/1,高雄市,大樹區,13139,43646,22534,21112
2011/11/1,高雄市,大社區,11906,33291,17061,16230
2011/11/1,高雄市,仁武區,27133,74787,38556,36231
2011/11/1,高雄市,鳥松區,16899,43166,21874,21292
2011/11/1,高雄市,岡山區,33612,97364,48764,48600
2011/11/1,高雄市,橋頭區,12880,36771,18819,17952
2011/11/1,高雄市,燕巢區,10130,30935,16507,14428
2011/11/1,高雄市,田寮區,3521,8037,4464,3573
2011/11/1,高雄市,阿蓮區,9225,30193,15223,14970
2011/11/1,高雄市,路竹區,16175,53496,27299,26197
2011/11/1,高雄市,湖內區,9768,28817,14826,13991
2011/11/1,高雄市,茄萣區,10184,31011,16136,14875
2011/11/1,高雄市,永安區,5812,14119,7183,6936
2011/11/1,高雄市,彌陀區,6672,20227,10502,9725
2011/11/1,高雄市,梓官區,12143,36602,19003,17599
2011/11/1,高雄市,旗山區,13862,39471,20534,18937
2011/11/1,高雄市,美濃區,14310,42686,22307,20379
2011/11/1,高雄市,六龜區,5753,14447,7813,6634
2011/11/1,高雄市,甲仙區,2494,6999,3752,3247
2011/11/1,高雄市,杉林區,4587,12120,6613,5507
2011/11/1,高雄市,內門區,5051,15679,8554,7125
2011/11/1,高雄市,茂林區,575,1831,919,912
2011/11/1,高雄市,桃源區,1365,4712,2484,2228
2011/11/1,高雄市,那瑪夏區,883,3264,1691,1573
2011/11/1,宜蘭縣,宜蘭市,33634,95614,46960,48654
2011/11/1,宜蘭縣,羅東鎮,25225,72843,34911,37932
2011/11/1,宜蘭縣,蘇澳鎮,13699,42440,21744,20696
2011/11/1,宜蘭縣,頭城鎮,9825,30570,15789,14781
2011/11/1,宜蘭縣,礁溪鄉,12573,35953,18810,17143
2011/11/1,宜蘭縣,壯圍鄉,8183,24703,13049,11654
2011/11/1,宜蘭縣,員山鄉,10934,32272,17288,14984
2011/11/1,宜蘭縣,冬山鄉,17725,52942,27216,25726
2011/11/1,宜蘭縣,五結鄉,13211,38804,20146,18658
2011/11/1,宜蘭縣,三星鄉,7622,21213,11470,9743
2011/11/1,宜蘭縣,大同鄉,1825,5938,3234,2704
2011/11/1,宜蘭縣,南澳鄉,1834,5935,3155,2780
2011/11/1,桃園市,桃園區,146900,409796,200581,209215
2011/11/1,桃園市,中壢區,129820,372117,185570,186547
2011/11/1,桃園市,平鎮區,68017,208548,104925,103623
2011/11/1,桃園市,八德區,59186,177313,89983,87330
2011/11/1,桃園市,楊梅區,49987,152345,77414,74931
2011/11/1,桃園市,大溪區,29577,91956,47408,44548
2011/11/1,桃園市,蘆竹區,49388,143770,72007,71763
2011/11/1,桃園市,大園區,26436,82076,42557,39519
2011/11/1,桃園市,龜山區,50911,138314,69946,68368
2011/11/1,桃園市,龍潭區,37343,114974,58359,56615
2011/11/1,桃園市,新屋區,15046,48661,26064,22597
2011/11/1,桃園市,觀音區,19580,61646,32462,29184
2011/11/1,桃園市,復興區,3690,10658,5947,4711
2011/11/1,新竹縣,竹北市,49376,146510,73298,73212
2011/11/1,新竹縣,關西鎮,9323,31584,16821,14763
2011/11/1,新竹縣,新埔鎮,10473,35248,18677,16571
2011/11/1,新竹縣,竹東鎮,31093,96462,48595,47867
2011/11/1,新竹縣,湖口鄉,23776,75891,38703,37188
2011/11/1,新竹縣,橫山鄉,4457,14200,7680,6520
2011/11/1,新竹縣,新豐鄉,16088,53593,27580,26013
2011/11/1,新竹縣,芎林鄉,6323,20525,10817,9708
2011/11/1,新竹縣,寶山鄉,4808,14088,7620,6468
2011/11/1,新竹縣,北埔鄉,3116,10003,5447,4556
2011/11/1,新竹縣,峨眉鄉,2038,5916,3270,2646
2011/11/1,新竹縣,尖石鄉,2723,8660,4703,3957
2011/11/1,新竹縣,五峰鄉,1733,4629,2537,2092
2011/11/1,苗栗縣,苗栗市,29506,90814,45664,45150
2011/11/1,苗栗縣,苑裡鎮,13969,48485,25309,23176
2011/11/1,苗栗縣,通霄鎮,11411,37644,19898,17746
2011/11/1,苗栗縣,竹南鎮,24782,79572,40404,39168
2011/11/1,苗栗縣,頭份市,30400,98303,49867,48436
2011/11/1,苗栗縣,後龍鎮,11789,39013,20622,18391
2011/11/1,苗栗縣,卓蘭鎮,5994,18404,9702,8702
2011/11/1,苗栗縣,大湖鄉,5354,15922,8464,7458
2011/11/1,苗栗縣,公館鄉,10319,34848,18224,16624
2011/11/1,苗栗縣,銅鑼鄉,6007,19346,10263,9083
2011/11/1,苗栗縣,南庄鄉,4004,11026,6074,4952
2011/11/1,苗栗縣,頭屋鄉,3548,11525,6079,5446
2011/11/1,苗栗縣,三義鄉,5330,17478,9210,8268
2011/11/1,苗栗縣,西湖鄉,2686,7811,4332,3479
2011/11/1,苗栗縣,造橋鄉,4053,13683,7215,6468
2011/11/1,苗栗縣,三灣鄉,2398,7193,3917,3276
2011/11/1,苗栗縣,獅潭鄉,1687,4831,2705,2126
2011/11/1,苗栗縣,泰安鄉,1949,5935,3225,2710
2011/11/1,彰化縣,彰化市,72786,236571,117648,118923
2011/11/1,彰化縣,鹿港鎮,22644,85416,43761,41655
2011/11/1,彰化縣,和美鎮,24624,90168,46143,44025
2011/11/1,彰化縣,北斗鎮,10060,33372,16911,16461
2011/11/1,彰化縣,員林市,37141,125083,62848,62235
2011/11/1,彰化縣,溪湖鎮,15314,55896,28524,27372
2011/11/1,彰化縣,田中鎮,12613,43688,22702,20986
2011/11/1,彰化縣,二林鎮,14426,53562,27668,25894
2011/11/1,彰化縣,線西鄉,4156,17009,8767,8242
2011/11/1,彰化縣,伸港鄉,9097,35950,18446,17504
2011/11/1,彰化縣,福興鄉,12205,48634,25385,23249
2011/11/1,彰化縣,秀水鄉,9916,39237,20299,18938
2011/11/1,彰化縣,花壇鄉,13138,46026,23674,22352
2011/11/1,彰化縣,芬園鄉,6876,24665,13087,11578
2011/11/1,彰化縣,大村鄉,10379,36549,19059,17490
2011/11/1,彰化縣,埔鹽鄉,8889,34112,17863,16249
2011/11/1,彰化縣,埔心鄉,10058,35295,18220,17075
2011/11/1,彰化縣,永靖鄉,10482,38930,20218,18712
2011/11/1,彰化縣,社頭鄉,12389,44454,22810,21644
2011/11/1,彰化縣,二水鄉,5337,16368,8601,7767
2011/11/1,彰化縣,田尾鄉,7713,28396,14787,13609
2011/11/1,彰化縣,埤頭鄉,8679,31506,16425,15081
2011/11/1,彰化縣,芳苑鄉,10018,35785,18925,16860
2011/11/1,彰化縣,大城鄉,5396,18667,10129,8538
2011/11/1,彰化縣,竹塘鄉,4607,16377,8608,7769
2011/11/1,彰化縣,溪州鄉,8726,31346,16498,14848
2011/11/1,南投縣,南投市,33593,103697,52145,51552
2011/11/1,南投縣,埔里鎮,28500,84628,42690,41938
2011/11/1,南投縣,草屯鎮,31302,99225,50154,49071
2011/11/1,南投縣,竹山鎮,19344,58007,29902,28105
2011/11/1,南投縣,集集鎮,4306,11750,6144,5606
2011/11/1,南投縣,名間鄉,12216,40973,21511,19462
2011/11/1,南投縣,鹿谷鄉,6931,18964,10066,8898
2011/11/1,南投縣,中寮鄉,5644,16018,8707,7311
2011/11/1,南投縣,魚池鄉,5739,16941,8938,8003
2011/11/1,南投縣,國姓鄉,7214,20373,11101,9272
2011/11/1,南投縣,水里鄉,7224,19724,10332,9392
2011/11/1,南投縣,信義鄉,5262,17086,9252,7834
2011/11/1,南投縣,仁愛鄉,4919,15577,8131,7446
2011/11/1,雲林縣,斗六市,35297,107094,53790,53304
2011/11/1,雲林縣,斗南鎮,15370,46839,23825,23014
2011/11/1,雲林縣,虎尾鎮,22833,70076,35635,34441
2011/11/1,雲林縣,西螺鎮,14127,48113,24513,23600
2011/11/1,雲林縣,土庫鎮,8853,30257,15814,14443
2011/11/1,雲林縣,北港鎮,15500,42535,22135,20400
2011/11/1,雲林縣,古坑鄉,10695,33685,17797,15888
2011/11/1,雲林縣,大埤鄉,6670,20889,11209,9680
2011/11/1,雲林縣,莿桐鄉,9094,30270,15889,14381
2011/11/1,雲林縣,林內鄉,5786,19625,10229,9396
2011/11/1,雲林縣,二崙鄉,8746,29346,15728,13618
2011/11/1,雲林縣,崙背鄉,8336,26905,14177,12728
2011/11/1,雲林縣,麥寮鄉,12877,39049,20223,18826
2011/11/1,雲林縣,東勢鄉,5726,16398,8937,7461
2011/11/1,雲林縣,褒忠鄉,4299,14021,7488,6533
2011/11/1,雲林縣,臺西鄉,8900,25704,13834,11870
2011/11/1,雲林縣,元長鄉,9354,28406,15490,12916
2011/11/1,雲林縣,四湖鄉,9056,26338,14341,11997
2011/11/1,雲林縣,口湖鄉,9600,29902,15932,13970
2011/11/1,雲林縣,水林鄉,10347,28304,15501,12803
2011/11/1,嘉義縣,太保市,11527,36687,18899,17788
2011/11/1,嘉義縣,朴子市,14842,43910,22339,21571
2011/11/1,嘉義縣,布袋鎮,10158,29693,15224,14469
2011/11/1,嘉義縣,大林鎮,11267,33219,17064,16155
2011/11/1,嘉義縣,民雄鄉,23120,72444,37176,35268
2011/11/1,嘉義縣,溪口鄉,5391,16038,8568,7470
2011/11/1,嘉義縣,新港鄉,10433,34254,18069,16185
2011/11/1,嘉義縣,六腳鄉,9143,25923,13735,12188
2011/11/1,嘉義縣,東石鄉,9503,27234,14476,12758
2011/11/1,嘉義縣,義竹鄉,7474,20664,10731,9933
2011/11/1,嘉義縣,鹿草鄉,5796,17037,9169,7868
2011/11/1,嘉義縣,水上鄉,17454,51809,26728,25081
2011/11/1,嘉義縣,中埔鄉,15529,47278,24655,22623
2011/11/1,嘉義縣,竹崎鄉,11433,38227,20376,17851
2011/11/1,嘉義縣,梅山鄉,6678,21216,11230,9986
2011/11/1,嘉義縣,番路鄉,4066,11844,6453,5391
2011/11/1,嘉義縣,大埔鄉,1930,4551,2396,2155
2011/11/1,嘉義縣,阿里山鄉,2071,6181,3297,2884
2011/11/1,屏東縣,屏東市,72423,209446,104335,105111
2011/11/1,屏東縣,潮州鎮,18352,55336,27805,27531
2011/11/1,屏東縣,東港鎮,15830,49585,25074,24511
2011/11/1,屏東縣,恆春鎮,10887,30863,15809,15054
2011/11/1,屏東縣,萬丹鄉,14411,53540,27712,25828
2011/11/1,屏東縣,長治鄉,9785,30688,16044,14644
2011/11/1,屏東縣,麟洛鄉,3614,11425,5917,5508
2011/11/1,屏東縣,九如鄉,6618,22729,11810,10919
2011/11/1,屏東縣,里港鄉,7913,25769,13193,12576
2011/11/1,屏東縣,鹽埔鄉,7763,27042,14054,12988
2011/11/1,屏東縣,高樹鄉,9419,26359,14064,12295
2011/11/1,屏東縣,萬巒鄉,6435,21635,11398,10237
2011/11/1,屏東縣,內埔鄉,17987,57572,29903,27669
2011/11/1,屏東縣,竹田鄉,5590,18190,9647,8543
2011/11/1,屏東縣,新埤鄉,3374,10558,5606,4952
2011/11/1,屏東縣,枋寮鄉,8502,26253,13794,12459
2011/11/1,屏東縣,新園鄉,11601,37841,19570,18271
2011/11/1,屏東縣,崁頂鄉,4300,17043,8692,8351
2011/11/1,屏東縣,林邊鄉,7144,20329,10474,9855
2011/11/1,屏東縣,南州鄉,3680,11542,5911,5631
2011/11/1,屏東縣,佳冬鄉,7136,21053,10977,10076
2011/11/1,屏東縣,琉球鄉,4015,12162,6756,5406
2011/11/1,屏東縣,車城鄉,3504,9429,5092,4337
2011/11/1,屏東縣,滿州鄉,3049,8256,4558,3698
2011/11/1,屏東縣,枋山鄉,2103,5925,3187,2738
2011/11/1,屏東縣,三地門鄉,2224,7545,3851,3694
2011/11/1,屏東縣,霧臺鄉,993,2962,1557,1405
2011/11/1,屏東縣,瑪家鄉,1929,6550,3406,3144
2011/11/1,屏東縣,泰武鄉,1241,5079,2654,2425
2011/11/1,屏東縣,來義鄉,2186,7690,3943,3747
2011/11/1,屏東縣,春日鄉,1327,4847,2512,2335
2011/11/1,屏東縣,獅子鄉,1466,4814,2544,2270
2011/11/1,屏東縣,牡丹鄉,1884,4922,2554,2368
2011/11/1,臺東縣,臺東市,38254,108331,54818,53513
2011/11/1,臺東縣,成功鎮,5425,15572,8257,7315
2011/11/1,臺東縣,關山鎮,3223,9564,5021,4543
2011/11/1,臺東縣,卑南鄉,6629,18069,9724,8345
2011/11/1,臺東縣,大武鄉,2520,6803,3565,3238
2011/11/1,臺東縣,太麻里鄉,4533,11834,6314,5520
2011/11/1,臺東縣,東河鄉,3624,9234,5145,4089
2011/11/1,臺東縣,長濱鄉,2937,8061,4601,3460
2011/11/1,臺東縣,鹿野鄉,3126,8414,4538,3876
2011/11/1,臺東縣,池上鄉,3258,9020,4762,4258
2011/11/1,臺東縣,綠島鄉,1035,3411,1808,1603
2011/11/1,臺東縣,延平鄉,1063,3556,1958,1598
2011/11/1,臺東縣,海端鄉,1099,4411,2398,2013
2011/11/1,臺東縣,達仁鄉,1505,3957,2163,1794
2011/11/1,臺東縣,金峰鄉,1061,3517,1827,1690
2011/11/1,臺東縣,蘭嶼鄉,1528,4676,2404,2272
2011/11/1,花蓮縣,花蓮市,40772,108699,53212,55487
2011/11/1,花蓮縣,鳳林鎮,4425,11732,6193,5539
2011/11/1,花蓮縣,玉里鎮,8894,26471,14312,12159
2011/11/1,花蓮縣,新城鄉,7344,20116,10448,9668
2011/11/1,花蓮縣,吉安鄉,29551,80442,41042,39400
2011/11/1,花蓮縣,壽豐鄉,6846,18496,9990,8506
2011/11/1,花蓮縣,光復鄉,5051,13852,7390,6462
2011/11/1,花蓮縣,豐濱鄉,1789,4880,2710,2170
2011/11/1,花蓮縣,瑞穗鄉,4639,12608,6816,5792
2011/11/1,花蓮縣,富里鄉,4009,11406,6211,5195
2011/11/1,花蓮縣,秀林鄉,4683,15166,7872,7294
2011/11/1,花蓮縣,萬榮鄉,2124,6740,3605,3135
2011/11/1,花蓮縣,卓溪鄉,1659,6228,3467,2761
2011/11/1,澎湖縣,馬公市,20933,57378,29044,28334
2011/11/1,澎湖縣,湖西鄉,4855,13712,7151,6561
2011/11/1,澎湖縣,白沙鄉,3174,9401,4930,4471
2011/11/1,澎湖縣,西嶼鄉,2862,8363,4309,4054
2011/11/1,澎湖縣,望安鄉,1899,4660,2519,2141
2011/11/1,澎湖縣,七美鄉,1267,3577,1872,1705
2011/11/1,基隆市,中正區,22157,54520,27926,26594
2011/11/1,基隆市,七堵區,20281,54772,27757,27015
2011/11/1,基隆市,暖暖區,14581,37958,19245,18713
2011/11/1,基隆市,仁愛區,19808,48752,24056,24696
2011/11/1,基隆市,中山區,19209,50379,25738,24641
2011/11/1,基隆市,安樂區,31785,82898,41342,41556
2011/11/1,基隆市,信義區,20211,51002,25509,25493
2011/11/1,新竹市,東區,70141,199557,98514,101043
2011/11/1,新竹市,北區,51588,146189,72082,74107
2011/11/1,新竹市,香山區,23596,73638,37551,36087
2011/11/1,嘉義市,東區,44373,124560,60811,63749
2011/11/1,嘉義市,西區,51638,147034,72664,74370
2011/11/1,金門縣,金城鎮,11381,34058,17222,16836
2011/11/1,金門縣,金湖鎮,7557,22601,11488,11113
2011/11/1,金門縣,金沙鎮,5533,16238,8176,8062
2011/11/1,金門縣,金寧鄉,6426,20408,10481,9927
2011/11/1,金門縣,烈嶼鄉,2715,9470,4705,4765
2011/11/1,金門縣,烏坵鄉,135,565,281,284
2011/11/1,連江縣,南竿鄉,1260,6002,3444,2558
2011/11/1,連江縣,北竿鄉,404,1862,1057,805
2011/11/1,連江縣,莒光鄉,246,1163,701,462
2011/11/1,連江縣,東引鄉,278,1077,639,438
2011/12/1,總計,新北市,1431791,3916451,1939844,1976607
2011/12/1,總計,臺北市,999879,2650968,1276343,1374625
2011/12/1,總計,臺中市,867854,2664394,1324894,1339500
2011/12/1,總計,臺南市,648283,1876960,943899,933061
2011/12/1,總計,高雄市,1035012,2774470,1388530,1385940
2011/12/1,總計,臺灣省,3038930,9227680,4713700,4513980
2011/12/1,總計,宜蘭縣,156356,459061,233661,225400
2011/12/1,總計,桃園市,686273,2013305,1013618,999687
2011/12/1,總計,新竹縣,165495,517641,265905,251736
2011/12/1,總計,苗栗縣,175305,562010,291218,270792
2011/12/1,總計,彰化縣,367801,1303039,667920,635119
2011/12/1,總計,南投縣,172262,522807,268979,253828
2011/12/1,總計,雲林縣,231594,713556,372365,341191
2011/12/1,總計,嘉義縣,177906,537942,280416,257526
2011/12/1,總計,屏東縣,278703,864529,444133,420396
2011/12/1,總計,臺東縣,80840,228290,119205,109085
2011/12/1,總計,花蓮縣,121833,336838,173205,163633
2011/12/1,總計,澎湖縣,35031,97157,49865,47292
2011/12/1,總計,基隆市,147971,379927,191367,188560
2011/12/1,總計,新竹市,145517,420052,208390,211662
2011/12/1,總計,嘉義市,96043,271526,133453,138073
2011/12/1,總計,福建省,36012,113989,58464,55525
2011/12/1,總計,金門縣,33816,103883,52631,51252
2011/12/1,總計,連江縣,2196,10106,5833,4273
2011/12/1,新北市,板橋區,198015,555335,273845,281490
2011/12/1,新北市,三重區,142515,390421,194126,196295
2011/12/1,新北市,中和區,157474,414939,204486,210453
2011/12/1,新北市,永和區,89972,232386,111416,120970
2011/12/1,新北市,新莊區,139207,404089,199224,204865
2011/12/1,新北市,新店區,117904,296581,144760,151821
2011/12/1,新北市,樹林區,62139,179788,90415,89373
2011/12/1,新北市,鶯歌區,27986,87683,44242,43441
2011/12/1,新北市,三峽區,36823,105629,53696,51933
2011/12/1,新北市,淡水區,59866,146756,71192,75564
2011/12/1,新北市,汐止區,80361,190679,94436,96243
2011/12/1,新北市,瑞芳區,15930,42031,21399,20632
2011/12/1,新北市,土城區,83316,239156,119365,119791
2011/12/1,新北市,蘆洲區,66457,198373,98077,100296
2011/12/1,新北市,五股區,27777,80518,40739,39779
2011/12/1,新北市,泰山區,26554,77057,38644,38413
2011/12/1,新北市,林口區,32503,86628,42729,43899
2011/12/1,新北市,深坑區,9085,23531,11848,11683
2011/12/1,新北市,石碇區,3340,7887,4386,3501
2011/12/1,新北市,坪林區,2457,6533,3632,2901
2011/12/1,新北市,三芝區,8946,23319,12040,11279
2011/12/1,新北市,石門區,4161,12841,6721,6120
2011/12/1,新北市,八里區,12671,35423,17888,17535
2011/12/1,新北市,平溪區,2392,5197,2900,2297
2011/12/1,新北市,雙溪區,3806,9555,5173,4382
2011/12/1,新北市,貢寮區,4438,13538,6987,6551
2011/12/1,新北市,金山區,6808,22447,11218,11229
2011/12/1,新北市,萬里區,7140,22204,11269,10935
2011/12/1,新北市,烏來區,1748,5927,2991,2936
2011/12/1,臺北市,松山區,78741,209948,99411,110537
2011/12/1,臺北市,信義區,86807,226541,108955,117586
2011/12/1,臺北市,大安區,118069,313846,147546,166300
2011/12/1,臺北市,中山區,93960,224102,105240,118862
2011/12/1,臺北市,中正區,63143,161449,77766,83683
2011/12/1,臺北市,大同區,48508,126640,62284,64356
2011/12/1,臺北市,萬華區,75235,190855,94865,95990
2011/12/1,臺北市,文山區,99098,266442,128894,137548
2011/12/1,臺北市,南港區,42923,116131,57055,59076
2011/12/1,臺北市,內湖區,99593,275652,132686,142966
2011/12/1,臺北市,士林區,102534,287072,139294,147778
2011/12/1,臺北市,北投區,91268,252290,122347,129943
2011/12/1,臺中市,中區,8224,21610,10701,10909
2011/12/1,臺中市,東區,26112,73960,37219,36741
2011/12/1,臺中市,南區,43024,115032,55734,59298
2011/12/1,臺中市,西區,43771,117210,56200,61010
2011/12/1,臺中市,北區,56515,147679,71380,76299
2011/12/1,臺中市,西屯區,75056,209672,101366,108306
2011/12/1,臺中市,南屯區,54515,155768,75218,80550
2011/12/1,臺中市,北屯區,85693,249742,121102,128640
2011/12/1,臺中市,豐原區,50424,165609,82142,83467
2011/12/1,臺中市,東勢區,17067,52780,27396,25384
2011/12/1,臺中市,大甲區,21870,78118,39596,38522
2011/12/1,臺中市,清水區,25281,85629,44170,41459
2011/12/1,臺中市,沙鹿區,24720,83238,42322,40916
2011/12/1,臺中市,梧棲區,16234,55544,28152,27392
2011/12/1,臺中市,后里區,14976,54033,27695,26338
2011/12/1,臺中市,神岡區,17895,63921,32860,31061
2011/12/1,臺中市,潭子區,33080,101781,50605,51176
2011/12/1,臺中市,大雅區,26724,90591,45571,45020
2011/12/1,臺中市,新社區,7380,25495,13314,12181
2011/12/1,臺中市,石岡區,4862,15792,8204,7588
2011/12/1,臺中市,外埔區,8976,32005,16453,15552
2011/12/1,臺中市,大安區,5317,20081,10549,9532
2011/12/1,臺中市,烏日區,21003,69224,35057,34167
2011/12/1,臺中市,大肚區,16052,55739,28596,27143
2011/12/1,臺中市,龍井區,21009,74682,37914,36768
2011/12/1,臺中市,霧峰區,18908,63904,32773,31131
2011/12/1,臺中市,太平區,55591,174284,87359,86925
2011/12/1,臺中市,大里區,63156,200588,99464,101124
2011/12/1,臺中市,和平區,4419,10683,5782,4901
2011/12/1,臺南市,新營區,27563,78473,39085,39388
2011/12/1,臺南市,鹽水區,10003,26891,14000,12891
2011/12/1,臺南市,白河區,10965,30947,16197,14750
2011/12/1,臺南市,柳營區,7802,22443,11741,10702
2011/12/1,臺南市,後壁區,8840,25569,13315,12254
2011/12/1,臺南市,東山區,8234,22771,12079,10692
2011/12/1,臺南市,麻豆區,15163,45609,23272,22337
2011/12/1,臺南市,下營區,9117,25803,13343,12460
2011/12/1,臺南市,六甲區,7684,23509,12233,11276
2011/12/1,臺南市,官田區,7639,21965,11237,10728
2011/12/1,臺南市,大內區,4033,10674,5688,4986
2011/12/1,臺南市,佳里區,19566,59155,29368,29787
2011/12/1,臺南市,學甲區,9569,27583,14121,13462
2011/12/1,臺南市,西港區,7864,25069,12740,12329
2011/12/1,臺南市,七股區,8054,24649,12877,11772
2011/12/1,臺南市,將軍區,7417,21261,10838,10423
2011/12/1,臺南市,北門區,4398,12254,6242,6012
2011/12/1,臺南市,新化區,13831,44023,22524,21499
2011/12/1,臺南市,善化區,14977,43995,22226,21769
2011/12/1,臺南市,新市區,10968,35035,17615,17420
2011/12/1,臺南市,安定區,9457,30263,15680,14583
2011/12/1,臺南市,山上區,2723,7757,4081,3676
2011/12/1,臺南市,玉井區,5097,15223,7863,7360
2011/12/1,臺南市,楠西區,3556,10445,5540,4905
2011/12/1,臺南市,南化區,2821,8840,4826,4014
2011/12/1,臺南市,左鎮區,1982,5359,2980,2379
2011/12/1,臺南市,仁德區,25075,70232,35947,34285
2011/12/1,臺南市,歸仁區,20874,66104,33728,32376
2011/12/1,臺南市,關廟區,10752,35593,18479,17114
2011/12/1,臺南市,龍崎區,1591,4311,2331,1980
2011/12/1,臺南市,永康區,77034,220825,109626,111199
2011/12/1,臺南市,東區,71375,193782,93556,100226
2011/12/1,臺南市,南區,43770,126129,63191,62938
2011/12/1,臺南市,北區,48697,132098,64952,67146
2011/12/1,臺南市,安南區,55867,179987,91372,88615
2011/12/1,臺南市,安平區,23654,63593,30445,33148
2011/12/1,臺南市,中西區,30271,78741,38561,40180
2011/12/1,高雄市,鹽埕區,11053,26723,13377,13346
2011/12/1,高雄市,鼓山區,53167,132868,64928,67940
2011/12/1,高雄市,左營區,74877,193482,94930,98552
2011/12/1,高雄市,楠梓區,62664,173969,86155,87814
2011/12/1,高雄市,三民區,132685,352159,172063,180096
2011/12/1,高雄市,新興區,22798,54345,26331,28014
2011/12/1,高雄市,前金區,12506,28446,13841,14605
2011/12/1,高雄市,苓雅區,72018,181717,88271,93446
2011/12/1,高雄市,前鎮區,76930,197693,98066,99627
2011/12/1,高雄市,旗津區,10993,29781,15436,14345
2011/12/1,高雄市,小港區,64255,154772,77627,77145
2011/12/1,高雄市,鳳山區,129337,345346,171486,173860
2011/12/1,高雄市,林園區,24616,70439,36072,34367
2011/12/1,高雄市,大寮區,38965,109157,56609,52548
2011/12/1,高雄市,大樹區,13111,43609,22522,21087
2011/12/1,高雄市,大社區,11905,33296,17052,16244
2011/12/1,高雄市,仁武區,27178,74867,38597,36270
2011/12/1,高雄市,鳥松區,16901,43191,21883,21308
2011/12/1,高雄市,岡山區,33621,97417,48796,48621
2011/12/1,高雄市,橋頭區,12884,36809,18841,17968
2011/12/1,高雄市,燕巢區,10147,30941,16499,14442
2011/12/1,高雄市,田寮區,3520,8012,4450,3562
2011/12/1,高雄市,阿蓮區,9233,30225,15240,14985
2011/12/1,高雄市,路竹區,16175,53443,27277,26166
2011/12/1,高雄市,湖內區,9770,28806,14818,13988
2011/12/1,高雄市,茄萣區,10189,31008,16127,14881
2011/12/1,高雄市,永安區,5805,14106,7168,6938
2011/12/1,高雄市,彌陀區,6677,20217,10495,9722
2011/12/1,高雄市,梓官區,12145,36559,18993,17566
2011/12/1,高雄市,旗山區,13852,39423,20508,18915
2011/12/1,高雄市,美濃區,14316,42658,22285,20373
2011/12/1,高雄市,六龜區,5758,14421,7799,6622
2011/12/1,高雄市,甲仙區,2493,6981,3741,3240
2011/12/1,高雄市,杉林區,4593,12136,6621,5515
2011/12/1,高雄市,內門區,5052,15662,8537,7125
2011/12/1,高雄市,茂林區,574,1834,922,912
2011/12/1,高雄市,桃源區,1367,4700,2480,2220
2011/12/1,高雄市,那瑪夏區,882,3252,1687,1565
2011/12/1,宜蘭縣,宜蘭市,33628,95521,46892,48629
2011/12/1,宜蘭縣,羅東鎮,25239,72860,34905,37955
2011/12/1,宜蘭縣,蘇澳鎮,13693,42417,21729,20688
2011/12/1,宜蘭縣,頭城鎮,9824,30556,15781,14775
2011/12/1,宜蘭縣,礁溪鄉,12577,35924,18794,17130
2011/12/1,宜蘭縣,壯圍鄉,8187,24674,13034,11640
2011/12/1,宜蘭縣,員山鄉,10956,32304,17302,15002
2011/12/1,宜蘭縣,冬山鄉,17738,52975,27246,25729
2011/12/1,宜蘭縣,五結鄉,13222,38772,20133,18639
2011/12/1,宜蘭縣,三星鄉,7629,21203,11468,9735
2011/12/1,宜蘭縣,大同鄉,1827,5931,3228,2703
2011/12/1,宜蘭縣,南澳鄉,1836,5924,3149,2775
2011/12/1,桃園市,桃園區,147001,410113,200696,209417
2011/12/1,桃園市,中壢區,129975,372429,185683,186746
2011/12/1,桃園市,平鎮區,67998,208561,104912,103649
2011/12/1,桃園市,八德區,59214,177435,90039,87396
2011/12/1,桃園市,楊梅區,50043,152441,77475,74966
2011/12/1,桃園市,大溪區,29582,91979,47408,44571
2011/12/1,桃園市,蘆竹區,49392,143886,72040,71846
2011/12/1,桃園市,大園區,26444,82136,42600,39536
2011/12/1,桃園市,龜山區,50907,138355,69924,68431
2011/12/1,桃園市,龍潭區,37362,114958,58348,56610
2011/12/1,桃園市,新屋區,15051,48652,26063,22589
2011/12/1,桃園市,觀音區,19607,61676,32468,29208
2011/12/1,桃園市,復興區,3697,10684,5962,4722
2011/12/1,新竹縣,竹北市,49493,146826,73435,73391
2011/12/1,新竹縣,關西鎮,9324,31553,16811,14742
2011/12/1,新竹縣,新埔鎮,10469,35240,18667,16573
2011/12/1,新竹縣,竹東鎮,31092,96421,48598,47823
2011/12/1,新竹縣,湖口鄉,23795,75921,38719,37202
2011/12/1,新竹縣,橫山鄉,4461,14200,7670,6530
2011/12/1,新竹縣,新豐鄉,16098,53610,27587,26023
2011/12/1,新竹縣,芎林鄉,6335,20519,10811,9708
2011/12/1,新竹縣,寶山鄉,4818,14106,7632,6474
2011/12/1,新竹縣,北埔鄉,3115,9994,5443,4551
2011/12/1,新竹縣,峨眉鄉,2035,5904,3271,2633
2011/12/1,新竹縣,尖石鄉,2728,8731,4730,4001
2011/12/1,新竹縣,五峰鄉,1732,4616,2531,2085
2011/12/1,苗栗縣,苗栗市,29521,90900,45702,45198
2011/12/1,苗栗縣,苑裡鎮,13980,48506,25301,23205
2011/12/1,苗栗縣,通霄鎮,11410,37614,19882,17732
2011/12/1,苗栗縣,竹南鎮,24818,79656,40436,39220
2011/12/1,苗栗縣,頭份市,30430,98377,49903,48474
2011/12/1,苗栗縣,後龍鎮,11780,38986,20606,18380
2011/12/1,苗栗縣,卓蘭鎮,6004,18417,9705,8712
2011/12/1,苗栗縣,大湖鄉,5355,15899,8459,7440
2011/12/1,苗栗縣,公館鄉,10324,34847,18208,16639
2011/12/1,苗栗縣,銅鑼鄉,6004,19332,10254,9078
2011/12/1,苗栗縣,南庄鄉,4004,11010,6065,4945
2011/12/1,苗栗縣,頭屋鄉,3557,11513,6077,5436
2011/12/1,苗栗縣,三義鄉,5335,17487,9213,8274
2011/12/1,苗栗縣,西湖鄉,2687,7801,4328,3473
2011/12/1,苗栗縣,造橋鄉,4055,13687,7222,6465
2011/12/1,苗栗縣,三灣鄉,2399,7210,3929,3281
2011/12/1,苗栗縣,獅潭鄉,1689,4821,2702,2119
2011/12/1,苗栗縣,泰安鄉,1953,5947,3226,2721
2011/12/1,彰化縣,彰化市,72824,236646,117667,118979
2011/12/1,彰化縣,鹿港鎮,22676,85476,43779,41697
2011/12/1,彰化縣,和美鎮,24645,90173,46152,44021
2011/12/1,彰化縣,北斗鎮,10070,33379,16925,16454
2011/12/1,彰化縣,員林市,37145,125144,62873,62271
2011/12/1,彰化縣,溪湖鎮,15326,55918,28527,27391
2011/12/1,彰化縣,田中鎮,12606,43652,22680,20972
2011/12/1,彰化縣,二林鎮,14424,53552,27668,25884
2011/12/1,彰化縣,線西鄉,4157,16998,8757,8241
2011/12/1,彰化縣,伸港鄉,9107,35985,18461,17524
2011/12/1,彰化縣,福興鄉,12203,48625,25367,23258
2011/12/1,彰化縣,秀水鄉,9926,39273,20316,18957
2011/12/1,彰化縣,花壇鄉,13134,46047,23688,22359
2011/12/1,彰化縣,芬園鄉,6870,24670,13081,11589
2011/12/1,彰化縣,大村鄉,10376,36533,19037,17496
2011/12/1,彰化縣,埔鹽鄉,8889,34082,17844,16238
2011/12/1,彰化縣,埔心鄉,10054,35278,18204,17074
2011/12/1,彰化縣,永靖鄉,10501,38907,20203,18704
2011/12/1,彰化縣,社頭鄉,12386,44418,22802,21616
2011/12/1,彰化縣,二水鄉,5338,16345,8587,7758
2011/12/1,彰化縣,田尾鄉,7711,28355,14770,13585
2011/12/1,彰化縣,埤頭鄉,8684,31501,16418,15083
2011/12/1,彰化縣,芳苑鄉,10013,35752,18910,16842
2011/12/1,彰化縣,大城鄉,5402,18639,10113,8526
2011/12/1,彰化縣,竹塘鄉,4602,16365,8605,7760
2011/12/1,彰化縣,溪州鄉,8732,31326,16486,14840
2011/12/1,南投縣,南投市,33605,103687,52137,51550
2011/12/1,南投縣,埔里鎮,28501,84596,42674,41922
2011/12/1,南投縣,草屯鎮,31333,99249,50177,49072
2011/12/1,南投縣,竹山鎮,19355,57988,29887,28101
2011/12/1,南投縣,集集鎮,4306,11737,6142,5595
2011/12/1,南投縣,名間鄉,12219,40966,21498,19468
2011/12/1,南投縣,鹿谷鄉,6935,18947,10062,8885
2011/12/1,南投縣,中寮鄉,5648,16005,8705,7300
2011/12/1,南投縣,魚池鄉,5741,16927,8927,8000
2011/12/1,南投縣,國姓鄉,7208,20351,11077,9274
2011/12/1,南投縣,水里鄉,7224,19700,10321,9379
2011/12/1,南投縣,信義鄉,5267,17059,9237,7822
2011/12/1,南投縣,仁愛鄉,4920,15595,8135,7460
2011/12/1,雲林縣,斗六市,35329,107143,53809,53334
2011/12/1,雲林縣,斗南鎮,15389,46815,23818,22997
2011/12/1,雲林縣,虎尾鎮,22855,70080,35629,34451
2011/12/1,雲林縣,西螺鎮,14131,48125,24508,23617
2011/12/1,雲林縣,土庫鎮,8858,30247,15811,14436
2011/12/1,雲林縣,北港鎮,15500,42483,22106,20377
2011/12/1,雲林縣,古坑鄉,10698,33659,17787,15872
2011/12/1,雲林縣,大埤鄉,6675,20893,11222,9671
2011/12/1,雲林縣,莿桐鄉,9102,30251,15875,14376
2011/12/1,雲林縣,林內鄉,5784,19581,10207,9374
2011/12/1,雲林縣,二崙鄉,8752,29331,15714,13617
2011/12/1,雲林縣,崙背鄉,8343,26879,14165,12714
2011/12/1,雲林縣,麥寮鄉,12885,39147,20255,18892
2011/12/1,雲林縣,東勢鄉,5741,16379,8939,7440
2011/12/1,雲林縣,褒忠鄉,4307,13997,7473,6524
2011/12/1,雲林縣,臺西鄉,8902,25662,13808,11854
2011/12/1,雲林縣,元長鄉,9354,28367,15477,12890
2011/12/1,雲林縣,四湖鄉,9052,26316,14327,11989
2011/12/1,雲林縣,口湖鄉,9590,29898,15940,13958
2011/12/1,雲林縣,水林鄉,10347,28303,15495,12808
2011/12/1,嘉義縣,太保市,11545,36673,18893,17780
2011/12/1,嘉義縣,朴子市,14857,43895,22343,21552
2011/12/1,嘉義縣,布袋鎮,10156,29664,15207,14457
2011/12/1,嘉義縣,大林鎮,11276,33207,17045,16162
2011/12/1,嘉義縣,民雄鄉,23146,72451,37173,35278
2011/12/1,嘉義縣,溪口鄉,5390,16015,8554,7461
2011/12/1,嘉義縣,新港鄉,10437,34231,18057,16174
2011/12/1,嘉義縣,六腳鄉,9144,25903,13731,12172
2011/12/1,嘉義縣,東石鄉,9505,27202,14449,12753
2011/12/1,嘉義縣,義竹鄉,7476,20653,10727,9926
2011/12/1,嘉義縣,鹿草鄉,5801,17022,9156,7866
2011/12/1,嘉義縣,水上鄉,17448,51793,26711,25082
2011/12/1,嘉義縣,中埔鄉,15539,47291,24663,22628
2011/12/1,嘉義縣,竹崎鄉,11441,38179,20344,17835
2011/12/1,嘉義縣,梅山鄉,6675,21171,11203,9968
2011/12/1,嘉義縣,番路鄉,4077,11881,6476,5405
2011/12/1,嘉義縣,大埔鄉,1927,4554,2402,2152
2011/12/1,嘉義縣,阿里山鄉,2066,6157,3282,2875
2011/12/1,屏東縣,屏東市,72425,209416,104312,105104
2011/12/1,屏東縣,潮州鎮,18357,55312,27787,27525
2011/12/1,屏東縣,東港鎮,15836,49568,25074,24494
2011/12/1,屏東縣,恆春鎮,10878,30867,15803,15064
2011/12/1,屏東縣,萬丹鄉,14427,53515,27706,25809
2011/12/1,屏東縣,長治鄉,9790,30686,16034,14652
2011/12/1,屏東縣,麟洛鄉,3616,11406,5914,5492
2011/12/1,屏東縣,九如鄉,6613,22689,11789,10900
2011/12/1,屏東縣,里港鄉,7912,25759,13187,12572
2011/12/1,屏東縣,鹽埔鄉,7759,27036,14041,12995
2011/12/1,屏東縣,高樹鄉,9420,26331,14047,12284
2011/12/1,屏東縣,萬巒鄉,6440,21635,11390,10245
2011/12/1,屏東縣,內埔鄉,17988,57508,29868,27640
2011/12/1,屏東縣,竹田鄉,5593,18169,9633,8536
2011/12/1,屏東縣,新埤鄉,3370,10532,5596,4936
2011/12/1,屏東縣,枋寮鄉,8504,26218,13768,12450
2011/12/1,屏東縣,新園鄉,11607,37819,19553,18266
2011/12/1,屏東縣,崁頂鄉,4306,17053,8703,8350
2011/12/1,屏東縣,林邊鄉,7138,20286,10455,9831
2011/12/1,屏東縣,南州鄉,3678,11522,5899,5623
2011/12/1,屏東縣,佳冬鄉,7135,21030,10965,10065
2011/12/1,屏東縣,琉球鄉,4020,12169,6760,5409
2011/12/1,屏東縣,車城鄉,3505,9410,5082,4328
2011/12/1,屏東縣,滿州鄉,3041,8256,4556,3700
2011/12/1,屏東縣,枋山鄉,2100,5919,3183,2736
2011/12/1,屏東縣,三地門鄉,2222,7548,3856,3692
2011/12/1,屏東縣,霧臺鄉,989,2966,1557,1409
2011/12/1,屏東縣,瑪家鄉,1931,6550,3404,3146
2011/12/1,屏東縣,泰武鄉,1239,5089,2660,2429
2011/12/1,屏東縣,來義鄉,2192,7688,3939,3749
2011/12/1,屏東縣,春日鄉,1324,4842,2515,2327
2011/12/1,屏東縣,獅子鄉,1464,4815,2546,2269
2011/12/1,屏東縣,牡丹鄉,1884,4920,2551,2369
2011/12/1,臺東縣,臺東市,38265,108310,54807,53503
2011/12/1,臺東縣,成功鎮,5422,15542,8234,7308
2011/12/1,臺東縣,關山鎮,3231,9559,5017,4542
2011/12/1,臺東縣,卑南鄉,6626,18055,9709,8346
2011/12/1,臺東縣,大武鄉,2518,6790,3558,3232
2011/12/1,臺東縣,太麻里鄉,4537,11823,6306,5517
2011/12/1,臺東縣,東河鄉,3633,9222,5139,4083
2011/12/1,臺東縣,長濱鄉,2931,8031,4580,3451
2011/12/1,臺東縣,鹿野鄉,3126,8403,4534,3869
2011/12/1,臺東縣,池上鄉,3254,9012,4758,4254
2011/12/1,臺東縣,綠島鄉,1040,3400,1808,1592
2011/12/1,臺東縣,延平鄉,1062,3560,1959,1601
2011/12/1,臺東縣,海端鄉,1098,4408,2395,2013
2011/12/1,臺東縣,達仁鄉,1503,3965,2159,1806
2011/12/1,臺東縣,金峰鄉,1058,3519,1829,1690
2011/12/1,臺東縣,蘭嶼鄉,1536,4691,2413,2278
2011/12/1,花蓮縣,花蓮市,40798,108755,53220,55535
2011/12/1,花蓮縣,鳳林鎮,4425,11712,6189,5523
2011/12/1,花蓮縣,玉里鎮,8896,26452,14294,12158
2011/12/1,花蓮縣,新城鄉,7354,20130,10449,9681
2011/12/1,花蓮縣,吉安鄉,29558,80464,41049,39415
2011/12/1,花蓮縣,壽豐鄉,6856,18494,9974,8520
2011/12/1,花蓮縣,光復鄉,5050,13837,7385,6452
2011/12/1,花蓮縣,豐濱鄉,1787,4857,2697,2160
2011/12/1,花蓮縣,瑞穗鄉,4641,12588,6799,5789
2011/12/1,花蓮縣,富里鄉,4004,11387,6197,5190
2011/12/1,花蓮縣,秀林鄉,4684,15173,7879,7294
2011/12/1,花蓮縣,萬榮鄉,2124,6756,3612,3144
2011/12/1,花蓮縣,卓溪鄉,1656,6233,3461,2772
2011/12/1,澎湖縣,馬公市,20984,57468,29113,28355
2011/12/1,澎湖縣,湖西鄉,4847,13699,7141,6558
2011/12/1,澎湖縣,白沙鄉,3172,9412,4933,4479
2011/12/1,澎湖縣,西嶼鄉,2863,8354,4299,4055
2011/12/1,澎湖縣,望安鄉,1899,4661,2517,2144
2011/12/1,澎湖縣,七美鄉,1266,3563,1862,1701
2011/12/1,基隆市,中正區,22140,54447,27877,26570
2011/12/1,基隆市,七堵區,20285,54711,27727,26984
2011/12/1,基隆市,暖暖區,14583,37943,19244,18699
2011/12/1,基隆市,仁愛區,19795,48717,24039,24678
2011/12/1,基隆市,中山區,19197,50297,25680,24617
2011/12/1,基隆市,安樂區,31756,82779,41284,41495
2011/12/1,基隆市,信義區,20215,51033,25516,25517
2011/12/1,新竹市,東區,70327,200092,98749,101343
2011/12/1,新竹市,北區,51572,146212,72051,74161
2011/12/1,新竹市,香山區,23618,73748,37590,36158
2011/12/1,嘉義市,東區,44366,124495,60779,63716
2011/12/1,嘉義市,西區,51677,147031,72674,74357
2011/12/1,金門縣,金城鎮,11408,34245,17323,16922
2011/12/1,金門縣,金湖鎮,7575,22738,11565,11173
2011/12/1,金門縣,金沙鎮,5547,16301,8209,8092
2011/12/1,金門縣,金寧鄉,6434,20520,10531,9989
2011/12/1,金門縣,烈嶼鄉,2718,9515,4720,4795
2011/12/1,金門縣,烏坵鄉,134,564,283,281
2011/12/1,連江縣,南竿鄉,1266,6000,3442,2558
2011/12/1,連江縣,北竿鄉,405,1864,1054,810
2011/12/1,連江縣,莒光鄉,245,1163,697,466
2011/12/1,連江縣,東引鄉,280,1079,640,439
2012/1/1,總計,新北市,1432483,3917945,1940279,1977666
2012/1/1,總計,臺北市,1000093,2652959,1277071,1375888
2012/1/1,總計,臺中市,868315,2665613,1325309,1340304
2012/1/1,總計,臺南市,648511,1877115,943790,933325
2012/1/1,總計,高雄市,1035310,2774925,1388542,1386383
2012/1/1,總計,臺灣省,3040229,9227278,4713093,4514185
2012/1/1,總計,宜蘭縣,156400,459018,233623,225395
2012/1/1,總計,桃園市,686765,2014216,1014070,1000146
2012/1/1,總計,新竹縣,165622,517853,265954,251899
2012/1/1,總計,苗栗縣,175435,562164,291219,270945
2012/1/1,總計,彰化縣,367925,1302754,667717,635037
2012/1/1,總計,南投縣,172347,522562,268856,253706
2012/1/1,總計,雲林縣,231722,713295,372192,341103
2012/1/1,總計,嘉義縣,177949,537628,280255,257373
2012/1/1,總計,屏東縣,278724,864081,443856,420225
2012/1/1,總計,臺東縣,80823,228118,119110,109008
2012/1/1,總計,花蓮縣,121791,336733,173137,163596
2012/1/1,總計,澎湖縣,35104,97248,49906,47342
2012/1/1,總計,基隆市,147935,379742,191240,188502
2012/1/1,總計,新竹市,145661,420342,208518,211824
2012/1/1,總計,嘉義市,96026,271524,133440,138084
2012/1/1,總計,福建省,36113,114671,58792,55879
2012/1/1,總計,金門縣,33914,104538,52955,51583
2012/1/1,總計,連江縣,2199,10133,5837,4296
2012/1/1,新北市,板橋區,198243,555484,273884,281600
2012/1/1,新北市,三重區,142564,390528,194157,196371
2012/1/1,新北市,中和區,157457,414947,204447,210500
2012/1/1,新北市,永和區,89942,232286,111288,120998
2012/1/1,新北市,新莊區,139286,404279,199314,204965
2012/1/1,新北市,新店區,117930,296649,144816,151833
2012/1/1,新北市,樹林區,62196,179972,90483,89489
2012/1/1,新北市,鶯歌區,27981,87715,44234,43481
2012/1/1,新北市,三峽區,36873,105756,53752,52004
2012/1/1,新北市,淡水區,59972,147048,71330,75718
2012/1/1,新北市,汐止區,80339,190704,94442,96262
2012/1/1,新北市,瑞芳區,15922,41996,21383,20613
2012/1/1,新北市,土城區,83379,239235,119391,119844
2012/1/1,新北市,蘆洲區,66493,198436,98082,100354
2012/1/1,新北市,五股區,27784,80562,40760,39802
2012/1/1,新北市,泰山區,26565,77101,38669,38432
2012/1/1,新北市,林口區,32553,86863,42817,44046
2012/1/1,新北市,深坑區,9091,23553,11848,11705
2012/1/1,新北市,石碇區,3343,7872,4377,3495
2012/1/1,新北市,坪林區,2455,6521,3627,2894
2012/1/1,新北市,三芝區,8946,23316,12038,11278
2012/1/1,新北市,石門區,4163,12830,6718,6112
2012/1/1,新北市,八里區,12668,35411,17883,17528
2012/1/1,新北市,平溪區,2389,5188,2887,2301
2012/1/1,新北市,雙溪區,3810,9540,5164,4376
2012/1/1,新北市,貢寮區,4439,13525,6979,6546
2012/1/1,新北市,金山區,6804,22440,11210,11230
2012/1/1,新北市,萬里區,7153,22266,11312,10954
2012/1/1,新北市,烏來區,1743,5922,2987,2935
2012/1/1,臺北市,松山區,78803,210119,99479,110640
2012/1/1,臺北市,信義區,86812,226704,109012,117692
2012/1/1,臺北市,大安區,118011,313825,147489,166336
2012/1/1,臺北市,中山區,93936,224193,105275,118918
2012/1/1,臺北市,中正區,63171,161616,77841,83775
2012/1/1,臺北市,大同區,48533,126821,62369,64452
2012/1/1,臺北市,萬華區,75252,190950,94902,96048
2012/1/1,臺北市,文山區,99143,266711,128975,137736
2012/1/1,臺北市,南港區,42995,116346,57133,59213
2012/1/1,臺北市,內湖區,99639,275968,132813,143155
2012/1/1,臺北市,士林區,102542,287298,139391,147907
2012/1/1,臺北市,北投區,91256,252408,122392,130016
2012/1/1,臺中市,中區,8209,21555,10686,10869
2012/1/1,臺中市,東區,26101,73952,37208,36744
2012/1/1,臺中市,南區,43051,115135,55784,59351
2012/1/1,臺中市,西區,43811,117299,56201,61098
2012/1/1,臺中市,北區,56537,147660,71353,76307
2012/1/1,臺中市,西屯區,75129,209838,101447,108391
2012/1/1,臺中市,南屯區,54535,155818,75224,80594
2012/1/1,臺中市,北屯區,85743,249964,121216,128748
2012/1/1,臺中市,豐原區,50442,165661,82158,83503
2012/1/1,臺中市,東勢區,17072,52742,27358,25384
2012/1/1,臺中市,大甲區,21883,78176,39634,38542
2012/1/1,臺中市,清水區,25278,85640,44178,41462
2012/1/1,臺中市,沙鹿區,24752,83358,42371,40987
2012/1/1,臺中市,梧棲區,16225,55539,28151,27388
2012/1/1,臺中市,后里區,14982,54029,27703,26326
2012/1/1,臺中市,神岡區,17901,63952,32871,31081
2012/1/1,臺中市,潭子區,33107,101890,50651,51239
2012/1/1,臺中市,大雅區,26757,90635,45584,45051
2012/1/1,臺中市,新社區,7380,25493,13307,12186
2012/1/1,臺中市,石岡區,4866,15789,8207,7582
2012/1/1,臺中市,外埔區,8965,31951,16424,15527
2012/1/1,臺中市,大安區,5321,20056,10529,9527
2012/1/1,臺中市,烏日區,21009,69288,35084,34204
2012/1/1,臺中市,大肚區,16063,55768,28595,27173
2012/1/1,臺中市,龍井區,21024,74671,37911,36760
2012/1/1,臺中市,霧峰區,18920,63922,32784,31138
2012/1/1,臺中市,太平區,55637,174403,87394,87009
2012/1/1,臺中市,大里區,63201,200764,99525,101239
2012/1/1,臺中市,和平區,4414,10665,5771,4894
2012/1/1,臺南市,新營區,27563,78467,39071,39396
2012/1/1,臺南市,鹽水區,10001,26892,13987,12905
2012/1/1,臺南市,白河區,10967,30907,16175,14732
2012/1/1,臺南市,柳營區,7804,22412,11729,10683
2012/1/1,臺南市,後壁區,8833,25537,13277,12260
2012/1/1,臺南市,東山區,8229,22727,12058,10669
2012/1/1,臺南市,麻豆區,15176,45593,23265,22328
2012/1/1,臺南市,下營區,9111,25788,13328,12460
2012/1/1,臺南市,六甲區,7692,23491,12224,11267
2012/1/1,臺南市,官田區,7641,21953,11237,10716
2012/1/1,臺南市,大內區,4036,10666,5682,4984
2012/1/1,臺南市,佳里區,19573,59148,29368,29780
2012/1/1,臺南市,學甲區,9583,27583,14120,13463
2012/1/1,臺南市,西港區,7866,25061,12739,12322
2012/1/1,臺南市,七股區,8049,24630,12859,11771
2012/1/1,臺南市,將軍區,7411,21226,10817,10409
2012/1/1,臺南市,北門區,4395,12249,6236,6013
2012/1/1,臺南市,新化區,13827,44012,22530,21482
2012/1/1,臺南市,善化區,14980,44012,22234,21778
2012/1/1,臺南市,新市區,10971,35046,17623,17423
2012/1/1,臺南市,安定區,9455,30251,15661,14590
2012/1/1,臺南市,山上區,2724,7754,4085,3669
2012/1/1,臺南市,玉井區,5099,15220,7866,7354
2012/1/1,臺南市,楠西區,3553,10438,5539,4899
2012/1/1,臺南市,南化區,2818,8829,4819,4010
2012/1/1,臺南市,左鎮區,1982,5348,2977,2371
2012/1/1,臺南市,仁德區,25105,70288,35961,34327
2012/1/1,臺南市,歸仁區,20909,66168,33754,32414
2012/1/1,臺南市,關廟區,10751,35568,18460,17108
2012/1/1,臺南市,龍崎區,1591,4313,2330,1983
2012/1/1,臺南市,永康區,77080,220969,109664,111305
2012/1/1,臺南市,東區,71352,193787,93523,100264
2012/1/1,臺南市,南區,43799,126183,63204,62979
2012/1/1,臺南市,北區,48687,132062,64912,67150
2012/1/1,臺南市,安南區,55961,180117,91429,88688
2012/1/1,臺南市,安平區,23666,63662,30470,33192
2012/1/1,臺南市,中西區,30271,78758,38577,40181
2012/1/1,高雄市,鹽埕區,11058,26701,13370,13331
2012/1/1,高雄市,鼓山區,53178,132959,64962,67997
2012/1/1,高雄市,左營區,74932,193695,94984,98711
2012/1/1,高雄市,楠梓區,62702,174025,86199,87826
2012/1/1,高雄市,三民區,132647,351991,171921,180070
2012/1/1,高雄市,新興區,22781,54322,26303,28019
2012/1/1,高雄市,前金區,12491,28397,13811,14586
2012/1/1,高雄市,苓雅區,72043,181630,88236,93394
2012/1/1,高雄市,前鎮區,76908,197593,98016,99577
2012/1/1,高雄市,旗津區,10989,29752,15414,14338
2012/1/1,高雄市,小港區,64276,154875,77674,77201
2012/1/1,高雄市,鳳山區,129425,345779,171670,174109
2012/1/1,高雄市,林園區,24643,70436,36071,34365
2012/1/1,高雄市,大寮區,38989,109173,56602,52571
2012/1/1,高雄市,大樹區,13102,43600,22515,21085
2012/1/1,高雄市,大社區,11915,33345,17084,16261
2012/1/1,高雄市,仁武區,27222,74999,38659,36340
2012/1/1,高雄市,鳥松區,16896,43203,21877,21326
2012/1/1,高雄市,岡山區,33644,97454,48795,48659
2012/1/1,高雄市,橋頭區,12893,36824,18849,17975
2012/1/1,高雄市,燕巢區,10141,30902,16485,14417
2012/1/1,高雄市,田寮區,3513,7995,4444,3551
2012/1/1,高雄市,阿蓮區,9235,30215,15233,14982
2012/1/1,高雄市,路竹區,16182,53439,27274,26165
2012/1/1,高雄市,湖內區,9779,28825,14828,13997
2012/1/1,高雄市,茄萣區,10192,30987,16117,14870
2012/1/1,高雄市,永安區,5791,14076,7148,6928
2012/1/1,高雄市,彌陀區,6681,20224,10489,9735
2012/1/1,高雄市,梓官區,12159,36574,19006,17568
2012/1/1,高雄市,旗山區,13858,39416,20503,18913
2012/1/1,高雄市,美濃區,14324,42621,22261,20360
2012/1/1,高雄市,六龜區,5758,14387,7785,6602
2012/1/1,高雄市,甲仙區,2483,6931,3711,3220
2012/1/1,高雄市,杉林區,4607,12165,6637,5528
2012/1/1,高雄市,內門區,5048,15639,8523,7116
2012/1/1,高雄市,茂林區,574,1833,921,912
2012/1/1,高雄市,桃源區,1371,4700,2483,2217
2012/1/1,高雄市,那瑪夏區,880,3243,1682,1561
2012/1/1,宜蘭縣,宜蘭市,33645,95521,46902,48619
2012/1/1,宜蘭縣,羅東鎮,25236,72884,34898,37986
2012/1/1,宜蘭縣,蘇澳鎮,13688,42363,21698,20665
2012/1/1,宜蘭縣,頭城鎮,9823,30528,15767,14761
2012/1/1,宜蘭縣,礁溪鄉,12571,35917,18778,17139
2012/1/1,宜蘭縣,壯圍鄉,8184,24663,13025,11638
2012/1/1,宜蘭縣,員山鄉,10955,32283,17297,14986
2012/1/1,宜蘭縣,冬山鄉,17752,52992,27265,25727
2012/1/1,宜蘭縣,五結鄉,13244,38816,20158,18658
2012/1/1,宜蘭縣,三星鄉,7634,21193,11460,9733
2012/1/1,宜蘭縣,大同鄉,1832,5923,3222,2701
2012/1/1,宜蘭縣,南澳鄉,1836,5935,3153,2782
2012/1/1,桃園市,桃園區,147084,410381,200881,209500
2012/1/1,桃園市,中壢區,130087,372525,185705,186820
2012/1/1,桃園市,平鎮區,68060,208683,104963,103720
2012/1/1,桃園市,八德區,59243,177494,90059,87435
2012/1/1,桃園市,楊梅區,50098,152563,77519,75044
2012/1/1,桃園市,大溪區,29592,91949,47388,44561
2012/1/1,桃園市,蘆竹區,49446,144104,72157,71947
2012/1/1,桃園市,大園區,26464,82166,42612,39554
2012/1/1,桃園市,龜山區,50932,138397,69953,68444
2012/1/1,桃園市,龍潭區,37382,114937,58316,56621
2012/1/1,桃園市,新屋區,15067,48641,26056,22585
2012/1/1,桃園市,觀音區,19616,61704,32511,29193
2012/1/1,桃園市,復興區,3694,10672,5950,4722
2012/1/1,新竹縣,竹北市,49592,147026,73521,73505
2012/1/1,新竹縣,關西鎮,9329,31518,16796,14722
2012/1/1,新竹縣,新埔鎮,10461,35195,18653,16542
2012/1/1,新竹縣,竹東鎮,31089,96462,48600,47862
2012/1/1,新竹縣,湖口鄉,23808,75921,38711,37210
2012/1/1,新竹縣,橫山鄉,4463,14208,7678,6530
2012/1/1,新竹縣,新豐鄉,16124,53657,27590,26067
2012/1/1,新竹縣,芎林鄉,6339,20540,10820,9720
2012/1/1,新竹縣,寶山鄉,4820,14106,7630,6476
2012/1/1,新竹縣,北埔鄉,3110,9984,5433,4551
2012/1/1,新竹縣,峨眉鄉,2033,5889,3270,2619
2012/1/1,新竹縣,尖石鄉,2726,8738,4728,4010
2012/1/1,新竹縣,五峰鄉,1728,4609,2524,2085
2012/1/1,苗栗縣,苗栗市,29533,90914,45702,45212
2012/1/1,苗栗縣,苑裡鎮,13995,48511,25290,23221
2012/1/1,苗栗縣,通霄鎮,11422,37603,19870,17733
2012/1/1,苗栗縣,竹南鎮,24845,79777,40503,39274
2012/1/1,苗栗縣,頭份市,30466,98482,49942,48540
2012/1/1,苗栗縣,後龍鎮,11784,38947,20573,18374
2012/1/1,苗栗縣,卓蘭鎮,6005,18419,9712,8707
2012/1/1,苗栗縣,大湖鄉,5359,15896,8456,7440
2012/1/1,苗栗縣,公館鄉,10328,34850,18200,16650
2012/1/1,苗栗縣,銅鑼鄉,6009,19331,10250,9081
2012/1/1,苗栗縣,南庄鄉,3997,10986,6050,4936
2012/1/1,苗栗縣,頭屋鄉,3561,11507,6069,5438
2012/1/1,苗栗縣,三義鄉,5333,17473,9199,8274
2012/1/1,苗栗縣,西湖鄉,2692,7790,4320,3470
2012/1/1,苗栗縣,造橋鄉,4055,13719,7230,6489
2012/1/1,苗栗縣,三灣鄉,2400,7190,3922,3268
2012/1/1,苗栗縣,獅潭鄉,1695,4819,2701,2118
2012/1/1,苗栗縣,泰安鄉,1956,5950,3230,2720
2012/1/1,彰化縣,彰化市,72839,236646,117660,118986
2012/1/1,彰化縣,鹿港鎮,22713,85522,43799,41723
2012/1/1,彰化縣,和美鎮,24667,90154,46149,44005
2012/1/1,彰化縣,北斗鎮,10071,33371,16923,16448
2012/1/1,彰化縣,員林市,37130,125147,62852,62295
2012/1/1,彰化縣,溪湖鎮,15329,55905,28526,27379
2012/1/1,彰化縣,田中鎮,12614,43632,22664,20968
2012/1/1,彰化縣,二林鎮,14422,53516,27648,25868
2012/1/1,彰化縣,線西鄉,4153,16991,8755,8236
2012/1/1,彰化縣,伸港鄉,9123,35993,18453,17540
2012/1/1,彰化縣,福興鄉,12207,48609,25347,23262
2012/1/1,彰化縣,秀水鄉,9919,39229,20295,18934
2012/1/1,彰化縣,花壇鄉,13142,46067,23695,22372
2012/1/1,彰化縣,芬園鄉,6871,24643,13066,11577
2012/1/1,彰化縣,大村鄉,10384,36522,19033,17489
2012/1/1,彰化縣,埔鹽鄉,8891,34070,17837,16233
2012/1/1,彰化縣,埔心鄉,10061,35268,18178,17090
2012/1/1,彰化縣,永靖鄉,10502,38887,20202,18685
2012/1/1,彰化縣,社頭鄉,12389,44412,22784,21628
2012/1/1,彰化縣,二水鄉,5336,16325,8577,7748
2012/1/1,彰化縣,田尾鄉,7721,28357,14771,13586
2012/1/1,彰化縣,埤頭鄉,8695,31498,16419,15079
2012/1/1,彰化縣,芳苑鄉,10016,35723,18899,16824
2012/1/1,彰化縣,大城鄉,5397,18600,10103,8497
2012/1/1,彰化縣,竹塘鄉,4594,16341,8598,7743
2012/1/1,彰化縣,溪州鄉,8739,31326,16484,14842
2012/1/1,南投縣,南投市,33623,103664,52139,51525
2012/1/1,南投縣,埔里鎮,28489,84585,42664,41921
2012/1/1,南投縣,草屯鎮,31365,99252,50184,49068
2012/1/1,南投縣,竹山鎮,19372,57938,29866,28072
2012/1/1,南投縣,集集鎮,4306,11720,6129,5591
2012/1/1,南投縣,名間鄉,12224,40930,21485,19445
2012/1/1,南投縣,鹿谷鄉,6944,18930,10051,8879
2012/1/1,南投縣,中寮鄉,5649,16001,8699,7302
2012/1/1,南投縣,魚池鄉,5739,16906,8917,7989
2012/1/1,南投縣,國姓鄉,7209,20327,11052,9275
2012/1/1,南投縣,水里鄉,7228,19676,10311,9365
2012/1/1,南投縣,信義鄉,5271,17019,9219,7800
2012/1/1,南投縣,仁愛鄉,4928,15614,8140,7474
2012/1/1,雲林縣,斗六市,35375,107205,53823,53382
2012/1/1,雲林縣,斗南鎮,15389,46782,23801,22981
2012/1/1,雲林縣,虎尾鎮,22891,70092,35648,34444
2012/1/1,雲林縣,西螺鎮,14125,48101,24497,23604
2012/1/1,雲林縣,土庫鎮,8860,30220,15797,14423
2012/1/1,雲林縣,北港鎮,15514,42483,22094,20389
2012/1/1,雲林縣,古坑鄉,10689,33630,17767,15863
2012/1/1,雲林縣,大埤鄉,6675,20870,11208,9662
2012/1/1,雲林縣,莿桐鄉,9103,30215,15859,14356
2012/1/1,雲林縣,林內鄉,5785,19559,10201,9358
2012/1/1,雲林縣,二崙鄉,8750,29300,15697,13603
2012/1/1,雲林縣,崙背鄉,8350,26866,14166,12700
2012/1/1,雲林縣,麥寮鄉,12915,39251,20296,18955
2012/1/1,雲林縣,東勢鄉,5746,16339,8922,7417
2012/1/1,雲林縣,褒忠鄉,4311,13970,7465,6505
2012/1/1,雲林縣,臺西鄉,8895,25624,13778,11846
2012/1/1,雲林縣,元長鄉,9358,28348,15466,12882
2012/1/1,雲林縣,四湖鄉,9053,26291,14312,11979
2012/1/1,雲林縣,口湖鄉,9591,29874,15921,13953
2012/1/1,雲林縣,水林鄉,10347,28275,15474,12801
2012/1/1,嘉義縣,太保市,11560,36681,18891,17790
2012/1/1,嘉義縣,朴子市,14867,43895,22343,21552
2012/1/1,嘉義縣,布袋鎮,10157,29646,15195,14451
2012/1/1,嘉義縣,大林鎮,11273,33202,17039,16163
2012/1/1,嘉義縣,民雄鄉,23154,72413,37155,35258
2012/1/1,嘉義縣,溪口鄉,5388,16005,8544,7461
2012/1/1,嘉義縣,新港鄉,10436,34212,18060,16152
2012/1/1,嘉義縣,六腳鄉,9140,25848,13707,12141
2012/1/1,嘉義縣,東石鄉,9498,27170,14432,12738
2012/1/1,嘉義縣,義竹鄉,7474,20620,10707,9913
2012/1/1,嘉義縣,鹿草鄉,5802,17007,9142,7865
2012/1/1,嘉義縣,水上鄉,17440,51748,26693,25055
2012/1/1,嘉義縣,中埔鄉,15556,47289,24680,22609
2012/1/1,嘉義縣,竹崎鄉,11453,38166,20323,17843
2012/1/1,嘉義縣,梅山鄉,6679,21126,11181,9945
2012/1/1,嘉義縣,番路鄉,4080,11873,6470,5403
2012/1/1,嘉義縣,大埔鄉,1927,4566,2406,2160
2012/1/1,嘉義縣,阿里山鄉,2065,6161,3287,2874
2012/1/1,屏東縣,屏東市,72422,209330,104252,105078
2012/1/1,屏東縣,潮州鎮,18380,55290,27768,27522
2012/1/1,屏東縣,東港鎮,15846,49567,25065,24502
2012/1/1,屏東縣,恆春鎮,10881,30835,15790,15045
2012/1/1,屏東縣,萬丹鄉,14424,53485,27690,25795
2012/1/1,屏東縣,長治鄉,9792,30683,16029,14654
2012/1/1,屏東縣,麟洛鄉,3614,11383,5906,5477
2012/1/1,屏東縣,九如鄉,6607,22659,11764,10895
2012/1/1,屏東縣,里港鄉,7922,25897,13254,12643
2012/1/1,屏東縣,鹽埔鄉,7759,26991,14024,12967
2012/1/1,屏東縣,高樹鄉,9418,26279,14018,12261
2012/1/1,屏東縣,萬巒鄉,6440,21628,11387,10241
2012/1/1,屏東縣,內埔鄉,17987,57485,29861,27624
2012/1/1,屏東縣,竹田鄉,5588,18151,9618,8533
2012/1/1,屏東縣,新埤鄉,3368,10519,5587,4932
2012/1/1,屏東縣,枋寮鄉,8506,26197,13756,12441
2012/1/1,屏東縣,新園鄉,11607,37748,19521,18227
2012/1/1,屏東縣,崁頂鄉,4301,17016,8680,8336
2012/1/1,屏東縣,林邊鄉,7132,20264,10438,9826
2012/1/1,屏東縣,南州鄉,3678,11517,5901,5616
2012/1/1,屏東縣,佳冬鄉,7135,21006,10951,10055
2012/1/1,屏東縣,琉球鄉,4022,12151,6756,5395
2012/1/1,屏東縣,車城鄉,3507,9396,5082,4314
2012/1/1,屏東縣,滿州鄉,3045,8278,4562,3716
2012/1/1,屏東縣,枋山鄉,2100,5905,3172,2733
2012/1/1,屏東縣,三地門鄉,2218,7547,3845,3702
2012/1/1,屏東縣,霧臺鄉,991,2963,1559,1404
2012/1/1,屏東縣,瑪家鄉,1931,6550,3402,3148
2012/1/1,屏東縣,泰武鄉,1237,5097,2661,2436
2012/1/1,屏東縣,來義鄉,2197,7694,3944,3750
2012/1/1,屏東縣,春日鄉,1324,4845,2517,2328
2012/1/1,屏東縣,獅子鄉,1465,4814,2545,2269
2012/1/1,屏東縣,牡丹鄉,1880,4911,2551,2360
2012/1/1,臺東縣,臺東市,38236,108220,54756,53464
2012/1/1,臺東縣,成功鎮,5420,15516,8219,7297
2012/1/1,臺東縣,關山鎮,3231,9554,5011,4543
2012/1/1,臺東縣,卑南鄉,6627,18051,9717,8334
2012/1/1,臺東縣,大武鄉,2517,6778,3548,3230
2012/1/1,臺東縣,太麻里鄉,4539,11809,6300,5509
2012/1/1,臺東縣,東河鄉,3641,9228,5146,4082
2012/1/1,臺東縣,長濱鄉,2930,8025,4576,3449
2012/1/1,臺東縣,鹿野鄉,3125,8405,4536,3869
2012/1/1,臺東縣,池上鄉,3255,8987,4745,4242
2012/1/1,臺東縣,綠島鄉,1040,3401,1807,1594
2012/1/1,臺東縣,延平鄉,1062,3555,1951,1604
2012/1/1,臺東縣,海端鄉,1098,4418,2396,2022
2012/1/1,臺東縣,達仁鄉,1504,3946,2150,1796
2012/1/1,臺東縣,金峰鄉,1058,3526,1833,1693
2012/1/1,臺東縣,蘭嶼鄉,1540,4699,2419,2280
2012/1/1,花蓮縣,花蓮市,40781,108756,53213,55543
2012/1/1,花蓮縣,鳳林鎮,4425,11695,6179,5516
2012/1/1,花蓮縣,玉里鎮,8886,26410,14279,12131
2012/1/1,花蓮縣,新城鄉,7345,20103,10437,9666
2012/1/1,花蓮縣,吉安鄉,29567,80501,41051,39450
2012/1/1,花蓮縣,壽豐鄉,6853,18484,9977,8507
2012/1/1,花蓮縣,光復鄉,5043,13841,7392,6449
2012/1/1,花蓮縣,豐濱鄉,1786,4840,2688,2152
2012/1/1,花蓮縣,瑞穗鄉,4638,12560,6785,5775
2012/1/1,花蓮縣,富里鄉,4001,11386,6192,5194
2012/1/1,花蓮縣,秀林鄉,4688,15166,7872,7294
2012/1/1,花蓮縣,萬榮鄉,2122,6755,3610,3145
2012/1/1,花蓮縣,卓溪鄉,1656,6236,3462,2774
2012/1/1,澎湖縣,馬公市,21031,57563,29154,28409
2012/1/1,澎湖縣,湖西鄉,4863,13698,7147,6551
2012/1/1,澎湖縣,白沙鄉,3177,9415,4941,4474
2012/1/1,澎湖縣,西嶼鄉,2862,8356,4296,4060
2012/1/1,澎湖縣,望安鄉,1903,4651,2503,2148
2012/1/1,澎湖縣,七美鄉,1268,3565,1865,1700
2012/1/1,基隆市,中正區,22129,54386,27844,26542
2012/1/1,基隆市,七堵區,20276,54679,27705,26974
2012/1/1,基隆市,暖暖區,14587,37947,19246,18701
2012/1/1,基隆市,仁愛區,19761,48642,23998,24644
2012/1/1,基隆市,中山區,19186,50246,25654,24592
2012/1/1,基隆市,安樂區,31755,82764,41251,41513
2012/1/1,基隆市,信義區,20241,51078,25542,25536
2012/1/1,新竹市,東區,70429,200297,98833,101464
2012/1/1,新竹市,北區,51598,146198,72035,74163
2012/1/1,新竹市,香山區,23634,73847,37650,36197
2012/1/1,嘉義市,東區,44356,124486,60777,63709
2012/1/1,嘉義市,西區,51670,147038,72663,74375
2012/1/1,金門縣,金城鎮,11431,34463,17435,17028
2012/1/1,金門縣,金湖鎮,7602,22883,11637,11246
2012/1/1,金門縣,金沙鎮,5566,16385,8253,8132
2012/1/1,金門縣,金寧鄉,6448,20631,10585,10046
2012/1/1,金門縣,烈嶼鄉,2733,9612,4762,4850
2012/1/1,金門縣,烏坵鄉,134,564,283,281
2012/1/1,連江縣,南竿鄉,1266,6015,3444,2571
2012/1/1,連江縣,北竿鄉,407,1866,1052,814
2012/1/1,連江縣,莒光鄉,246,1165,698,467
2012/1/1,連江縣,東引鄉,280,1087,643,444
2012/2/1,總計,新北市,1434464,3919597,1940589,1979008
2012/2/1,總計,臺北市,1000766,2653948,1277560,1376388
2012/2/1,總計,臺中市,869618,2666925,1325785,1341140
2012/2/1,總計,臺南市,649105,1877397,943875,933522
2012/2/1,總計,高雄市,1036151,2774831,1388254,1386577
2012/2/1,總計,臺灣省,3043193,9225736,4711862,4513874
2012/2/1,總計,宜蘭縣,156472,458792,233501,225291
2012/2/1,總計,桃園市,687633,2015012,1014341,1000671
2012/2/1,總計,新竹縣,165977,518371,266158,252213
2012/2/1,總計,苗栗縣,175683,562190,291172,271018
2012/2/1,總計,彰化縣,368154,1302193,667406,634787
2012/2/1,總計,南投縣,172462,522201,268625,253576
2012/2/1,總計,雲林縣,231967,712989,371968,341021
2012/2/1,總計,嘉義縣,178086,537072,279958,257114
2012/2/1,總計,屏東縣,278895,863540,443577,419963
2012/2/1,總計,臺東縣,80845,227934,119040,108894
2012/2/1,總計,花蓮縣,121850,336621,173041,163580
2012/2/1,總計,澎湖縣,35166,97268,49947,47321
2012/2/1,總計,基隆市,147986,379416,191056,188360
2012/2/1,總計,新竹市,145912,420588,208638,211950
2012/2/1,總計,嘉義市,96105,271549,133434,138115
2012/2/1,總計,福建省,36246,115569,59189,56380
2012/2/1,總計,金門縣,34047,105434,53359,52075
2012/2/1,總計,連江縣,2199,10135,5830,4305
2012/2/1,新北市,板橋區,198558,555792,273947,281845
2012/2/1,新北市,三重區,142703,390520,194113,196407
2012/2/1,新北市,中和區,157665,414981,204424,210557
2012/2/1,新北市,永和區,90030,232252,111254,120998
2012/2/1,新北市,新莊區,139525,404426,199352,205074
2012/2/1,新北市,新店區,118019,296570,144733,151837
2012/2/1,新北市,樹林區,62328,180192,90545,89647
2012/2/1,新北市,鶯歌區,28021,87738,44245,43493
2012/2/1,新北市,三峽區,36988,105922,53847,52075
2012/2/1,新北市,淡水區,60129,147367,71439,75928
2012/2/1,新北市,汐止區,80400,190919,94504,96415
2012/2/1,新北市,瑞芳區,15921,41926,21338,20588
2012/2/1,新北市,土城區,83505,239347,119417,119930
2012/2/1,新北市,蘆洲區,66539,198477,98063,100414
2012/2/1,新北市,五股區,27848,80657,40800,39857
2012/2/1,新北市,泰山區,26587,77151,38684,38467
2012/2/1,新北市,林口區,32643,87110,42902,44208
2012/2/1,新北市,深坑區,9092,23521,11836,11685
2012/2/1,新北市,石碇區,3348,7891,4381,3510
2012/2/1,新北市,坪林區,2457,6518,3628,2890
2012/2/1,新北市,三芝區,8953,23277,12014,11263
2012/2/1,新北市,石門區,4173,12819,6716,6103
2012/2/1,新北市,八里區,12664,35364,17871,17493
2012/2/1,新北市,平溪區,2391,5192,2885,2307
2012/2/1,新北市,雙溪區,3808,9521,5148,4373
2012/2/1,新北市,貢寮區,4444,13508,6974,6534
2012/2/1,新北市,金山區,6815,22443,11209,11234
2012/2/1,新北市,萬里區,7164,22271,11332,10939
2012/2/1,新北市,烏來區,1746,5925,2988,2937
2012/2/1,臺北市,松山區,78812,210347,99620,110727
2012/2/1,臺北市,信義區,86820,226770,109051,117719
2012/2/1,臺北市,大安區,117989,313710,147409,166301
2012/2/1,臺北市,中山區,94081,224258,105264,118994
2012/2/1,臺北市,中正區,63159,161409,77769,83640
2012/2/1,臺北市,大同區,48655,127092,62493,64599
2012/2/1,臺北市,萬華區,75262,190963,94917,96046
2012/2/1,臺北市,文山區,99223,266934,129055,137879
2012/2/1,臺北市,南港區,43091,116516,57217,59299
2012/2/1,臺北市,內湖區,99771,276217,132921,143296
2012/2/1,臺北市,士林區,102567,287248,139400,147848
2012/2/1,臺北市,北投區,91336,252484,122444,130040
2012/2/1,臺中市,中區,8198,21491,10651,10840
2012/2/1,臺中市,東區,26140,73955,37215,36740
2012/2/1,臺中市,南區,43119,115193,55802,59391
2012/2/1,臺中市,西區,43849,117210,56144,61066
2012/2/1,臺中市,北區,56629,147733,71357,76376
2012/2/1,臺中市,西屯區,75256,210019,101474,108545
2012/2/1,臺中市,南屯區,54642,156074,75365,80709
2012/2/1,臺中市,北屯區,85890,250118,121249,128869
2012/2/1,臺中市,豐原區,50524,165773,82187,83586
2012/2/1,臺中市,東勢區,17073,52684,27334,25350
2012/2/1,臺中市,大甲區,21891,78178,39636,38542
2012/2/1,臺中市,清水區,25281,85640,44173,41467
2012/2/1,臺中市,沙鹿區,24819,83442,42431,41011
2012/2/1,臺中市,梧棲區,16241,55552,28164,27388
2012/2/1,臺中市,后里區,14999,54047,27732,26315
2012/2/1,臺中市,神岡區,17944,64000,32920,31080
2012/2/1,臺中市,潭子區,33160,102057,50727,51330
2012/2/1,臺中市,大雅區,26774,90653,45570,45083
2012/2/1,臺中市,新社區,7380,25455,13296,12159
2012/2/1,臺中市,石岡區,4860,15776,8200,7576
2012/2/1,臺中市,外埔區,8980,31931,16409,15522
2012/2/1,臺中市,大安區,5323,20041,10519,9522
2012/2/1,臺中市,烏日區,21073,69377,35135,34242
2012/2/1,臺中市,大肚區,16086,55716,28584,27132
2012/2/1,臺中市,龍井區,21065,74663,37893,36770
2012/2/1,臺中市,霧峰區,18948,63949,32795,31154
2012/2/1,臺中市,太平區,55722,174551,87454,87097
2012/2/1,臺中市,大里區,63344,201019,99623,101396
2012/2/1,臺中市,和平區,4408,10628,5746,4882
2012/2/1,臺南市,新營區,27580,78521,39097,39424
2012/2/1,臺南市,鹽水區,10002,26869,13970,12899
2012/2/1,臺南市,白河區,10972,30891,16181,14710
2012/2/1,臺南市,柳營區,7802,22352,11701,10651
2012/2/1,臺南市,後壁區,8849,25465,13236,12229
2012/2/1,臺南市,東山區,8240,22685,12048,10637
2012/2/1,臺南市,麻豆區,15187,45578,23252,22326
2012/2/1,臺南市,下營區,9107,25756,13302,12454
2012/2/1,臺南市,六甲區,7685,23454,12205,11249
2012/2/1,臺南市,官田區,7654,21950,11237,10713
2012/2/1,臺南市,大內區,4038,10655,5676,4979
2012/2/1,臺南市,佳里區,19603,59171,29385,29786
2012/2/1,臺南市,學甲區,9587,27559,14105,13454
2012/2/1,臺南市,西港區,7867,25032,12734,12298
2012/2/1,臺南市,七股區,8050,24615,12841,11774
2012/2/1,臺南市,將軍區,7404,21186,10791,10395
2012/2/1,臺南市,北門區,4388,12237,6231,6006
2012/2/1,臺南市,新化區,13823,43979,22521,21458
2012/2/1,臺南市,善化區,15008,44044,22237,21807
2012/2/1,臺南市,新市區,10990,35076,17631,17445
2012/2/1,臺南市,安定區,9465,30244,15650,14594
2012/2/1,臺南市,山上區,2730,7752,4083,3669
2012/2/1,臺南市,玉井區,5100,15205,7863,7342
2012/2/1,臺南市,楠西區,3550,10412,5525,4887
2012/2/1,臺南市,南化區,2813,8808,4812,3996
2012/2/1,臺南市,左鎮區,1981,5355,2978,2377
2012/2/1,臺南市,仁德區,25134,70379,36037,34342
2012/2/1,臺南市,歸仁區,20948,66206,33760,32446
2012/2/1,臺南市,關廟區,10747,35526,18447,17079
2012/2/1,臺南市,龍崎區,1589,4312,2329,1983
2012/2/1,臺南市,永康區,77214,221262,109803,111459
2012/2/1,臺南市,東區,71384,193751,93480,100271
2012/2/1,臺南市,南區,43817,126145,63188,62957
2012/2/1,臺南市,北區,48722,132119,64919,67200
2012/2/1,臺南市,安南區,56070,180357,91554,88803
2012/2/1,臺南市,安平區,23686,63695,30467,33228
2012/2/1,臺南市,中西區,30319,78794,38599,40195
2012/2/1,高雄市,鹽埕區,11079,26695,13359,13336
2012/2/1,高雄市,鼓山區,53226,132877,64927,67950
2012/2/1,高雄市,左營區,75000,193892,95040,98852
2012/2/1,高雄市,楠梓區,62778,174135,86241,87894
2012/2/1,高雄市,三民區,132655,351676,171743,179933
2012/2/1,高雄市,新興區,22789,54257,26258,27999
2012/2/1,高雄市,前金區,12485,28375,13801,14574
2012/2/1,高雄市,苓雅區,72016,181396,88108,93288
2012/2/1,高雄市,前鎮區,76932,197367,97890,99477
2012/2/1,高雄市,旗津區,11000,29705,15395,14310
2012/2/1,高雄市,小港區,64351,155004,77764,77240
2012/2/1,高雄市,鳳山區,129620,346130,171805,174325
2012/2/1,高雄市,林園區,24655,70467,36056,34411
2012/2/1,高雄市,大寮區,39017,109205,56588,52617
2012/2/1,高雄市,大樹區,13109,43582,22502,21080
2012/2/1,高雄市,大社區,11925,33384,17111,16273
2012/2/1,高雄市,仁武區,27331,75259,38763,36496
2012/2/1,高雄市,鳥松區,16931,43313,21950,21363
2012/2/1,高雄市,岡山區,33694,97463,48771,48692
2012/2/1,高雄市,橋頭區,12917,36835,18845,17990
2012/2/1,高雄市,燕巢區,10144,30881,16470,14411
2012/2/1,高雄市,田寮區,3511,7967,4427,3540
2012/2/1,高雄市,阿蓮區,9234,30194,15231,14963
2012/2/1,高雄市,路竹區,16187,53418,27270,26148
2012/2/1,高雄市,湖內區,9809,28836,14840,13996
2012/2/1,高雄市,茄萣區,10202,30914,16084,14830
2012/2/1,高雄市,永安區,5794,14048,7141,6907
2012/2/1,高雄市,彌陀區,6680,20226,10483,9743
2012/2/1,高雄市,梓官區,12167,36527,18967,17560
2012/2/1,高雄市,旗山區,13845,39420,20487,18933
2012/2/1,高雄市,美濃區,14321,42568,22253,20315
2012/2/1,高雄市,六龜區,5757,14361,7766,6595
2012/2/1,高雄市,甲仙區,2475,6886,3687,3199
2012/2/1,高雄市,杉林區,4638,12200,6654,5546
2012/2/1,高雄市,內門區,5047,15594,8502,7092
2012/2/1,高雄市,茂林區,577,1847,924,923
2012/2/1,高雄市,桃源區,1373,4688,2473,2215
2012/2/1,高雄市,那瑪夏區,880,3239,1678,1561
2012/2/1,宜蘭縣,宜蘭市,33665,95541,46880,48661
2012/2/1,宜蘭縣,羅東鎮,25244,72866,34902,37964
2012/2/1,宜蘭縣,蘇澳鎮,13680,42285,21673,20612
2012/2/1,宜蘭縣,頭城鎮,9823,30504,15746,14758
2012/2/1,宜蘭縣,礁溪鄉,12574,35880,18774,17106
2012/2/1,宜蘭縣,壯圍鄉,8191,24654,13022,11632
2012/2/1,宜蘭縣,員山鄉,10955,32242,17282,14960
2012/2/1,宜蘭縣,冬山鄉,17769,53001,27255,25746
2012/2/1,宜蘭縣,五結鄉,13253,38813,20149,18664
2012/2/1,宜蘭縣,三星鄉,7641,21156,11439,9717
2012/2/1,宜蘭縣,大同鄉,1834,5932,3233,2699
2012/2/1,宜蘭縣,南澳鄉,1843,5918,3146,2772
2012/2/1,桃園市,桃園區,147292,410576,200972,209604
2012/2/1,桃園市,中壢區,130292,372785,185774,187011
2012/2/1,桃園市,平鎮區,68125,208724,104967,103757
2012/2/1,桃園市,八德區,59282,177505,90052,87453
2012/2/1,桃園市,楊梅區,50212,152670,77560,75110
2012/2/1,桃園市,大溪區,29649,92012,47405,44607
2012/2/1,桃園市,蘆竹區,49538,144294,72268,72026
2012/2/1,桃園市,大園區,26479,82156,42605,39551
2012/2/1,桃園市,龜山區,50950,138387,69962,68425
2012/2/1,桃園市,龍潭區,37403,114954,58300,56654
2012/2/1,桃園市,新屋區,15066,48554,26022,22532
2012/2/1,桃園市,觀音區,19654,61748,32514,29234
2012/2/1,桃園市,復興區,3691,10647,5940,4707
2012/2/1,新竹縣,竹北市,49792,147487,73734,73753
2012/2/1,新竹縣,關西鎮,9347,31502,16783,14719
2012/2/1,新竹縣,新埔鎮,10469,35205,18672,16533
2012/2/1,新竹縣,竹東鎮,31147,96525,48627,47898
2012/2/1,新竹縣,湖口鄉,23851,75967,38727,37240
2012/2/1,新竹縣,橫山鄉,4462,14190,7659,6531
2012/2/1,新竹縣,新豐鄉,16141,53713,27603,26110
2012/2/1,新竹縣,芎林鄉,6335,20508,10804,9704
2012/2/1,新竹縣,寶山鄉,4830,14080,7611,6469
2012/2/1,新竹縣,北埔鄉,3110,9952,5414,4538
2012/2/1,新竹縣,峨眉鄉,2035,5887,3266,2621
2012/2/1,新竹縣,尖石鄉,2732,8759,4740,4019
2012/2/1,新竹縣,五峰鄉,1726,4596,2518,2078
2012/2/1,苗栗縣,苗栗市,29563,90916,45692,45224
2012/2/1,苗栗縣,苑裡鎮,14011,48520,25292,23228
2012/2/1,苗栗縣,通霄鎮,11430,37568,19848,17720
2012/2/1,苗栗縣,竹南鎮,24901,79855,40540,39315
2012/2/1,苗栗縣,頭份市,30558,98610,50002,48608
2012/2/1,苗栗縣,後龍鎮,11780,38872,20524,18348
2012/2/1,苗栗縣,卓蘭鎮,6007,18429,9710,8719
2012/2/1,苗栗縣,大湖鄉,5361,15883,8441,7442
2012/2/1,苗栗縣,公館鄉,10331,34848,18199,16649
2012/2/1,苗栗縣,銅鑼鄉,6023,19309,10244,9065
2012/2/1,苗栗縣,南庄鄉,3992,10961,6031,4930
2012/2/1,苗栗縣,頭屋鄉,3564,11509,6066,5443
2012/2/1,苗栗縣,三義鄉,5345,17451,9179,8272
2012/2/1,苗栗縣,西湖鄉,2693,7779,4318,3461
2012/2/1,苗栗縣,造橋鄉,4066,13733,7241,6492
2012/2/1,苗栗縣,三灣鄉,2398,7175,3912,3263
2012/2/1,苗栗縣,獅潭鄉,1702,4821,2706,2115
2012/2/1,苗栗縣,泰安鄉,1958,5951,3227,2724
2012/2/1,彰化縣,彰化市,72873,236547,117587,118960
2012/2/1,彰化縣,鹿港鎮,22745,85505,43783,41722
2012/2/1,彰化縣,和美鎮,24696,90195,46186,44009
2012/2/1,彰化縣,北斗鎮,10080,33363,16904,16459
2012/2/1,彰化縣,員林市,37164,125236,62915,62321
2012/2/1,彰化縣,溪湖鎮,15350,55921,28545,27376
2012/2/1,彰化縣,田中鎮,12613,43587,22630,20957
2012/2/1,彰化縣,二林鎮,14410,53459,27598,25861
2012/2/1,彰化縣,線西鄉,4162,17000,8771,8229
2012/2/1,彰化縣,伸港鄉,9135,35974,18442,17532
2012/2/1,彰化縣,福興鄉,12208,48567,25339,23228
2012/2/1,彰化縣,秀水鄉,9934,39279,20322,18957
2012/2/1,彰化縣,花壇鄉,13159,46088,23689,22399
2012/2/1,彰化縣,芬園鄉,6876,24601,13044,11557
2012/2/1,彰化縣,大村鄉,10387,36467,18993,17474
2012/2/1,彰化縣,埔鹽鄉,8880,33998,17806,16192
2012/2/1,彰化縣,埔心鄉,10068,35208,18146,17062
2012/2/1,彰化縣,永靖鄉,10504,38851,20186,18665
2012/2/1,彰化縣,社頭鄉,12399,44372,22766,21606
2012/2/1,彰化縣,二水鄉,5335,16295,8564,7731
2012/2/1,彰化縣,田尾鄉,7717,28306,14737,13569
2012/2/1,彰化縣,埤頭鄉,8700,31523,16427,15096
2012/2/1,彰化縣,芳苑鄉,10018,35638,18848,16790
2012/2/1,彰化縣,大城鄉,5398,18577,10100,8477
2012/2/1,彰化縣,竹塘鄉,4598,16325,8596,7729
2012/2/1,彰化縣,溪州鄉,8745,31311,16482,14829
2012/2/1,南投縣,南投市,33659,103662,52139,51523
2012/2/1,南投縣,埔里鎮,28491,84493,42593,41900
2012/2/1,南投縣,草屯鎮,31387,99195,50149,49046
2012/2/1,南投縣,竹山鎮,19406,57897,29834,28063
2012/2/1,南投縣,集集鎮,4311,11705,6116,5589
2012/2/1,南投縣,名間鄉,12234,40896,21474,19422
2012/2/1,南投縣,鹿谷鄉,6949,18922,10057,8865
2012/2/1,南投縣,中寮鄉,5645,15982,8684,7298
2012/2/1,南投縣,魚池鄉,5741,16892,8906,7986
2012/2/1,南投縣,國姓鄉,7215,20328,11049,9279
2012/2/1,南投縣,水里鄉,7230,19643,10301,9342
2012/2/1,南投縣,信義鄉,5266,17008,9207,7801
2012/2/1,南投縣,仁愛鄉,4928,15578,8116,7462
2012/2/1,雲林縣,斗六市,35436,107288,53849,53439
2012/2/1,雲林縣,斗南鎮,15385,46736,23772,22964
2012/2/1,雲林縣,虎尾鎮,22930,70149,35651,34498
2012/2/1,雲林縣,西螺鎮,14130,48118,24477,23641
2012/2/1,雲林縣,土庫鎮,8878,30184,15782,14402
2012/2/1,雲林縣,北港鎮,15516,42446,22068,20378
2012/2/1,雲林縣,古坑鄉,10704,33540,17725,15815
2012/2/1,雲林縣,大埤鄉,6677,20823,11187,9636
2012/2/1,雲林縣,莿桐鄉,9111,30189,15850,14339
2012/2/1,雲林縣,林內鄉,5799,19524,10181,9343
2012/2/1,雲林縣,二崙鄉,8744,29259,15679,13580
2012/2/1,雲林縣,崙背鄉,8374,26845,14160,12685
2012/2/1,雲林縣,麥寮鄉,12965,39494,20410,19084
2012/2/1,雲林縣,東勢鄉,5754,16276,8889,7387
2012/2/1,雲林縣,褒忠鄉,4318,13968,7465,6503
2012/2/1,雲林縣,臺西鄉,8881,25543,13730,11813
2012/2/1,雲林縣,元長鄉,9363,28304,15449,12855
2012/2/1,雲林縣,四湖鄉,9055,26243,14287,11956
2012/2/1,雲林縣,口湖鄉,9599,29843,15907,13936
2012/2/1,雲林縣,水林鄉,10348,28217,15450,12767
2012/2/1,嘉義縣,太保市,11569,36627,18875,17752
2012/2/1,嘉義縣,朴子市,14880,43914,22343,21571
2012/2/1,嘉義縣,布袋鎮,10161,29612,15177,14435
2012/2/1,嘉義縣,大林鎮,11283,33142,17009,16133
2012/2/1,嘉義縣,民雄鄉,23211,72457,37179,35278
2012/2/1,嘉義縣,溪口鄉,5389,15963,8518,7445
2012/2/1,嘉義縣,新港鄉,10443,34188,18048,16140
2012/2/1,嘉義縣,六腳鄉,9141,25769,13667,12102
2012/2/1,嘉義縣,東石鄉,9500,27098,14399,12699
2012/2/1,嘉義縣,義竹鄉,7476,20571,10687,9884
2012/2/1,嘉義縣,鹿草鄉,5796,16957,9114,7843
2012/2/1,嘉義縣,水上鄉,17469,51748,26691,25057
2012/2/1,嘉義縣,中埔鄉,15574,47232,24638,22594
2012/2/1,嘉義縣,竹崎鄉,11440,38133,20308,17825
2012/2/1,嘉義縣,梅山鄉,6685,21095,11168,9927
2012/2/1,嘉義縣,番路鄉,4072,11842,6446,5396
2012/2/1,嘉義縣,大埔鄉,1931,4561,2405,2156
2012/2/1,嘉義縣,阿里山鄉,2066,6163,3286,2877
2012/2/1,屏東縣,屏東市,72454,209281,104196,105085
2012/2/1,屏東縣,潮州鎮,18414,55284,27763,27521
2012/2/1,屏東縣,東港鎮,15868,49583,25079,24504
2012/2/1,屏東縣,恆春鎮,10915,30823,15788,15035
2012/2/1,屏東縣,萬丹鄉,14429,53470,27687,25783
2012/2/1,屏東縣,長治鄉,9801,30672,16030,14642
2012/2/1,屏東縣,麟洛鄉,3611,11361,5884,5477
2012/2/1,屏東縣,九如鄉,6615,22649,11765,10884
2012/2/1,屏東縣,里港鄉,7936,25955,13270,12685
2012/2/1,屏東縣,鹽埔鄉,7765,26949,14015,12934
2012/2/1,屏東縣,高樹鄉,9427,26236,13995,12241
2012/2/1,屏東縣,萬巒鄉,6424,21614,11380,10234
2012/2/1,屏東縣,內埔鄉,17988,57410,29818,27592
2012/2/1,屏東縣,竹田鄉,5597,18151,9622,8529
2012/2/1,屏東縣,新埤鄉,3366,10498,5583,4915
2012/2/1,屏東縣,枋寮鄉,8507,26153,13743,12410
2012/2/1,屏東縣,新園鄉,11611,37691,19490,18201
2012/2/1,屏東縣,崁頂鄉,4301,16969,8648,8321
2012/2/1,屏東縣,林邊鄉,7126,20221,10423,9798
2012/2/1,屏東縣,南州鄉,3677,11484,5879,5605
2012/2/1,屏東縣,佳冬鄉,7131,20988,10945,10043
2012/2/1,屏東縣,琉球鄉,4033,12132,6749,5383
2012/2/1,屏東縣,車城鄉,3505,9391,5076,4315
2012/2/1,屏東縣,滿州鄉,3044,8293,4572,3721
2012/2/1,屏東縣,枋山鄉,2099,5901,3171,2730
2012/2/1,屏東縣,三地門鄉,2220,7533,3843,3690
2012/2/1,屏東縣,霧臺鄉,992,2963,1560,1403
2012/2/1,屏東縣,瑪家鄉,1932,6557,3400,3157
2012/2/1,屏東縣,泰武鄉,1236,5097,2665,2432
2012/2/1,屏東縣,來義鄉,2198,7693,3945,3748
2012/2/1,屏東縣,春日鄉,1325,4844,2511,2333
2012/2/1,屏東縣,獅子鄉,1469,4806,2540,2266
2012/2/1,屏東縣,牡丹鄉,1879,4888,2542,2346
2012/2/1,臺東縣,臺東市,38236,108170,54756,53414
2012/2/1,臺東縣,成功鎮,5417,15507,8212,7295
2012/2/1,臺東縣,關山鎮,3234,9560,5022,4538
2012/2/1,臺東縣,卑南鄉,6622,18022,9696,8326
2012/2/1,臺東縣,大武鄉,2518,6774,3542,3232
2012/2/1,臺東縣,太麻里鄉,4541,11796,6287,5509
2012/2/1,臺東縣,東河鄉,3644,9202,5136,4066
2012/2/1,臺東縣,長濱鄉,2925,8014,4570,3444
2012/2/1,臺東縣,鹿野鄉,3129,8400,4526,3874
2012/2/1,臺東縣,池上鄉,3259,8958,4732,4226
2012/2/1,臺東縣,綠島鄉,1040,3400,1808,1592
2012/2/1,臺東縣,延平鄉,1063,3556,1947,1609
2012/2/1,臺東縣,海端鄉,1099,4410,2399,2011
2012/2/1,臺東縣,達仁鄉,1502,3940,2148,1792
2012/2/1,臺東縣,金峰鄉,1059,3524,1840,1684
2012/2/1,臺東縣,蘭嶼鄉,1557,4701,2419,2282
2012/2/1,花蓮縣,花蓮市,40799,108672,53146,55526
2012/2/1,花蓮縣,鳳林鎮,4422,11691,6180,5511
2012/2/1,花蓮縣,玉里鎮,8884,26398,14270,12128
2012/2/1,花蓮縣,新城鄉,7359,20149,10452,9697
2012/2/1,花蓮縣,吉安鄉,29591,80577,41075,39502
2012/2/1,花蓮縣,壽豐鄉,6859,18497,9982,8515
2012/2/1,花蓮縣,光復鄉,5036,13827,7389,6438
2012/2/1,花蓮縣,豐濱鄉,1787,4821,2689,2132
2012/2/1,花蓮縣,瑞穗鄉,4644,12521,6763,5758
2012/2/1,花蓮縣,富里鄉,4001,11361,6180,5181
2012/2/1,花蓮縣,秀林鄉,4680,15138,7863,7275
2012/2/1,花蓮縣,萬榮鄉,2125,6742,3597,3145
2012/2/1,花蓮縣,卓溪鄉,1663,6227,3455,2772
2012/2/1,澎湖縣,馬公市,21082,57613,29190,28423
2012/2/1,澎湖縣,湖西鄉,4868,13691,7155,6536
2012/2/1,澎湖縣,白沙鄉,3177,9417,4947,4470
2012/2/1,澎湖縣,西嶼鄉,2870,8351,4298,4053
2012/2/1,澎湖縣,望安鄉,1899,4639,2495,2144
2012/2/1,澎湖縣,七美鄉,1270,3557,1862,1695
2012/2/1,基隆市,中正區,22137,54338,27833,26505
2012/2/1,基隆市,七堵區,20278,54604,27659,26945
2012/2/1,基隆市,暖暖區,14590,37896,19218,18678
2012/2/1,基隆市,仁愛區,19764,48605,23972,24633
2012/2/1,基隆市,中山區,19204,50209,25627,24582
2012/2/1,基隆市,安樂區,31765,82731,41236,41495
2012/2/1,基隆市,信義區,20248,51033,25511,25522
2012/2/1,新竹市,東區,70575,200486,98945,101541
2012/2/1,新竹市,北區,51664,146243,72024,74219
2012/2/1,新竹市,香山區,23673,73859,37669,36190
2012/2/1,嘉義市,東區,44369,124473,60755,63718
2012/2/1,嘉義市,西區,51736,147076,72679,74397
2012/2/1,金門縣,金城鎮,11482,34781,17559,17222
2012/2/1,金門縣,金湖鎮,7625,23119,11748,11371
2012/2/1,金門縣,金沙鎮,5581,16503,8311,8192
2012/2/1,金門縣,金寧鄉,6468,20747,10645,10102
2012/2/1,金門縣,烈嶼鄉,2757,9715,4812,4903
2012/2/1,金門縣,烏坵鄉,134,569,284,285
2012/2/1,連江縣,南竿鄉,1266,6015,3434,2581
2012/2/1,連江縣,北竿鄉,408,1864,1050,814
2012/2/1,連江縣,莒光鄉,246,1165,700,465
2012/2/1,連江縣,東引鄉,279,1091,646,445
2012/3/1,總計,新北市,1437026,3920761,1940522,1980239
2012/3/1,總計,臺北市,1002545,2656512,1278723,1377789
2012/3/1,總計,臺中市,871092,2668799,1326578,1342221
2012/3/1,總計,臺南市,649966,1877778,943967,933811
2012/3/1,總計,高雄市,1037078,2774586,1387840,1386746
2012/3/1,總計,臺灣省,3047332,9224343,4710855,4513488
2012/3/1,總計,宜蘭縣,156685,458611,233442,225169
2012/3/1,總計,桃園市,688896,2015933,1014692,1001241
2012/3/1,總計,新竹縣,166438,518831,266375,252456
2012/3/1,總計,苗栗縣,175896,562259,291164,271095
2012/3/1,總計,彰化縣,368464,1301506,667019,634487
2012/3/1,總計,南投縣,172674,521902,268467,253435
2012/3/1,總計,雲林縣,232295,712747,371785,340962
2012/3/1,總計,嘉義縣,178219,536373,279616,256757
2012/3/1,總計,屏東縣,279184,862946,443253,419693
2012/3/1,總計,臺東縣,80911,227772,118930,108842
2012/3/1,總計,花蓮縣,121980,336485,172936,163549
2012/3/1,總計,澎湖縣,35284,97452,50060,47392
2012/3/1,總計,基隆市,148007,379021,190875,188146
2012/3/1,總計,新竹市,146232,421041,208860,212181
2012/3/1,總計,嘉義市,96167,271464,133381,138083
2012/3/1,總計,福建省,36394,116489,59636,56853
2012/3/1,總計,金門縣,34193,106358,53813,52545
2012/3/1,總計,連江縣,2201,10131,5823,4308
2012/3/1,新北市,板橋區,199038,556033,274003,282030
2012/3/1,新北市,三重區,142807,390242,193923,196319
2012/3/1,新北市,中和區,157866,414975,204301,210674
2012/3/1,新北市,永和區,90196,232428,111329,121099
2012/3/1,新北市,新莊區,139792,404625,199423,205202
2012/3/1,新北市,新店區,118145,296513,144577,151936
2012/3/1,新北市,樹林區,62460,180331,90585,89746
2012/3/1,新北市,鶯歌區,28073,87710,44190,43520
2012/3/1,新北市,三峽區,37177,106150,53952,52198
2012/3/1,新北市,淡水區,60312,147557,71523,76034
2012/3/1,新北市,汐止區,80530,191073,94532,96541
2012/3/1,新北市,瑞芳區,15931,41859,21297,20562
2012/3/1,新北市,土城區,83646,239410,119409,120001
2012/3/1,新北市,蘆洲區,66663,198617,98125,100492
2012/3/1,新北市,五股區,27878,80682,40810,39872
2012/3/1,新北市,泰山區,26608,77164,38677,38487
2012/3/1,新北市,林口區,32802,87341,43012,44329
2012/3/1,新北市,深坑區,9098,23506,11829,11677
2012/3/1,新北市,石碇區,3351,7890,4375,3515
2012/3/1,新北市,坪林區,2463,6508,3625,2883
2012/3/1,新北市,三芝區,8970,23294,12026,11268
2012/3/1,新北市,石門區,4174,12795,6701,6094
2012/3/1,新北市,八里區,12653,35272,17826,17446
2012/3/1,新北市,平溪區,2393,5173,2875,2298
2012/3/1,新北市,雙溪區,3811,9522,5140,4382
2012/3/1,新北市,貢寮區,4446,13516,6970,6546
2012/3/1,新北市,金山區,6822,22430,11197,11233
2012/3/1,新北市,萬里區,7174,22229,11308,10921
2012/3/1,新北市,烏來區,1747,5916,2982,2934
2012/3/1,臺北市,松山區,78891,210487,99712,110775
2012/3/1,臺北市,信義區,86983,226916,109101,117815
2012/3/1,臺北市,大安區,118068,313801,147429,166372
2012/3/1,臺北市,中山區,94291,224544,105397,119147
2012/3/1,臺北市,中正區,63259,161610,77873,83737
2012/3/1,臺北市,大同區,48832,127436,62648,64788
2012/3/1,臺北市,萬華區,75423,191134,94956,96178
2012/3/1,臺北市,文山區,99424,267325,129259,138066
2012/3/1,臺北市,南港區,43166,116680,57275,59405
2012/3/1,臺北市,內湖區,100017,276525,133061,143464
2012/3/1,臺北市,士林區,102703,287380,139476,147904
2012/3/1,臺北市,北投區,91488,252674,122536,130138
2012/3/1,臺中市,中區,8171,21413,10619,10794
2012/3/1,臺中市,東區,26185,73936,37206,36730
2012/3/1,臺中市,南區,43228,115237,55795,59442
2012/3/1,臺中市,西區,43910,117262,56160,61102
2012/3/1,臺中市,北區,56663,147673,71346,76327
2012/3/1,臺中市,西屯區,75512,210461,101689,108772
2012/3/1,臺中市,南屯區,54815,156368,75484,80884
2012/3/1,臺中市,北屯區,86072,250414,121335,129079
2012/3/1,臺中市,豐原區,50568,165802,82213,83589
2012/3/1,臺中市,東勢區,17069,52652,27316,25336
2012/3/1,臺中市,大甲區,21906,78147,39630,38517
2012/3/1,臺中市,清水區,25280,85662,44171,41491
2012/3/1,臺中市,沙鹿區,24868,83598,42507,41091
2012/3/1,臺中市,梧棲區,16257,55611,28175,27436
2012/3/1,臺中市,后里區,15017,54063,27735,26328
2012/3/1,臺中市,神岡區,17956,64015,32921,31094
2012/3/1,臺中市,潭子區,33217,102184,50802,51382
2012/3/1,臺中市,大雅區,26798,90714,45601,45113
2012/3/1,臺中市,新社區,7384,25431,13285,12146
2012/3/1,臺中市,石岡區,4869,15764,8195,7569
2012/3/1,臺中市,外埔區,8993,31922,16413,15509
2012/3/1,臺中市,大安區,5323,20010,10506,9504
2012/3/1,臺中市,烏日區,21124,69413,35154,34259
2012/3/1,臺中市,大肚區,16115,55749,28592,27157
2012/3/1,臺中市,龍井區,21078,74654,37878,36776
2012/3/1,臺中市,霧峰區,18934,63936,32776,31160
2012/3/1,臺中市,太平區,55849,174755,87549,87206
2012/3/1,臺中市,大里區,63518,201331,99785,101546
2012/3/1,臺中市,和平區,4413,10622,5740,4882
2012/3/1,臺南市,新營區,27623,78601,39152,39449
2012/3/1,臺南市,鹽水區,10007,26839,13956,12883
2012/3/1,臺南市,白河區,10986,30857,16154,14703
2012/3/1,臺南市,柳營區,7805,22329,11676,10653
2012/3/1,臺南市,後壁區,8849,25402,13201,12201
2012/3/1,臺南市,東山區,8256,22663,12036,10627
2012/3/1,臺南市,麻豆區,15183,45554,23238,22316
2012/3/1,臺南市,下營區,9107,25741,13294,12447
2012/3/1,臺南市,六甲區,7692,23452,12191,11261
2012/3/1,臺南市,官田區,7652,21897,11217,10680
2012/3/1,臺南市,大內區,4035,10634,5669,4965
2012/3/1,臺南市,佳里區,19614,59166,29378,29788
2012/3/1,臺南市,學甲區,9592,27509,14076,13433
2012/3/1,臺南市,西港區,7874,24999,12717,12282
2012/3/1,臺南市,七股區,8045,24606,12830,11776
2012/3/1,臺南市,將軍區,7417,21173,10787,10386
2012/3/1,臺南市,北門區,4399,12223,6225,5998
2012/3/1,臺南市,新化區,13837,43962,22524,21438
2012/3/1,臺南市,善化區,15037,44110,22254,21856
2012/3/1,臺南市,新市區,11015,35102,17645,17457
2012/3/1,臺南市,安定區,9476,30247,15647,14600
2012/3/1,臺南市,山上區,2728,7743,4076,3667
2012/3/1,臺南市,玉井區,5097,15176,7852,7324
2012/3/1,臺南市,楠西區,3549,10395,5514,4881
2012/3/1,臺南市,南化區,2817,8803,4804,3999
2012/3/1,臺南市,左鎮區,1985,5340,2972,2368
2012/3/1,臺南市,仁德區,25192,70455,36059,34396
2012/3/1,臺南市,歸仁區,20994,66260,33779,32481
2012/3/1,臺南市,關廟區,10746,35502,18421,17081
2012/3/1,臺南市,龍崎區,1589,4298,2323,1975
2012/3/1,臺南市,永康區,77367,221613,109981,111632
2012/3/1,臺南市,東區,71426,193771,93473,100298
2012/3/1,臺南市,南區,43878,126159,63199,62960
2012/3/1,臺南市,北區,48807,132120,64909,67211
2012/3/1,臺南市,安南區,56178,180508,91625,88883
2012/3/1,臺南市,安平區,23754,63812,30536,33276
2012/3/1,臺南市,中西區,30358,78757,38577,40180
2012/3/1,高雄市,鹽埕區,11064,26651,13327,13324
2012/3/1,高雄市,鼓山區,53250,132923,64923,68000
2012/3/1,高雄市,左營區,75023,193773,94983,98790
2012/3/1,高雄市,楠梓區,62872,174306,86254,88052
2012/3/1,高雄市,三民區,132730,351463,171598,179865
2012/3/1,高雄市,新興區,22802,54254,26257,27997
2012/3/1,高雄市,前金區,12490,28370,13810,14560
2012/3/1,高雄市,苓雅區,72012,181191,88021,93170
2012/3/1,高雄市,前鎮區,76949,197171,97750,99421
2012/3/1,高雄市,旗津區,10988,29656,15389,14267
2012/3/1,高雄市,小港區,64384,154933,77678,77255
2012/3/1,高雄市,鳳山區,129930,346646,171989,174657
2012/3/1,高雄市,林園區,24685,70480,36063,34417
2012/3/1,高雄市,大寮區,39062,109119,56543,52576
2012/3/1,高雄市,大樹區,13119,43572,22497,21075
2012/3/1,高雄市,大社區,11934,33416,17133,16283
2012/3/1,高雄市,仁武區,27450,75457,38872,36585
2012/3/1,高雄市,鳥松區,16933,43330,21967,21363
2012/3/1,高雄市,岡山區,33733,97434,48742,48692
2012/3/1,高雄市,橋頭區,12918,36821,18829,17992
2012/3/1,高雄市,燕巢區,10155,30881,16453,14428
2012/3/1,高雄市,田寮區,3508,7956,4424,3532
2012/3/1,高雄市,阿蓮區,9236,30170,15223,14947
2012/3/1,高雄市,路竹區,16200,53418,27277,26141
2012/3/1,高雄市,湖內區,9843,28866,14847,14019
2012/3/1,高雄市,茄萣區,10199,30851,16053,14798
2012/3/1,高雄市,永安區,5793,14061,7146,6915
2012/3/1,高雄市,彌陀區,6679,20235,10488,9747
2012/3/1,高雄市,梓官區,12188,36541,18982,17559
2012/3/1,高雄市,旗山區,13859,39376,20460,18916
2012/3/1,高雄市,美濃區,14322,42508,22214,20294
2012/3/1,高雄市,六龜區,5751,14315,7743,6572
2012/3/1,高雄市,甲仙區,2466,6839,3656,3183
2012/3/1,高雄市,杉林區,4669,12255,6685,5570
2012/3/1,高雄市,內門區,5052,15592,8503,7089
2012/3/1,高雄市,茂林區,578,1840,921,919
2012/3/1,高雄市,桃源區,1370,4677,2465,2212
2012/3/1,高雄市,那瑪夏區,882,3239,1675,1564
2012/3/1,宜蘭縣,宜蘭市,33679,95466,46845,48621
2012/3/1,宜蘭縣,羅東鎮,25276,72825,34884,37941
2012/3/1,宜蘭縣,蘇澳鎮,13678,42229,21641,20588
2012/3/1,宜蘭縣,頭城鎮,9842,30457,15728,14729
2012/3/1,宜蘭縣,礁溪鄉,12605,35923,18788,17135
2012/3/1,宜蘭縣,壯圍鄉,8209,24630,13034,11596
2012/3/1,宜蘭縣,員山鄉,10980,32242,17284,14958
2012/3/1,宜蘭縣,冬山鄉,17817,53037,27279,25758
2012/3/1,宜蘭縣,五結鄉,13265,38823,20151,18672
2012/3/1,宜蘭縣,三星鄉,7644,21146,11431,9715
2012/3/1,宜蘭縣,大同鄉,1840,5913,3222,2691
2012/3/1,宜蘭縣,南澳鄉,1850,5920,3155,2765
2012/3/1,桃園市,桃園區,147627,410904,201130,209774
2012/3/1,桃園市,中壢區,130525,372894,185860,187034
2012/3/1,桃園市,平鎮區,68201,208661,104930,103731
2012/3/1,桃園市,八德區,59389,177571,90072,87499
2012/3/1,桃園市,楊梅區,50313,152807,77625,75182
2012/3/1,桃園市,大溪區,29669,91940,47369,44571
2012/3/1,桃園市,蘆竹區,49674,144566,72404,72162
2012/3/1,桃園市,大園區,26536,82191,42581,39610
2012/3/1,桃園市,龜山區,51056,138480,69958,68522
2012/3/1,桃園市,龍潭區,37445,114983,58293,56690
2012/3/1,桃園市,新屋區,15083,48497,25995,22502
2012/3/1,桃園市,觀音區,19689,61821,32554,29267
2012/3/1,桃園市,復興區,3689,10618,5921,4697
2012/3/1,新竹縣,竹北市,50042,148006,73941,74065
2012/3/1,新竹縣,關西鎮,9359,31460,16758,14702
2012/3/1,新竹縣,新埔鎮,10480,35161,18678,16483
2012/3/1,新竹縣,竹東鎮,31188,96547,48625,47922
2012/3/1,新竹縣,湖口鄉,23915,76043,38767,37276
2012/3/1,新竹縣,橫山鄉,4471,14158,7651,6507
2012/3/1,新竹縣,新豐鄉,16180,53745,27622,26123
2012/3/1,新竹縣,芎林鄉,6336,20480,10794,9686
2012/3/1,新竹縣,寶山鄉,4845,14070,7603,6467
2012/3/1,新竹縣,北埔鄉,3112,9930,5411,4519
2012/3/1,新竹縣,峨眉鄉,2041,5878,3263,2615
2012/3/1,新竹縣,尖石鄉,2744,8755,4741,4014
2012/3/1,新竹縣,五峰鄉,1725,4598,2521,2077
2012/3/1,苗栗縣,苗栗市,29605,90868,45666,45202
2012/3/1,苗栗縣,苑裡鎮,14011,48490,25269,23221
2012/3/1,苗栗縣,通霄鎮,11433,37572,19853,17719
2012/3/1,苗栗縣,竹南鎮,24962,79926,40570,39356
2012/3/1,苗栗縣,頭份市,30620,98750,50074,48676
2012/3/1,苗栗縣,後龍鎮,11768,38828,20495,18333
2012/3/1,苗栗縣,卓蘭鎮,6020,18414,9700,8714
2012/3/1,苗栗縣,大湖鄉,5365,15900,8444,7456
2012/3/1,苗栗縣,公館鄉,10349,34881,18216,16665
2012/3/1,苗栗縣,銅鑼鄉,6036,19314,10238,9076
2012/3/1,苗栗縣,南庄鄉,3987,10938,6012,4926
2012/3/1,苗栗縣,頭屋鄉,3565,11504,6061,5443
2012/3/1,苗栗縣,三義鄉,5351,17474,9186,8288
2012/3/1,苗栗縣,西湖鄉,2692,7765,4312,3453
2012/3/1,苗栗縣,造橋鄉,4063,13698,7224,6474
2012/3/1,苗栗縣,三灣鄉,2402,7185,3918,3267
2012/3/1,苗栗縣,獅潭鄉,1705,4807,2704,2103
2012/3/1,苗栗縣,泰安鄉,1962,5945,3222,2723
2012/3/1,彰化縣,彰化市,72936,236480,117556,118924
2012/3/1,彰化縣,鹿港鎮,22774,85561,43789,41772
2012/3/1,彰化縣,和美鎮,24715,90170,46165,44005
2012/3/1,彰化縣,北斗鎮,10082,33339,16893,16446
2012/3/1,彰化縣,員林市,37205,125243,62888,62355
2012/3/1,彰化縣,溪湖鎮,15367,55977,28564,27413
2012/3/1,彰化縣,田中鎮,12637,43547,22615,20932
2012/3/1,彰化縣,二林鎮,14428,53450,27586,25864
2012/3/1,彰化縣,線西鄉,4162,16977,8765,8212
2012/3/1,彰化縣,伸港鄉,9140,35986,18451,17535
2012/3/1,彰化縣,福興鄉,12212,48483,25291,23192
2012/3/1,彰化縣,秀水鄉,9947,39290,20341,18949
2012/3/1,彰化縣,花壇鄉,13177,46040,23669,22371
2012/3/1,彰化縣,芬園鄉,6875,24557,13010,11547
2012/3/1,彰化縣,大村鄉,10391,36406,18963,17443
2012/3/1,彰化縣,埔鹽鄉,8876,33952,17782,16170
2012/3/1,彰化縣,埔心鄉,10070,35176,18132,17044
2012/3/1,彰化縣,永靖鄉,10508,38809,20159,18650
2012/3/1,彰化縣,社頭鄉,12409,44312,22761,21551
2012/3/1,彰化縣,二水鄉,5343,16294,8562,7732
2012/3/1,彰化縣,田尾鄉,7728,28275,14720,13555
2012/3/1,彰化縣,埤頭鄉,8713,31509,16422,15087
2012/3/1,彰化縣,芳苑鄉,10016,35581,18822,16759
2012/3/1,彰化縣,大城鄉,5396,18510,10058,8452
2012/3/1,彰化縣,竹塘鄉,4608,16321,8601,7720
2012/3/1,彰化縣,溪州鄉,8749,31261,16454,14807
2012/3/1,南投縣,南投市,33694,103671,52118,51553
2012/3/1,南投縣,埔里鎮,28528,84485,42573,41912
2012/3/1,南投縣,草屯鎮,31420,99157,50153,49004
2012/3/1,南投縣,竹山鎮,19430,57881,29828,28053
2012/3/1,南投縣,集集鎮,4308,11674,6089,5585
2012/3/1,南投縣,名間鄉,12259,40858,21462,19396
2012/3/1,南投縣,鹿谷鄉,6983,18905,10048,8857
2012/3/1,南投縣,中寮鄉,5652,15950,8672,7278
2012/3/1,南投縣,魚池鄉,5750,16853,8889,7964
2012/3/1,南投縣,國姓鄉,7230,20305,11042,9263
2012/3/1,南投縣,水里鄉,7231,19594,10285,9309
2012/3/1,南投縣,信義鄉,5266,16988,9191,7797
2012/3/1,南投縣,仁愛鄉,4923,15581,8117,7464
2012/3/1,雲林縣,斗六市,35505,107344,53863,53481
2012/3/1,雲林縣,斗南鎮,15393,46657,23725,22932
2012/3/1,雲林縣,虎尾鎮,22969,70174,35676,34498
2012/3/1,雲林縣,西螺鎮,14129,48062,24426,23636
2012/3/1,雲林縣,土庫鎮,8888,30142,15753,14389
2012/3/1,雲林縣,北港鎮,15621,42759,22209,20550
2012/3/1,雲林縣,古坑鄉,10720,33527,17715,15812
2012/3/1,雲林縣,大埤鄉,6680,20791,11182,9609
2012/3/1,雲林縣,莿桐鄉,9123,30167,15835,14332
2012/3/1,雲林縣,林內鄉,5798,19472,10162,9310
2012/3/1,雲林縣,二崙鄉,8749,29224,15660,13564
2012/3/1,雲林縣,崙背鄉,8390,26819,14150,12669
2012/3/1,雲林縣,麥寮鄉,13007,39642,20481,19161
2012/3/1,雲林縣,東勢鄉,5756,16251,8880,7371
2012/3/1,雲林縣,褒忠鄉,4327,13945,7451,6494
2012/3/1,雲林縣,臺西鄉,8876,25497,13708,11789
2012/3/1,雲林縣,元長鄉,9359,28213,15402,12811
2012/3/1,雲林縣,四湖鄉,9054,26208,14256,11952
2012/3/1,雲林縣,口湖鄉,9607,29751,15858,13893
2012/3/1,雲林縣,水林鄉,10344,28102,15393,12709
2012/3/1,嘉義縣,太保市,11592,36610,18871,17739
2012/3/1,嘉義縣,朴子市,14884,43887,22313,21574
2012/3/1,嘉義縣,布袋鎮,10168,29566,15160,14406
2012/3/1,嘉義縣,大林鎮,11284,33081,16985,16096
2012/3/1,嘉義縣,民雄鄉,23245,72480,37196,35284
2012/3/1,嘉義縣,溪口鄉,5399,15929,8499,7430
2012/3/1,嘉義縣,新港鄉,10438,34168,18032,16136
2012/3/1,嘉義縣,六腳鄉,9135,25632,13601,12031
2012/3/1,嘉義縣,東石鄉,9495,27041,14371,12670
2012/3/1,嘉義縣,義竹鄉,7485,20531,10670,9861
2012/3/1,嘉義縣,鹿草鄉,5803,16936,9100,7836
2012/3/1,嘉義縣,水上鄉,17472,51665,26671,24994
2012/3/1,嘉義縣,中埔鄉,15597,47169,24590,22579
2012/3/1,嘉義縣,竹崎鄉,11448,38083,20283,17800
2012/3/1,嘉義縣,梅山鄉,6700,21057,11155,9902
2012/3/1,嘉義縣,番路鄉,4078,11834,6441,5393
2012/3/1,嘉義縣,大埔鄉,1929,4550,2399,2151
2012/3/1,嘉義縣,阿里山鄉,2067,6154,3279,2875
2012/3/1,屏東縣,屏東市,72550,209179,104153,105026
2012/3/1,屏東縣,潮州鎮,18441,55267,27741,27526
2012/3/1,屏東縣,東港鎮,15901,49566,25074,24492
2012/3/1,屏東縣,恆春鎮,10928,30784,15773,15011
2012/3/1,屏東縣,萬丹鄉,14443,53437,27660,25777
2012/3/1,屏東縣,長治鄉,9796,30621,16002,14619
2012/3/1,屏東縣,麟洛鄉,3615,11352,5877,5475
2012/3/1,屏東縣,九如鄉,6627,22622,11748,10874
2012/3/1,屏東縣,里港鄉,7944,25990,13276,12714
2012/3/1,屏東縣,鹽埔鄉,7761,26899,13993,12906
2012/3/1,屏東縣,高樹鄉,9432,26224,13987,12237
2012/3/1,屏東縣,萬巒鄉,6418,21564,11364,10200
2012/3/1,屏東縣,內埔鄉,18007,57360,29777,27583
2012/3/1,屏東縣,竹田鄉,5611,18147,9623,8524
2012/3/1,屏東縣,新埤鄉,3372,10472,5566,4906
2012/3/1,屏東縣,枋寮鄉,8509,26119,13726,12393
2012/3/1,屏東縣,新園鄉,11625,37651,19473,18178
2012/3/1,屏東縣,崁頂鄉,4309,16924,8629,8295
2012/3/1,屏東縣,林邊鄉,7120,20174,10399,9775
2012/3/1,屏東縣,南州鄉,3685,11463,5868,5595
2012/3/1,屏東縣,佳冬鄉,7133,20963,10939,10024
2012/3/1,屏東縣,琉球鄉,4032,12122,6744,5378
2012/3/1,屏東縣,車城鄉,3506,9371,5065,4306
2012/3/1,屏東縣,滿州鄉,3052,8374,4608,3766
2012/3/1,屏東縣,枋山鄉,2109,5908,3177,2731
2012/3/1,屏東縣,三地門鄉,2221,7529,3840,3689
2012/3/1,屏東縣,霧臺鄉,993,2983,1569,1414
2012/3/1,屏東縣,瑪家鄉,1935,6569,3405,3164
2012/3/1,屏東縣,泰武鄉,1235,5102,2664,2438
2012/3/1,屏東縣,來義鄉,2203,7692,3942,3750
2012/3/1,屏東縣,春日鄉,1322,4844,2516,2328
2012/3/1,屏東縣,獅子鄉,1469,4786,2532,2254
2012/3/1,屏東縣,牡丹鄉,1880,4888,2543,2345
2012/3/1,臺東縣,臺東市,38273,108164,54741,53423
2012/3/1,臺東縣,成功鎮,5418,15482,8200,7282
2012/3/1,臺東縣,關山鎮,3232,9548,5021,4527
2012/3/1,臺東縣,卑南鄉,6627,18009,9696,8313
2012/3/1,臺東縣,大武鄉,2509,6732,3516,3216
2012/3/1,臺東縣,太麻里鄉,4548,11781,6279,5502
2012/3/1,臺東縣,東河鄉,3650,9201,5132,4069
2012/3/1,臺東縣,長濱鄉,2921,7999,4566,3433
2012/3/1,臺東縣,鹿野鄉,3133,8386,4510,3876
2012/3/1,臺東縣,池上鄉,3268,8937,4714,4223
2012/3/1,臺東縣,綠島鄉,1042,3406,1815,1591
2012/3/1,臺東縣,延平鄉,1064,3548,1941,1607
2012/3/1,臺東縣,海端鄉,1097,4399,2393,2006
2012/3/1,臺東縣,達仁鄉,1503,3932,2139,1793
2012/3/1,臺東縣,金峰鄉,1061,3534,1845,1689
2012/3/1,臺東縣,蘭嶼鄉,1565,4714,2422,2292
2012/3/1,花蓮縣,花蓮市,40850,108658,53130,55528
2012/3/1,花蓮縣,鳳林鎮,4419,11658,6161,5497
2012/3/1,花蓮縣,玉里鎮,8884,26347,14234,12113
2012/3/1,花蓮縣,新城鄉,7359,20138,10433,9705
2012/3/1,花蓮縣,吉安鄉,29674,80720,41144,39576
2012/3/1,花蓮縣,壽豐鄉,6861,18462,9953,8509
2012/3/1,花蓮縣,光復鄉,5035,13783,7360,6423
2012/3/1,花蓮縣,豐濱鄉,1787,4803,2676,2127
2012/3/1,花蓮縣,瑞穗鄉,4647,12500,6759,5741
2012/3/1,花蓮縣,富里鄉,4000,11354,6185,5169
2012/3/1,花蓮縣,秀林鄉,4680,15121,7853,7268
2012/3/1,花蓮縣,萬榮鄉,2120,6722,3592,3130
2012/3/1,花蓮縣,卓溪鄉,1664,6219,3456,2763
2012/3/1,澎湖縣,馬公市,21155,57716,29246,28470
2012/3/1,澎湖縣,湖西鄉,4893,13752,7199,6553
2012/3/1,澎湖縣,白沙鄉,3179,9423,4949,4474
2012/3/1,澎湖縣,西嶼鄉,2875,8347,4299,4048
2012/3/1,澎湖縣,望安鄉,1903,4651,2502,2149
2012/3/1,澎湖縣,七美鄉,1279,3563,1865,1698
2012/3/1,基隆市,中正區,22161,54283,27811,26472
2012/3/1,基隆市,七堵區,20281,54542,27619,26923
2012/3/1,基隆市,暖暖區,14583,37854,19204,18650
2012/3/1,基隆市,仁愛區,19783,48628,23981,24647
2012/3/1,基隆市,中山區,19199,50114,25599,24515
2012/3/1,基隆市,安樂區,31741,82626,41176,41450
2012/3/1,基隆市,信義區,20259,50974,25485,25489
2012/3/1,新竹市,東區,70773,200742,99084,101658
2012/3/1,新竹市,北區,51738,146420,72107,74313
2012/3/1,新竹市,香山區,23721,73879,37669,36210
2012/3/1,嘉義市,東區,44382,124488,60762,63726
2012/3/1,嘉義市,西區,51785,146976,72619,74357
2012/3/1,金門縣,金城鎮,11534,35083,17693,17390
2012/3/1,金門縣,金湖鎮,7657,23292,11857,11435
2012/3/1,金門縣,金沙鎮,5607,16639,8367,8272
2012/3/1,金門縣,金寧鄉,6497,20958,10748,10210
2012/3/1,金門縣,烈嶼鄉,2764,9815,4863,4952
2012/3/1,金門縣,烏坵鄉,134,571,285,286
2012/3/1,連江縣,南竿鄉,1264,6015,3427,2588
2012/3/1,連江縣,北竿鄉,411,1864,1048,816
2012/3/1,連江縣,莒光鄉,247,1170,705,465
2012/3/1,連江縣,東引鄉,279,1082,643,439
2012/4/1,總計,新北市,1439068,3921580,1940717,1980863
2012/4/1,總計,臺北市,1004142,2658685,1279554,1379131
2012/4/1,總計,臺中市,872214,2670395,1327186,1343209
2012/4/1,總計,臺南市,650546,1878077,943996,934081
2012/4/1,總計,高雄市,1038014,2774649,1387633,1387016
2012/4/1,總計,臺灣省,3050931,9224309,4710498,4513811
2012/4/1,總計,宜蘭縣,156858,458479,233351,225128
2012/4/1,總計,桃園市,690047,2017262,1015285,1001977
2012/4/1,總計,新竹縣,166770,519181,266575,252606
2012/4/1,總計,苗栗縣,176150,562372,291189,271183
2012/4/1,總計,彰化縣,368784,1301053,666768,634285
2012/4/1,總計,南投縣,172876,521804,268407,253397
2012/4/1,總計,雲林縣,232579,712529,371637,340892
2012/4/1,總計,嘉義縣,178336,535845,279340,256505
2012/4/1,總計,屏東縣,279325,862363,442976,419387
2012/4/1,總計,臺東縣,80935,227578,118783,108795
2012/4/1,總計,花蓮縣,122070,336318,172832,163486
2012/4/1,總計,澎湖縣,35347,97612,50133,47479
2012/4/1,總計,基隆市,148068,378886,190778,188108
2012/4/1,總計,新竹市,146487,421432,209023,212409
2012/4/1,總計,嘉義市,96299,271595,133421,138174
2012/4/1,總計,福建省,36522,117323,60026,57297
2012/4/1,總計,金門縣,34314,107198,54208,52990
2012/4/1,總計,連江縣,2208,10125,5818,4307
2012/4/1,新北市,板橋區,199418,556069,273995,282074
2012/4/1,新北市,三重區,142903,390003,193795,196208
2012/4/1,新北市,中和區,157985,414848,204237,210611
2012/4/1,新北市,永和區,90278,232418,111324,121094
2012/4/1,新北市,新莊區,140059,404922,199538,205384
2012/4/1,新北市,新店區,118264,296519,144595,151924
2012/4/1,新北市,樹林區,62587,180468,90634,89834
2012/4/1,新北市,鶯歌區,28120,87760,44188,43572
2012/4/1,新北市,三峽區,37265,106292,54018,52274
2012/4/1,新北市,淡水區,60450,147709,71574,76135
2012/4/1,新北市,汐止區,80647,191202,94610,96592
2012/4/1,新北市,瑞芳區,15920,41787,21259,20528
2012/4/1,新北市,土城區,83775,239476,119370,120106
2012/4/1,新北市,蘆洲區,66744,198694,98165,100529
2012/4/1,新北市,五股區,27923,80727,40844,39883
2012/4/1,新北市,泰山區,26661,77220,38696,38524
2012/4/1,新北市,林口區,32925,87591,43128,44463
2012/4/1,新北市,深坑區,9109,23507,11826,11681
2012/4/1,新北市,石碇區,3350,7872,4363,3509
2012/4/1,新北市,坪林區,2463,6484,3615,2869
2012/4/1,新北市,三芝區,8984,23308,12036,11272
2012/4/1,新北市,石門區,4184,12782,6701,6081
2012/4/1,新北市,八里區,12654,35234,17782,17452
2012/4/1,新北市,平溪區,2393,5172,2876,2296
2012/4/1,新北市,雙溪區,3812,9482,5127,4355
2012/4/1,新北市,貢寮區,4452,13493,6961,6532
2012/4/1,新北市,金山區,6824,22429,11197,11232
2012/4/1,新北市,萬里區,7175,22218,11293,10925
2012/4/1,新北市,烏來區,1744,5894,2970,2924
2012/4/1,臺北市,松山區,79005,210616,99765,110851
2012/4/1,臺北市,信義區,87147,227135,109198,117937
2012/4/1,臺北市,大安區,118134,313893,147457,166436
2012/4/1,臺北市,中山區,94461,224818,105479,119339
2012/4/1,臺北市,中正區,63365,161757,77899,83858
2012/4/1,臺北市,大同區,48985,127717,62761,64956
2012/4/1,臺北市,萬華區,75552,191319,95022,96297
2012/4/1,臺北市,文山區,99589,267607,129398,138209
2012/4/1,臺北市,南港區,43249,116742,57283,59459
2012/4/1,臺北市,內湖區,100246,276795,133187,143608
2012/4/1,臺北市,士林區,102870,287601,139559,148042
2012/4/1,臺北市,北投區,91539,252685,122546,130139
2012/4/1,臺中市,中區,8172,21331,10581,10750
2012/4/1,臺中市,東區,26226,73985,37211,36774
2012/4/1,臺中市,南區,43281,115368,55857,59511
2012/4/1,臺中市,西區,43946,117265,56139,61126
2012/4/1,臺中市,北區,56709,147628,71321,76307
2012/4/1,臺中市,西屯區,75625,210715,101800,108915
2012/4/1,臺中市,南屯區,54944,156608,75598,81010
2012/4/1,臺中市,北屯區,86216,250661,121412,129249
2012/4/1,臺中市,豐原區,50655,165909,82242,83667
2012/4/1,臺中市,東勢區,17068,52651,27310,25341
2012/4/1,臺中市,大甲區,21929,78158,39638,38520
2012/4/1,臺中市,清水區,25275,85676,44180,41496
2012/4/1,臺中市,沙鹿區,24921,83732,42574,41158
2012/4/1,臺中市,梧棲區,16265,55653,28171,27482
2012/4/1,臺中市,后里區,15033,54042,27711,26331
2012/4/1,臺中市,神岡區,17989,64068,32951,31117
2012/4/1,臺中市,潭子區,33250,102229,50834,51395
2012/4/1,臺中市,大雅區,26838,90802,45646,45156
2012/4/1,臺中市,新社區,7374,25411,13274,12137
2012/4/1,臺中市,石岡區,4874,15769,8196,7573
2012/4/1,臺中市,外埔區,9001,31885,16397,15488
2012/4/1,臺中市,大安區,5322,19994,10501,9493
2012/4/1,臺中市,烏日區,21165,69464,35180,34284
2012/4/1,臺中市,大肚區,16125,55748,28589,27159
2012/4/1,臺中市,龍井區,21103,74657,37875,36782
2012/4/1,臺中市,霧峰區,18942,63940,32775,31165
2012/4/1,臺中市,太平區,55917,174899,87654,87245
2012/4/1,臺中市,大里區,63639,201540,99840,101700
2012/4/1,臺中市,和平區,4410,10607,5729,4878
2012/4/1,臺南市,新營區,27642,78668,39154,39514
2012/4/1,臺南市,鹽水區,10013,26803,13941,12862
2012/4/1,臺南市,白河區,10989,30820,16129,14691
2012/4/1,臺南市,柳營區,7808,22299,11666,10633
2012/4/1,臺南市,後壁區,8860,25399,13208,12191
2012/4/1,臺南市,東山區,8267,22637,12011,10626
2012/4/1,臺南市,麻豆區,15189,45516,23221,22295
2012/4/1,臺南市,下營區,9103,25714,13277,12437
2012/4/1,臺南市,六甲區,7688,23428,12171,11257
2012/4/1,臺南市,官田區,7659,21891,11209,10682
2012/4/1,臺南市,大內區,4034,10627,5661,4966
2012/4/1,臺南市,佳里區,19601,59168,29385,29783
2012/4/1,臺南市,學甲區,9599,27491,14073,13418
2012/4/1,臺南市,西港區,7877,24999,12719,12280
2012/4/1,臺南市,七股區,8034,24555,12811,11744
2012/4/1,臺南市,將軍區,7425,21164,10772,10392
2012/4/1,臺南市,北門區,4397,12198,6210,5988
2012/4/1,臺南市,新化區,13844,43965,22521,21444
2012/4/1,臺南市,善化區,15049,44130,22276,21854
2012/4/1,臺南市,新市區,11021,35134,17662,17472
2012/4/1,臺南市,安定區,9487,30244,15638,14606
2012/4/1,臺南市,山上區,2727,7727,4060,3667
2012/4/1,臺南市,玉井區,5100,15174,7853,7321
2012/4/1,臺南市,楠西區,3553,10372,5498,4874
2012/4/1,臺南市,南化區,2821,8782,4800,3982
2012/4/1,臺南市,左鎮區,1985,5325,2966,2359
2012/4/1,臺南市,仁德區,25247,70540,36123,34417
2012/4/1,臺南市,歸仁區,21030,66293,33796,32497
2012/4/1,臺南市,關廟區,10749,35487,18403,17084
2012/4/1,臺南市,龍崎區,1589,4305,2329,1976
2012/4/1,臺南市,永康區,77500,221933,110129,111804
2012/4/1,臺南市,東區,71510,193715,93407,100308
2012/4/1,臺南市,南區,43905,126125,63161,62964
2012/4/1,臺南市,北區,48833,132104,64874,67230
2012/4/1,臺南市,安南區,56283,180732,91753,88979
2012/4/1,臺南市,安平區,23756,63859,30570,33289
2012/4/1,臺南市,中西區,30372,78754,38559,40195
2012/4/1,高雄市,鹽埕區,11061,26606,13289,13317
2012/4/1,高雄市,鼓山區,53317,133038,64956,68082
2012/4/1,高雄市,左營區,75139,193941,95045,98896
2012/4/1,高雄市,楠梓區,62935,174380,86295,88085
2012/4/1,高雄市,三民區,132753,351214,171459,179755
2012/4/1,高雄市,新興區,22813,54264,26263,28001
2012/4/1,高雄市,前金區,12485,28339,13800,14539
2012/4/1,高雄市,苓雅區,72007,180979,87925,93054
2012/4/1,高雄市,前鎮區,76986,197001,97697,99304
2012/4/1,高雄市,旗津區,10979,29599,15362,14237
2012/4/1,高雄市,小港區,64428,154923,77646,77277
2012/4/1,高雄市,鳳山區,130159,346916,172045,174871
2012/4/1,高雄市,林園區,24706,70469,36060,34409
2012/4/1,高雄市,大寮區,39127,109176,56559,52617
2012/4/1,高雄市,大樹區,13121,43542,22466,21076
2012/4/1,高雄市,大社區,11955,33472,17157,16315
2012/4/1,高雄市,仁武區,27537,75727,38973,36754
2012/4/1,高雄市,鳥松區,16968,43339,21965,21374
2012/4/1,高雄市,岡山區,33761,97460,48752,48708
2012/4/1,高雄市,橋頭區,12930,36786,18809,17977
2012/4/1,高雄市,燕巢區,10147,30884,16440,14444
2012/4/1,高雄市,田寮區,3505,7951,4421,3530
2012/4/1,高雄市,阿蓮區,9244,30146,15214,14932
2012/4/1,高雄市,路竹區,16214,53359,27248,26111
2012/4/1,高雄市,湖內區,9868,28876,14846,14030
2012/4/1,高雄市,茄萣區,10218,30880,16058,14822
2012/4/1,高雄市,永安區,5797,14074,7148,6926
2012/4/1,高雄市,彌陀區,6677,20221,10477,9744
2012/4/1,高雄市,梓官區,12203,36536,18984,17552
2012/4/1,高雄市,旗山區,13866,39368,20455,18913
2012/4/1,高雄市,美濃區,14326,42467,22185,20282
2012/4/1,高雄市,六龜區,5746,14297,7740,6557
2012/4/1,高雄市,甲仙區,2454,6791,3624,3167
2012/4/1,高雄市,杉林區,4697,12305,6716,5589
2012/4/1,高雄市,內門區,5052,15584,8500,7084
2012/4/1,高雄市,茂林區,580,1843,923,920
2012/4/1,高雄市,桃源區,1371,4664,2461,2203
2012/4/1,高雄市,那瑪夏區,882,3232,1670,1562
2012/4/1,宜蘭縣,宜蘭市,33737,95498,46823,48675
2012/4/1,宜蘭縣,羅東鎮,25287,72819,34890,37929
2012/4/1,宜蘭縣,蘇澳鎮,13688,42195,21628,20567
2012/4/1,宜蘭縣,頭城鎮,9848,30423,15717,14706
2012/4/1,宜蘭縣,礁溪鄉,12639,35906,18781,17125
2012/4/1,宜蘭縣,壯圍鄉,8215,24598,13040,11558
2012/4/1,宜蘭縣,員山鄉,10981,32225,17275,14950
2012/4/1,宜蘭縣,冬山鄉,17842,53035,27264,25771
2012/4/1,宜蘭縣,五結鄉,13280,38813,20142,18671
2012/4/1,宜蘭縣,三星鄉,7651,21148,11432,9716
2012/4/1,宜蘭縣,大同鄉,1841,5907,3209,2698
2012/4/1,宜蘭縣,南澳鄉,1849,5912,3150,2762
2012/4/1,桃園市,桃園區,147901,411143,201221,209922
2012/4/1,桃園市,中壢區,130759,373151,186024,187127
2012/4/1,桃園市,平鎮區,68283,208734,104982,103752
2012/4/1,桃園市,八德區,59486,177673,90128,87545
2012/4/1,桃園市,楊梅區,50397,153005,77725,75280
2012/4/1,桃園市,大溪區,29713,91942,47365,44577
2012/4/1,桃園市,蘆竹區,49807,144765,72485,72280
2012/4/1,桃園市,大園區,26591,82333,42631,39702
2012/4/1,桃園市,龜山區,51137,138494,69970,68524
2012/4/1,桃園市,龍潭區,37469,115001,58267,56734
2012/4/1,桃園市,新屋區,15090,48482,25983,22499
2012/4/1,桃園市,觀音區,19725,61935,32584,29351
2012/4/1,桃園市,復興區,3689,10604,5920,4684
2012/4/1,新竹縣,竹北市,50219,148365,74144,74221
2012/4/1,新竹縣,關西鎮,9357,31427,16736,14691
2012/4/1,新竹縣,新埔鎮,10489,35148,18665,16483
2012/4/1,新竹縣,竹東鎮,31262,96605,48643,47962
2012/4/1,新竹縣,湖口鄉,23975,76094,38784,37310
2012/4/1,新竹縣,橫山鄉,4465,14135,7644,6491
2012/4/1,新竹縣,新豐鄉,16193,53800,27650,26150
2012/4/1,新竹縣,芎林鄉,6340,20456,10793,9663
2012/4/1,新竹縣,寶山鄉,4852,14057,7619,6438
2012/4/1,新竹縣,北埔鄉,3109,9910,5390,4520
2012/4/1,新竹縣,峨眉鄉,2038,5869,3257,2612
2012/4/1,新竹縣,尖石鄉,2746,8729,4732,3997
2012/4/1,新竹縣,五峰鄉,1725,4586,2518,2068
2012/4/1,苗栗縣,苗栗市,29677,90899,45663,45236
2012/4/1,苗栗縣,苑裡鎮,14018,48481,25259,23222
2012/4/1,苗栗縣,通霄鎮,11452,37568,19855,17713
2012/4/1,苗栗縣,竹南鎮,24998,79997,40620,39377
2012/4/1,苗栗縣,頭份市,30680,98855,50120,48735
2012/4/1,苗栗縣,後龍鎮,11779,38854,20500,18354
2012/4/1,苗栗縣,卓蘭鎮,6024,18396,9691,8705
2012/4/1,苗栗縣,大湖鄉,5374,15893,8446,7447
2012/4/1,苗栗縣,公館鄉,10367,34932,18246,16686
2012/4/1,苗栗縣,銅鑼鄉,6039,19274,10213,9061
2012/4/1,苗栗縣,南庄鄉,3989,10923,5999,4924
2012/4/1,苗栗縣,頭屋鄉,3564,11479,6049,5430
2012/4/1,苗栗縣,三義鄉,5352,17465,9187,8278
2012/4/1,苗栗縣,西湖鄉,2692,7753,4302,3451
2012/4/1,苗栗縣,造橋鄉,4073,13691,7215,6476
2012/4/1,苗栗縣,三灣鄉,2400,7180,3914,3266
2012/4/1,苗栗縣,獅潭鄉,1705,4791,2692,2099
2012/4/1,苗栗縣,泰安鄉,1967,5941,3218,2723
2012/4/1,彰化縣,彰化市,73039,236485,117546,118939
2012/4/1,彰化縣,鹿港鎮,22821,85589,43790,41799
2012/4/1,彰化縣,和美鎮,24739,90188,46181,44007
2012/4/1,彰化縣,北斗鎮,10086,33351,16888,16463
2012/4/1,彰化縣,員林市,37219,125248,62884,62364
2012/4/1,彰化縣,溪湖鎮,15379,55976,28559,27417
2012/4/1,彰化縣,田中鎮,12652,43492,22601,20891
2012/4/1,彰化縣,二林鎮,14429,53409,27556,25853
2012/4/1,彰化縣,線西鄉,4163,16975,8765,8210
2012/4/1,彰化縣,伸港鄉,9139,35929,18426,17503
2012/4/1,彰化縣,福興鄉,12228,48458,25285,23173
2012/4/1,彰化縣,秀水鄉,9948,39311,20364,18947
2012/4/1,彰化縣,花壇鄉,13181,46019,23648,22371
2012/4/1,彰化縣,芬園鄉,6883,24528,12990,11538
2012/4/1,彰化縣,大村鄉,10400,36343,18934,17409
2012/4/1,彰化縣,埔鹽鄉,8878,33918,17769,16149
2012/4/1,彰化縣,埔心鄉,10076,35178,18124,17054
2012/4/1,彰化縣,永靖鄉,10513,38739,20130,18609
2012/4/1,彰化縣,社頭鄉,12439,44306,22759,21547
2012/4/1,彰化縣,二水鄉,5339,16269,8549,7720
2012/4/1,彰化縣,田尾鄉,7729,28265,14711,13554
2012/4/1,彰化縣,埤頭鄉,8719,31487,16416,15071
2012/4/1,彰化縣,芳苑鄉,10016,35551,18804,16747
2012/4/1,彰化縣,大城鄉,5394,18485,10045,8440
2012/4/1,彰化縣,竹塘鄉,4620,16335,8604,7731
2012/4/1,彰化縣,溪州鄉,8755,31219,16440,14779
2012/4/1,南投縣,南投市,33726,103698,52115,51583
2012/4/1,南投縣,埔里鎮,28579,84542,42613,41929
2012/4/1,南投縣,草屯鎮,31473,99195,50177,49018
2012/4/1,南投縣,竹山鎮,19462,57822,29809,28013
2012/4/1,南投縣,集集鎮,4311,11654,6080,5574
2012/4/1,南投縣,名間鄉,12279,40840,21449,19391
2012/4/1,南投縣,鹿谷鄉,7007,18903,10049,8854
2012/4/1,南投縣,中寮鄉,5648,15921,8649,7272
2012/4/1,南投縣,魚池鄉,5750,16823,8874,7949
2012/4/1,南投縣,國姓鄉,7223,20282,11028,9254
2012/4/1,南投縣,水里鄉,7233,19579,10272,9307
2012/4/1,南投縣,信義鄉,5261,16975,9190,7785
2012/4/1,南投縣,仁愛鄉,4924,15570,8102,7468
2012/4/1,雲林縣,斗六市,35550,107401,53879,53522
2012/4/1,雲林縣,斗南鎮,15420,46657,23717,22940
2012/4/1,雲林縣,虎尾鎮,23003,70181,35680,34501
2012/4/1,雲林縣,西螺鎮,14147,48071,24433,23638
2012/4/1,雲林縣,土庫鎮,8896,30134,15753,14381
2012/4/1,雲林縣,北港鎮,15654,42701,22203,20498
2012/4/1,雲林縣,古坑鄉,10729,33455,17663,15792
2012/4/1,雲林縣,大埤鄉,6684,20730,11155,9575
2012/4/1,雲林縣,莿桐鄉,9135,30122,15817,14305
2012/4/1,雲林縣,林內鄉,5808,19498,10176,9322
2012/4/1,雲林縣,二崙鄉,8762,29190,15641,13549
2012/4/1,雲林縣,崙背鄉,8402,26814,14152,12662
2012/4/1,雲林縣,麥寮鄉,13044,39784,20523,19261
2012/4/1,雲林縣,東勢鄉,5761,16248,8872,7376
2012/4/1,雲林縣,褒忠鄉,4331,13968,7466,6502
2012/4/1,雲林縣,臺西鄉,8873,25474,13692,11782
2012/4/1,雲林縣,元長鄉,9359,28163,15366,12797
2012/4/1,雲林縣,四湖鄉,9059,26152,14225,11927
2012/4/1,雲林縣,口湖鄉,9617,29735,15864,13871
2012/4/1,雲林縣,水林鄉,10345,28051,15360,12691
2012/4/1,嘉義縣,太保市,11609,36600,18863,17737
2012/4/1,嘉義縣,朴子市,14905,43900,22307,21593
2012/4/1,嘉義縣,布袋鎮,10174,29495,15128,14367
2012/4/1,嘉義縣,大林鎮,11285,33033,16953,16080
2012/4/1,嘉義縣,民雄鄉,23266,72411,37161,35250
2012/4/1,嘉義縣,溪口鄉,5409,15929,8499,7430
2012/4/1,嘉義縣,新港鄉,10459,34193,18050,16143
2012/4/1,嘉義縣,六腳鄉,9135,25600,13581,12019
2012/4/1,嘉義縣,東石鄉,9485,26947,14321,12626
2012/4/1,嘉義縣,義竹鄉,7484,20475,10650,9825
2012/4/1,嘉義縣,鹿草鄉,5802,16924,9093,7831
2012/4/1,嘉義縣,水上鄉,17482,51606,26644,24962
2012/4/1,嘉義縣,中埔鄉,15610,47126,24574,22552
2012/4/1,嘉義縣,竹崎鄉,11448,38048,20252,17796
2012/4/1,嘉義縣,梅山鄉,6710,21042,11151,9891
2012/4/1,嘉義縣,番路鄉,4079,11806,6429,5377
2012/4/1,嘉義縣,大埔鄉,1925,4550,2397,2153
2012/4/1,嘉義縣,阿里山鄉,2069,6160,3287,2873
2012/4/1,屏東縣,屏東市,72589,209080,104081,104999
2012/4/1,屏東縣,潮州鎮,18458,55311,27779,27532
2012/4/1,屏東縣,東港鎮,15905,49528,25049,24479
2012/4/1,屏東縣,恆春鎮,10951,30783,15784,14999
2012/4/1,屏東縣,萬丹鄉,14455,53385,27627,25758
2012/4/1,屏東縣,長治鄉,9795,30606,16001,14605
2012/4/1,屏東縣,麟洛鄉,3619,11363,5884,5479
2012/4/1,屏東縣,九如鄉,6631,22601,11741,10860
2012/4/1,屏東縣,里港鄉,7953,26029,13299,12730
2012/4/1,屏東縣,鹽埔鄉,7764,26887,13985,12902
2012/4/1,屏東縣,高樹鄉,9433,26184,13970,12214
2012/4/1,屏東縣,萬巒鄉,6423,21552,11362,10190
2012/4/1,屏東縣,內埔鄉,18012,57316,29758,27558
2012/4/1,屏東縣,竹田鄉,5612,18120,9614,8506
2012/4/1,屏東縣,新埤鄉,3380,10473,5570,4903
2012/4/1,屏東縣,枋寮鄉,8514,26096,13712,12384
2012/4/1,屏東縣,新園鄉,11627,37601,19447,18154
2012/4/1,屏東縣,崁頂鄉,4310,16871,8602,8269
2012/4/1,屏東縣,林邊鄉,7124,20145,10371,9774
2012/4/1,屏東縣,南州鄉,3680,11446,5853,5593
2012/4/1,屏東縣,佳冬鄉,7132,20950,10937,10013
2012/4/1,屏東縣,琉球鄉,4030,12125,6756,5369
2012/4/1,屏東縣,車城鄉,3501,9354,5057,4297
2012/4/1,屏東縣,滿州鄉,3054,8356,4599,3757
2012/4/1,屏東縣,枋山鄉,2106,5896,3175,2721
2012/4/1,屏東縣,三地門鄉,2222,7511,3833,3678
2012/4/1,屏東縣,霧臺鄉,994,2991,1570,1421
2012/4/1,屏東縣,瑪家鄉,1934,6562,3401,3161
2012/4/1,屏東縣,泰武鄉,1233,5074,2655,2419
2012/4/1,屏東縣,來義鄉,2207,7673,3930,3743
2012/4/1,屏東縣,春日鄉,1324,4844,2515,2329
2012/4/1,屏東縣,獅子鄉,1468,4769,2521,2248
2012/4/1,屏東縣,牡丹鄉,1885,4881,2538,2343
2012/4/1,臺東縣,臺東市,38285,108103,54679,53424
2012/4/1,臺東縣,成功鎮,5415,15468,8192,7276
2012/4/1,臺東縣,關山鎮,3239,9541,5013,4528
2012/4/1,臺東縣,卑南鄉,6626,17952,9665,8287
2012/4/1,臺東縣,大武鄉,2513,6729,3512,3217
2012/4/1,臺東縣,太麻里鄉,4546,11770,6272,5498
2012/4/1,臺東縣,東河鄉,3656,9191,5116,4075
2012/4/1,臺東縣,長濱鄉,2916,7978,4561,3417
2012/4/1,臺東縣,鹿野鄉,3133,8386,4518,3868
2012/4/1,臺東縣,池上鄉,3271,8940,4712,4228
2012/4/1,臺東縣,綠島鄉,1041,3417,1818,1599
2012/4/1,臺東縣,延平鄉,1062,3542,1946,1596
2012/4/1,臺東縣,海端鄉,1099,4380,2380,2000
2012/4/1,臺東縣,達仁鄉,1502,3930,2132,1798
2012/4/1,臺東縣,金峰鄉,1056,3523,1840,1683
2012/4/1,臺東縣,蘭嶼鄉,1575,4728,2427,2301
2012/4/1,花蓮縣,花蓮市,40856,108623,53102,55521
2012/4/1,花蓮縣,鳳林鎮,4420,11635,6145,5490
2012/4/1,花蓮縣,玉里鎮,8895,26313,14219,12094
2012/4/1,花蓮縣,新城鄉,7365,20119,10423,9696
2012/4/1,花蓮縣,吉安鄉,29731,80797,41188,39609
2012/4/1,花蓮縣,壽豐鄉,6863,18423,9939,8484
2012/4/1,花蓮縣,光復鄉,5034,13778,7358,6420
2012/4/1,花蓮縣,豐濱鄉,1783,4784,2662,2122
2012/4/1,花蓮縣,瑞穗鄉,4647,12503,6764,5739
2012/4/1,花蓮縣,富里鄉,4007,11316,6162,5154
2012/4/1,花蓮縣,秀林鄉,4686,15113,7839,7274
2012/4/1,花蓮縣,萬榮鄉,2118,6696,3578,3118
2012/4/1,花蓮縣,卓溪鄉,1665,6218,3453,2765
2012/4/1,澎湖縣,馬公市,21190,57831,29301,28530
2012/4/1,澎湖縣,湖西鄉,4909,13774,7207,6567
2012/4/1,澎湖縣,白沙鄉,3186,9437,4958,4479
2012/4/1,澎湖縣,西嶼鄉,2877,8352,4299,4053
2012/4/1,澎湖縣,望安鄉,1904,4652,2500,2152
2012/4/1,澎湖縣,七美鄉,1281,3566,1868,1698
2012/4/1,基隆市,中正區,22176,54274,27804,26470
2012/4/1,基隆市,七堵區,20292,54509,27604,26905
2012/4/1,基隆市,暖暖區,14590,37878,19215,18663
2012/4/1,基隆市,仁愛區,19779,48569,23962,24607
2012/4/1,基隆市,中山區,19212,50060,25550,24510
2012/4/1,基隆市,安樂區,31749,82610,41160,41450
2012/4/1,基隆市,信義區,20270,50986,25483,25503
2012/4/1,新竹市,東區,70929,201149,99238,101911
2012/4/1,新竹市,北區,51812,146446,72142,74304
2012/4/1,新竹市,香山區,23746,73837,37643,36194
2012/4/1,嘉義市,東區,44451,124598,60778,63820
2012/4/1,嘉義市,西區,51848,146997,72643,74354
2012/4/1,金門縣,金城鎮,11581,35391,17832,17559
2012/4/1,金門縣,金湖鎮,7689,23460,11937,11523
2012/4/1,金門縣,金沙鎮,5635,16762,8416,8346
2012/4/1,金門縣,金寧鄉,6499,21146,10853,10293
2012/4/1,金門縣,烈嶼鄉,2776,9867,4884,4983
2012/4/1,金門縣,烏坵鄉,134,572,286,286
2012/4/1,連江縣,南竿鄉,1265,6014,3426,2588
2012/4/1,連江縣,北竿鄉,414,1864,1050,814
2012/4/1,連江縣,莒光鄉,247,1164,699,465
2012/4/1,連江縣,東引鄉,282,1083,643,440
2012/5/1,總計,新北市,1441803,3923969,1941386,1982583
2012/5/1,總計,臺北市,1006200,2661017,1280457,1380560
2012/5/1,總計,臺中市,873922,2672390,1327944,1344446
2012/5/1,總計,臺南市,651160,1878314,944012,934302
2012/5/1,總計,高雄市,1039050,2774730,1387515,1387215
2012/5/1,總計,臺灣省,3055224,9224154,4709832,4514322
2012/5/1,總計,宜蘭縣,157101,458511,233340,225171
2012/5/1,總計,桃園市,691336,2018663,1015808,1002855
2012/5/1,總計,新竹縣,167241,519704,266807,252897
2012/5/1,總計,苗栗縣,176455,562507,291211,271296
2012/5/1,總計,彰化縣,369140,1300589,666506,634083
2012/5/1,總計,南投縣,173039,521452,268157,253295
2012/5/1,總計,雲林縣,232859,712102,371322,340780
2012/5/1,總計,嘉義縣,178524,535353,279110,256243
2012/5/1,總計,屏東縣,279486,861928,442742,419186
2012/5/1,總計,臺東縣,80971,227400,118632,108768
2012/5/1,總計,花蓮縣,122126,336076,172704,163372
2012/5/1,總計,澎湖縣,35396,97639,50140,47499
2012/5/1,總計,基隆市,148178,378522,190616,187906
2012/5/1,總計,新竹市,146911,422013,209283,212730
2012/5/1,總計,嘉義市,96461,271695,133454,138241
2012/5/1,總計,福建省,36632,117818,60238,57580
2012/5/1,總計,金門縣,34421,107646,54402,53244
2012/5/1,總計,連江縣,2211,10172,5836,4336
2012/5/1,新北市,板橋區,199969,556580,274190,282390
2012/5/1,新北市,三重區,143003,389849,193651,196198
2012/5/1,新北市,中和區,158327,415202,204300,210902
2012/5/1,新北市,永和區,90332,232172,111165,121007
2012/5/1,新北市,新莊區,140419,405257,199658,205599
2012/5/1,新北市,新店區,118380,296560,144563,151997
2012/5/1,新北市,樹林區,62743,180691,90727,89964
2012/5/1,新北市,鶯歌區,28200,87890,44254,43636
2012/5/1,新北市,三峽區,37395,106524,54104,52420
2012/5/1,新北市,淡水區,60672,148049,71727,76322
2012/5/1,新北市,汐止區,80755,191340,94670,96670
2012/5/1,新北市,瑞芳區,15918,41773,21259,20514
2012/5/1,新北市,土城區,83871,239493,119325,120168
2012/5/1,新北市,蘆洲區,66863,198838,98229,100609
2012/5/1,新北市,五股區,27966,80852,40895,39957
2012/5/1,新北市,泰山區,26719,77277,38729,38548
2012/5/1,新北市,林口區,33090,87890,43273,44617
2012/5/1,新北市,深坑區,9124,23505,11826,11679
2012/5/1,新北市,石碇區,3348,7868,4346,3522
2012/5/1,新北市,坪林區,2468,6482,3624,2858
2012/5/1,新北市,三芝區,8981,23316,12036,11280
2012/5/1,新北市,石門區,4193,12768,6692,6076
2012/5/1,新北市,八里區,12655,35216,17784,17432
2012/5/1,新北市,平溪區,2390,5153,2868,2285
2012/5/1,新北市,雙溪區,3808,9474,5122,4352
2012/5/1,新北市,貢寮區,4455,13454,6929,6525
2012/5/1,新北市,金山區,6831,22406,11189,11217
2012/5/1,新北市,萬里區,7184,22203,11287,10916
2012/5/1,新北市,烏來區,1744,5887,2964,2923
2012/5/1,臺北市,松山區,79138,210773,99820,110953
2012/5/1,臺北市,信義區,87314,227223,109268,117955
2012/5/1,臺北市,大安區,118328,313949,147426,166523
2012/5/1,臺北市,中山區,94697,225100,105609,119491
2012/5/1,臺北市,中正區,63399,161633,77838,83795
2012/5/1,臺北市,大同區,49089,127852,62768,65084
2012/5/1,臺北市,萬華區,75680,191415,95083,96332
2012/5/1,臺北市,文山區,99745,267842,129495,138347
2012/5/1,臺北市,南港區,43359,116870,57291,59579
2012/5/1,臺北市,內湖區,100680,277644,133574,144070
2012/5/1,臺北市,士林區,103042,287848,139663,148185
2012/5/1,臺北市,北投區,91729,252868,122622,130246
2012/5/1,臺中市,中區,8179,21268,10557,10711
2012/5/1,臺中市,東區,26265,74026,37238,36788
2012/5/1,臺中市,南區,43363,115428,55874,59554
2012/5/1,臺中市,西區,44040,117334,56106,61228
2012/5/1,臺中市,北區,56753,147641,71300,76341
2012/5/1,臺中市,西屯區,75951,211268,102020,109248
2012/5/1,臺中市,南屯區,55087,156789,75679,81110
2012/5/1,臺中市,北屯區,86381,250952,121579,129373
2012/5/1,臺中市,豐原區,50719,165863,82217,83646
2012/5/1,臺中市,東勢區,17074,52633,27295,25338
2012/5/1,臺中市,大甲區,21956,78141,39638,38503
2012/5/1,臺中市,清水區,25297,85684,44182,41502
2012/5/1,臺中市,沙鹿區,24984,83833,42642,41191
2012/5/1,臺中市,梧棲區,16296,55697,28189,27508
2012/5/1,臺中市,后里區,15045,54043,27700,26343
2012/5/1,臺中市,神岡區,18030,64199,33005,31194
2012/5/1,臺中市,潭子區,33303,102325,50881,51444
2012/5/1,臺中市,大雅區,26843,90833,45662,45171
2012/5/1,臺中市,新社區,7383,25408,13274,12134
2012/5/1,臺中市,石岡區,4877,15755,8190,7565
2012/5/1,臺中市,外埔區,9020,31883,16394,15489
2012/5/1,臺中市,大安區,5306,19997,10502,9495
2012/5/1,臺中市,烏日區,21225,69555,35204,34351
2012/5/1,臺中市,大肚區,16142,55724,28573,27151
2012/5/1,臺中市,龍井區,21134,74670,37884,36786
2012/5/1,臺中市,霧峰區,18976,63961,32775,31186
2012/5/1,臺中市,太平區,56073,175168,87777,87391
2012/5/1,臺中市,大里區,63820,201718,99888,101830
2012/5/1,臺中市,和平區,4400,10594,5719,4875
2012/5/1,臺南市,新營區,27683,78651,39152,39499
2012/5/1,臺南市,鹽水區,10015,26789,13940,12849
2012/5/1,臺南市,白河區,10997,30771,16111,14660
2012/5/1,臺南市,柳營區,7802,22288,11649,10639
2012/5/1,臺南市,後壁區,8858,25371,13200,12171
2012/5/1,臺南市,東山區,8268,22621,11998,10623
2012/5/1,臺南市,麻豆區,15191,45526,23232,22294
2012/5/1,臺南市,下營區,9115,25717,13276,12441
2012/5/1,臺南市,六甲區,7683,23409,12151,11258
2012/5/1,臺南市,官田區,7667,21882,11206,10676
2012/5/1,臺南市,大內區,4028,10598,5648,4950
2012/5/1,臺南市,佳里區,19608,59266,29433,29833
2012/5/1,臺南市,學甲區,9595,27474,14053,13421
2012/5/1,臺南市,西港區,7873,25002,12710,12292
2012/5/1,臺南市,七股區,8024,24393,12722,11671
2012/5/1,臺南市,將軍區,7425,21156,10762,10394
2012/5/1,臺南市,北門區,4397,12178,6200,5978
2012/5/1,臺南市,新化區,13868,43947,22506,21441
2012/5/1,臺南市,善化區,15090,44174,22295,21879
2012/5/1,臺南市,新市區,11026,35075,17642,17433
2012/5/1,臺南市,安定區,9501,30259,15646,14613
2012/5/1,臺南市,山上區,2725,7717,4051,3666
2012/5/1,臺南市,玉井區,5096,15148,7845,7303
2012/5/1,臺南市,楠西區,3553,10359,5491,4868
2012/5/1,臺南市,南化區,2823,8776,4797,3979
2012/5/1,臺南市,左鎮區,1985,5330,2971,2359
2012/5/1,臺南市,仁德區,25303,70656,36155,34501
2012/5/1,臺南市,歸仁區,21086,66346,33813,32533
2012/5/1,臺南市,關廟區,10753,35469,18399,17070
2012/5/1,臺南市,龍崎區,1592,4299,2328,1971
2012/5/1,臺南市,永康區,77633,222225,110291,111934
2012/5/1,臺南市,東區,71548,193636,93358,100278
2012/5/1,臺南市,南區,43927,126106,63142,62964
2012/5/1,臺南市,北區,48845,132048,64831,67217
2012/5/1,臺南市,安南區,56401,180994,91868,89126
2012/5/1,臺南市,安平區,23780,63951,30613,33338
2012/5/1,臺南市,中西區,30396,78707,38527,40180
2012/5/1,高雄市,鹽埕區,11036,26558,13256,13302
2012/5/1,高雄市,鼓山區,53384,133171,65034,68137
2012/5/1,高雄市,左營區,75212,194054,95082,98972
2012/5/1,高雄市,楠梓區,62993,174447,86351,88096
2012/5/1,高雄市,三民區,132780,350996,171269,179727
2012/5/1,高雄市,新興區,22805,54188,26230,27958
2012/5/1,高雄市,前金區,12487,28323,13788,14535
2012/5/1,高雄市,苓雅區,72021,180723,87822,92901
2012/5/1,高雄市,前鎮區,77087,196969,97680,99289
2012/5/1,高雄市,旗津區,10978,29565,15336,14229
2012/5/1,高雄市,小港區,64492,154971,77653,77318
2012/5/1,高雄市,鳳山區,130384,347296,172209,175087
2012/5/1,高雄市,林園區,24767,70483,36040,34443
2012/5/1,高雄市,大寮區,39167,109111,56513,52598
2012/5/1,高雄市,大樹區,13139,43515,22450,21065
2012/5/1,高雄市,大社區,11971,33503,17174,16329
2012/5/1,高雄市,仁武區,27671,76022,39137,36885
2012/5/1,高雄市,鳥松區,16999,43376,22002,21374
2012/5/1,高雄市,岡山區,33789,97461,48735,48726
2012/5/1,高雄市,橋頭區,12940,36815,18827,17988
2012/5/1,高雄市,燕巢區,10166,30848,16429,14419
2012/5/1,高雄市,田寮區,3506,7926,4410,3516
2012/5/1,高雄市,阿蓮區,9259,30116,15197,14919
2012/5/1,高雄市,路竹區,16220,53344,27225,26119
2012/5/1,高雄市,湖內區,9876,28886,14859,14027
2012/5/1,高雄市,茄萣區,10229,30895,16065,14830
2012/5/1,高雄市,永安區,5806,14077,7150,6927
2012/5/1,高雄市,彌陀區,6675,20211,10463,9748
2012/5/1,高雄市,梓官區,12215,36511,18967,17544
2012/5/1,高雄市,旗山區,13859,39299,20410,18889
2012/5/1,高雄市,美濃區,14343,42402,22159,20243
2012/5/1,高雄市,六龜區,5748,14293,7737,6556
2012/5/1,高雄市,甲仙區,2434,6743,3593,3150
2012/5/1,高雄市,杉林區,4725,12337,6732,5605
2012/5/1,高雄市,內門區,5057,15585,8498,7087
2012/5/1,高雄市,茂林區,579,1843,922,921
2012/5/1,高雄市,桃源區,1369,4650,2451,2199
2012/5/1,高雄市,那瑪夏區,882,3217,1660,1557
2012/5/1,宜蘭縣,宜蘭市,33765,95469,46810,48659
2012/5/1,宜蘭縣,羅東鎮,25303,72779,34855,37924
2012/5/1,宜蘭縣,蘇澳鎮,13711,42178,21618,20560
2012/5/1,宜蘭縣,頭城鎮,9860,30406,15715,14691
2012/5/1,宜蘭縣,礁溪鄉,12690,35947,18800,17147
2012/5/1,宜蘭縣,壯圍鄉,8234,24599,13051,11548
2012/5/1,宜蘭縣,員山鄉,10993,32246,17271,14975
2012/5/1,宜蘭縣,冬山鄉,17902,53116,27297,25819
2012/5/1,宜蘭縣,五結鄉,13286,38827,20152,18675
2012/5/1,宜蘭縣,三星鄉,7658,21125,11415,9710
2012/5/1,宜蘭縣,大同鄉,1842,5903,3208,2695
2012/5/1,宜蘭縣,南澳鄉,1857,5916,3148,2768
2012/5/1,桃園市,桃園區,148274,411517,201390,210127
2012/5/1,桃園市,中壢區,131098,373685,186274,187411
2012/5/1,桃園市,平鎮區,68347,208688,105000,103688
2012/5/1,桃園市,八德區,59586,177712,90106,87606
2012/5/1,桃園市,楊梅區,50518,153172,77778,75394
2012/5/1,桃園市,大溪區,29756,91956,47355,44601
2012/5/1,桃園市,蘆竹區,49947,144992,72601,72391
2012/5/1,桃園市,大園區,26576,82326,42628,39698
2012/5/1,桃園市,龜山區,51211,138512,69945,68567
2012/5/1,桃園市,龍潭區,37507,115022,58245,56777
2012/5/1,桃園市,新屋區,15083,48469,25961,22508
2012/5/1,桃園市,觀音區,19747,62027,32623,29404
2012/5/1,桃園市,復興區,3686,10585,5902,4683
2012/5/1,新竹縣,竹北市,50469,148879,74395,74484
2012/5/1,新竹縣,關西鎮,9367,31370,16714,14656
2012/5/1,新竹縣,新埔鎮,10501,35126,18657,16469
2012/5/1,新竹縣,竹東鎮,31313,96654,48672,47982
2012/5/1,新竹縣,湖口鄉,24034,76118,38794,37324
2012/5/1,新竹縣,橫山鄉,4471,14141,7646,6495
2012/5/1,新竹縣,新豐鄉,16222,53832,27665,26167
2012/5/1,新竹縣,芎林鄉,6358,20440,10770,9670
2012/5/1,新竹縣,寶山鄉,4865,14055,7612,6443
2012/5/1,新竹縣,北埔鄉,3119,9923,5385,4538
2012/5/1,新竹縣,峨眉鄉,2040,5851,3250,2601
2012/5/1,新竹縣,尖石鄉,2754,8746,4733,4013
2012/5/1,新竹縣,五峰鄉,1728,4569,2514,2055
2012/5/1,苗栗縣,苗栗市,29748,90960,45686,45274
2012/5/1,苗栗縣,苑裡鎮,14031,48470,25245,23225
2012/5/1,苗栗縣,通霄鎮,11469,37535,19843,17692
2012/5/1,苗栗縣,竹南鎮,25065,80124,40669,39455
2012/5/1,苗栗縣,頭份市,30760,98967,50191,48776
2012/5/1,苗栗縣,後龍鎮,11803,38853,20494,18359
2012/5/1,苗栗縣,卓蘭鎮,6028,18383,9682,8701
2012/5/1,苗栗縣,大湖鄉,5386,15886,8439,7447
2012/5/1,苗栗縣,公館鄉,10370,34927,18228,16699
2012/5/1,苗栗縣,銅鑼鄉,6036,19243,10203,9040
2012/5/1,苗栗縣,南庄鄉,3982,10898,5988,4910
2012/5/1,苗栗縣,頭屋鄉,3568,11478,6052,5426
2012/5/1,苗栗縣,三義鄉,5361,17456,9180,8276
2012/5/1,苗栗縣,西湖鄉,2695,7756,4299,3457
2012/5/1,苗栗縣,造橋鄉,4073,13675,7203,6472
2012/5/1,苗栗縣,三灣鄉,2407,7190,3919,3271
2012/5/1,苗栗縣,獅潭鄉,1705,4789,2687,2102
2012/5/1,苗栗縣,泰安鄉,1968,5917,3203,2714
2012/5/1,彰化縣,彰化市,73104,236445,117502,118943
2012/5/1,彰化縣,鹿港鎮,22849,85584,43779,41805
2012/5/1,彰化縣,和美鎮,24785,90188,46183,44005
2012/5/1,彰化縣,北斗鎮,10080,33326,16877,16449
2012/5/1,彰化縣,員林市,37257,125221,62848,62373
2012/5/1,彰化縣,溪湖鎮,15401,55975,28571,27404
2012/5/1,彰化縣,田中鎮,12656,43502,22607,20895
2012/5/1,彰化縣,二林鎮,14437,53323,27499,25824
2012/5/1,彰化縣,線西鄉,4166,17001,8785,8216
2012/5/1,彰化縣,伸港鄉,9156,35931,18431,17500
2012/5/1,彰化縣,福興鄉,12236,48391,25265,23126
2012/5/1,彰化縣,秀水鄉,9972,39311,20354,18957
2012/5/1,彰化縣,花壇鄉,13182,45991,23650,22341
2012/5/1,彰化縣,芬園鄉,6884,24515,12976,11539
2012/5/1,彰化縣,大村鄉,10422,36379,18950,17429
2012/5/1,彰化縣,埔鹽鄉,8885,33860,17730,16130
2012/5/1,彰化縣,埔心鄉,10084,35159,18133,17026
2012/5/1,彰化縣,永靖鄉,10534,38747,20129,18618
2012/5/1,彰化縣,社頭鄉,12457,44284,22745,21539
2012/5/1,彰化縣,二水鄉,5340,16251,8535,7716
2012/5/1,彰化縣,田尾鄉,7725,28233,14684,13549
2012/5/1,彰化縣,埤頭鄉,8724,31474,16424,15050
2012/5/1,彰化縣,芳苑鄉,10020,35514,18781,16733
2012/5/1,彰化縣,大城鄉,5396,18454,10030,8424
2012/5/1,彰化縣,竹塘鄉,4623,16327,8601,7726
2012/5/1,彰化縣,溪州鄉,8765,31203,16437,14766
2012/5/1,南投縣,南投市,33749,103665,52080,51585
2012/5/1,南投縣,埔里鎮,28591,84480,42554,41926
2012/5/1,南投縣,草屯鎮,31504,99177,50156,49021
2012/5/1,南投縣,竹山鎮,19504,57805,29779,28026
2012/5/1,南投縣,集集鎮,4318,11649,6079,5570
2012/5/1,南投縣,名間鄉,12288,40797,21433,19364
2012/5/1,南投縣,鹿谷鄉,7024,18858,10027,8831
2012/5/1,南投縣,中寮鄉,5649,15893,8641,7252
2012/5/1,南投縣,魚池鄉,5753,16796,8861,7935
2012/5/1,南投縣,國姓鄉,7234,20291,11035,9256
2012/5/1,南投縣,水里鄉,7240,19528,10240,9288
2012/5/1,南投縣,信義鄉,5257,16940,9172,7768
2012/5/1,南投縣,仁愛鄉,4928,15573,8100,7473
2012/5/1,雲林縣,斗六市,35600,107405,53878,53527
2012/5/1,雲林縣,斗南鎮,15444,46642,23701,22941
2012/5/1,雲林縣,虎尾鎮,23050,70188,35675,34513
2012/5/1,雲林縣,西螺鎮,14154,48053,24399,23654
2012/5/1,雲林縣,土庫鎮,8913,30125,15752,14373
2012/5/1,雲林縣,北港鎮,15675,42604,22151,20453
2012/5/1,雲林縣,古坑鄉,10725,33399,17642,15757
2012/5/1,雲林縣,大埤鄉,6688,20693,11125,9568
2012/5/1,雲林縣,莿桐鄉,9139,30063,15778,14285
2012/5/1,雲林縣,林內鄉,5829,19599,10224,9375
2012/5/1,雲林縣,二崙鄉,8769,29162,15621,13541
2012/5/1,雲林縣,崙背鄉,8410,26749,14121,12628
2012/5/1,雲林縣,麥寮鄉,13086,39928,20559,19369
2012/5/1,雲林縣,東勢鄉,5765,16207,8858,7349
2012/5/1,雲林縣,褒忠鄉,4345,13949,7453,6496
2012/5/1,雲林縣,臺西鄉,8857,25381,13649,11732
2012/5/1,雲林縣,元長鄉,9362,28144,15352,12792
2012/5/1,雲林縣,四湖鄉,9071,26110,14200,11910
2012/5/1,雲林縣,口湖鄉,9624,29714,15860,13854
2012/5/1,雲林縣,水林鄉,10353,27987,15324,12663
2012/5/1,嘉義縣,太保市,11645,36665,18902,17763
2012/5/1,嘉義縣,朴子市,14932,43907,22305,21602
2012/5/1,嘉義縣,布袋鎮,10168,29445,15100,14345
2012/5/1,嘉義縣,大林鎮,11310,33024,16961,16063
2012/5/1,嘉義縣,民雄鄉,23294,72337,37129,35208
2012/5/1,嘉義縣,溪口鄉,5407,15913,8489,7424
2012/5/1,嘉義縣,新港鄉,10464,34169,18029,16140
2012/5/1,嘉義縣,六腳鄉,9135,25548,13550,11998
2012/5/1,嘉義縣,東石鄉,9483,26865,14278,12587
2012/5/1,嘉義縣,義竹鄉,7491,20418,10622,9796
2012/5/1,嘉義縣,鹿草鄉,5819,16920,9091,7829
2012/5/1,嘉義縣,水上鄉,17493,51535,26619,24916
2012/5/1,嘉義縣,中埔鄉,15620,47061,24544,22517
2012/5/1,嘉義縣,竹崎鄉,11468,38052,20259,17793
2012/5/1,嘉義縣,梅山鄉,6718,21002,11134,9868
2012/5/1,嘉義縣,番路鄉,4081,11787,6422,5365
2012/5/1,嘉義縣,大埔鄉,1927,4541,2389,2152
2012/5/1,嘉義縣,阿里山鄉,2069,6164,3287,2877
2012/5/1,屏東縣,屏東市,72648,208904,103993,104911
2012/5/1,屏東縣,潮州鎮,18462,55336,27798,27538
2012/5/1,屏東縣,東港鎮,15917,49496,25029,24467
2012/5/1,屏東縣,恆春鎮,10969,30780,15785,14995
2012/5/1,屏東縣,萬丹鄉,14472,53374,27624,25750
2012/5/1,屏東縣,長治鄉,9804,30620,16004,14616
2012/5/1,屏東縣,麟洛鄉,3622,11357,5881,5476
2012/5/1,屏東縣,九如鄉,6640,22626,11757,10869
2012/5/1,屏東縣,里港鄉,7959,26074,13335,12739
2012/5/1,屏東縣,鹽埔鄉,7770,26876,13980,12896
2012/5/1,屏東縣,高樹鄉,9439,26182,13966,12216
2012/5/1,屏東縣,萬巒鄉,6424,21517,11348,10169
2012/5/1,屏東縣,內埔鄉,18027,57315,29756,27559
2012/5/1,屏東縣,竹田鄉,5610,18093,9600,8493
2012/5/1,屏東縣,新埤鄉,3377,10442,5551,4891
2012/5/1,屏東縣,枋寮鄉,8517,26094,13706,12388
2012/5/1,屏東縣,新園鄉,11639,37615,19449,18166
2012/5/1,屏東縣,崁頂鄉,4319,16852,8589,8263
2012/5/1,屏東縣,林邊鄉,7111,20106,10351,9755
2012/5/1,屏東縣,南州鄉,3678,11431,5841,5590
2012/5/1,屏東縣,佳冬鄉,7135,20934,10925,10009
2012/5/1,屏東縣,琉球鄉,4030,12104,6741,5363
2012/5/1,屏東縣,車城鄉,3497,9333,5052,4281
2012/5/1,屏東縣,滿州鄉,3050,8338,4584,3754
2012/5/1,屏東縣,枋山鄉,2098,5875,3169,2706
2012/5/1,屏東縣,三地門鄉,2222,7516,3831,3685
2012/5/1,屏東縣,霧臺鄉,999,2999,1574,1425
2012/5/1,屏東縣,瑪家鄉,1935,6547,3391,3156
2012/5/1,屏東縣,泰武鄉,1230,5058,2647,2411
2012/5/1,屏東縣,來義鄉,2204,7648,3915,3733
2012/5/1,屏東縣,春日鄉,1323,4836,2506,2330
2012/5/1,屏東縣,獅子鄉,1469,4767,2524,2243
2012/5/1,屏東縣,牡丹鄉,1890,4883,2540,2343
2012/5/1,臺東縣,臺東市,38296,108061,54627,53434
2012/5/1,臺東縣,成功鎮,5416,15439,8172,7267
2012/5/1,臺東縣,關山鎮,3241,9536,5017,4519
2012/5/1,臺東縣,卑南鄉,6628,17943,9645,8298
2012/5/1,臺東縣,大武鄉,2516,6704,3497,3207
2012/5/1,臺東縣,太麻里鄉,4544,11767,6269,5498
2012/5/1,臺東縣,東河鄉,3672,9172,5107,4065
2012/5/1,臺東縣,長濱鄉,2912,7965,4552,3413
2012/5/1,臺東縣,鹿野鄉,3126,8368,4509,3859
2012/5/1,臺東縣,池上鄉,3273,8931,4702,4229
2012/5/1,臺東縣,綠島鄉,1045,3425,1822,1603
2012/5/1,臺東縣,延平鄉,1062,3545,1945,1600
2012/5/1,臺東縣,海端鄉,1098,4365,2374,1991
2012/5/1,臺東縣,達仁鄉,1500,3912,2125,1787
2012/5/1,臺東縣,金峰鄉,1063,3526,1838,1688
2012/5/1,臺東縣,蘭嶼鄉,1579,4741,2431,2310
2012/5/1,花蓮縣,花蓮市,40858,108504,53028,55476
2012/5/1,花蓮縣,鳳林鎮,4422,11623,6144,5479
2012/5/1,花蓮縣,玉里鎮,8890,26257,14189,12068
2012/5/1,花蓮縣,新城鄉,7372,20135,10436,9699
2012/5/1,花蓮縣,吉安鄉,29780,80881,41236,39645
2012/5/1,花蓮縣,壽豐鄉,6858,18393,9917,8476
2012/5/1,花蓮縣,光復鄉,5033,13740,7333,6407
2012/5/1,花蓮縣,豐濱鄉,1783,4770,2658,2112
2012/5/1,花蓮縣,瑞穗鄉,4656,12498,6754,5744
2012/5/1,花蓮縣,富里鄉,4015,11305,6161,5144
2012/5/1,花蓮縣,秀林鄉,4675,15086,7832,7254
2012/5/1,花蓮縣,萬榮鄉,2118,6680,3573,3107
2012/5/1,花蓮縣,卓溪鄉,1666,6204,3443,2761
2012/5/1,澎湖縣,馬公市,21216,57858,29316,28542
2012/5/1,澎湖縣,湖西鄉,4920,13767,7196,6571
2012/5/1,澎湖縣,白沙鄉,3188,9438,4960,4478
2012/5/1,澎湖縣,西嶼鄉,2885,8347,4297,4050
2012/5/1,澎湖縣,望安鄉,1905,4664,2510,2154
2012/5/1,澎湖縣,七美鄉,1282,3565,1861,1704
2012/5/1,基隆市,中正區,22191,54235,27787,26448
2012/5/1,基隆市,七堵區,20324,54479,27605,26874
2012/5/1,基隆市,暖暖區,14603,37853,19195,18658
2012/5/1,基隆市,仁愛區,19774,48434,23913,24521
2012/5/1,基隆市,中山區,19216,49997,25521,24476
2012/5/1,基隆市,安樂區,31775,82562,41144,41418
2012/5/1,基隆市,信義區,20295,50962,25451,25511
2012/5/1,新竹市,東區,71201,201601,99452,102149
2012/5/1,新竹市,北區,51942,146559,72184,74375
2012/5/1,新竹市,香山區,23768,73853,37647,36206
2012/5/1,嘉義市,東區,44539,124664,60784,63880
2012/5/1,嘉義市,西區,51922,147031,72670,74361
2012/5/1,金門縣,金城鎮,11621,35557,17919,17638
2012/5/1,金門縣,金湖鎮,7713,23564,11972,11592
2012/5/1,金門縣,金沙鎮,5652,16819,8444,8375
2012/5/1,金門縣,金寧鄉,6513,21208,10869,10339
2012/5/1,金門縣,烈嶼鄉,2788,9917,4907,5010
2012/5/1,金門縣,烏坵鄉,134,581,291,290
2012/5/1,連江縣,南竿鄉,1265,6050,3449,2601
2012/5/1,連江縣,北竿鄉,414,1881,1054,827
2012/5/1,連江縣,莒光鄉,248,1166,696,470
2012/5/1,連江縣,東引鄉,284,1075,637,438
2012/6/1,總計,新北市,1443851,3926188,1942318,1983870
2012/6/1,總計,臺北市,1007687,2663263,1281370,1381893
2012/6/1,總計,臺中市,875159,2674359,1328771,1345588
2012/6/1,總計,臺南市,651898,1878795,944219,934576
2012/6/1,總計,高雄市,1039797,2775482,1387701,1387781
2012/6/1,總計,臺灣省,3058931,9225260,4710028,4515232
2012/6/1,總計,宜蘭縣,157379,458616,233390,225226
2012/6/1,總計,桃園市,692509,2020103,1016488,1003615
2012/6/1,總計,新竹縣,167603,520234,267028,253206
2012/6/1,總計,苗栗縣,176682,562684,291269,271415
2012/6/1,總計,彰化縣,369488,1300618,666430,634188
2012/6/1,總計,南投縣,173262,521218,267983,253235
2012/6/1,總計,雲林縣,233120,711887,371212,340675
2012/6/1,總計,嘉義縣,178627,535045,278912,256133
2012/6/1,總計,屏東縣,279610,861373,442423,418950
2012/6/1,總計,臺東縣,80981,227194,118499,108695
2012/6/1,總計,花蓮縣,122228,336020,172668,163352
2012/6/1,總計,澎湖縣,35395,97724,50205,47519
2012/6/1,總計,基隆市,148277,378301,190523,187778
2012/6/1,總計,新竹市,147214,422554,209551,213003
2012/6/1,總計,嘉義市,96556,271689,133447,138242
2012/6/1,總計,福建省,36750,118400,60500,57900
2012/6/1,總計,金門縣,34534,108147,54633,53514
2012/6/1,總計,連江縣,2216,10253,5867,4386
2012/6/1,新北市,板橋區,200280,556898,274278,282620
2012/6/1,新北市,三重區,143166,389829,193644,196185
2012/6/1,新北市,中和區,158469,415326,204348,210978
2012/6/1,新北市,永和區,90364,232103,111098,121005
2012/6/1,新北市,新莊區,140660,405604,199818,205786
2012/6/1,新北市,新店區,118475,296640,144569,152071
2012/6/1,新北市,樹林區,62913,180933,90858,90075
2012/6/1,新北市,鶯歌區,28227,87927,44270,43657
2012/6/1,新北市,三峽區,37529,106696,54210,52486
2012/6/1,新北市,淡水區,60841,148334,71847,76487
2012/6/1,新北市,汐止區,80885,191412,94715,96697
2012/6/1,新北市,瑞芳區,15913,41732,21230,20502
2012/6/1,新北市,土城區,83989,239612,119353,120259
2012/6/1,新北市,蘆洲區,66958,198962,98281,100681
2012/6/1,新北市,五股區,28006,80871,40949,39922
2012/6/1,新北市,泰山區,26755,77320,38732,38588
2012/6/1,新北市,林口區,33181,88128,43389,44739
2012/6/1,新北市,深坑區,9135,23489,11819,11670
2012/6/1,新北市,石碇區,3332,7866,4348,3518
2012/6/1,新北市,坪林區,2471,6494,3629,2865
2012/6/1,新北市,三芝區,9002,23359,12051,11308
2012/6/1,新北市,石門區,4192,12766,6694,6072
2012/6/1,新北市,八里區,12669,35242,17808,17434
2012/6/1,新北市,平溪區,2392,5133,2859,2274
2012/6/1,新北市,雙溪區,3813,9500,5130,4370
2012/6/1,新北市,貢寮區,4456,13428,6907,6521
2012/6/1,新北市,金山區,6837,22411,11189,11222
2012/6/1,新北市,萬里區,7200,22270,11322,10948
2012/6/1,新北市,烏來區,1741,5903,2973,2930
2012/6/1,臺北市,松山區,79229,210880,99884,110996
2012/6/1,臺北市,信義區,87400,227323,109337,117986
2012/6/1,臺北市,大安區,118421,313985,147405,166580
2012/6/1,臺北市,中山區,94852,225278,105675,119603
2012/6/1,臺北市,中正區,63449,161732,77877,83855
2012/6/1,臺北市,大同區,49201,128057,62852,65205
2012/6/1,臺北市,萬華區,75824,191600,95110,96490
2012/6/1,臺北市,文山區,99871,268009,129586,138423
2012/6/1,臺北市,南港區,43458,117129,57387,59742
2012/6/1,臺北市,內湖區,100885,277935,133679,144256
2012/6/1,臺北市,士林區,103229,288213,139813,148400
2012/6/1,臺北市,北投區,91868,253122,122765,130357
2012/6/1,臺中市,中區,8158,21165,10513,10652
2012/6/1,臺中市,東區,26280,74025,37238,36787
2012/6/1,臺中市,南區,43438,115508,55921,59587
2012/6/1,臺中市,西區,44049,117262,56040,61222
2012/6/1,臺中市,北區,56834,147671,71306,76365
2012/6/1,臺中市,西屯區,76095,211435,102086,109349
2012/6/1,臺中市,南屯區,55211,157018,75774,81244
2012/6/1,臺中市,北屯區,86534,251243,121657,129586
2012/6/1,臺中市,豐原區,50817,165912,82245,83667
2012/6/1,臺中市,東勢區,17093,52606,27269,25337
2012/6/1,臺中市,大甲區,21954,78124,39611,38513
2012/6/1,臺中市,清水區,25317,85692,44195,41497
2012/6/1,臺中市,沙鹿區,25024,83940,42686,41254
2012/6/1,臺中市,梧棲區,16336,55777,28244,27533
2012/6/1,臺中市,后里區,15046,54030,27679,26351
2012/6/1,臺中市,神岡區,18045,64285,33048,31237
2012/6/1,臺中市,潭子區,33363,102526,50985,51541
2012/6/1,臺中市,大雅區,26853,90894,45690,45204
2012/6/1,臺中市,新社區,7381,25400,13278,12122
2012/6/1,臺中市,石岡區,4875,15773,8194,7579
2012/6/1,臺中市,外埔區,9021,31875,16395,15480
2012/6/1,臺中市,大安區,5313,20003,10508,9495
2012/6/1,臺中市,烏日區,21261,69651,35241,34410
2012/6/1,臺中市,大肚區,16174,55797,28594,27203
2012/6/1,臺中市,龍井區,21172,74700,37904,36796
2012/6/1,臺中市,霧峰區,18984,63931,32775,31156
2012/6/1,臺中市,太平區,56156,175425,87900,87525
2012/6/1,臺中市,大里區,63981,202111,100077,102034
2012/6/1,臺中市,和平區,4394,10580,5718,4862
2012/6/1,臺南市,新營區,27695,78648,39167,39481
2012/6/1,臺南市,鹽水區,10036,26789,13939,12850
2012/6/1,臺南市,白河區,10997,30735,16088,14647
2012/6/1,臺南市,柳營區,7806,22259,11626,10633
2012/6/1,臺南市,後壁區,8856,25350,13197,12153
2012/6/1,臺南市,東山區,8268,22620,11995,10625
2012/6/1,臺南市,麻豆區,15200,45527,23210,22317
2012/6/1,臺南市,下營區,9121,25706,13273,12433
2012/6/1,臺南市,六甲區,7693,23403,12147,11256
2012/6/1,臺南市,官田區,7674,21897,11210,10687
2012/6/1,臺南市,大內區,4025,10585,5649,4936
2012/6/1,臺南市,佳里區,19631,59247,29422,29825
2012/6/1,臺南市,學甲區,9603,27447,14044,13403
2012/6/1,臺南市,西港區,7889,25015,12710,12305
2012/6/1,臺南市,七股區,8025,24386,12712,11674
2012/6/1,臺南市,將軍區,7426,21115,10729,10386
2012/6/1,臺南市,北門區,4395,12148,6185,5963
2012/6/1,臺南市,新化區,13896,43959,22514,21445
2012/6/1,臺南市,善化區,15135,44215,22320,21895
2012/6/1,臺南市,新市區,11050,35100,17665,17435
2012/6/1,臺南市,安定區,9506,30267,15654,14613
2012/6/1,臺南市,山上區,2719,7724,4055,3669
2012/6/1,臺南市,玉井區,5100,15139,7846,7293
2012/6/1,臺南市,楠西區,3552,10346,5488,4858
2012/6/1,臺南市,南化區,2825,8789,4802,3987
2012/6/1,臺南市,左鎮區,1984,5324,2970,2354
2012/6/1,臺南市,仁德區,25334,70654,36144,34510
2012/6/1,臺南市,歸仁區,21114,66359,33804,32555
2012/6/1,臺南市,關廟區,10764,35432,18388,17044
2012/6/1,臺南市,龍崎區,1593,4294,2325,1969
2012/6/1,臺南市,永康區,77773,222494,110429,112065
2012/6/1,臺南市,東區,71595,193610,93339,100271
2012/6/1,臺南市,南區,43959,126102,63131,62971
2012/6/1,臺南市,北區,48887,132138,64878,67260
2012/6/1,臺南市,安南區,56534,181263,91982,89281
2012/6/1,臺南市,安平區,23800,63991,30643,33348
2012/6/1,臺南市,中西區,30438,78718,38539,40179
2012/6/1,高雄市,鹽埕區,11027,26546,13247,13299
2012/6/1,高雄市,鼓山區,53456,133297,65078,68219
2012/6/1,高雄市,左營區,75196,194117,95081,99036
2012/6/1,高雄市,楠梓區,63095,174615,86465,88150
2012/6/1,高雄市,三民區,132812,350830,171190,179640
2012/6/1,高雄市,新興區,22804,54149,26201,27948
2012/6/1,高雄市,前金區,12507,28337,13783,14554
2012/6/1,高雄市,苓雅區,72071,180600,87729,92871
2012/6/1,高雄市,前鎮區,77148,196949,97633,99316
2012/6/1,高雄市,旗津區,10967,29539,15329,14210
2012/6/1,高雄市,小港區,64599,155139,77733,77406
2012/6/1,高雄市,鳳山區,130493,347560,172266,175294
2012/6/1,高雄市,林園區,24777,70421,36028,34393
2012/6/1,高雄市,大寮區,39205,109171,56561,52610
2012/6/1,高雄市,大樹區,13128,43512,22444,21068
2012/6/1,高雄市,大社區,11989,33542,17189,16353
2012/6/1,高雄市,仁武區,27752,76239,39264,36975
2012/6/1,高雄市,鳥松區,17013,43417,22018,21399
2012/6/1,高雄市,岡山區,33803,97469,48739,48730
2012/6/1,高雄市,橋頭區,12939,36840,18842,17998
2012/6/1,高雄市,燕巢區,10184,30868,16433,14435
2012/6/1,高雄市,田寮區,3502,7925,4411,3514
2012/6/1,高雄市,阿蓮區,9270,30121,15207,14914
2012/6/1,高雄市,路竹區,16230,53334,27220,26114
2012/6/1,高雄市,湖內區,9900,28918,14875,14043
2012/6/1,高雄市,茄萣區,10240,30916,16070,14846
2012/6/1,高雄市,永安區,5810,14090,7150,6940
2012/6/1,高雄市,彌陀區,6678,20226,10469,9757
2012/6/1,高雄市,梓官區,12227,36508,18954,17554
2012/6/1,高雄市,旗山區,13856,39271,20386,18885
2012/6/1,高雄市,美濃區,14331,42374,22135,20239
2012/6/1,高雄市,六龜區,5747,14278,7722,6556
2012/6/1,高雄市,甲仙區,2435,6736,3589,3147
2012/6/1,高雄市,杉林區,4727,12359,6741,5618
2012/6/1,高雄市,內門區,5058,15592,8503,7089
2012/6/1,高雄市,茂林區,578,1840,920,920
2012/6/1,高雄市,桃源區,1364,4629,2440,2189
2012/6/1,高雄市,那瑪夏區,879,3208,1656,1552
2012/6/1,宜蘭縣,宜蘭市,33795,95470,46817,48653
2012/6/1,宜蘭縣,羅東鎮,25336,72764,34858,37906
2012/6/1,宜蘭縣,蘇澳鎮,13717,42152,21599,20553
2012/6/1,宜蘭縣,頭城鎮,9880,30418,15720,14698
2012/6/1,宜蘭縣,礁溪鄉,12756,35998,18825,17173
2012/6/1,宜蘭縣,壯圍鄉,8241,24577,13040,11537
2012/6/1,宜蘭縣,員山鄉,11012,32245,17269,14976
2012/6/1,宜蘭縣,冬山鄉,17953,53213,27326,25887
2012/6/1,宜蘭縣,五結鄉,13308,38820,20136,18684
2012/6/1,宜蘭縣,三星鄉,7679,21141,11437,9704
2012/6/1,宜蘭縣,大同鄉,1843,5900,3206,2694
2012/6/1,宜蘭縣,南澳鄉,1859,5918,3157,2761
2012/6/1,桃園市,桃園區,148575,411817,201575,210242
2012/6/1,桃園市,中壢區,131358,374160,186500,187660
2012/6/1,桃園市,平鎮區,68450,208713,105007,103706
2012/6/1,桃園市,八德區,59724,177939,90213,87726
2012/6/1,桃園市,楊梅區,50606,153281,77845,75436
2012/6/1,桃園市,大溪區,29778,91890,47330,44560
2012/6/1,桃園市,蘆竹區,50039,145164,72685,72479
2012/6/1,桃園市,大園區,26609,82388,42652,39736
2012/6/1,桃園市,龜山區,51290,138649,69980,68669
2012/6/1,桃園市,龍潭區,37532,114984,58208,56776
2012/6/1,桃園市,新屋區,15080,48438,25943,22495
2012/6/1,桃園市,觀音區,19780,62120,32658,29462
2012/6/1,桃園市,復興區,3688,10560,5892,4668
2012/6/1,新竹縣,竹北市,50667,149309,74631,74678
2012/6/1,新竹縣,關西鎮,9382,31360,16703,14657
2012/6/1,新竹縣,新埔鎮,10501,35118,18655,16463
2012/6/1,新竹縣,竹東鎮,31337,96640,48657,47983
2012/6/1,新竹縣,湖口鄉,24081,76194,38807,37387
2012/6/1,新竹縣,橫山鄉,4479,14138,7644,6494
2012/6/1,新竹縣,新豐鄉,16277,53916,27695,26221
2012/6/1,新竹縣,芎林鄉,6360,20439,10768,9671
2012/6/1,新竹縣,寶山鄉,4872,14058,7607,6451
2012/6/1,新竹縣,北埔鄉,3124,9908,5374,4534
2012/6/1,新竹縣,峨眉鄉,2044,5837,3242,2595
2012/6/1,新竹縣,尖石鄉,2753,8754,4735,4019
2012/6/1,新竹縣,五峰鄉,1726,4563,2510,2053
2012/6/1,苗栗縣,苗栗市,29764,90988,45692,45296
2012/6/1,苗栗縣,苑裡鎮,14056,48444,25230,23214
2012/6/1,苗栗縣,通霄鎮,11474,37511,19828,17683
2012/6/1,苗栗縣,竹南鎮,25131,80250,40727,39523
2012/6/1,苗栗縣,頭份市,30823,99087,50256,48831
2012/6/1,苗栗縣,後龍鎮,11816,38867,20499,18368
2012/6/1,苗栗縣,卓蘭鎮,6032,18365,9667,8698
2012/6/1,苗栗縣,大湖鄉,5388,15880,8443,7437
2012/6/1,苗栗縣,公館鄉,10369,34931,18228,16703
2012/6/1,苗栗縣,銅鑼鄉,6041,19218,10196,9022
2012/6/1,苗栗縣,南庄鄉,3984,10888,5979,4909
2012/6/1,苗栗縣,頭屋鄉,3570,11473,6051,5422
2012/6/1,苗栗縣,三義鄉,5374,17463,9174,8289
2012/6/1,苗栗縣,西湖鄉,2699,7746,4291,3455
2012/6/1,苗栗縣,造橋鄉,4076,13671,7199,6472
2012/6/1,苗栗縣,三灣鄉,2412,7209,3927,3282
2012/6/1,苗栗縣,獅潭鄉,1705,4781,2675,2106
2012/6/1,苗栗縣,泰安鄉,1968,5912,3207,2705
2012/6/1,彰化縣,彰化市,73207,236588,117555,119033
2012/6/1,彰化縣,鹿港鎮,22877,85660,43793,41867
2012/6/1,彰化縣,和美鎮,24800,90162,46154,44008
2012/6/1,彰化縣,北斗鎮,10096,33350,16874,16476
2012/6/1,彰化縣,員林市,37276,125154,62807,62347
2012/6/1,彰化縣,溪湖鎮,15420,55960,28566,27394
2012/6/1,彰化縣,田中鎮,12664,43459,22581,20878
2012/6/1,彰化縣,二林鎮,14463,53329,27499,25830
2012/6/1,彰化縣,線西鄉,4179,17040,8807,8233
2012/6/1,彰化縣,伸港鄉,9161,35934,18422,17512
2012/6/1,彰化縣,福興鄉,12249,48374,25255,23119
2012/6/1,彰化縣,秀水鄉,9987,39342,20347,18995
2012/6/1,彰化縣,花壇鄉,13185,46004,23669,22335
2012/6/1,彰化縣,芬園鄉,6882,24505,12963,11542
2012/6/1,彰化縣,大村鄉,10434,36390,18948,17442
2012/6/1,彰化縣,埔鹽鄉,8889,33836,17724,16112
2012/6/1,彰化縣,埔心鄉,10087,35157,18150,17007
2012/6/1,彰化縣,永靖鄉,10548,38760,20135,18625
2012/6/1,彰化縣,社頭鄉,12471,44266,22742,21524
2012/6/1,彰化縣,二水鄉,5349,16264,8537,7727
2012/6/1,彰化縣,田尾鄉,7722,28191,14665,13526
2012/6/1,彰化縣,埤頭鄉,8727,31471,16432,15039
2012/6/1,彰化縣,芳苑鄉,10032,35473,18762,16711
2012/6/1,彰化縣,大城鄉,5397,18437,10022,8415
2012/6/1,彰化縣,竹塘鄉,4625,16332,8596,7736
2012/6/1,彰化縣,溪州鄉,8761,31180,16425,14755
2012/6/1,南投縣,南投市,33798,103713,52089,51624
2012/6/1,南投縣,埔里鎮,28617,84499,42537,41962
2012/6/1,南投縣,草屯鎮,31566,99161,50147,49014
2012/6/1,南投縣,竹山鎮,19549,57777,29762,28015
2012/6/1,南投縣,集集鎮,4324,11624,6069,5555
2012/6/1,南投縣,名間鄉,12302,40770,21429,19341
2012/6/1,南投縣,鹿谷鄉,7040,18826,10014,8812
2012/6/1,南投縣,中寮鄉,5649,15883,8632,7251
2012/6/1,南投縣,魚池鄉,5755,16788,8848,7940
2012/6/1,南投縣,國姓鄉,7235,20256,11016,9240
2012/6/1,南投縣,水里鄉,7236,19498,10220,9278
2012/6/1,南投縣,信義鄉,5255,16888,9133,7755
2012/6/1,南投縣,仁愛鄉,4936,15535,8087,7448
2012/6/1,雲林縣,斗六市,35657,107393,53853,53540
2012/6/1,雲林縣,斗南鎮,15451,46644,23714,22930
2012/6/1,雲林縣,虎尾鎮,23062,70199,35665,34534
2012/6/1,雲林縣,西螺鎮,14162,47946,24371,23575
2012/6/1,雲林縣,土庫鎮,8928,30127,15761,14366
2012/6/1,雲林縣,北港鎮,15675,42595,22160,20435
2012/6/1,雲林縣,古坑鄉,10744,33429,17666,15763
2012/6/1,雲林縣,大埤鄉,6693,20667,11110,9557
2012/6/1,雲林縣,莿桐鄉,9150,30096,15794,14302
2012/6/1,雲林縣,林內鄉,5837,19610,10213,9397
2012/6/1,雲林縣,二崙鄉,8784,29133,15604,13529
2012/6/1,雲林縣,崙背鄉,8419,26707,14095,12612
2012/6/1,雲林縣,麥寮鄉,13136,40069,20620,19449
2012/6/1,雲林縣,東勢鄉,5773,16172,8847,7325
2012/6/1,雲林縣,褒忠鄉,4355,13931,7443,6488
2012/6/1,雲林縣,臺西鄉,8863,25313,13623,11690
2012/6/1,雲林縣,元長鄉,9359,28112,15333,12779
2012/6/1,雲林縣,四湖鄉,9073,26096,14195,11901
2012/6/1,雲林縣,口湖鄉,9640,29693,15841,13852
2012/6/1,雲林縣,水林鄉,10359,27955,15304,12651
2012/6/1,嘉義縣,太保市,11662,36681,18906,17775
2012/6/1,嘉義縣,朴子市,14950,43954,22331,21623
2012/6/1,嘉義縣,布袋鎮,10170,29395,15075,14320
2012/6/1,嘉義縣,大林鎮,11325,33029,16977,16052
2012/6/1,嘉義縣,民雄鄉,23300,72286,37087,35199
2012/6/1,嘉義縣,溪口鄉,5415,15904,8481,7423
2012/6/1,嘉義縣,新港鄉,10463,34141,18012,16129
2012/6/1,嘉義縣,六腳鄉,9131,25504,13526,11978
2012/6/1,嘉義縣,東石鄉,9489,26816,14244,12572
2012/6/1,嘉義縣,義竹鄉,7498,20393,10610,9783
2012/6/1,嘉義縣,鹿草鄉,5818,16899,9078,7821
2012/6/1,嘉義縣,水上鄉,17514,51533,26598,24935
2012/6/1,嘉義縣,中埔鄉,15619,47028,24521,22507
2012/6/1,嘉義縣,竹崎鄉,11478,38025,20252,17773
2012/6/1,嘉義縣,梅山鄉,6722,20989,11118,9871
2012/6/1,嘉義縣,番路鄉,4076,11763,6414,5349
2012/6/1,嘉義縣,大埔鄉,1925,4539,2392,2147
2012/6/1,嘉義縣,阿里山鄉,2072,6166,3290,2876
2012/6/1,屏東縣,屏東市,72672,208761,103902,104859
2012/6/1,屏東縣,潮州鎮,18473,55319,27791,27528
2012/6/1,屏東縣,東港鎮,15920,49433,25008,24425
2012/6/1,屏東縣,恆春鎮,10972,30747,15778,14969
2012/6/1,屏東縣,萬丹鄉,14492,53357,27613,25744
2012/6/1,屏東縣,長治鄉,9815,30629,16008,14621
2012/6/1,屏東縣,麟洛鄉,3622,11345,5875,5470
2012/6/1,屏東縣,九如鄉,6645,22616,11750,10866
2012/6/1,屏東縣,里港鄉,7964,26090,13333,12757
2012/6/1,屏東縣,鹽埔鄉,7783,26866,13971,12895
2012/6/1,屏東縣,高樹鄉,9425,26131,13947,12184
2012/6/1,屏東縣,萬巒鄉,6424,21518,11350,10168
2012/6/1,屏東縣,內埔鄉,18063,57308,29754,27554
2012/6/1,屏東縣,竹田鄉,5610,18081,9585,8496
2012/6/1,屏東縣,新埤鄉,3382,10425,5542,4883
2012/6/1,屏東縣,枋寮鄉,8507,26048,13679,12369
2012/6/1,屏東縣,新園鄉,11637,37584,19431,18153
2012/6/1,屏東縣,崁頂鄉,4325,16798,8561,8237
2012/6/1,屏東縣,林邊鄉,7110,20083,10344,9739
2012/6/1,屏東縣,南州鄉,3677,11409,5833,5576
2012/6/1,屏東縣,佳冬鄉,7139,20945,10927,10018
2012/6/1,屏東縣,琉球鄉,4032,12098,6738,5360
2012/6/1,屏東縣,車城鄉,3494,9355,5058,4297
2012/6/1,屏東縣,滿州鄉,3055,8315,4569,3746
2012/6/1,屏東縣,枋山鄉,2103,5855,3153,2702
2012/6/1,屏東縣,三地門鄉,2222,7515,3837,3678
2012/6/1,屏東縣,霧臺鄉,999,3011,1576,1435
2012/6/1,屏東縣,瑪家鄉,1933,6548,3392,3156
2012/6/1,屏東縣,泰武鄉,1230,5057,2646,2411
2012/6/1,屏東縣,來義鄉,2204,7657,3920,3737
2012/6/1,屏東縣,春日鄉,1321,4832,2500,2332
2012/6/1,屏東縣,獅子鄉,1470,4763,2519,2244
2012/6/1,屏東縣,牡丹鄉,1890,4874,2533,2341
2012/6/1,臺東縣,臺東市,38298,107989,54581,53408
2012/6/1,臺東縣,成功鎮,5414,15403,8144,7259
2012/6/1,臺東縣,關山鎮,3235,9511,5000,4511
2012/6/1,臺東縣,卑南鄉,6635,17931,9629,8302
2012/6/1,臺東縣,大武鄉,2513,6693,3496,3197
2012/6/1,臺東縣,太麻里鄉,4546,11750,6258,5492
2012/6/1,臺東縣,東河鄉,3685,9174,5111,4063
2012/6/1,臺東縣,長濱鄉,2910,7949,4540,3409
2012/6/1,臺東縣,鹿野鄉,3127,8365,4510,3855
2012/6/1,臺東縣,池上鄉,3279,8928,4696,4232
2012/6/1,臺東縣,綠島鄉,1044,3427,1823,1604
2012/6/1,臺東縣,延平鄉,1063,3540,1943,1597
2012/6/1,臺東縣,海端鄉,1097,4373,2379,1994
2012/6/1,臺東縣,達仁鄉,1493,3898,2122,1776
2012/6/1,臺東縣,金峰鄉,1061,3520,1834,1686
2012/6/1,臺東縣,蘭嶼鄉,1581,4743,2433,2310
2012/6/1,花蓮縣,花蓮市,40919,108570,53042,55528
2012/6/1,花蓮縣,鳳林鎮,4429,11625,6154,5471
2012/6/1,花蓮縣,玉里鎮,8891,26240,14178,12062
2012/6/1,花蓮縣,新城鄉,7372,20103,10425,9678
2012/6/1,花蓮縣,吉安鄉,29808,80926,41251,39675
2012/6/1,花蓮縣,壽豐鄉,6851,18355,9901,8454
2012/6/1,花蓮縣,光復鄉,5036,13715,7317,6398
2012/6/1,花蓮縣,豐濱鄉,1783,4756,2653,2103
2012/6/1,花蓮縣,瑞穗鄉,4663,12471,6743,5728
2012/6/1,花蓮縣,富里鄉,4019,11300,6165,5135
2012/6/1,花蓮縣,秀林鄉,4675,15083,7823,7260
2012/6/1,花蓮縣,萬榮鄉,2117,6684,3574,3110
2012/6/1,花蓮縣,卓溪鄉,1665,6192,3442,2750
2012/6/1,澎湖縣,馬公市,21201,57862,29350,28512
2012/6/1,澎湖縣,湖西鄉,4929,13797,7209,6588
2012/6/1,澎湖縣,白沙鄉,3189,9444,4958,4486
2012/6/1,澎湖縣,西嶼鄉,2882,8353,4298,4055
2012/6/1,澎湖縣,望安鄉,1912,4685,2516,2169
2012/6/1,澎湖縣,七美鄉,1282,3583,1874,1709
2012/6/1,基隆市,中正區,22208,54245,27802,26443
2012/6/1,基隆市,七堵區,20341,54430,27578,26852
2012/6/1,基隆市,暖暖區,14629,37878,19217,18661
2012/6/1,基隆市,仁愛區,19777,48349,23876,24473
2012/6/1,基隆市,中山區,19227,49953,25491,24462
2012/6/1,基隆市,安樂區,31786,82495,41115,41380
2012/6/1,基隆市,信義區,20309,50951,25444,25507
2012/6/1,新竹市,東區,71338,201857,99567,102290
2012/6/1,新竹市,北區,52074,146808,72322,74486
2012/6/1,新竹市,香山區,23802,73889,37662,36227
2012/6/1,嘉義市,東區,44576,124654,60777,63877
2012/6/1,嘉義市,西區,51980,147035,72670,74365
2012/6/1,金門縣,金城鎮,11658,35712,17990,17722
2012/6/1,金門縣,金湖鎮,7734,23699,12047,11652
2012/6/1,金門縣,金沙鎮,5675,16909,8484,8425
2012/6/1,金門縣,金寧鄉,6542,21267,10889,10378
2012/6/1,金門縣,烈嶼鄉,2791,9973,4929,5044
2012/6/1,金門縣,烏坵鄉,134,587,294,293
2012/6/1,連江縣,南竿鄉,1269,6107,3472,2635
2012/6/1,連江縣,北竿鄉,415,1889,1055,834
2012/6/1,連江縣,莒光鄉,248,1172,698,474
2012/6/1,連江縣,東引鄉,284,1085,642,443
2012/7/1,總計,新北市,1447028,3928418,1942943,1985475
2012/7/1,總計,臺北市,1009673,2664487,1281745,1382742
2012/7/1,總計,臺中市,877011,2675939,1329403,1346536
2012/7/1,總計,臺南市,652826,1879022,944204,934818
2012/7/1,總計,高雄市,1041365,2775734,1387586,1388148
2012/7/1,總計,臺灣省,3064424,9225185,4709547,4515638
2012/7/1,總計,宜蘭縣,157699,458514,233319,225195
2012/7/1,總計,桃園市,694348,2021677,1017101,1004576
2012/7/1,總計,新竹縣,168103,520776,267315,253461
2012/7/1,總計,苗栗縣,177005,562762,291274,271488
2012/7/1,總計,彰化縣,370085,1300223,666210,634013
2012/7/1,總計,南投縣,173500,520992,267794,253198
2012/7/1,總計,雲林縣,233485,711538,371010,340528
2012/7/1,總計,嘉義縣,178812,534686,278767,255919
2012/7/1,總計,屏東縣,279892,860759,442079,418680
2012/7/1,總計,臺東縣,81071,227014,118369,108645
2012/7/1,總計,花蓮縣,122325,335794,172555,163239
2012/7/1,總計,澎湖縣,35467,97947,50333,47614
2012/7/1,總計,基隆市,148383,378032,190373,187659
2012/7/1,總計,新竹市,147574,422883,209694,213189
2012/7/1,總計,嘉義市,96675,271588,133354,138234
2012/7/1,總計,福建省,36945,119587,61069,58518
2012/7/1,總計,金門縣,34696,108963,54998,53965
2012/7/1,總計,連江縣,2249,10624,6071,4553
2012/7/1,新北市,板橋區,200676,556939,274255,282684
2012/7/1,新北市,三重區,143393,389791,193594,196197
2012/7/1,新北市,中和區,158833,415781,204499,211282
2012/7/1,新北市,永和區,90385,231803,110916,120887
2012/7/1,新北市,新莊區,141025,405884,199886,205998
2012/7/1,新北市,新店區,118695,296950,144647,152303
2012/7/1,新北市,樹林區,63100,181080,90908,90172
2012/7/1,新北市,鶯歌區,28282,87961,44309,43652
2012/7/1,新北市,三峽區,37673,106888,54303,52585
2012/7/1,新北市,淡水區,61131,148704,72004,76700
2012/7/1,新北市,汐止區,81146,191617,94798,96819
2012/7/1,新北市,瑞芳區,15933,41721,21217,20504
2012/7/1,新北市,土城區,84074,239558,119318,120240
2012/7/1,新北市,蘆洲區,67097,198992,98247,100745
2012/7/1,新北市,五股區,28089,80991,40993,39998
2012/7/1,新北市,泰山區,26796,77323,38729,38594
2012/7/1,新北市,林口區,33346,88461,43546,44915
2012/7/1,新北市,深坑區,9142,23484,11824,11660
2012/7/1,新北市,石碇區,3333,7853,4342,3511
2012/7/1,新北市,坪林區,2472,6487,3629,2858
2012/7/1,新北市,三芝區,9005,23353,12043,11310
2012/7/1,新北市,石門區,4199,12764,6685,6079
2012/7/1,新北市,八里區,12724,35333,17858,17475
2012/7/1,新北市,平溪區,2394,5125,2848,2277
2012/7/1,新北市,雙溪區,3808,9460,5115,4345
2012/7/1,新北市,貢寮區,4462,13438,6914,6524
2012/7/1,新北市,金山區,6863,22438,11193,11245
2012/7/1,新北市,萬里區,7215,22336,11352,10984
2012/7/1,新北市,烏來區,1737,5903,2971,2932
2012/7/1,臺北市,松山區,79415,210922,99861,111061
2012/7/1,臺北市,信義區,87549,227375,109343,118032
2012/7/1,臺北市,大安區,118515,313811,147298,166513
2012/7/1,臺北市,中山區,95046,225461,105732,119729
2012/7/1,臺北市,中正區,63560,161756,77843,83913
2012/7/1,臺北市,大同區,49335,128230,62917,65313
2012/7/1,臺北市,萬華區,76011,191707,95161,96546
2012/7/1,臺北市,文山區,100095,268167,129662,138505
2012/7/1,臺北市,南港區,43598,117371,57477,59894
2012/7/1,臺北市,內湖區,101113,278195,133799,144396
2012/7/1,臺北市,士林區,103417,288276,139835,148441
2012/7/1,臺北市,北投區,92019,253216,122817,130399
2012/7/1,臺中市,中區,8140,21078,10475,10603
2012/7/1,臺中市,東區,26355,74044,37216,36828
2012/7/1,臺中市,南區,43541,115619,55949,59670
2012/7/1,臺中市,西區,44067,117115,55950,61165
2012/7/1,臺中市,北區,56914,147654,71289,76365
2012/7/1,臺中市,西屯區,76281,211642,102241,109401
2012/7/1,臺中市,南屯區,55409,157428,75971,81457
2012/7/1,臺中市,北屯區,86764,251402,121716,129686
2012/7/1,臺中市,豐原區,50891,165949,82259,83690
2012/7/1,臺中市,東勢區,17113,52538,27227,25311
2012/7/1,臺中市,大甲區,21997,78097,39602,38495
2012/7/1,臺中市,清水區,25360,85658,44173,41485
2012/7/1,臺中市,沙鹿區,25131,84094,42768,41326
2012/7/1,臺中市,梧棲區,16373,55797,28256,27541
2012/7/1,臺中市,后里區,15063,54020,27665,26355
2012/7/1,臺中市,神岡區,18078,64356,33083,31273
2012/7/1,臺中市,潭子區,33454,102737,51091,51646
2012/7/1,臺中市,大雅區,26904,90998,45727,45271
2012/7/1,臺中市,新社區,7394,25392,13271,12121
2012/7/1,臺中市,石岡區,4878,15757,8191,7566
2012/7/1,臺中市,外埔區,9023,31850,16389,15461
2012/7/1,臺中市,大安區,5309,19976,10504,9472
2012/7/1,臺中市,烏日區,21296,69721,35265,34456
2012/7/1,臺中市,大肚區,16206,55790,28580,27210
2012/7/1,臺中市,龍井區,21206,74719,37903,36816
2012/7/1,臺中市,霧峰區,19009,63946,32803,31143
2012/7/1,臺中市,太平區,56301,175605,87968,87637
2012/7/1,臺中市,大里區,64149,202357,100149,102208
2012/7/1,臺中市,和平區,4405,10600,5722,4878
2012/7/1,臺南市,新營區,27728,78648,39155,39493
2012/7/1,臺南市,鹽水區,10032,26750,13920,12830
2012/7/1,臺南市,白河區,11008,30691,16080,14611
2012/7/1,臺南市,柳營區,7807,22213,11606,10607
2012/7/1,臺南市,後壁區,8877,25328,13189,12139
2012/7/1,臺南市,東山區,8265,22619,11986,10633
2012/7/1,臺南市,麻豆區,15208,45475,23173,22302
2012/7/1,臺南市,下營區,9130,25699,13276,12423
2012/7/1,臺南市,六甲區,7700,23390,12139,11251
2012/7/1,臺南市,官田區,7675,21889,11206,10683
2012/7/1,臺南市,大內區,4027,10577,5643,4934
2012/7/1,臺南市,佳里區,19667,59213,29409,29804
2012/7/1,臺南市,學甲區,9604,27441,14031,13410
2012/7/1,臺南市,西港區,7906,25005,12705,12300
2012/7/1,臺南市,七股區,8031,24335,12681,11654
2012/7/1,臺南市,將軍區,7437,21112,10728,10384
2012/7/1,臺南市,北門區,4393,12123,6175,5948
2012/7/1,臺南市,新化區,13913,43926,22518,21408
2012/7/1,臺南市,善化區,15186,44275,22326,21949
2012/7/1,臺南市,新市區,11082,35090,17650,17440
2012/7/1,臺南市,安定區,9513,30252,15642,14610
2012/7/1,臺南市,山上區,2728,7732,4055,3677
2012/7/1,臺南市,玉井區,5098,15126,7847,7279
2012/7/1,臺南市,楠西區,3551,10336,5483,4853
2012/7/1,臺南市,南化區,2825,8785,4796,3989
2012/7/1,臺南市,左鎮區,1984,5309,2966,2343
2012/7/1,臺南市,仁德區,25372,70755,36183,34572
2012/7/1,臺南市,歸仁區,21152,66417,33818,32599
2012/7/1,臺南市,關廟區,10785,35418,18381,17037
2012/7/1,臺南市,龍崎區,1590,4283,2326,1957
2012/7/1,臺南市,永康區,77982,222764,110522,112242
2012/7/1,臺南市,東區,71615,193363,93229,100134
2012/7/1,臺南市,南區,44001,126048,63096,62952
2012/7/1,臺南市,北區,48926,132194,64893,67301
2012/7/1,臺南市,安南區,56704,181639,92172,89467
2012/7/1,臺南市,安平區,23857,64093,30697,33396
2012/7/1,臺南市,中西區,30467,78709,38502,40207
2012/7/1,高雄市,鹽埕區,11031,26509,13227,13282
2012/7/1,高雄市,鼓山區,53620,133491,65133,68358
2012/7/1,高雄市,左營區,75330,194182,95071,99111
2012/7/1,高雄市,楠梓區,63273,174870,86605,88265
2012/7/1,高雄市,三民區,132923,350530,171047,179483
2012/7/1,高雄市,新興區,22813,54062,26162,27900
2012/7/1,高雄市,前金區,12535,28323,13768,14555
2012/7/1,高雄市,苓雅區,72116,180429,87632,92797
2012/7/1,高雄市,前鎮區,77218,196811,97532,99279
2012/7/1,高雄市,旗津區,10969,29527,15312,14215
2012/7/1,高雄市,小港區,64656,155156,77730,77426
2012/7/1,高雄市,鳳山區,130786,347950,172458,175492
2012/7/1,高雄市,林園區,24812,70362,35982,34380
2012/7/1,高雄市,大寮區,39285,109310,56602,52708
2012/7/1,高雄市,大樹區,13117,43430,22410,21020
2012/7/1,高雄市,大社區,12014,33577,17208,16369
2012/7/1,高雄市,仁武區,27877,76445,39343,37102
2012/7/1,高雄市,鳥松區,17080,43477,22054,21423
2012/7/1,高雄市,岡山區,33853,97488,48743,48745
2012/7/1,高雄市,橋頭區,12959,36881,18854,18027
2012/7/1,高雄市,燕巢區,10165,30834,16391,14443
2012/7/1,高雄市,田寮區,3498,7897,4397,3500
2012/7/1,高雄市,阿蓮區,9279,30095,15196,14899
2012/7/1,高雄市,路竹區,16252,53324,27229,26095
2012/7/1,高雄市,湖內區,9927,28932,14883,14049
2012/7/1,高雄市,茄萣區,10252,30941,16082,14859
2012/7/1,高雄市,永安區,5836,14105,7146,6959
2012/7/1,高雄市,彌陀區,6686,20199,10460,9739
2012/7/1,高雄市,梓官區,12228,36481,18941,17540
2012/7/1,高雄市,旗山區,13854,39202,20338,18864
2012/7/1,高雄市,美濃區,14331,42308,22106,20202
2012/7/1,高雄市,六龜區,5745,14271,7713,6558
2012/7/1,高雄市,甲仙區,2428,6706,3574,3132
2012/7/1,高雄市,杉林區,4743,12415,6763,5652
2012/7/1,高雄市,內門區,5049,15546,8481,7065
2012/7/1,高雄市,茂林區,580,1837,919,918
2012/7/1,高雄市,桃源區,1367,4624,2438,2186
2012/7/1,高雄市,那瑪夏區,878,3207,1656,1551
2012/7/1,宜蘭縣,宜蘭市,33921,95632,46894,48738
2012/7/1,宜蘭縣,羅東鎮,25364,72685,34826,37859
2012/7/1,宜蘭縣,蘇澳鎮,13725,42082,21545,20537
2012/7/1,宜蘭縣,頭城鎮,9887,30381,15712,14669
2012/7/1,宜蘭縣,礁溪鄉,12816,36003,18822,17181
2012/7/1,宜蘭縣,壯圍鄉,8252,24539,13024,11515
2012/7/1,宜蘭縣,員山鄉,10996,32158,17228,14930
2012/7/1,宜蘭縣,冬山鄉,17995,53245,27346,25899
2012/7/1,宜蘭縣,五結鄉,13347,38809,20117,18692
2012/7/1,宜蘭縣,三星鄉,7697,21133,11428,9705
2012/7/1,宜蘭縣,大同鄉,1844,5916,3215,2701
2012/7/1,宜蘭縣,南澳鄉,1855,5931,3162,2769
2012/7/1,桃園市,桃園區,148914,412074,201670,210404
2012/7/1,桃園市,中壢區,131780,374545,186631,187914
2012/7/1,桃園市,平鎮區,68614,208884,105059,103825
2012/7/1,桃園市,八德區,59901,177992,90258,87734
2012/7/1,桃園市,楊梅區,50717,153329,77849,75480
2012/7/1,桃園市,大溪區,29844,91919,47343,44576
2012/7/1,桃園市,蘆竹區,50273,145507,72828,72679
2012/7/1,桃園市,大園區,26670,82425,42669,39756
2012/7/1,桃園市,龜山區,51435,138804,70061,68743
2012/7/1,桃園市,龍潭區,37590,115002,58228,56774
2012/7/1,桃園市,新屋區,15114,48429,25946,22483
2012/7/1,桃園市,觀音區,19803,62189,32667,29522
2012/7/1,桃園市,復興區,3693,10578,5892,4686
2012/7/1,新竹縣,竹北市,50923,149797,74886,74911
2012/7/1,新竹縣,關西鎮,9405,31313,16672,14641
2012/7/1,新竹縣,新埔鎮,10519,35089,18648,16441
2012/7/1,新竹縣,竹東鎮,31392,96659,48664,47995
2012/7/1,新竹縣,湖口鄉,24117,76177,38800,37377
2012/7/1,新竹縣,橫山鄉,4484,14107,7634,6473
2012/7/1,新竹縣,新豐鄉,16357,54055,27759,26296
2012/7/1,新竹縣,芎林鄉,6371,20460,10781,9679
2012/7/1,新竹縣,寶山鄉,4874,14044,7605,6439
2012/7/1,新竹縣,北埔鄉,3129,9903,5376,4527
2012/7/1,新竹縣,峨眉鄉,2046,5841,3241,2600
2012/7/1,新竹縣,尖石鄉,2755,8776,4746,4030
2012/7/1,新竹縣,五峰鄉,1731,4555,2503,2052
2012/7/1,苗栗縣,苗栗市,29801,90975,45690,45285
2012/7/1,苗栗縣,苑裡鎮,14071,48410,25205,23205
2012/7/1,苗栗縣,通霄鎮,11482,37521,19831,17690
2012/7/1,苗栗縣,竹南鎮,25203,80344,40775,39569
2012/7/1,苗栗縣,頭份市,30898,99224,50303,48921
2012/7/1,苗栗縣,後龍鎮,11832,38815,20468,18347
2012/7/1,苗栗縣,卓蘭鎮,6048,18356,9661,8695
2012/7/1,苗栗縣,大湖鄉,5391,15846,8427,7419
2012/7/1,苗栗縣,公館鄉,10412,34941,18229,16712
2012/7/1,苗栗縣,銅鑼鄉,6057,19217,10204,9013
2012/7/1,苗栗縣,南庄鄉,3975,10871,5976,4895
2012/7/1,苗栗縣,頭屋鄉,3582,11469,6055,5414
2012/7/1,苗栗縣,三義鄉,5387,17463,9165,8298
2012/7/1,苗栗縣,西湖鄉,2698,7738,4282,3456
2012/7/1,苗栗縣,造橋鄉,4076,13662,7196,6466
2012/7/1,苗栗縣,三灣鄉,2415,7214,3931,3283
2012/7/1,苗栗縣,獅潭鄉,1710,4787,2674,2113
2012/7/1,苗栗縣,泰安鄉,1967,5909,3202,2707
2012/7/1,彰化縣,彰化市,73363,236679,117618,119061
2012/7/1,彰化縣,鹿港鎮,22913,85645,43777,41868
2012/7/1,彰化縣,和美鎮,24853,90161,46153,44008
2012/7/1,彰化縣,北斗鎮,10118,33326,16846,16480
2012/7/1,彰化縣,員林市,37335,125173,62823,62350
2012/7/1,彰化縣,溪湖鎮,15440,55938,28555,27383
2012/7/1,彰化縣,田中鎮,12682,43409,22548,20861
2012/7/1,彰化縣,二林鎮,14495,53315,27494,25821
2012/7/1,彰化縣,線西鄉,4181,17030,8797,8233
2012/7/1,彰化縣,伸港鄉,9181,35910,18417,17493
2012/7/1,彰化縣,福興鄉,12255,48278,25210,23068
2012/7/1,彰化縣,秀水鄉,10009,39338,20337,19001
2012/7/1,彰化縣,花壇鄉,13221,45984,23671,22313
2012/7/1,彰化縣,芬園鄉,6882,24488,12948,11540
2012/7/1,彰化縣,大村鄉,10445,36401,18939,17462
2012/7/1,彰化縣,埔鹽鄉,8895,33807,17719,16088
2012/7/1,彰化縣,埔心鄉,10112,35168,18156,17012
2012/7/1,彰化縣,永靖鄉,10564,38777,20140,18637
2012/7/1,彰化縣,社頭鄉,12491,44256,22730,21526
2012/7/1,彰化縣,二水鄉,5345,16224,8523,7701
2012/7/1,彰化縣,田尾鄉,7735,28162,14655,13507
2012/7/1,彰化縣,埤頭鄉,8736,31438,16412,15026
2012/7/1,彰化縣,芳苑鄉,10041,35449,18744,16705
2012/7/1,彰化縣,大城鄉,5390,18398,9997,8401
2012/7/1,彰化縣,竹塘鄉,4631,16312,8587,7725
2012/7/1,彰化縣,溪州鄉,8772,31157,16414,14743
2012/7/1,南投縣,南投市,33832,103650,52041,51609
2012/7/1,南投縣,埔里鎮,28655,84472,42524,41948
2012/7/1,南投縣,草屯鎮,31613,99237,50157,49080
2012/7/1,南投縣,竹山鎮,19589,57722,29729,27993
2012/7/1,南投縣,集集鎮,4333,11603,6059,5544
2012/7/1,南投縣,名間鄉,12320,40731,21403,19328
2012/7/1,南投縣,鹿谷鄉,7058,18821,10012,8809
2012/7/1,南投縣,中寮鄉,5652,15878,8621,7257
2012/7/1,南投縣,魚池鄉,5763,16774,8835,7939
2012/7/1,南投縣,國姓鄉,7250,20262,11017,9245
2012/7/1,南投縣,水里鄉,7240,19480,10204,9276
2012/7/1,南投縣,信義鄉,5257,16845,9111,7734
2012/7/1,南投縣,仁愛鄉,4938,15517,8081,7436
2012/7/1,雲林縣,斗六市,35748,107445,53870,53575
2012/7/1,雲林縣,斗南鎮,15473,46631,23700,22931
2012/7/1,雲林縣,虎尾鎮,23139,70259,35698,34561
2012/7/1,雲林縣,西螺鎮,14171,47848,24341,23507
2012/7/1,雲林縣,土庫鎮,8934,30097,15746,14351
2012/7/1,雲林縣,北港鎮,15684,42529,22124,20405
2012/7/1,雲林縣,古坑鄉,10761,33387,17639,15748
2012/7/1,雲林縣,大埤鄉,6697,20652,11102,9550
2012/7/1,雲林縣,莿桐鄉,9149,30058,15783,14275
2012/7/1,雲林縣,林內鄉,5843,19572,10194,9378
2012/7/1,雲林縣,二崙鄉,8815,29104,15579,13525
2012/7/1,雲林縣,崙背鄉,8432,26686,14082,12604
2012/7/1,雲林縣,麥寮鄉,13178,40245,20692,19553
2012/7/1,雲林縣,東勢鄉,5776,16144,8828,7316
2012/7/1,雲林縣,褒忠鄉,4356,13913,7425,6488
2012/7/1,雲林縣,臺西鄉,8859,25265,13604,11661
2012/7/1,雲林縣,元長鄉,9380,28081,15306,12775
2012/7/1,雲林縣,四湖鄉,9079,26061,14191,11870
2012/7/1,雲林縣,口湖鄉,9639,29639,15823,13816
2012/7/1,雲林縣,水林鄉,10372,27922,15283,12639
2012/7/1,嘉義縣,太保市,11686,36747,18941,17806
2012/7/1,嘉義縣,朴子市,14982,43923,22318,21605
2012/7/1,嘉義縣,布袋鎮,10181,29360,15071,14289
2012/7/1,嘉義縣,大林鎮,11340,33006,16970,16036
2012/7/1,嘉義縣,民雄鄉,23335,72313,37088,35225
2012/7/1,嘉義縣,溪口鄉,5421,15899,8481,7418
2012/7/1,嘉義縣,新港鄉,10466,34054,17965,16089
2012/7/1,嘉義縣,六腳鄉,9122,25466,13506,11960
2012/7/1,嘉義縣,東石鄉,9481,26790,14239,12551
2012/7/1,嘉義縣,義竹鄉,7506,20363,10591,9772
2012/7/1,嘉義縣,鹿草鄉,5818,16882,9069,7813
2012/7/1,嘉義縣,水上鄉,17528,51533,26619,24914
2012/7/1,嘉義縣,中埔鄉,15648,47018,24514,22504
2012/7/1,嘉義縣,竹崎鄉,11486,37936,20211,17725
2012/7/1,嘉義縣,梅山鄉,6734,20961,11098,9863
2012/7/1,嘉義縣,番路鄉,4077,11732,6408,5324
2012/7/1,嘉義縣,大埔鄉,1931,4544,2391,2153
2012/7/1,嘉義縣,阿里山鄉,2070,6159,3287,2872
2012/7/1,屏東縣,屏東市,72722,208538,103767,104771
2012/7/1,屏東縣,潮州鎮,18522,55336,27791,27545
2012/7/1,屏東縣,東港鎮,15951,49389,24981,24408
2012/7/1,屏東縣,恆春鎮,10978,30763,15785,14978
2012/7/1,屏東縣,萬丹鄉,14505,53274,27577,25697
2012/7/1,屏東縣,長治鄉,9841,30660,16025,14635
2012/7/1,屏東縣,麟洛鄉,3628,11327,5865,5462
2012/7/1,屏東縣,九如鄉,6655,22629,11751,10878
2012/7/1,屏東縣,里港鄉,7977,26141,13360,12781
2012/7/1,屏東縣,鹽埔鄉,7794,26861,13968,12893
2012/7/1,屏東縣,高樹鄉,9430,26117,13940,12177
2012/7/1,屏東縣,萬巒鄉,6432,21454,11316,10138
2012/7/1,屏東縣,內埔鄉,18082,57236,29715,27521
2012/7/1,屏東縣,竹田鄉,5613,18063,9580,8483
2012/7/1,屏東縣,新埤鄉,3385,10429,5540,4889
2012/7/1,屏東縣,枋寮鄉,8524,26032,13674,12358
2012/7/1,屏東縣,新園鄉,11646,37531,19430,18101
2012/7/1,屏東縣,崁頂鄉,4330,16762,8529,8233
2012/7/1,屏東縣,林邊鄉,7109,20080,10341,9739
2012/7/1,屏東縣,南州鄉,3664,11368,5816,5552
2012/7/1,屏東縣,佳冬鄉,7134,20907,10910,9997
2012/7/1,屏東縣,琉球鄉,4037,12090,6738,5352
2012/7/1,屏東縣,車城鄉,3493,9333,5043,4290
2012/7/1,屏東縣,滿州鄉,3047,8289,4552,3737
2012/7/1,屏東縣,枋山鄉,2103,5848,3144,2704
2012/7/1,屏東縣,三地門鄉,2222,7524,3840,3684
2012/7/1,屏東縣,霧臺鄉,1002,3031,1589,1442
2012/7/1,屏東縣,瑪家鄉,1936,6563,3391,3172
2012/7/1,屏東縣,泰武鄉,1230,5039,2640,2399
2012/7/1,屏東縣,來義鄉,2210,7679,3937,3742
2012/7/1,屏東縣,春日鄉,1324,4839,2502,2337
2012/7/1,屏東縣,獅子鄉,1475,4764,2516,2248
2012/7/1,屏東縣,牡丹鄉,1891,4863,2526,2337
2012/7/1,臺東縣,臺東市,38365,107959,54569,53390
2012/7/1,臺東縣,成功鎮,5420,15365,8124,7241
2012/7/1,臺東縣,關山鎮,3238,9501,4991,4510
2012/7/1,臺東縣,卑南鄉,6635,17891,9605,8286
2012/7/1,臺東縣,大武鄉,2511,6683,3487,3196
2012/7/1,臺東縣,太麻里鄉,4552,11749,6260,5489
2012/7/1,臺東縣,東河鄉,3695,9160,5094,4066
2012/7/1,臺東縣,長濱鄉,2911,7935,4527,3408
2012/7/1,臺東縣,鹿野鄉,3124,8362,4496,3866
2012/7/1,臺東縣,池上鄉,3280,8911,4690,4221
2012/7/1,臺東縣,綠島鄉,1047,3438,1831,1607
2012/7/1,臺東縣,延平鄉,1062,3534,1940,1594
2012/7/1,臺東縣,海端鄉,1096,4375,2380,1995
2012/7/1,臺東縣,達仁鄉,1493,3881,2114,1767
2012/7/1,臺東縣,金峰鄉,1063,3513,1828,1685
2012/7/1,臺東縣,蘭嶼鄉,1579,4757,2433,2324
2012/7/1,花蓮縣,花蓮市,40939,108414,52959,55455
2012/7/1,花蓮縣,鳳林鎮,4425,11594,6140,5454
2012/7/1,花蓮縣,玉里鎮,8897,26193,14160,12033
2012/7/1,花蓮縣,新城鄉,7388,20133,10448,9685
2012/7/1,花蓮縣,吉安鄉,29865,80966,41263,39703
2012/7/1,花蓮縣,壽豐鄉,6868,18365,9895,8470
2012/7/1,花蓮縣,光復鄉,5036,13706,7311,6395
2012/7/1,花蓮縣,豐濱鄉,1778,4727,2643,2084
2012/7/1,花蓮縣,瑞穗鄉,4662,12456,6737,5719
2012/7/1,花蓮縣,富里鄉,4016,11279,6161,5118
2012/7/1,花蓮縣,秀林鄉,4671,15091,7827,7264
2012/7/1,花蓮縣,萬榮鄉,2117,6670,3563,3107
2012/7/1,花蓮縣,卓溪鄉,1663,6200,3448,2752
2012/7/1,澎湖縣,馬公市,21180,57785,29328,28457
2012/7/1,澎湖縣,湖西鄉,4954,13819,7220,6599
2012/7/1,澎湖縣,白沙鄉,3196,9457,4960,4497
2012/7/1,澎湖縣,西嶼鄉,2888,8356,4303,4053
2012/7/1,澎湖縣,望安鄉,1957,4912,2626,2286
2012/7/1,澎湖縣,七美鄉,1292,3618,1896,1722
2012/7/1,基隆市,中正區,22205,54216,27787,26429
2012/7/1,基隆市,七堵區,20372,54436,27588,26848
2012/7/1,基隆市,暖暖區,14642,37829,19195,18634
2012/7/1,基隆市,仁愛區,19759,48262,23815,24447
2012/7/1,基隆市,中山區,19225,49846,25441,24405
2012/7/1,基隆市,安樂區,31856,82485,41102,41383
2012/7/1,基隆市,信義區,20324,50958,25445,25513
2012/7/1,新竹市,東區,71543,202004,99603,102401
2012/7/1,新竹市,北區,52169,146891,72382,74509
2012/7/1,新竹市,香山區,23862,73988,37709,36279
2012/7/1,嘉義市,東區,44620,124560,60733,63827
2012/7/1,嘉義市,西區,52055,147028,72621,74407
2012/7/1,金門縣,金城鎮,11732,35947,18089,17858
2012/7/1,金門縣,金湖鎮,7745,23856,12123,11733
2012/7/1,金門縣,金沙鎮,5700,17035,8537,8498
2012/7/1,金門縣,金寧鄉,6577,21455,10978,10477
2012/7/1,金門縣,烈嶼鄉,2808,10084,4977,5107
2012/7/1,金門縣,烏坵鄉,134,586,294,292
2012/7/1,連江縣,南竿鄉,1283,6314,3583,2731
2012/7/1,連江縣,北竿鄉,425,1970,1096,874
2012/7/1,連江縣,莒光鄉,256,1240,743,497
2012/7/1,連江縣,東引鄉,285,1100,649,451
2012/8/1,總計,新北市,1450751,3930638,1943762,1986876
2012/8/1,總計,臺北市,1012381,2665602,1282160,1383442
2012/8/1,總計,臺中市,879085,2677876,1330225,1347651
2012/8/1,總計,臺南市,654057,1879506,944314,935192
2012/8/1,總計,高雄市,1043274,2776204,1387643,1388561
2012/8/1,總計,臺灣省,3071675,9226093,4709287,4516806
2012/8/1,總計,宜蘭縣,158144,458550,233315,225235
2012/8/1,總計,桃園市,696907,2024100,1018097,1006003
2012/8/1,總計,新竹縣,168827,521578,267641,253937
2012/8/1,總計,苗栗縣,177393,562888,291253,271635
2012/8/1,總計,彰化縣,370815,1299734,665888,633846
2012/8/1,總計,南投縣,173748,520640,267545,253095
2012/8/1,總計,雲林縣,233965,711394,370846,340548
2012/8/1,總計,嘉義縣,179040,534387,278629,255758
2012/8/1,總計,屏東縣,280212,860044,441678,418366
2012/8/1,總計,臺東縣,81132,226778,118213,108565
2012/8/1,總計,花蓮縣,122460,335522,172379,163143
2012/8/1,總計,澎湖縣,35555,98017,50359,47658
2012/8/1,總計,基隆市,148564,377744,190264,187480
2012/8/1,總計,新竹市,148070,423318,209941,213377
2012/8/1,總計,嘉義市,96843,271399,133239,138160
2012/8/1,總計,福建省,37183,120522,61508,59014
2012/8/1,總計,金門縣,34908,109728,55366,54362
2012/8/1,總計,連江縣,2275,10794,6142,4652
2012/8/1,新北市,板橋區,201039,556885,274166,282719
2012/8/1,新北市,三重區,143667,389806,193580,196226
2012/8/1,新北市,中和區,159197,416020,204589,211431
2012/8/1,新北市,永和區,90482,231439,110754,120685
2012/8/1,新北市,新莊區,141451,406105,199974,206131
2012/8/1,新北市,新店區,118961,297159,144734,152425
2012/8/1,新北市,樹林區,63264,181282,90976,90306
2012/8/1,新北市,鶯歌區,28371,88032,44334,43698
2012/8/1,新北市,三峽區,37856,107049,54354,52695
2012/8/1,新北市,淡水區,61591,149235,72261,76974
2012/8/1,新北市,汐止區,81460,191896,94906,96990
2012/8/1,新北市,瑞芳區,15941,41703,21199,20504
2012/8/1,新北市,土城區,84238,239645,119363,120282
2012/8/1,新北市,蘆洲區,67202,199083,98293,100790
2012/8/1,新北市,五股區,28153,81048,41006,40042
2012/8/1,新北市,泰山區,26830,77387,38743,38644
2012/8/1,新北市,林口區,33522,88783,43701,45082
2012/8/1,新北市,深坑區,9173,23473,11815,11658
2012/8/1,新北市,石碇區,3336,7867,4343,3524
2012/8/1,新北市,坪林區,2473,6487,3631,2856
2012/8/1,新北市,三芝區,9035,23365,12052,11313
2012/8/1,新北市,石門區,4204,12759,6672,6087
2012/8/1,新北市,八里區,12787,35397,17899,17498
2012/8/1,新北市,平溪區,2392,5129,2852,2277
2012/8/1,新北市,雙溪區,3810,9448,5112,4336
2012/8/1,新北市,貢寮區,4465,13424,6908,6516
2012/8/1,新北市,金山區,6875,22437,11194,11243
2012/8/1,新北市,萬里區,7234,22388,11377,11011
2012/8/1,新北市,烏來區,1742,5907,2974,2933
2012/8/1,臺北市,松山區,79520,210751,99818,110933
2012/8/1,臺北市,信義區,87734,227422,109344,118078
2012/8/1,臺北市,大安區,118692,313462,147167,166295
2012/8/1,臺北市,中山區,95413,225772,105844,119928
2012/8/1,臺北市,中正區,63698,161793,77846,83947
2012/8/1,臺北市,大同區,49495,128352,62961,65391
2012/8/1,臺北市,萬華區,76267,191910,95298,96612
2012/8/1,臺北市,文山區,100388,268375,129718,138657
2012/8/1,臺北市,南港區,43798,117593,57611,59982
2012/8/1,臺北市,內湖區,101478,278566,133899,144667
2012/8/1,臺北市,士林區,103650,288261,139813,148448
2012/8/1,臺北市,北投區,92248,253345,122841,130504
2012/8/1,臺中市,中區,8129,20935,10406,10529
2012/8/1,臺中市,東區,26447,74158,37275,36883
2012/8/1,臺中市,南區,43796,116049,56124,59925
2012/8/1,臺中市,西區,44102,116918,55850,61068
2012/8/1,臺中市,北區,57010,147651,71288,76363
2012/8/1,臺中市,西屯區,76495,211892,102353,109539
2012/8/1,臺中市,南屯區,55573,157583,76051,81532
2012/8/1,臺中市,北屯區,87016,251750,121865,129885
2012/8/1,臺中市,豐原區,50964,165976,82300,83676
2012/8/1,臺中市,東勢區,17131,52527,27215,25312
2012/8/1,臺中市,大甲區,22041,78035,39575,38460
2012/8/1,臺中市,清水區,25418,85646,44158,41488
2012/8/1,臺中市,沙鹿區,25233,84277,42852,41425
2012/8/1,臺中市,梧棲區,16396,55781,28242,27539
2012/8/1,臺中市,后里區,15080,54029,27650,26379
2012/8/1,臺中市,神岡區,18113,64410,33099,31311
2012/8/1,臺中市,潭子區,33522,102872,51132,51740
2012/8/1,臺中市,大雅區,26934,91122,45801,45321
2012/8/1,臺中市,新社區,7392,25399,13264,12135
2012/8/1,臺中市,石岡區,4885,15766,8197,7569
2012/8/1,臺中市,外埔區,9034,31833,16371,15462
2012/8/1,臺中市,大安區,5315,19943,10482,9461
2012/8/1,臺中市,烏日區,21354,69730,35261,34469
2012/8/1,臺中市,大肚區,16229,55835,28586,27249
2012/8/1,臺中市,龍井區,21248,74795,37940,36855
2012/8/1,臺中市,霧峰區,19027,64028,32841,31187
2012/8/1,臺中市,太平區,56467,175832,88080,87752
2012/8/1,臺中市,大里區,64334,202533,100260,102273
2012/8/1,臺中市,和平區,4400,10571,5707,4864
2012/8/1,臺南市,新營區,27772,78584,39126,39458
2012/8/1,臺南市,鹽水區,10062,26754,13912,12842
2012/8/1,臺南市,白河區,11006,30659,16060,14599
2012/8/1,臺南市,柳營區,7807,22184,11585,10599
2012/8/1,臺南市,後壁區,8891,25326,13177,12149
2012/8/1,臺南市,東山區,8260,22580,11969,10611
2012/8/1,臺南市,麻豆區,15241,45463,23176,22287
2012/8/1,臺南市,下營區,9140,25679,13268,12411
2012/8/1,臺南市,六甲區,7707,23372,12120,11252
2012/8/1,臺南市,官田區,7686,21881,11194,10687
2012/8/1,臺南市,大內區,4027,10569,5640,4929
2012/8/1,臺南市,佳里區,19723,59221,29407,29814
2012/8/1,臺南市,學甲區,9626,27426,14025,13401
2012/8/1,臺南市,西港區,7920,25027,12702,12325
2012/8/1,臺南市,七股區,8037,24307,12677,11630
2012/8/1,臺南市,將軍區,7439,21111,10729,10382
2012/8/1,臺南市,北門區,4403,12120,6158,5962
2012/8/1,臺南市,新化區,13932,43885,22500,21385
2012/8/1,臺南市,善化區,15272,44388,22386,22002
2012/8/1,臺南市,新市區,11117,35112,17668,17444
2012/8/1,臺南市,安定區,9520,30244,15623,14621
2012/8/1,臺南市,山上區,2733,7713,4043,3670
2012/8/1,臺南市,玉井區,5113,15085,7835,7250
2012/8/1,臺南市,楠西區,3549,10322,5477,4845
2012/8/1,臺南市,南化區,2826,8780,4789,3991
2012/8/1,臺南市,左鎮區,1986,5313,2974,2339
2012/8/1,臺南市,仁德區,25454,70936,36255,34681
2012/8/1,臺南市,歸仁區,21183,66469,33831,32638
2012/8/1,臺南市,關廟區,10800,35399,18373,17026
2012/8/1,臺南市,龍崎區,1590,4288,2330,1958
2012/8/1,臺南市,永康區,78288,223261,110739,112522
2012/8/1,臺南市,東區,71650,193143,93106,100037
2012/8/1,臺南市,南區,44045,126046,63083,62963
2012/8/1,臺南市,北區,48999,132190,64916,67274
2012/8/1,臺南市,安南區,56885,181913,92300,89613
2012/8/1,臺南市,安平區,23920,64180,30732,33448
2012/8/1,臺南市,中西區,30448,78576,38429,40147
2012/8/1,高雄市,鹽埕區,11037,26449,13198,13251
2012/8/1,高雄市,鼓山區,53742,133560,65150,68410
2012/8/1,高雄市,左營區,75510,194259,95084,99175
2012/8/1,高雄市,楠梓區,63476,175056,86694,88362
2012/8/1,高雄市,三民區,133061,350358,170935,179423
2012/8/1,高雄市,新興區,22837,53995,26146,27849
2012/8/1,高雄市,前金區,12563,28290,13750,14540
2012/8/1,高雄市,苓雅區,72177,180153,87514,92639
2012/8/1,高雄市,前鎮區,77285,196753,97516,99237
2012/8/1,高雄市,旗津區,10968,29506,15312,14194
2012/8/1,高雄市,小港區,64738,155226,77751,77475
2012/8/1,高雄市,鳳山區,131139,348317,172576,175741
2012/8/1,高雄市,林園區,24850,70344,35960,34384
2012/8/1,高雄市,大寮區,39401,109457,56657,52800
2012/8/1,高雄市,大樹區,13132,43412,22410,21002
2012/8/1,高雄市,大社區,12049,33650,17242,16408
2012/8/1,高雄市,仁武區,28038,76719,39459,37260
2012/8/1,高雄市,鳥松區,17135,43532,22088,21444
2012/8/1,高雄市,岡山區,33898,97500,48703,48797
2012/8/1,高雄市,橋頭區,12958,36928,18863,18065
2012/8/1,高雄市,燕巢區,10180,30832,16380,14452
2012/8/1,高雄市,田寮區,3497,7902,4404,3498
2012/8/1,高雄市,阿蓮區,9283,30060,15183,14877
2012/8/1,高雄市,路竹區,16285,53262,27209,26053
2012/8/1,高雄市,湖內區,9969,28983,14905,14078
2012/8/1,高雄市,茄萣區,10263,30953,16088,14865
2012/8/1,高雄市,永安區,5842,14126,7162,6964
2012/8/1,高雄市,彌陀區,6690,20176,10461,9715
2012/8/1,高雄市,梓官區,12252,36508,18952,17556
2012/8/1,高雄市,旗山區,13859,39144,20312,18832
2012/8/1,高雄市,美濃區,14347,42247,22071,20176
2012/8/1,高雄市,六龜區,5744,14246,7695,6551
2012/8/1,高雄市,甲仙區,2428,6689,3563,3126
2012/8/1,高雄市,杉林區,4770,12448,6777,5671
2012/8/1,高雄市,內門區,5048,15552,8487,7065
2012/8/1,高雄市,茂林區,581,1836,915,921
2012/8/1,高雄市,桃源區,1365,4591,2423,2168
2012/8/1,高雄市,那瑪夏區,877,3185,1648,1537
2012/8/1,宜蘭縣,宜蘭市,34096,95748,46976,48772
2012/8/1,宜蘭縣,羅東鎮,25405,72617,34771,37846
2012/8/1,宜蘭縣,蘇澳鎮,13751,42016,21518,20498
2012/8/1,宜蘭縣,頭城鎮,9923,30409,15717,14692
2012/8/1,宜蘭縣,礁溪鄉,12884,36025,18830,17195
2012/8/1,宜蘭縣,壯圍鄉,8269,24592,13045,11547
2012/8/1,宜蘭縣,員山鄉,11015,32130,17208,14922
2012/8/1,宜蘭縣,冬山鄉,18015,53236,27345,25891
2012/8/1,宜蘭縣,五結鄉,13374,38841,20113,18728
2012/8/1,宜蘭縣,三星鄉,7700,21114,11420,9694
2012/8/1,宜蘭縣,大同鄉,1852,5913,3219,2694
2012/8/1,宜蘭縣,南澳鄉,1860,5909,3153,2756
2012/8/1,桃園市,桃園區,149460,412589,201896,210693
2012/8/1,桃園市,中壢區,132305,375093,186884,188209
2012/8/1,桃園市,平鎮區,68838,209004,105089,103915
2012/8/1,桃園市,八德區,60175,178253,90365,87888
2012/8/1,桃園市,楊梅區,50920,153579,77954,75625
2012/8/1,桃園市,大溪區,29903,91886,47321,44565
2012/8/1,桃園市,蘆竹區,50504,145773,72931,72842
2012/8/1,桃園市,大園區,26768,82408,42627,39781
2012/8/1,桃園市,龜山區,51646,139137,70218,68919
2012/8/1,桃園市,龍潭區,37681,115078,58281,56797
2012/8/1,桃園市,新屋區,15159,48419,25936,22483
2012/8/1,桃園市,觀音區,19857,62291,32698,29593
2012/8/1,桃園市,復興區,3691,10590,5897,4693
2012/8/1,新竹縣,竹北市,51361,150519,75189,75330
2012/8/1,新竹縣,關西鎮,9429,31286,16657,14629
2012/8/1,新竹縣,新埔鎮,10518,35013,18615,16398
2012/8/1,新竹縣,竹東鎮,31465,96660,48655,48005
2012/8/1,新竹縣,湖口鄉,24187,76235,38830,37405
2012/8/1,新竹縣,橫山鄉,4485,14111,7641,6470
2012/8/1,新竹縣,新豐鄉,16424,54177,27819,26358
2012/8/1,新竹縣,芎林鄉,6369,20414,10759,9655
2012/8/1,新竹縣,寶山鄉,4921,14082,7612,6470
2012/8/1,新竹縣,北埔鄉,3132,9891,5364,4527
2012/8/1,新竹縣,峨眉鄉,2051,5840,3244,2596
2012/8/1,新竹縣,尖石鄉,2756,8794,4754,4040
2012/8/1,新竹縣,五峰鄉,1729,4556,2502,2054
2012/8/1,苗栗縣,苗栗市,29871,90986,45675,45311
2012/8/1,苗栗縣,苑裡鎮,14105,48387,25194,23193
2012/8/1,苗栗縣,通霄鎮,11487,37491,19806,17685
2012/8/1,苗栗縣,竹南鎮,25302,80416,40800,39616
2012/8/1,苗栗縣,頭份市,31019,99418,50396,49022
2012/8/1,苗栗縣,後龍鎮,11846,38811,20458,18353
2012/8/1,苗栗縣,卓蘭鎮,6045,18348,9654,8694
2012/8/1,苗栗縣,大湖鄉,5393,15853,8426,7427
2012/8/1,苗栗縣,公館鄉,10427,34908,18203,16705
2012/8/1,苗栗縣,銅鑼鄉,6066,19219,10202,9017
2012/8/1,苗栗縣,南庄鄉,3971,10851,5965,4886
2012/8/1,苗栗縣,頭屋鄉,3583,11462,6054,5408
2012/8/1,苗栗縣,三義鄉,5396,17470,9173,8297
2012/8/1,苗栗縣,西湖鄉,2704,7734,4279,3455
2012/8/1,苗栗縣,造橋鄉,4079,13640,7177,6463
2012/8/1,苗栗縣,三灣鄉,2419,7212,3926,3286
2012/8/1,苗栗縣,獅潭鄉,1712,4789,2677,2112
2012/8/1,苗栗縣,泰安鄉,1968,5893,3188,2705
2012/8/1,彰化縣,彰化市,73522,236619,117546,119073
2012/8/1,彰化縣,鹿港鎮,22973,85712,43808,41904
2012/8/1,彰化縣,和美鎮,24930,90180,46171,44009
2012/8/1,彰化縣,北斗鎮,10147,33305,16829,16476
2012/8/1,彰化縣,員林市,37446,125112,62806,62306
2012/8/1,彰化縣,溪湖鎮,15492,55904,28514,27390
2012/8/1,彰化縣,田中鎮,12692,43385,22525,20860
2012/8/1,彰化縣,二林鎮,14513,53250,27464,25786
2012/8/1,彰化縣,線西鄉,4177,17053,8808,8245
2012/8/1,彰化縣,伸港鄉,9191,35927,18437,17490
2012/8/1,彰化縣,福興鄉,12265,48183,25159,23024
2012/8/1,彰化縣,秀水鄉,10047,39335,20332,19003
2012/8/1,彰化縣,花壇鄉,13252,46036,23698,22338
2012/8/1,彰化縣,芬園鄉,6880,24480,12935,11545
2012/8/1,彰化縣,大村鄉,10471,36430,18959,17471
2012/8/1,彰化縣,埔鹽鄉,8907,33772,17701,16071
2012/8/1,彰化縣,埔心鄉,10131,35143,18126,17017
2012/8/1,彰化縣,永靖鄉,10572,38730,20112,18618
2012/8/1,彰化縣,社頭鄉,12505,44233,22713,21520
2012/8/1,彰化縣,二水鄉,5345,16178,8499,7679
2012/8/1,彰化縣,田尾鄉,7754,28143,14654,13489
2012/8/1,彰化縣,埤頭鄉,8742,31397,16397,15000
2012/8/1,彰化縣,芳苑鄉,10055,35444,18738,16706
2012/8/1,彰化縣,大城鄉,5389,18376,9980,8396
2012/8/1,彰化縣,竹塘鄉,4631,16275,8574,7701
2012/8/1,彰化縣,溪州鄉,8786,31132,16403,14729
2012/8/1,南投縣,南投市,33880,103565,51991,51574
2012/8/1,南投縣,埔里鎮,28695,84453,42478,41975
2012/8/1,南投縣,草屯鎮,31664,99238,50163,49075
2012/8/1,南投縣,竹山鎮,19641,57684,29691,27993
2012/8/1,南投縣,集集鎮,4332,11610,6057,5553
2012/8/1,南投縣,名間鄉,12326,40671,21362,19309
2012/8/1,南投縣,鹿谷鄉,7084,18816,10004,8812
2012/8/1,南投縣,中寮鄉,5656,15866,8620,7246
2012/8/1,南投縣,魚池鄉,5777,16785,8836,7949
2012/8/1,南投縣,國姓鄉,7258,20208,10989,9219
2012/8/1,南投縣,水里鄉,7246,19443,10194,9249
2012/8/1,南投縣,信義鄉,5257,16846,9106,7740
2012/8/1,南投縣,仁愛鄉,4932,15455,8054,7401
2012/8/1,雲林縣,斗六市,35867,107559,53903,53656
2012/8/1,雲林縣,斗南鎮,15489,46586,23672,22914
2012/8/1,雲林縣,虎尾鎮,23226,70314,35727,34587
2012/8/1,雲林縣,西螺鎮,14191,47832,24330,23502
2012/8/1,雲林縣,土庫鎮,8942,30049,15719,14330
2012/8/1,雲林縣,北港鎮,15733,42487,22113,20374
2012/8/1,雲林縣,古坑鄉,10774,33319,17605,15714
2012/8/1,雲林縣,大埤鄉,6709,20642,11100,9542
2012/8/1,雲林縣,莿桐鄉,9158,30033,15767,14266
2012/8/1,雲林縣,林內鄉,5845,19530,10171,9359
2012/8/1,雲林縣,二崙鄉,8840,29112,15570,13542
2012/8/1,雲林縣,崙背鄉,8452,26664,14064,12600
2012/8/1,雲林縣,麥寮鄉,13234,40410,20753,19657
2012/8/1,雲林縣,東勢鄉,5782,16125,8815,7310
2012/8/1,雲林縣,褒忠鄉,4361,13904,7425,6479
2012/8/1,雲林縣,臺西鄉,8864,25224,13578,11646
2012/8/1,雲林縣,元長鄉,9389,28074,15309,12765
2012/8/1,雲林縣,四湖鄉,9081,26001,14150,11851
2012/8/1,雲林縣,口湖鄉,9653,29647,15827,13820
2012/8/1,雲林縣,水林鄉,10375,27882,15248,12634
2012/8/1,嘉義縣,太保市,11712,36788,18964,17824
2012/8/1,嘉義縣,朴子市,15018,43909,22308,21601
2012/8/1,嘉義縣,布袋鎮,10188,29320,15053,14267
2012/8/1,嘉義縣,大林鎮,11341,32951,16952,15999
2012/8/1,嘉義縣,民雄鄉,23408,72322,37092,35230
2012/8/1,嘉義縣,溪口鄉,5426,15890,8472,7418
2012/8/1,嘉義縣,新港鄉,10469,33988,17939,16049
2012/8/1,嘉義縣,六腳鄉,9122,25412,13480,11932
2012/8/1,嘉義縣,東石鄉,9489,26776,14234,12542
2012/8/1,嘉義縣,義竹鄉,7519,20321,10569,9752
2012/8/1,嘉義縣,鹿草鄉,5821,16868,9065,7803
2012/8/1,嘉義縣,水上鄉,17548,51527,26603,24924
2012/8/1,嘉義縣,中埔鄉,15677,47016,24515,22501
2012/8/1,嘉義縣,竹崎鄉,11492,37921,20206,17715
2012/8/1,嘉義縣,梅山鄉,6737,20930,11089,9841
2012/8/1,嘉義縣,番路鄉,4079,11728,6405,5323
2012/8/1,嘉義縣,大埔鄉,1926,4551,2393,2158
2012/8/1,嘉義縣,阿里山鄉,2068,6169,3290,2879
2012/8/1,屏東縣,屏東市,72807,208361,103641,104720
2012/8/1,屏東縣,潮州鎮,18577,55378,27812,27566
2012/8/1,屏東縣,東港鎮,15992,49305,24932,24373
2012/8/1,屏東縣,恆春鎮,11006,30746,15765,14981
2012/8/1,屏東縣,萬丹鄉,14534,53259,27582,25677
2012/8/1,屏東縣,長治鄉,9841,30623,16011,14612
2012/8/1,屏東縣,麟洛鄉,3633,11309,5859,5450
2012/8/1,屏東縣,九如鄉,6658,22617,11736,10881
2012/8/1,屏東縣,里港鄉,7981,26142,13351,12791
2012/8/1,屏東縣,鹽埔鄉,7803,26844,13968,12876
2012/8/1,屏東縣,高樹鄉,9435,26098,13931,12167
2012/8/1,屏東縣,萬巒鄉,6439,21420,11294,10126
2012/8/1,屏東縣,內埔鄉,18095,57180,29678,27502
2012/8/1,屏東縣,竹田鄉,5620,18044,9569,8475
2012/8/1,屏東縣,新埤鄉,3389,10421,5536,4885
2012/8/1,屏東縣,枋寮鄉,8533,26018,13669,12349
2012/8/1,屏東縣,新園鄉,11641,37518,19416,18102
2012/8/1,屏東縣,崁頂鄉,4330,16710,8496,8214
2012/8/1,屏東縣,林邊鄉,7110,20026,10311,9715
2012/8/1,屏東縣,南州鄉,3666,11360,5811,5549
2012/8/1,屏東縣,佳冬鄉,7129,20873,10894,9979
2012/8/1,屏東縣,琉球鄉,4040,12087,6737,5350
2012/8/1,屏東縣,車城鄉,3488,9315,5041,4274
2012/8/1,屏東縣,滿州鄉,3053,8291,4556,3735
2012/8/1,屏東縣,枋山鄉,2107,5835,3139,2696
2012/8/1,屏東縣,三地門鄉,2220,7520,3845,3675
2012/8/1,屏東縣,霧臺鄉,1008,3050,1594,1456
2012/8/1,屏東縣,瑪家鄉,1937,6565,3401,3164
2012/8/1,屏東縣,泰武鄉,1231,5041,2637,2404
2012/8/1,屏東縣,來義鄉,2214,7663,3943,3720
2012/8/1,屏東縣,春日鄉,1327,4830,2500,2330
2012/8/1,屏東縣,獅子鄉,1476,4748,2509,2239
2012/8/1,屏東縣,牡丹鄉,1892,4847,2514,2333
2012/8/1,臺東縣,臺東市,38390,107839,54489,53350
2012/8/1,臺東縣,成功鎮,5422,15357,8125,7232
2012/8/1,臺東縣,關山鎮,3235,9470,4978,4492
2012/8/1,臺東縣,卑南鄉,6634,17855,9580,8275
2012/8/1,臺東縣,大武鄉,2506,6668,3477,3191
2012/8/1,臺東縣,太麻里鄉,4550,11733,6247,5486
2012/8/1,臺東縣,東河鄉,3705,9161,5097,4064
2012/8/1,臺東縣,長濱鄉,2919,7914,4514,3400
2012/8/1,臺東縣,鹿野鄉,3125,8356,4492,3864
2012/8/1,臺東縣,池上鄉,3287,8916,4685,4231
2012/8/1,臺東縣,綠島鄉,1051,3444,1830,1614
2012/8/1,臺東縣,延平鄉,1058,3531,1939,1592
2012/8/1,臺東縣,海端鄉,1099,4377,2378,1999
2012/8/1,臺東縣,達仁鄉,1493,3870,2108,1762
2012/8/1,臺東縣,金峰鄉,1065,3512,1830,1682
2012/8/1,臺東縣,蘭嶼鄉,1593,4775,2444,2331
2012/8/1,花蓮縣,花蓮市,40974,108274,52880,55394
2012/8/1,花蓮縣,鳳林鎮,4418,11589,6129,5460
2012/8/1,花蓮縣,玉里鎮,8888,26130,14124,12006
2012/8/1,花蓮縣,新城鄉,7396,20137,10439,9698
2012/8/1,花蓮縣,吉安鄉,29949,81058,41292,39766
2012/8/1,花蓮縣,壽豐鄉,6870,18326,9878,8448
2012/8/1,花蓮縣,光復鄉,5036,13687,7302,6385
2012/8/1,花蓮縣,豐濱鄉,1778,4713,2637,2076
2012/8/1,花蓮縣,瑞穗鄉,4673,12441,6733,5708
2012/8/1,花蓮縣,富里鄉,4027,11251,6146,5105
2012/8/1,花蓮縣,秀林鄉,4679,15079,7829,7250
2012/8/1,花蓮縣,萬榮鄉,2114,6645,3549,3096
2012/8/1,花蓮縣,卓溪鄉,1658,6192,3441,2751
2012/8/1,澎湖縣,馬公市,21208,57793,29317,28476
2012/8/1,澎湖縣,湖西鄉,4973,13838,7223,6615
2012/8/1,澎湖縣,白沙鄉,3202,9445,4959,4486
2012/8/1,澎湖縣,西嶼鄉,2892,8345,4298,4047
2012/8/1,澎湖縣,望安鄉,1982,4992,2669,2323
2012/8/1,澎湖縣,七美鄉,1298,3604,1893,1711
2012/8/1,基隆市,中正區,22221,54173,27756,26417
2012/8/1,基隆市,七堵區,20405,54371,27563,26808
2012/8/1,基隆市,暖暖區,14678,37850,19205,18645
2012/8/1,基隆市,仁愛區,19751,48145,23746,24399
2012/8/1,基隆市,中山區,19244,49798,25436,24362
2012/8/1,基隆市,安樂區,31911,82438,41111,41327
2012/8/1,基隆市,信義區,20354,50969,25447,25522
2012/8/1,新竹市,東區,71794,202144,99714,102430
2012/8/1,新竹市,北區,52338,147091,72461,74630
2012/8/1,新竹市,香山區,23938,74083,37766,36317
2012/8/1,嘉義市,東區,44696,124457,60683,63774
2012/8/1,嘉義市,西區,52147,146942,72556,74386
2012/8/1,金門縣,金城鎮,11804,36164,18184,17980
2012/8/1,金門縣,金湖鎮,7797,24036,12207,11829
2012/8/1,金門縣,金沙鎮,5718,17128,8578,8550
2012/8/1,金門縣,金寧鄉,6636,21646,11075,10571
2012/8/1,金門縣,烈嶼鄉,2819,10166,5026,5140
2012/8/1,金門縣,烏坵鄉,134,588,296,292
2012/8/1,連江縣,南竿鄉,1293,6412,3622,2790
2012/8/1,連江縣,北竿鄉,434,2001,1108,893
2012/8/1,連江縣,莒光鄉,262,1278,763,515
2012/8/1,連江縣,東引鄉,286,1103,649,454
2012/9/1,總計,新北市,1454691,3933061,1944629,1988432
2012/9/1,總計,臺北市,1015637,2665832,1282207,1383625
2012/9/1,總計,臺中市,880904,2679172,1330795,1348377
2012/9/1,總計,臺南市,655152,1879644,944292,935352
2012/9/1,總計,高雄市,1045314,2776550,1387596,1388954
2012/9/1,總計,臺灣省,3078663,9226623,4709301,4517322
2012/9/1,總計,宜蘭縣,158515,458432,233215,225217
2012/9/1,總計,桃園市,699340,2025716,1018895,1006821
2012/9/1,總計,新竹縣,169624,522376,268057,254319
2012/9/1,總計,苗栗縣,177863,563013,291267,271746
2012/9/1,總計,彰化縣,371570,1299446,665710,633736
2012/9/1,總計,南投縣,173900,520374,267404,252970
2012/9/1,總計,雲林縣,234240,711041,370598,340443
2012/9/1,總計,嘉義縣,179189,534178,278498,255680
2012/9/1,總計,屏東縣,280556,859423,441359,418064
2012/9/1,總計,臺東縣,81216,226621,118108,108513
2012/9/1,總計,花蓮縣,122614,335331,172256,163075
2012/9/1,總計,澎湖縣,35635,98104,50411,47693
2012/9/1,總計,基隆市,148826,377537,190152,187385
2012/9/1,總計,新竹市,148624,423692,210178,213514
2012/9/1,總計,嘉義市,96951,271339,133193,138146
2012/9/1,總計,福建省,37315,121788,62139,59649
2012/9/1,總計,金門縣,35020,110851,55903,54948
2012/9/1,總計,連江縣,2295,10937,6236,4701
2012/9/1,新北市,板橋區,201592,557033,274215,282818
2012/9/1,新北市,三重區,144003,389900,193606,196294
2012/9/1,新北市,中和區,159625,416220,204655,211565
2012/9/1,新北市,永和區,90546,231172,110606,120566
2012/9/1,新北市,新莊區,141775,406235,200013,206222
2012/9/1,新北市,新店區,119308,297284,144766,152518
2012/9/1,新北市,樹林區,63407,181451,91056,90395
2012/9/1,新北市,鶯歌區,28442,88041,44348,43693
2012/9/1,新北市,三峽區,38020,107278,54432,52846
2012/9/1,新北市,淡水區,62079,149740,72492,77248
2012/9/1,新北市,汐止區,81788,192295,95080,97215
2012/9/1,新北市,瑞芳區,15958,41690,21169,20521
2012/9/1,新北市,土城區,84350,239728,119359,120369
2012/9/1,新北市,蘆洲區,67296,199144,98315,100829
2012/9/1,新北市,五股區,28222,81061,41002,40059
2012/9/1,新北市,泰山區,26900,77439,38758,38681
2012/9/1,新北市,林口區,33705,89040,43834,45206
2012/9/1,新北市,深坑區,9196,23530,11843,11687
2012/9/1,新北市,石碇區,3337,7884,4351,3533
2012/9/1,新北市,坪林區,2476,6482,3621,2861
2012/9/1,新北市,三芝區,9056,23374,12052,11322
2012/9/1,新北市,石門區,4218,12771,6687,6084
2012/9/1,新北市,八里區,12854,35527,17937,17590
2012/9/1,新北市,平溪區,2393,5129,2850,2279
2012/9/1,新北市,雙溪區,3805,9438,5106,4332
2012/9/1,新北市,貢寮區,4470,13425,6914,6511
2012/9/1,新北市,金山區,6886,22441,11195,11246
2012/9/1,新北市,萬里區,7235,22387,11383,11004
2012/9/1,新北市,烏來區,1749,5922,2984,2938
2012/9/1,臺北市,松山區,79655,210372,99633,110739
2012/9/1,臺北市,信義區,87987,227390,109332,118058
2012/9/1,臺北市,大安區,118904,312958,146925,166033
2012/9/1,臺北市,中山區,95883,226043,105955,120088
2012/9/1,臺北市,中正區,63855,161648,77765,83883
2012/9/1,臺北市,大同區,49747,128522,63087,65435
2012/9/1,臺北市,萬華區,76499,192032,95343,96689
2012/9/1,臺北市,文山區,100668,268442,129675,138767
2012/9/1,臺北市,南港區,44038,117890,57737,60153
2012/9/1,臺北市,內湖區,101878,278793,134019,144774
2012/9/1,臺北市,士林區,103976,288289,139812,148477
2012/9/1,臺北市,北投區,92547,253453,122924,130529
2012/9/1,臺中市,中區,8118,20832,10363,10469
2012/9/1,臺中市,東區,26497,74186,37288,36898
2012/9/1,臺中市,南區,44051,116428,56317,60111
2012/9/1,臺中市,西區,44167,116779,55777,61002
2012/9/1,臺中市,北區,57099,147649,71277,76372
2012/9/1,臺中市,西屯區,76736,212259,102527,109732
2012/9/1,臺中市,南屯區,55706,157671,76093,81578
2012/9/1,臺中市,北屯區,87226,251941,121937,130004
2012/9/1,臺中市,豐原區,51043,165991,82318,83673
2012/9/1,臺中市,東勢區,17156,52475,27174,25301
2012/9/1,臺中市,大甲區,22075,78012,39570,38442
2012/9/1,臺中市,清水區,25458,85626,44141,41485
2012/9/1,臺中市,沙鹿區,25332,84390,42912,41478
2012/9/1,臺中市,梧棲區,16417,55783,28211,27572
2012/9/1,臺中市,后里區,15090,54017,27640,26377
2012/9/1,臺中市,神岡區,18148,64417,33100,31317
2012/9/1,臺中市,潭子區,33604,103065,51246,51819
2012/9/1,臺中市,大雅區,26954,91085,45767,45318
2012/9/1,臺中市,新社區,7398,25391,13265,12126
2012/9/1,臺中市,石岡區,4883,15764,8203,7561
2012/9/1,臺中市,外埔區,9041,31809,16365,15444
2012/9/1,臺中市,大安區,5318,19947,10480,9467
2012/9/1,臺中市,烏日區,21401,69761,35271,34490
2012/9/1,臺中市,大肚區,16247,55820,28578,27242
2012/9/1,臺中市,龍井區,21273,74815,37967,36848
2012/9/1,臺中市,霧峰區,19065,64090,32877,31213
2012/9/1,臺中市,太平區,56595,175980,88157,87823
2012/9/1,臺中市,大里區,64408,202633,100278,102355
2012/9/1,臺中市,和平區,4398,10556,5696,4860
2012/9/1,臺南市,新營區,27848,78543,39121,39422
2012/9/1,臺南市,鹽水區,10061,26730,13902,12828
2012/9/1,臺南市,白河區,11003,30615,16038,14577
2012/9/1,臺南市,柳營區,7808,22171,11577,10594
2012/9/1,臺南市,後壁區,8897,25331,13176,12155
2012/9/1,臺南市,東山區,8263,22577,11965,10612
2012/9/1,臺南市,麻豆區,15287,45433,23170,22263
2012/9/1,臺南市,下營區,9140,25654,13253,12401
2012/9/1,臺南市,六甲區,7712,23354,12111,11243
2012/9/1,臺南市,官田區,7694,21885,11201,10684
2012/9/1,臺南市,大內區,4022,10538,5623,4915
2012/9/1,臺南市,佳里區,19783,59254,29415,29839
2012/9/1,臺南市,學甲區,9634,27411,14021,13390
2012/9/1,臺南市,西港區,7929,25030,12697,12333
2012/9/1,臺南市,七股區,8038,24241,12649,11592
2012/9/1,臺南市,將軍區,7439,21090,10714,10376
2012/9/1,臺南市,北門區,4399,12103,6146,5957
2012/9/1,臺南市,新化區,13962,43894,22514,21380
2012/9/1,臺南市,善化區,15370,44486,22440,22046
2012/9/1,臺南市,新市區,11134,35121,17672,17449
2012/9/1,臺南市,安定區,9526,30253,15630,14623
2012/9/1,臺南市,山上區,2736,7715,4045,3670
2012/9/1,臺南市,玉井區,5117,15076,7836,7240
2012/9/1,臺南市,楠西區,3548,10298,5465,4833
2012/9/1,臺南市,南化區,2828,8785,4795,3990
2012/9/1,臺南市,左鎮區,1987,5311,2973,2338
2012/9/1,臺南市,仁德區,25511,70981,36274,34707
2012/9/1,臺南市,歸仁區,21210,66461,33823,32638
2012/9/1,臺南市,關廟區,10806,35386,18360,17026
2012/9/1,臺南市,龍崎區,1591,4297,2335,1962
2012/9/1,臺南市,永康區,78481,223459,110813,112646
2012/9/1,臺南市,東區,71737,193037,93023,100014
2012/9/1,臺南市,南區,44084,126039,63066,62973
2012/9/1,臺南市,北區,49044,132180,64915,67265
2012/9/1,臺南市,安南區,57063,182116,92342,89774
2012/9/1,臺南市,安平區,23986,64289,30780,33509
2012/9/1,臺南市,中西區,30474,78500,38412,40088
2012/9/1,高雄市,鹽埕區,11053,26375,13164,13211
2012/9/1,高雄市,鼓山區,53880,133740,65214,68526
2012/9/1,高雄市,左營區,75645,194307,95050,99257
2012/9/1,高雄市,楠梓區,63738,175254,86817,88437
2012/9/1,高雄市,三民區,133255,350081,170759,179322
2012/9/1,高雄市,新興區,22844,53871,26078,27793
2012/9/1,高雄市,前金區,12594,28270,13743,14527
2012/9/1,高雄市,苓雅區,72250,179913,87365,92548
2012/9/1,高雄市,前鎮區,77360,196648,97443,99205
2012/9/1,高雄市,旗津區,10991,29529,15319,14210
2012/9/1,高雄市,小港區,64842,155267,77760,77507
2012/9/1,高雄市,鳳山區,131499,348695,172752,175943
2012/9/1,高雄市,林園區,24878,70319,35956,34363
2012/9/1,高雄市,大寮區,39543,109562,56681,52881
2012/9/1,高雄市,大樹區,13150,43444,22433,21011
2012/9/1,高雄市,大社區,12086,33699,17255,16444
2012/9/1,高雄市,仁武區,28189,77003,39593,37410
2012/9/1,高雄市,鳥松區,17168,43572,22112,21460
2012/9/1,高雄市,岡山區,33956,97511,48711,48800
2012/9/1,高雄市,橋頭區,12980,36923,18852,18071
2012/9/1,高雄市,燕巢區,10168,30810,16368,14442
2012/9/1,高雄市,田寮區,3491,7878,4399,3479
2012/9/1,高雄市,阿蓮區,9303,30045,15177,14868
2012/9/1,高雄市,路竹區,16324,53241,27198,26043
2012/9/1,高雄市,湖內區,10005,29055,14947,14108
2012/9/1,高雄市,茄萣區,10267,30966,16084,14882
2012/9/1,高雄市,永安區,5833,14118,7154,6964
2012/9/1,高雄市,彌陀區,6690,20157,10465,9692
2012/9/1,高雄市,梓官區,12263,36473,18921,17552
2012/9/1,高雄市,旗山區,13867,39101,20288,18813
2012/9/1,高雄市,美濃區,14370,42214,22047,20167
2012/9/1,高雄市,六龜區,5747,14241,7695,6546
2012/9/1,高雄市,甲仙區,2428,6674,3559,3115
2012/9/1,高雄市,杉林區,4778,12461,6781,5680
2012/9/1,高雄市,內門區,5055,15533,8479,7054
2012/9/1,高雄市,茂林區,580,1831,915,916
2012/9/1,高雄市,桃源區,1364,4586,2420,2166
2012/9/1,高雄市,那瑪夏區,880,3183,1642,1541
2012/9/1,宜蘭縣,宜蘭市,34322,95843,47013,48830
2012/9/1,宜蘭縣,羅東鎮,25419,72546,34738,37808
2012/9/1,宜蘭縣,蘇澳鎮,13772,41955,21479,20476
2012/9/1,宜蘭縣,頭城鎮,9938,30382,15706,14676
2012/9/1,宜蘭縣,礁溪鄉,12908,35990,18792,17198
2012/9/1,宜蘭縣,壯圍鄉,8282,24571,13033,11538
2012/9/1,宜蘭縣,員山鄉,11039,32114,17189,14925
2012/9/1,宜蘭縣,冬山鄉,18021,53231,27366,25865
2012/9/1,宜蘭縣,五結鄉,13395,38888,20130,18758
2012/9/1,宜蘭縣,三星鄉,7711,21105,11410,9695
2012/9/1,宜蘭縣,大同鄉,1849,5910,3217,2693
2012/9/1,宜蘭縣,南澳鄉,1859,5897,3142,2755
2012/9/1,桃園市,桃園區,149924,412761,201967,210794
2012/9/1,桃園市,中壢區,132851,375438,187047,188391
2012/9/1,桃園市,平鎮區,69065,209139,105156,103983
2012/9/1,桃園市,八德區,60491,178523,90491,88032
2012/9/1,桃園市,楊梅區,51131,153763,78058,75705
2012/9/1,桃園市,大溪區,29993,91893,47328,44565
2012/9/1,桃園市,蘆竹區,50739,146032,73047,72985
2012/9/1,桃園市,大園區,26826,82436,42656,39780
2012/9/1,桃園市,龜山區,51793,139293,70296,68997
2012/9/1,桃園市,龍潭區,37768,115116,58289,56827
2012/9/1,桃園市,新屋區,15163,48345,25891,22454
2012/9/1,桃園市,觀音區,19895,62385,32764,29621
2012/9/1,桃園市,復興區,3701,10592,5905,4687
2012/9/1,新竹縣,竹北市,51894,151274,75594,75680
2012/9/1,新竹縣,關西鎮,9442,31254,16636,14618
2012/9/1,新竹縣,新埔鎮,10534,34982,18612,16370
2012/9/1,新竹縣,竹東鎮,31564,96651,48653,47998
2012/9/1,新竹縣,湖口鄉,24242,76296,38854,37442
2012/9/1,新竹縣,橫山鄉,4486,14072,7625,6447
2012/9/1,新竹縣,新豐鄉,16482,54243,27853,26390
2012/9/1,新竹縣,芎林鄉,6367,20367,10729,9638
2012/9/1,新竹縣,寶山鄉,4933,14068,7597,6471
2012/9/1,新竹縣,北埔鄉,3137,9888,5356,4532
2012/9/1,新竹縣,峨眉鄉,2052,5838,3249,2589
2012/9/1,新竹縣,尖石鄉,2764,8885,4796,4089
2012/9/1,新竹縣,五峰鄉,1727,4558,2503,2055
2012/9/1,苗栗縣,苗栗市,29929,90961,45657,45304
2012/9/1,苗栗縣,苑裡鎮,14125,48396,25185,23211
2012/9/1,苗栗縣,通霄鎮,11489,37453,19797,17656
2012/9/1,苗栗縣,竹南鎮,25428,80516,40850,39666
2012/9/1,苗栗縣,頭份市,31226,99650,50519,49131
2012/9/1,苗栗縣,後龍鎮,11836,38759,20428,18331
2012/9/1,苗栗縣,卓蘭鎮,6058,18355,9648,8707
2012/9/1,苗栗縣,大湖鄉,5391,15833,8413,7420
2012/9/1,苗栗縣,公館鄉,10462,34900,18189,16711
2012/9/1,苗栗縣,銅鑼鄉,6066,19207,10198,9009
2012/9/1,苗栗縣,南庄鄉,3973,10837,5955,4882
2012/9/1,苗栗縣,頭屋鄉,3589,11458,6052,5406
2012/9/1,苗栗縣,三義鄉,5402,17464,9160,8304
2012/9/1,苗栗縣,西湖鄉,2700,7725,4278,3447
2012/9/1,苗栗縣,造橋鄉,4083,13632,7168,6464
2012/9/1,苗栗縣,三灣鄉,2422,7198,3915,3283
2012/9/1,苗栗縣,獅潭鄉,1712,4780,2673,2107
2012/9/1,苗栗縣,泰安鄉,1972,5889,3182,2707
2012/9/1,彰化縣,彰化市,73648,236482,117498,118984
2012/9/1,彰化縣,鹿港鎮,23030,85755,43829,41926
2012/9/1,彰化縣,和美鎮,25002,90214,46190,44024
2012/9/1,彰化縣,北斗鎮,10165,33282,16817,16465
2012/9/1,彰化縣,員林市,37586,125073,62760,62313
2012/9/1,彰化縣,溪湖鎮,15545,55858,28493,27365
2012/9/1,彰化縣,田中鎮,12723,43386,22500,20886
2012/9/1,彰化縣,二林鎮,14538,53219,27451,25768
2012/9/1,彰化縣,線西鄉,4176,17058,8811,8247
2012/9/1,彰化縣,伸港鄉,9209,35949,18442,17507
2012/9/1,彰化縣,福興鄉,12284,48153,25137,23016
2012/9/1,彰化縣,秀水鄉,10091,39379,20343,19036
2012/9/1,彰化縣,花壇鄉,13263,46008,23695,22313
2012/9/1,彰化縣,芬園鄉,6881,24429,12906,11523
2012/9/1,彰化縣,大村鄉,10479,36465,18982,17483
2012/9/1,彰化縣,埔鹽鄉,8910,33785,17704,16081
2012/9/1,彰化縣,埔心鄉,10147,35173,18148,17025
2012/9/1,彰化縣,永靖鄉,10605,38745,20127,18618
2012/9/1,彰化縣,社頭鄉,12537,44208,22693,21515
2012/9/1,彰化縣,二水鄉,5354,16166,8487,7679
2012/9/1,彰化縣,田尾鄉,7761,28108,14631,13477
2012/9/1,彰化縣,埤頭鄉,8758,31392,16397,14995
2012/9/1,彰化縣,芳苑鄉,10056,35404,18724,16680
2012/9/1,彰化縣,大城鄉,5391,18371,9982,8389
2012/9/1,彰化縣,竹塘鄉,4632,16251,8560,7691
2012/9/1,彰化縣,溪州鄉,8799,31133,16403,14730
2012/9/1,南投縣,南投市,33914,103421,51955,51466
2012/9/1,南投縣,埔里鎮,28716,84383,42430,41953
2012/9/1,南投縣,草屯鎮,31743,99284,50179,49105
2012/9/1,南投縣,竹山鎮,19658,57613,29649,27964
2012/9/1,南投縣,集集鎮,4333,11592,6048,5544
2012/9/1,南投縣,名間鄉,12332,40673,21360,19313
2012/9/1,南投縣,鹿谷鄉,7096,18832,10012,8820
2012/9/1,南投縣,中寮鄉,5655,15876,8622,7254
2012/9/1,南投縣,魚池鄉,5779,16786,8831,7955
2012/9/1,南投縣,國姓鄉,7250,20185,10972,9213
2012/9/1,南投縣,水里鄉,7245,19399,10175,9224
2012/9/1,南投縣,信義鄉,5254,16825,9090,7735
2012/9/1,南投縣,仁愛鄉,4925,15505,8081,7424
2012/9/1,雲林縣,斗六市,35953,107603,53893,53710
2012/9/1,雲林縣,斗南鎮,15502,46566,23666,22900
2012/9/1,雲林縣,虎尾鎮,23296,70314,35734,34580
2012/9/1,雲林縣,西螺鎮,14202,47808,24315,23493
2012/9/1,雲林縣,土庫鎮,8948,30003,15688,14315
2012/9/1,雲林縣,北港鎮,15761,42433,22087,20346
2012/9/1,雲林縣,古坑鄉,10785,33311,17600,15711
2012/9/1,雲林縣,大埤鄉,6712,20621,11098,9523
2012/9/1,雲林縣,莿桐鄉,9154,29986,15744,14242
2012/9/1,雲林縣,林內鄉,5846,19479,10145,9334
2012/9/1,雲林縣,二崙鄉,8843,29092,15552,13540
2012/9/1,雲林縣,崙背鄉,8445,26619,14048,12571
2012/9/1,雲林縣,麥寮鄉,13260,40539,20784,19755
2012/9/1,雲林縣,東勢鄉,5791,16125,8815,7310
2012/9/1,雲林縣,褒忠鄉,4366,13895,7419,6476
2012/9/1,雲林縣,臺西鄉,8864,25178,13555,11623
2012/9/1,雲林縣,元長鄉,9393,28044,15293,12751
2012/9/1,雲林縣,四湖鄉,9083,25957,14115,11842
2012/9/1,雲林縣,口湖鄉,9673,29614,15808,13806
2012/9/1,雲林縣,水林鄉,10363,27854,15239,12615
2012/9/1,嘉義縣,太保市,11728,36805,18961,17844
2012/9/1,嘉義縣,朴子市,15059,43858,22294,21564
2012/9/1,嘉義縣,布袋鎮,10186,29289,15041,14248
2012/9/1,嘉義縣,大林鎮,11367,32955,16953,16002
2012/9/1,嘉義縣,民雄鄉,23445,72323,37078,35245
2012/9/1,嘉義縣,溪口鄉,5423,15866,8466,7400
2012/9/1,嘉義縣,新港鄉,10475,33966,17931,16035
2012/9/1,嘉義縣,六腳鄉,9128,25388,13469,11919
2012/9/1,嘉義縣,東石鄉,9492,26762,14223,12539
2012/9/1,嘉義縣,義竹鄉,7519,20293,10551,9742
2012/9/1,嘉義縣,鹿草鄉,5823,16865,9058,7807
2012/9/1,嘉義縣,水上鄉,17572,51537,26605,24932
2012/9/1,嘉義縣,中埔鄉,15692,47009,24504,22505
2012/9/1,嘉義縣,竹崎鄉,11466,37916,20211,17705
2012/9/1,嘉義縣,梅山鄉,6739,20905,11075,9830
2012/9/1,嘉義縣,番路鄉,4076,11716,6393,5323
2012/9/1,嘉義縣,大埔鄉,1929,4548,2390,2158
2012/9/1,嘉義縣,阿里山鄉,2070,6177,3295,2882
2012/9/1,屏東縣,屏東市,72917,208162,103523,104639
2012/9/1,屏東縣,潮州鎮,18612,55312,27773,27539
2012/9/1,屏東縣,東港鎮,16019,49283,24906,24377
2012/9/1,屏東縣,恆春鎮,11030,30747,15766,14981
2012/9/1,屏東縣,萬丹鄉,14563,53210,27580,25630
2012/9/1,屏東縣,長治鄉,9856,30620,16007,14613
2012/9/1,屏東縣,麟洛鄉,3636,11307,5859,5448
2012/9/1,屏東縣,九如鄉,6668,22599,11725,10874
2012/9/1,屏東縣,里港鄉,7994,26185,13365,12820
2012/9/1,屏東縣,鹽埔鄉,7802,26827,13971,12856
2012/9/1,屏東縣,高樹鄉,9424,26066,13917,12149
2012/9/1,屏東縣,萬巒鄉,6446,21402,11272,10130
2012/9/1,屏東縣,內埔鄉,18105,57120,29656,27464
2012/9/1,屏東縣,竹田鄉,5622,18061,9571,8490
2012/9/1,屏東縣,新埤鄉,3397,10408,5526,4882
2012/9/1,屏東縣,枋寮鄉,8543,26016,13676,12340
2012/9/1,屏東縣,新園鄉,11649,37489,19406,18083
2012/9/1,屏東縣,崁頂鄉,4336,16673,8479,8194
2012/9/1,屏東縣,林邊鄉,7116,20008,10302,9706
2012/9/1,屏東縣,南州鄉,3661,11340,5804,5536
2012/9/1,屏東縣,佳冬鄉,7130,20838,10867,9971
2012/9/1,屏東縣,琉球鄉,4041,12084,6735,5349
2012/9/1,屏東縣,車城鄉,3491,9259,5014,4245
2012/9/1,屏東縣,滿州鄉,3054,8281,4559,3722
2012/9/1,屏東縣,枋山鄉,2111,5836,3140,2696
2012/9/1,屏東縣,三地門鄉,2220,7520,3850,3670
2012/9/1,屏東縣,霧臺鄉,1012,3062,1603,1459
2012/9/1,屏東縣,瑪家鄉,1941,6551,3392,3159
2012/9/1,屏東縣,泰武鄉,1235,5055,2642,2413
2012/9/1,屏東縣,來義鄉,2216,7656,3941,3715
2012/9/1,屏東縣,春日鄉,1328,4827,2495,2332
2012/9/1,屏東縣,獅子鄉,1489,4779,2522,2257
2012/9/1,屏東縣,牡丹鄉,1892,4840,2515,2325
2012/9/1,臺東縣,臺東市,38414,107777,54430,53347
2012/9/1,臺東縣,成功鎮,5428,15339,8119,7220
2012/9/1,臺東縣,關山鎮,3238,9450,4968,4482
2012/9/1,臺東縣,卑南鄉,6632,17865,9588,8277
2012/9/1,臺東縣,大武鄉,2507,6648,3468,3180
2012/9/1,臺東縣,太麻里鄉,4561,11725,6250,5475
2012/9/1,臺東縣,東河鄉,3714,9153,5089,4064
2012/9/1,臺東縣,長濱鄉,2917,7924,4520,3404
2012/9/1,臺東縣,鹿野鄉,3134,8344,4489,3855
2012/9/1,臺東縣,池上鄉,3287,8889,4673,4216
2012/9/1,臺東縣,綠島鄉,1059,3450,1832,1618
2012/9/1,臺東縣,延平鄉,1060,3535,1936,1599
2012/9/1,臺東縣,海端鄉,1099,4379,2373,2006
2012/9/1,臺東縣,達仁鄉,1494,3846,2098,1748
2012/9/1,臺東縣,金峰鄉,1068,3513,1828,1685
2012/9/1,臺東縣,蘭嶼鄉,1604,4784,2447,2337
2012/9/1,花蓮縣,花蓮市,41029,108164,52783,55381
2012/9/1,花蓮縣,鳳林鎮,4420,11560,6120,5440
2012/9/1,花蓮縣,玉里鎮,8903,26105,14107,11998
2012/9/1,花蓮縣,新城鄉,7411,20150,10459,9691
2012/9/1,花蓮縣,吉安鄉,30031,81124,41330,39794
2012/9/1,花蓮縣,壽豐鄉,6874,18325,9878,8447
2012/9/1,花蓮縣,光復鄉,5030,13645,7282,6363
2012/9/1,花蓮縣,豐濱鄉,1775,4702,2631,2071
2012/9/1,花蓮縣,瑞穗鄉,4662,12413,6708,5705
2012/9/1,花蓮縣,富里鄉,4022,11208,6126,5082
2012/9/1,花蓮縣,秀林鄉,4685,15106,7841,7265
2012/9/1,花蓮縣,萬榮鄉,2113,6642,3549,3093
2012/9/1,花蓮縣,卓溪鄉,1659,6187,3442,2745
2012/9/1,澎湖縣,馬公市,21266,57846,29338,28508
2012/9/1,澎湖縣,湖西鄉,4985,13858,7241,6617
2012/9/1,澎湖縣,白沙鄉,3202,9455,4970,4485
2012/9/1,澎湖縣,西嶼鄉,2895,8335,4295,4040
2012/9/1,澎湖縣,望安鄉,1989,5015,2678,2337
2012/9/1,澎湖縣,七美鄉,1298,3595,1889,1706
2012/9/1,基隆市,中正區,22273,54135,27746,26389
2012/9/1,基隆市,七堵區,20453,54344,27554,26790
2012/9/1,基隆市,暖暖區,14702,37822,19189,18633
2012/9/1,基隆市,仁愛區,19725,47963,23637,24326
2012/9/1,基隆市,中山區,19266,49815,25452,24363
2012/9/1,基隆市,安樂區,31964,82395,41088,41307
2012/9/1,基隆市,信義區,20443,51063,25486,25577
2012/9/1,新竹市,東區,72142,202333,99847,102486
2012/9/1,新竹市,北區,52475,147167,72493,74674
2012/9/1,新竹市,香山區,24007,74192,37838,36354
2012/9/1,嘉義市,東區,44726,124381,60649,63732
2012/9/1,嘉義市,西區,52225,146958,72544,74414
2012/9/1,金門縣,金城鎮,11843,36351,18282,18069
2012/9/1,金門縣,金湖鎮,7816,24161,12267,11894
2012/9/1,金門縣,金沙鎮,5723,17224,8614,8610
2012/9/1,金門縣,金寧鄉,6678,22281,11371,10910
2012/9/1,金門縣,烈嶼鄉,2826,10234,5070,5164
2012/9/1,金門縣,烏坵鄉,134,600,299,301
2012/9/1,連江縣,南竿鄉,1306,6500,3679,2821
2012/9/1,連江縣,北竿鄉,438,2021,1121,900
2012/9/1,連江縣,莒光鄉,265,1300,775,525
2012/9/1,連江縣,東引鄉,286,1116,661,455
2012/10/1,總計,新北市,1455601,3935072,1945232,1989840
2012/10/1,總計,臺北市,1015991,2668231,1283262,1384969
2012/10/1,總計,臺中市,881529,2681041,1331586,1349455
2012/10/1,總計,臺南市,655442,1880360,944569,935791
2012/10/1,總計,高雄市,1045437,2777128,1387672,1389456
2012/10/1,總計,臺灣省,3081245,9228928,4710127,4518801
2012/10/1,總計,宜蘭縣,158642,458438,233207,225231
2012/10/1,總計,桃園市,699989,2027097,1019473,1007624
2012/10/1,總計,新竹縣,169905,522855,268261,254594
2012/10/1,總計,苗栗縣,177990,563300,291338,271962
2012/10/1,總計,彰化縣,371857,1299606,665829,633777
2012/10/1,總計,南投縣,174010,520289,267371,252918
2012/10/1,總計,雲林縣,234452,711183,370639,340544
2012/10/1,總計,嘉義縣,179320,533985,278400,255585
2012/10/1,總計,屏東縣,280674,859066,441132,417934
2012/10/1,總計,臺東縣,81306,226513,118024,108489
2012/10/1,總計,花蓮縣,122600,335288,172197,163091
2012/10/1,總計,澎湖縣,36072,98612,50662,47950
2012/10/1,總計,基隆市,148770,377309,190049,187260
2012/10/1,總計,新竹市,148726,424099,210376,213723
2012/10/1,總計,嘉義市,96932,271288,133169,138119
2012/10/1,總計,福建省,37436,122833,62678,60155
2012/10/1,總計,金門縣,35131,111775,56370,55405
2012/10/1,總計,連江縣,2305,11058,6308,4750
2012/10/1,新北市,板橋區,201634,557040,274172,282868
2012/10/1,新北市,三重區,144143,390057,193641,196416
2012/10/1,新北市,中和區,159687,416365,204640,211725
2012/10/1,新北市,永和區,90448,230958,110525,120433
2012/10/1,新北市,新莊區,141809,406550,200145,206405
2012/10/1,新北市,新店區,119302,297421,144792,152629
2012/10/1,新北市,樹林區,63449,181595,91105,90490
2012/10/1,新北市,鶯歌區,28483,88122,44387,43735
2012/10/1,新北市,三峽區,38099,107374,54500,52874
2012/10/1,新北市,淡水區,62242,149946,72565,77381
2012/10/1,新北市,汐止區,81854,192385,95076,97309
2012/10/1,新北市,瑞芳區,15966,41667,21157,20510
2012/10/1,新北市,土城區,84396,239810,119376,120434
2012/10/1,新北市,蘆洲區,67330,199292,98364,100928
2012/10/1,新北市,五股區,28271,81131,41031,40100
2012/10/1,新北市,泰山區,26923,77515,38771,38744
2012/10/1,新北市,林口區,33800,89289,43980,45309
2012/10/1,新北市,深坑區,9202,23532,11845,11687
2012/10/1,新北市,石碇區,3341,7890,4349,3541
2012/10/1,新北市,坪林區,2478,6484,3618,2866
2012/10/1,新北市,三芝區,9069,23424,12075,11349
2012/10/1,新北市,石門區,4225,12777,6689,6088
2012/10/1,新北市,八里區,12875,35590,17956,17634
2012/10/1,新北市,平溪區,2394,5124,2847,2277
2012/10/1,新北市,雙溪區,3813,9460,5112,4348
2012/10/1,新北市,貢寮區,4471,13424,6909,6515
2012/10/1,新北市,金山區,6882,22452,11203,11249
2012/10/1,新北市,萬里區,7255,22438,11400,11038
2012/10/1,新北市,烏來區,1760,5960,3002,2958
2012/10/1,臺北市,松山區,79621,210538,99699,110839
2012/10/1,臺北市,信義區,88007,227507,109357,118150
2012/10/1,臺北市,大安區,118942,313183,147048,166135
2012/10/1,臺北市,中山區,95889,226149,106005,120144
2012/10/1,臺北市,中正區,63835,161725,77771,83954
2012/10/1,臺北市,大同區,49737,128547,63101,65446
2012/10/1,臺北市,萬華區,76547,192303,95463,96840
2012/10/1,臺北市,文山區,100707,268700,129781,138919
2012/10/1,臺北市,南港區,44088,118094,57843,60251
2012/10/1,臺北市,內湖區,102013,279166,134212,144954
2012/10/1,臺北市,士林區,103960,288540,139928,148612
2012/10/1,臺北市,北投區,92645,253779,123054,130725
2012/10/1,臺中市,中區,8088,20740,10309,10431
2012/10/1,臺中市,東區,26527,74223,37294,36929
2012/10/1,臺中市,南區,44113,116590,56412,60178
2012/10/1,臺中市,西區,44122,116684,55716,60968
2012/10/1,臺中市,北區,57146,147720,71332,76388
2012/10/1,臺中市,西屯區,76811,212457,102635,109822
2012/10/1,臺中市,南屯區,55778,157864,76130,81734
2012/10/1,臺中市,北屯區,87286,252159,121987,130172
2012/10/1,臺中市,豐原區,51039,165999,82317,83682
2012/10/1,臺中市,東勢區,17149,52420,27149,25271
2012/10/1,臺中市,大甲區,22097,78002,39577,38425
2012/10/1,臺中市,清水區,25473,85667,44159,41508
2012/10/1,臺中市,沙鹿區,25360,84528,42960,41568
2012/10/1,臺中市,梧棲區,16421,55797,28204,27593
2012/10/1,臺中市,后里區,15100,54056,27653,26403
2012/10/1,臺中市,神岡區,18164,64464,33140,31324
2012/10/1,臺中市,潭子區,33649,103247,51344,51903
2012/10/1,臺中市,大雅區,26994,91179,45819,45360
2012/10/1,臺中市,新社區,7397,25397,13259,12138
2012/10/1,臺中市,石岡區,4879,15761,8201,7560
2012/10/1,臺中市,外埔區,9035,31794,16363,15431
2012/10/1,臺中市,大安區,5314,19945,10482,9463
2012/10/1,臺中市,烏日區,21430,69855,35321,34534
2012/10/1,臺中市,大肚區,16251,55820,28582,27238
2012/10/1,臺中市,龍井區,21307,74998,38047,36951
2012/10/1,臺中市,霧峰區,19066,64123,32881,31242
2012/10/1,臺中市,太平區,56663,176195,88261,87934
2012/10/1,臺中市,大里區,64475,202784,100346,102438
2012/10/1,臺中市,和平區,4395,10573,5706,4867
2012/10/1,臺南市,新營區,27864,78498,39075,39423
2012/10/1,臺南市,鹽水區,10056,26702,13891,12811
2012/10/1,臺南市,白河區,11015,30622,16049,14573
2012/10/1,臺南市,柳營區,7821,22192,11595,10597
2012/10/1,臺南市,後壁區,8908,25315,13177,12138
2012/10/1,臺南市,東山區,8265,22549,11950,10599
2012/10/1,臺南市,麻豆區,15296,45431,23176,22255
2012/10/1,臺南市,下營區,9136,25628,13236,12392
2012/10/1,臺南市,六甲區,7724,23354,12119,11235
2012/10/1,臺南市,官田區,7704,21911,11201,10710
2012/10/1,臺南市,大內區,4024,10536,5624,4912
2012/10/1,臺南市,佳里區,19785,59245,29414,29831
2012/10/1,臺南市,學甲區,9642,27396,14018,13378
2012/10/1,臺南市,西港區,7932,25018,12695,12323
2012/10/1,臺南市,七股區,8037,24235,12637,11598
2012/10/1,臺南市,將軍區,7436,21071,10702,10369
2012/10/1,臺南市,北門區,4395,12102,6133,5969
2012/10/1,臺南市,新化區,13975,43916,22530,21386
2012/10/1,臺南市,善化區,15384,44546,22462,22084
2012/10/1,臺南市,新市區,11151,35164,17678,17486
2012/10/1,臺南市,安定區,9530,30266,15635,14631
2012/10/1,臺南市,山上區,2736,7703,4034,3669
2012/10/1,臺南市,玉井區,5115,15063,7833,7230
2012/10/1,臺南市,楠西區,3547,10301,5467,4834
2012/10/1,臺南市,南化區,2828,8782,4797,3985
2012/10/1,臺南市,左鎮區,1984,5296,2961,2335
2012/10/1,臺南市,仁德區,25549,71088,36319,34769
2012/10/1,臺南市,歸仁區,21220,66522,33867,32655
2012/10/1,臺南市,關廟區,10801,35391,18359,17032
2012/10/1,臺南市,龍崎區,1592,4309,2345,1964
2012/10/1,臺南市,永康區,78552,223806,110975,112831
2012/10/1,臺南市,東區,71736,192964,93001,99963
2012/10/1,臺南市,南區,44075,126005,63040,62965
2012/10/1,臺南市,北區,49056,132219,64919,67300
2012/10/1,臺南市,安南區,57109,182354,92464,89890
2012/10/1,臺南市,安平區,23985,64332,30775,33557
2012/10/1,臺南市,中西區,30477,78528,38416,40112
2012/10/1,高雄市,鹽埕區,11034,26300,13144,13156
2012/10/1,高雄市,鼓山區,53884,133781,65208,68573
2012/10/1,高雄市,左營區,75625,194520,95121,99399
2012/10/1,高雄市,楠梓區,63767,175413,86888,88525
2012/10/1,高雄市,三民區,133232,350019,170644,179375
2012/10/1,高雄市,新興區,22837,53801,26041,27760
2012/10/1,高雄市,前金區,12571,28223,13713,14510
2012/10/1,高雄市,苓雅區,72182,179727,87246,92481
2012/10/1,高雄市,前鎮區,77331,196528,97388,99140
2012/10/1,高雄市,旗津區,10989,29537,15335,14202
2012/10/1,高雄市,小港區,64857,155331,77754,77577
2012/10/1,高雄市,鳳山區,131613,349089,172908,176181
2012/10/1,高雄市,林園區,24925,70365,35985,34380
2012/10/1,高雄市,大寮區,39564,109606,56709,52897
2012/10/1,高雄市,大樹區,13138,43400,22418,20982
2012/10/1,高雄市,大社區,12084,33694,17259,16435
2012/10/1,高雄市,仁武區,28227,77142,39640,37502
2012/10/1,高雄市,鳥松區,17179,43590,22137,21453
2012/10/1,高雄市,岡山區,33970,97536,48719,48817
2012/10/1,高雄市,橋頭區,12991,36960,18877,18083
2012/10/1,高雄市,燕巢區,10185,30828,16380,14448
2012/10/1,高雄市,田寮區,3489,7876,4396,3480
2012/10/1,高雄市,阿蓮區,9294,30026,15164,14862
2012/10/1,高雄市,路竹區,16306,53204,27189,26015
2012/10/1,高雄市,湖內區,10001,29081,14958,14123
2012/10/1,高雄市,茄萣區,10277,30977,16094,14883
2012/10/1,高雄市,永安區,5829,14119,7152,6967
2012/10/1,高雄市,彌陀區,6687,20138,10464,9674
2012/10/1,高雄市,梓官區,12283,36518,18941,17577
2012/10/1,高雄市,旗山區,13870,39089,20271,18818
2012/10/1,高雄市,美濃區,14376,42197,22033,20164
2012/10/1,高雄市,六龜區,5750,14233,7687,6546
2012/10/1,高雄市,甲仙區,2426,6660,3553,3107
2012/10/1,高雄市,杉林區,4784,12466,6781,5685
2012/10/1,高雄市,內門區,5052,15537,8488,7049
2012/10/1,高雄市,茂林區,581,1839,921,918
2012/10/1,高雄市,桃源區,1362,4584,2419,2165
2012/10/1,高雄市,那瑪夏區,885,3194,1647,1547
2012/10/1,宜蘭縣,宜蘭市,34416,95938,47040,48898
2012/10/1,宜蘭縣,羅東鎮,25410,72458,34709,37749
2012/10/1,宜蘭縣,蘇澳鎮,13790,41942,21469,20473
2012/10/1,宜蘭縣,頭城鎮,9940,30351,15685,14666
2012/10/1,宜蘭縣,礁溪鄉,12881,35961,18776,17185
2012/10/1,宜蘭縣,壯圍鄉,8291,24572,13023,11549
2012/10/1,宜蘭縣,員山鄉,11042,32108,17189,14919
2012/10/1,宜蘭縣,冬山鄉,18022,53264,27381,25883
2012/10/1,宜蘭縣,五結鄉,13418,38902,20148,18754
2012/10/1,宜蘭縣,三星鄉,7717,21144,11433,9711
2012/10/1,宜蘭縣,大同鄉,1854,5910,3218,2692
2012/10/1,宜蘭縣,南澳鄉,1861,5888,3136,2752
2012/10/1,桃園市,桃園區,149941,412859,201990,210869
2012/10/1,桃園市,中壢區,133051,375738,187210,188528
2012/10/1,桃園市,平鎮區,69078,209189,105174,104015
2012/10/1,桃園市,八德區,60559,178670,90567,88103
2012/10/1,桃園市,楊梅區,51205,153992,78146,75846
2012/10/1,桃園市,大溪區,30001,91916,47316,44600
2012/10/1,桃園市,蘆竹區,50801,146207,73114,73093
2012/10/1,桃園市,大園區,26889,82495,42689,39806
2012/10/1,桃園市,龜山區,51883,139478,70360,69118
2012/10/1,桃園市,龍潭區,37789,115139,58314,56825
2012/10/1,桃園市,新屋區,15177,48320,25867,22453
2012/10/1,桃園市,觀音區,19918,62484,32812,29672
2012/10/1,桃園市,復興區,3697,10610,5914,4696
2012/10/1,新竹縣,竹北市,52065,151737,75793,75944
2012/10/1,新竹縣,關西鎮,9456,31249,16641,14608
2012/10/1,新竹縣,新埔鎮,10543,34965,18607,16358
2012/10/1,新竹縣,竹東鎮,31577,96589,48624,47965
2012/10/1,新竹縣,湖口鄉,24259,76344,38869,37475
2012/10/1,新竹縣,橫山鄉,4484,14048,7613,6435
2012/10/1,新竹縣,新豐鄉,16514,54301,27883,26418
2012/10/1,新竹縣,芎林鄉,6371,20362,10727,9635
2012/10/1,新竹縣,寶山鄉,4941,14088,7602,6486
2012/10/1,新竹縣,北埔鄉,3141,9881,5356,4525
2012/10/1,新竹縣,峨眉鄉,2053,5834,3250,2584
2012/10/1,新竹縣,尖石鄉,2776,8922,4805,4117
2012/10/1,新竹縣,五峰鄉,1725,4535,2491,2044
2012/10/1,苗栗縣,苗栗市,29921,90961,45657,45304
2012/10/1,苗栗縣,苑裡鎮,14141,48441,25189,23252
2012/10/1,苗栗縣,通霄鎮,11490,37471,19796,17675
2012/10/1,苗栗縣,竹南鎮,25451,80594,40873,39721
2012/10/1,苗栗縣,頭份市,31265,99759,50558,49201
2012/10/1,苗栗縣,後龍鎮,11845,38777,20439,18338
2012/10/1,苗栗縣,卓蘭鎮,6072,18405,9675,8730
2012/10/1,苗栗縣,大湖鄉,5394,15823,8406,7417
2012/10/1,苗栗縣,公館鄉,10462,34877,18172,16705
2012/10/1,苗栗縣,銅鑼鄉,6070,19201,10190,9011
2012/10/1,苗栗縣,南庄鄉,3984,10857,5961,4896
2012/10/1,苗栗縣,頭屋鄉,3586,11451,6052,5399
2012/10/1,苗栗縣,三義鄉,5406,17474,9157,8317
2012/10/1,苗栗縣,西湖鄉,2704,7730,4284,3446
2012/10/1,苗栗縣,造橋鄉,4087,13624,7162,6462
2012/10/1,苗栗縣,三灣鄉,2425,7189,3912,3277
2012/10/1,苗栗縣,獅潭鄉,1711,4786,2678,2108
2012/10/1,苗栗縣,泰安鄉,1976,5880,3177,2703
2012/10/1,彰化縣,彰化市,73722,236523,117517,119006
2012/10/1,彰化縣,鹿港鎮,23061,85777,43848,41929
2012/10/1,彰化縣,和美鎮,25006,90293,46211,44082
2012/10/1,彰化縣,北斗鎮,10171,33278,16821,16457
2012/10/1,彰化縣,員林市,37598,125095,62778,62317
2012/10/1,彰化縣,溪湖鎮,15577,55857,28513,27344
2012/10/1,彰化縣,田中鎮,12744,43413,22509,20904
2012/10/1,彰化縣,二林鎮,14549,53219,27451,25768
2012/10/1,彰化縣,線西鄉,4181,17077,8823,8254
2012/10/1,彰化縣,伸港鄉,9217,35964,18449,17515
2012/10/1,彰化縣,福興鄉,12289,48168,25155,23013
2012/10/1,彰化縣,秀水鄉,10106,39382,20341,19041
2012/10/1,彰化縣,花壇鄉,13264,45980,23683,22297
2012/10/1,彰化縣,芬園鄉,6887,24463,12910,11553
2012/10/1,彰化縣,大村鄉,10502,36483,18989,17494
2012/10/1,彰化縣,埔鹽鄉,8915,33763,17696,16067
2012/10/1,彰化縣,埔心鄉,10152,35191,18159,17032
2012/10/1,彰化縣,永靖鄉,10604,38717,20139,18578
2012/10/1,彰化縣,社頭鄉,12548,44192,22690,21502
2012/10/1,彰化縣,二水鄉,5351,16166,8488,7678
2012/10/1,彰化縣,田尾鄉,7759,28086,14625,13461
2012/10/1,彰化縣,埤頭鄉,8768,31403,16403,15000
2012/10/1,彰化縣,芳苑鄉,10049,35375,18702,16673
2012/10/1,彰化縣,大城鄉,5397,18360,9977,8383
2012/10/1,彰化縣,竹塘鄉,4635,16229,8548,7681
2012/10/1,彰化縣,溪州鄉,8805,31152,16404,14748
2012/10/1,南投縣,南投市,33920,103375,51940,51435
2012/10/1,南投縣,埔里鎮,28712,84326,42395,41931
2012/10/1,南投縣,草屯鎮,31763,99303,50218,49085
2012/10/1,南投縣,竹山鎮,19667,57576,29615,27961
2012/10/1,南投縣,集集鎮,4340,11593,6054,5539
2012/10/1,南投縣,名間鄉,12349,40672,21362,19310
2012/10/1,南投縣,鹿谷鄉,7115,18849,10017,8832
2012/10/1,南投縣,中寮鄉,5659,15880,8620,7260
2012/10/1,南投縣,魚池鄉,5774,16765,8822,7943
2012/10/1,南投縣,國姓鄉,7262,20190,10973,9217
2012/10/1,南投縣,水里鄉,7259,19390,10170,9220
2012/10/1,南投縣,信義鄉,5259,16820,9086,7734
2012/10/1,南投縣,仁愛鄉,4931,15550,8099,7451
2012/10/1,雲林縣,斗六市,36011,107688,53928,53760
2012/10/1,雲林縣,斗南鎮,15513,46571,23679,22892
2012/10/1,雲林縣,虎尾鎮,23328,70369,35768,34601
2012/10/1,雲林縣,西螺鎮,14206,47798,24323,23475
2012/10/1,雲林縣,土庫鎮,8959,29998,15684,14314
2012/10/1,雲林縣,北港鎮,15758,42356,22056,20300
2012/10/1,雲林縣,古坑鄉,10790,33299,17586,15713
2012/10/1,雲林縣,大埤鄉,6724,20605,11089,9516
2012/10/1,雲林縣,莿桐鄉,9169,29963,15740,14223
2012/10/1,雲林縣,林內鄉,5837,19413,10111,9302
2012/10/1,雲林縣,二崙鄉,8850,29090,15543,13547
2012/10/1,雲林縣,崙背鄉,8454,26601,14036,12565
2012/10/1,雲林縣,麥寮鄉,13302,40843,20902,19941
2012/10/1,雲林縣,東勢鄉,5791,16105,8813,7292
2012/10/1,雲林縣,褒忠鄉,4370,13889,7414,6475
2012/10/1,雲林縣,臺西鄉,8857,25141,13537,11604
2012/10/1,雲林縣,元長鄉,9402,28035,15284,12751
2012/10/1,雲林縣,四湖鄉,9084,25917,14094,11823
2012/10/1,雲林縣,口湖鄉,9683,29637,15806,13831
2012/10/1,雲林縣,水林鄉,10364,27865,15246,12619
2012/10/1,嘉義縣,太保市,11738,36838,18986,17852
2012/10/1,嘉義縣,朴子市,15088,43823,22252,21571
2012/10/1,嘉義縣,布袋鎮,10187,29274,15041,14233
2012/10/1,嘉義縣,大林鎮,11379,32938,16943,15995
2012/10/1,嘉義縣,民雄鄉,23454,72286,37065,35221
2012/10/1,嘉義縣,溪口鄉,5428,15853,8462,7391
2012/10/1,嘉義縣,新港鄉,10481,33921,17916,16005
2012/10/1,嘉義縣,六腳鄉,9128,25363,13454,11909
2012/10/1,嘉義縣,東石鄉,9496,26768,14222,12546
2012/10/1,嘉義縣,義竹鄉,7513,20237,10525,9712
2012/10/1,嘉義縣,鹿草鄉,5832,16858,9057,7801
2012/10/1,嘉義縣,水上鄉,17578,51528,26599,24929
2012/10/1,嘉義縣,中埔鄉,15711,47056,24523,22533
2012/10/1,嘉義縣,竹崎鄉,11483,37919,20209,17710
2012/10/1,嘉義縣,梅山鄉,6747,20889,11069,9820
2012/10/1,嘉義縣,番路鄉,4079,11719,6397,5322
2012/10/1,嘉義縣,大埔鄉,1930,4535,2382,2153
2012/10/1,嘉義縣,阿里山鄉,2068,6180,3298,2882
2012/10/1,屏東縣,屏東市,72889,208023,103422,104601
2012/10/1,屏東縣,潮州鎮,18620,55251,27736,27515
2012/10/1,屏東縣,東港鎮,16029,49238,24883,24355
2012/10/1,屏東縣,恆春鎮,11037,30738,15760,14978
2012/10/1,屏東縣,萬丹鄉,14566,53159,27556,25603
2012/10/1,屏東縣,長治鄉,9864,30594,15998,14596
2012/10/1,屏東縣,麟洛鄉,3637,11300,5855,5445
2012/10/1,屏東縣,九如鄉,6680,22584,11725,10859
2012/10/1,屏東縣,里港鄉,7991,26221,13382,12839
2012/10/1,屏東縣,鹽埔鄉,7805,26837,13975,12862
2012/10/1,屏東縣,高樹鄉,9434,26071,13933,12138
2012/10/1,屏東縣,萬巒鄉,6456,21410,11276,10134
2012/10/1,屏東縣,內埔鄉,18136,57120,29664,27456
2012/10/1,屏東縣,竹田鄉,5620,18057,9573,8484
2012/10/1,屏東縣,新埤鄉,3391,10383,5514,4869
2012/10/1,屏東縣,枋寮鄉,8541,25996,13654,12342
2012/10/1,屏東縣,新園鄉,11660,37495,19403,18092
2012/10/1,屏東縣,崁頂鄉,4343,16673,8472,8201
2012/10/1,屏東縣,林邊鄉,7115,19959,10280,9679
2012/10/1,屏東縣,南州鄉,3666,11318,5795,5523
2012/10/1,屏東縣,佳冬鄉,7124,20813,10855,9958
2012/10/1,屏東縣,琉球鄉,4046,12096,6736,5360
2012/10/1,屏東縣,車城鄉,3490,9251,5000,4251
2012/10/1,屏東縣,滿州鄉,3056,8291,4570,3721
2012/10/1,屏東縣,枋山鄉,2117,5843,3138,2705
2012/10/1,屏東縣,三地門鄉,2226,7529,3845,3684
2012/10/1,屏東縣,霧臺鄉,1014,3069,1608,1461
2012/10/1,屏東縣,瑪家鄉,1949,6573,3401,3172
2012/10/1,屏東縣,泰武鄉,1239,5062,2648,2414
2012/10/1,屏東縣,來義鄉,2217,7659,3943,3716
2012/10/1,屏東縣,春日鄉,1327,4831,2500,2331
2012/10/1,屏東縣,獅子鄉,1492,4780,2520,2260
2012/10/1,屏東縣,牡丹鄉,1897,4842,2512,2330
2012/10/1,臺東縣,臺東市,38443,107757,54415,53342
2012/10/1,臺東縣,成功鎮,5424,15312,8103,7209
2012/10/1,臺東縣,關山鎮,3244,9436,4958,4478
2012/10/1,臺東縣,卑南鄉,6641,17857,9581,8276
2012/10/1,臺東縣,大武鄉,2513,6637,3461,3176
2012/10/1,臺東縣,太麻里鄉,4561,11694,6236,5458
2012/10/1,臺東縣,東河鄉,3735,9154,5089,4065
2012/10/1,臺東縣,長濱鄉,2915,7918,4517,3401
2012/10/1,臺東縣,鹿野鄉,3131,8324,4479,3845
2012/10/1,臺東縣,池上鄉,3292,8879,4660,4219
2012/10/1,臺東縣,綠島鄉,1060,3456,1835,1621
2012/10/1,臺東縣,延平鄉,1063,3544,1935,1609
2012/10/1,臺東縣,海端鄉,1099,4391,2381,2010
2012/10/1,臺東縣,達仁鄉,1491,3832,2086,1746
2012/10/1,臺東縣,金峰鄉,1074,3517,1832,1685
2012/10/1,臺東縣,蘭嶼鄉,1620,4805,2456,2349
2012/10/1,花蓮縣,花蓮市,41015,108147,52781,55366
2012/10/1,花蓮縣,鳳林鎮,4410,11551,6112,5439
2012/10/1,花蓮縣,玉里鎮,8921,26099,14101,11998
2012/10/1,花蓮縣,新城鄉,7402,20124,10452,9672
2012/10/1,花蓮縣,吉安鄉,30034,81172,41336,39836
2012/10/1,花蓮縣,壽豐鄉,6877,18320,9871,8449
2012/10/1,花蓮縣,光復鄉,5035,13642,7284,6358
2012/10/1,花蓮縣,豐濱鄉,1769,4687,2614,2073
2012/10/1,花蓮縣,瑞穗鄉,4660,12400,6700,5700
2012/10/1,花蓮縣,富里鄉,4021,11201,6114,5087
2012/10/1,花蓮縣,秀林鄉,4695,15151,7860,7291
2012/10/1,花蓮縣,萬榮鄉,2102,6605,3531,3074
2012/10/1,花蓮縣,卓溪鄉,1659,6189,3441,2748
2012/10/1,澎湖縣,馬公市,21668,58304,29566,28738
2012/10/1,澎湖縣,湖西鄉,5004,13908,7267,6641
2012/10/1,澎湖縣,白沙鄉,3210,9464,4974,4490
2012/10/1,澎湖縣,西嶼鄉,2896,8336,4295,4041
2012/10/1,澎湖縣,望安鄉,1991,5003,2672,2331
2012/10/1,澎湖縣,七美鄉,1303,3597,1888,1709
2012/10/1,基隆市,中正區,22260,54058,27710,26348
2012/10/1,基隆市,七堵區,20444,54272,27514,26758
2012/10/1,基隆市,暖暖區,14690,37799,19169,18630
2012/10/1,基隆市,仁愛區,19692,47889,23603,24286
2012/10/1,基隆市,中山區,19270,49786,25433,24353
2012/10/1,基隆市,安樂區,31955,82348,41080,41268
2012/10/1,基隆市,信義區,20459,51157,25540,25617
2012/10/1,新竹市,東區,72152,202527,99934,102593
2012/10/1,新竹市,北區,52543,147332,72573,74759
2012/10/1,新竹市,香山區,24031,74240,37869,36371
2012/10/1,嘉義市,東區,44726,124304,60617,63687
2012/10/1,嘉義市,西區,52206,146984,72552,74432
2012/10/1,金門縣,金城鎮,11875,36598,18392,18206
2012/10/1,金門縣,金湖鎮,7843,24345,12345,12000
2012/10/1,金門縣,金沙鎮,5739,17322,8668,8654
2012/10/1,金門縣,金寧鄉,6705,22605,11554,11051
2012/10/1,金門縣,烈嶼鄉,2835,10303,5112,5191
2012/10/1,金門縣,烏坵鄉,134,602,299,303
2012/10/1,連江縣,南竿鄉,1314,6585,3731,2854
2012/10/1,連江縣,北竿鄉,438,2034,1127,907
2012/10/1,連江縣,莒光鄉,267,1320,786,534
2012/10/1,連江縣,東引鄉,286,1119,664,455
2012/11/1,總計,新北市,1456856,3937149,1945842,1991307
2012/11/1,總計,臺北市,1016644,2671006,1284419,1386587
2012/11/1,總計,臺中市,882449,2683066,1332440,1350626
2012/11/1,總計,臺南市,655898,1881026,944852,936174
2012/11/1,總計,高雄市,1046080,2777897,1387842,1390055
2012/11/1,總計,臺灣省,3083929,9231237,4710826,4520411
2012/11/1,總計,宜蘭縣,158806,458548,233264,225284
2012/11/1,總計,桃園市,700781,2028628,1020127,1008501
2012/11/1,總計,新竹縣,170180,523333,268488,254845
2012/11/1,總計,苗栗縣,178174,563660,291480,272180
2012/11/1,總計,彰化縣,372092,1299692,665853,633839
2012/11/1,總計,南投縣,174167,520278,267354,252924
2012/11/1,總計,雲林縣,234674,711000,370520,340480
2012/11/1,總計,嘉義縣,179504,533933,278303,255630
2012/11/1,總計,屏東縣,280790,858739,440935,417804
2012/11/1,總計,臺東縣,81332,226383,117905,108478
2012/11/1,總計,花蓮縣,122637,335223,172113,163110
2012/11/1,總計,澎湖縣,36122,98745,50745,48000
2012/11/1,總計,基隆市,148822,377259,189993,187266
2012/11/1,總計,新竹市,148880,424533,210593,213940
2012/11/1,總計,嘉義市,96968,271283,133153,138130
2012/11/1,總計,福建省,37573,123640,63088,60552
2012/11/1,總計,金門縣,35264,112444,56710,55734
2012/11/1,總計,連江縣,2309,11196,6378,4818
2012/11/1,新北市,板橋區,201759,557196,274182,283014
2012/11/1,新北市,三重區,144234,390114,193623,196491
2012/11/1,新北市,中和區,159742,416553,204644,211909
2012/11/1,新北市,永和區,90408,230780,110440,120340
2012/11/1,新北市,新莊區,141914,406792,200291,206501
2012/11/1,新北市,新店區,119360,297481,144782,152699
2012/11/1,新北市,樹林區,63501,181770,91178,90592
2012/11/1,新北市,鶯歌區,28543,88263,44445,43818
2012/11/1,新北市,三峽區,38310,107557,54570,52987
2012/11/1,新北市,淡水區,62452,150300,72722,77578
2012/11/1,新北市,汐止區,81900,192523,95114,97409
2012/11/1,新北市,瑞芳區,15960,41658,21142,20516
2012/11/1,新北市,土城區,84431,239775,119361,120414
2012/11/1,新北市,蘆洲區,67399,199380,98405,100975
2012/11/1,新北市,五股區,28270,81164,41046,40118
2012/11/1,新北市,泰山區,26950,77632,38800,38832
2012/11/1,新北市,林口區,33912,89549,44106,45443
2012/11/1,新北市,深坑區,9202,23568,11859,11709
2012/11/1,新北市,石碇區,3345,7890,4349,3541
2012/11/1,新北市,坪林區,2476,6484,3617,2867
2012/11/1,新北市,三芝區,9068,23434,12068,11366
2012/11/1,新北市,石門區,4227,12786,6691,6095
2012/11/1,新北市,八里區,12906,35630,17961,17669
2012/11/1,新北市,平溪區,2392,5119,2841,2278
2012/11/1,新北市,雙溪區,3823,9458,5102,4356
2012/11/1,新北市,貢寮區,4464,13417,6902,6515
2012/11/1,新北市,金山區,6900,22459,11201,11258
2012/11/1,新北市,萬里區,7249,22447,11401,11046
2012/11/1,新北市,烏來區,1759,5970,2999,2971
2012/11/1,臺北市,松山區,79622,210746,99795,110951
2012/11/1,臺北市,信義區,88011,227624,109407,118217
2012/11/1,臺北市,大安區,118943,313314,147078,166236
2012/11/1,臺北市,中山區,95979,226511,106152,120359
2012/11/1,臺北市,中正區,63901,161977,77887,84090
2012/11/1,臺北市,大同區,49823,128704,63142,65562
2012/11/1,臺北市,萬華區,76578,192510,95530,96980
2012/11/1,臺北市,文山區,100761,268987,129926,139061
2012/11/1,臺北市,南港區,44177,118305,57934,60371
2012/11/1,臺北市,內湖區,102103,279619,134404,145215
2012/11/1,臺北市,士林區,104029,288742,140001,148741
2012/11/1,臺北市,北投區,92717,253967,123163,130804
2012/11/1,臺中市,中區,8067,20712,10280,10432
2012/11/1,臺中市,東區,26526,74225,37298,36927
2012/11/1,臺中市,南區,44196,116668,56448,60220
2012/11/1,臺中市,西區,44169,116748,55728,61020
2012/11/1,臺中市,北區,57198,147762,71351,76411
2012/11/1,臺中市,西屯區,76878,212628,102705,109923
2012/11/1,臺中市,南屯區,55853,158108,76258,81850
2012/11/1,臺中市,北屯區,87423,252444,122113,130331
2012/11/1,臺中市,豐原區,51067,166053,82327,83726
2012/11/1,臺中市,東勢區,17155,52410,27152,25258
2012/11/1,臺中市,大甲區,22108,78002,39569,38433
2012/11/1,臺中市,清水區,25495,85712,44180,41532
2012/11/1,臺中市,沙鹿區,25427,84683,43033,41650
2012/11/1,臺中市,梧棲區,16412,55823,28213,27610
2012/11/1,臺中市,后里區,15110,54091,27673,26418
2012/11/1,臺中市,神岡區,18192,64497,33144,31353
2012/11/1,臺中市,潭子區,33681,103379,51396,51983
2012/11/1,臺中市,大雅區,27014,91252,45859,45393
2012/11/1,臺中市,新社區,7400,25388,13247,12141
2012/11/1,臺中市,石岡區,4882,15761,8196,7565
2012/11/1,臺中市,外埔區,9044,31794,16359,15435
2012/11/1,臺中市,大安區,5311,19924,10473,9451
2012/11/1,臺中市,烏日區,21470,69934,35365,34569
2012/11/1,臺中市,大肚區,16243,55830,28599,27231
2012/11/1,臺中市,龍井區,21341,75066,38077,36989
2012/11/1,臺中市,霧峰區,19077,64194,32924,31270
2012/11/1,臺中市,太平區,56746,176402,88357,88045
2012/11/1,臺中市,大里區,64569,203012,100417,102595
2012/11/1,臺中市,和平區,4395,10564,5699,4865
2012/11/1,臺南市,新營區,27873,78481,39037,39444
2012/11/1,臺南市,鹽水區,10068,26717,13909,12808
2012/11/1,臺南市,白河區,11022,30608,16040,14568
2012/11/1,臺南市,柳營區,7818,22185,11587,10598
2012/11/1,臺南市,後壁區,8929,25278,13174,12104
2012/11/1,臺南市,東山區,8272,22544,11946,10598
2012/11/1,臺南市,麻豆區,15308,45407,23162,22245
2012/11/1,臺南市,下營區,9143,25620,13236,12384
2012/11/1,臺南市,六甲區,7736,23368,12131,11237
2012/11/1,臺南市,官田區,7710,21920,11216,10704
2012/11/1,臺南市,大內區,4023,10542,5628,4914
2012/11/1,臺南市,佳里區,19796,59249,29426,29823
2012/11/1,臺南市,學甲區,9655,27416,14020,13396
2012/11/1,臺南市,西港區,7942,25041,12701,12340
2012/11/1,臺南市,七股區,8049,24212,12628,11584
2012/11/1,臺南市,將軍區,7429,21044,10694,10350
2012/11/1,臺南市,北門區,4393,12081,6119,5962
2012/11/1,臺南市,新化區,13979,43917,22515,21402
2012/11/1,臺南市,善化區,15400,44566,22480,22086
2012/11/1,臺南市,新市區,11173,35184,17689,17495
2012/11/1,臺南市,安定區,9539,30280,15648,14632
2012/11/1,臺南市,山上區,2734,7703,4031,3672
2012/11/1,臺南市,玉井區,5114,15061,7833,7228
2012/11/1,臺南市,楠西區,3544,10292,5463,4829
2012/11/1,臺南市,南化區,2829,8798,4809,3989
2012/11/1,臺南市,左鎮區,1988,5299,2963,2336
2012/11/1,臺南市,仁德區,25575,71167,36369,34798
2012/11/1,臺南市,歸仁區,21245,66579,33882,32697
2012/11/1,臺南市,關廟區,10810,35383,18344,17039
2012/11/1,臺南市,龍崎區,1593,4323,2353,1970
2012/11/1,臺南市,永康區,78653,224060,111116,112944
2012/11/1,臺南市,東區,71719,192909,92963,99946
2012/11/1,臺南市,南區,44114,126068,63055,63013
2012/11/1,臺南市,北區,49054,132241,64922,67319
2012/11/1,臺南市,安南區,57186,182565,92568,89997
2012/11/1,臺南市,安平區,24003,64360,30780,33580
2012/11/1,臺南市,中西區,30480,78558,38415,40143
2012/11/1,高雄市,鹽埕區,11029,26277,13114,13163
2012/11/1,高雄市,鼓山區,53933,133851,65203,68648
2012/11/1,高雄市,左營區,75649,194669,95125,99544
2012/11/1,高雄市,楠梓區,63832,175636,87007,88629
2012/11/1,高雄市,三民區,133191,349848,170521,179327
2012/11/1,高雄市,新興區,22839,53809,26031,27778
2012/11/1,高雄市,前金區,12552,28202,13701,14501
2012/11/1,高雄市,苓雅區,72173,179615,87179,92436
2012/11/1,高雄市,前鎮區,77317,196383,97306,99077
2012/11/1,高雄市,旗津區,10985,29489,15312,14177
2012/11/1,高雄市,小港區,64990,155595,77881,77714
2012/11/1,高雄市,鳳山區,131791,349503,173089,176414
2012/11/1,高雄市,林園區,24940,70393,35993,34400
2012/11/1,高雄市,大寮區,39618,109622,56741,52881
2012/11/1,高雄市,大樹區,13148,43436,22453,20983
2012/11/1,高雄市,大社區,12088,33714,17269,16445
2012/11/1,高雄市,仁武區,28324,77237,39668,37569
2012/11/1,高雄市,鳥松區,17206,43678,22179,21499
2012/11/1,高雄市,岡山區,33988,97564,48723,48841
2012/11/1,高雄市,橋頭區,12991,36947,18874,18073
2012/11/1,高雄市,燕巢區,10181,30774,16337,14437
2012/11/1,高雄市,田寮區,3488,7866,4391,3475
2012/11/1,高雄市,阿蓮區,9300,30040,15168,14872
2012/11/1,高雄市,路竹區,16313,53157,27178,25979
2012/11/1,高雄市,湖內區,10002,29072,14950,14122
2012/11/1,高雄市,茄萣區,10283,30989,16095,14894
2012/11/1,高雄市,永安區,5832,14108,7151,6957
2012/11/1,高雄市,彌陀區,6700,20130,10454,9676
2012/11/1,高雄市,梓官區,12285,36529,18952,17577
2012/11/1,高雄市,旗山區,13875,39083,20265,18818
2012/11/1,高雄市,美濃區,14382,42180,22029,20151
2012/11/1,高雄市,六龜區,5754,14234,7691,6543
2012/11/1,高雄市,甲仙區,2428,6652,3544,3108
2012/11/1,高雄市,杉林區,4790,12472,6785,5687
2012/11/1,高雄市,內門區,5058,15522,8486,7036
2012/11/1,高雄市,茂林區,581,1846,926,920
2012/11/1,高雄市,桃源區,1357,4578,2420,2158
2012/11/1,高雄市,那瑪夏區,887,3197,1651,1546
2012/11/1,宜蘭縣,宜蘭市,34456,95978,47054,48924
2012/11/1,宜蘭縣,羅東鎮,25442,72454,34716,37738
2012/11/1,宜蘭縣,蘇澳鎮,13786,41899,21440,20459
2012/11/1,宜蘭縣,頭城鎮,9942,30335,15683,14652
2012/11/1,宜蘭縣,礁溪鄉,12878,35970,18777,17193
2012/11/1,宜蘭縣,壯圍鄉,8302,24558,13019,11539
2012/11/1,宜蘭縣,員山鄉,11039,32110,17195,14915
2012/11/1,宜蘭縣,冬山鄉,18052,53291,27396,25895
2012/11/1,宜蘭縣,五結鄉,13439,38989,20185,18804
2012/11/1,宜蘭縣,三星鄉,7750,21148,11438,9710
2012/11/1,宜蘭縣,大同鄉,1857,5918,3223,2695
2012/11/1,宜蘭縣,南澳鄉,1863,5898,3138,2760
2012/11/1,桃園市,桃園區,150051,413149,202154,210995
2012/11/1,桃園市,中壢區,133188,375998,187295,188703
2012/11/1,桃園市,平鎮區,69168,209390,105272,104118
2012/11/1,桃園市,八德區,60633,178769,90587,88182
2012/11/1,桃園市,楊梅區,51285,154127,78207,75920
2012/11/1,桃園市,大溪區,29994,91923,47333,44590
2012/11/1,桃園市,蘆竹區,50874,146527,73265,73262
2012/11/1,桃園市,大園區,26935,82578,42711,39867
2012/11/1,桃園市,龜山區,52005,139551,70375,69176
2012/11/1,桃園市,龍潭區,37822,115148,58309,56839
2012/11/1,桃園市,新屋區,15183,48301,25865,22436
2012/11/1,桃園市,觀音區,19937,62532,32831,29701
2012/11/1,桃園市,復興區,3706,10635,5923,4712
2012/11/1,新竹縣,竹北市,52224,152155,75978,76177
2012/11/1,新竹縣,關西鎮,9461,31235,16629,14606
2012/11/1,新竹縣,新埔鎮,10541,34946,18600,16346
2012/11/1,新竹縣,竹東鎮,31616,96607,48637,47970
2012/11/1,新竹縣,湖口鄉,24300,76410,38908,37502
2012/11/1,新竹縣,橫山鄉,4480,14025,7600,6425
2012/11/1,新竹縣,新豐鄉,16538,54348,27904,26444
2012/11/1,新竹縣,芎林鄉,6377,20350,10724,9626
2012/11/1,新竹縣,寶山鄉,4940,14065,7595,6470
2012/11/1,新竹縣,北埔鄉,3140,9889,5359,4530
2012/11/1,新竹縣,峨眉鄉,2057,5832,3250,2582
2012/11/1,新竹縣,尖石鄉,2782,8941,4816,4125
2012/11/1,新竹縣,五峰鄉,1724,4530,2488,2042
2012/11/1,苗栗縣,苗栗市,29948,90981,45652,45329
2012/11/1,苗栗縣,苑裡鎮,14136,48421,25189,23232
2012/11/1,苗栗縣,通霄鎮,11495,37457,19789,17668
2012/11/1,苗栗縣,竹南鎮,25508,80722,40941,39781
2012/11/1,苗栗縣,頭份市,31323,99899,50614,49285
2012/11/1,苗栗縣,後龍鎮,11851,38773,20428,18345
2012/11/1,苗栗縣,卓蘭鎮,6084,18436,9693,8743
2012/11/1,苗栗縣,大湖鄉,5396,15807,8393,7414
2012/11/1,苗栗縣,公館鄉,10469,34902,18174,16728
2012/11/1,苗栗縣,銅鑼鄉,6072,19207,10186,9021
2012/11/1,苗栗縣,南庄鄉,3979,10855,5959,4896
2012/11/1,苗栗縣,頭屋鄉,3589,11455,6058,5397
2012/11/1,苗栗縣,三義鄉,5410,17500,9169,8331
2012/11/1,苗栗縣,西湖鄉,2709,7742,4291,3451
2012/11/1,苗栗縣,造橋鄉,4083,13634,7172,6462
2012/11/1,苗栗縣,三灣鄉,2431,7194,3916,3278
2012/11/1,苗栗縣,獅潭鄉,1715,4779,2675,2104
2012/11/1,苗栗縣,泰安鄉,1976,5896,3181,2715
2012/11/1,彰化縣,彰化市,73769,236516,117528,118988
2012/11/1,彰化縣,鹿港鎮,23065,85811,43860,41951
2012/11/1,彰化縣,和美鎮,25029,90317,46222,44095
2012/11/1,彰化縣,北斗鎮,10183,33259,16814,16445
2012/11/1,彰化縣,員林市,37617,125093,62767,62326
2012/11/1,彰化縣,溪湖鎮,15585,55881,28513,27368
2012/11/1,彰化縣,田中鎮,12754,43426,22508,20918
2012/11/1,彰化縣,二林鎮,14554,53200,27439,25761
2012/11/1,彰化縣,線西鄉,4189,17063,8818,8245
2012/11/1,彰化縣,伸港鄉,9236,35996,18475,17521
2012/11/1,彰化縣,福興鄉,12301,48169,25153,23016
2012/11/1,彰化縣,秀水鄉,10115,39417,20365,19052
2012/11/1,彰化縣,花壇鄉,13277,46033,23692,22341
2012/11/1,彰化縣,芬園鄉,6890,24467,12910,11557
2012/11/1,彰化縣,大村鄉,10513,36497,18987,17510
2012/11/1,彰化縣,埔鹽鄉,8922,33726,17688,16038
2012/11/1,彰化縣,埔心鄉,10154,35183,18154,17029
2012/11/1,彰化縣,永靖鄉,10617,38730,20148,18582
2012/11/1,彰化縣,社頭鄉,12558,44198,22707,21491
2012/11/1,彰化縣,二水鄉,5351,16127,8473,7654
2012/11/1,彰化縣,田尾鄉,7753,28078,14620,13458
2012/11/1,彰化縣,埤頭鄉,8775,31391,16387,15004
2012/11/1,彰化縣,芳苑鄉,10058,35397,18714,16683
2012/11/1,彰化縣,大城鄉,5396,18339,9966,8373
2012/11/1,彰化縣,竹塘鄉,4628,16205,8537,7668
2012/11/1,彰化縣,溪州鄉,8803,31173,16408,14765
2012/11/1,南投縣,南投市,33925,103319,51916,51403
2012/11/1,南投縣,埔里鎮,28734,84324,42400,41924
2012/11/1,南投縣,草屯鎮,31780,99328,50232,49096
2012/11/1,南投縣,竹山鎮,19705,57552,29614,27938
2012/11/1,南投縣,集集鎮,4341,11581,6050,5531
2012/11/1,南投縣,名間鄉,12370,40707,21374,19333
2012/11/1,南投縣,鹿谷鄉,7141,18868,10017,8851
2012/11/1,南投縣,中寮鄉,5660,15900,8623,7277
2012/11/1,南投縣,魚池鄉,5778,16757,8807,7950
2012/11/1,南投縣,國姓鄉,7278,20192,10975,9217
2012/11/1,南投縣,水里鄉,7271,19372,10162,9210
2012/11/1,南投縣,信義鄉,5254,16816,9080,7736
2012/11/1,南投縣,仁愛鄉,4930,15562,8104,7458
2012/11/1,雲林縣,斗六市,36027,107696,53924,53772
2012/11/1,雲林縣,斗南鎮,15521,46546,23679,22867
2012/11/1,雲林縣,虎尾鎮,23370,70391,35777,34614
2012/11/1,雲林縣,西螺鎮,14222,47798,24318,23480
2012/11/1,雲林縣,土庫鎮,8973,29995,15683,14312
2012/11/1,雲林縣,北港鎮,15763,42279,22025,20254
2012/11/1,雲林縣,古坑鄉,10813,33279,17576,15703
2012/11/1,雲林縣,大埤鄉,6736,20600,11086,9514
2012/11/1,雲林縣,莿桐鄉,9173,29946,15739,14207
2012/11/1,雲林縣,林內鄉,5848,19375,10087,9288
2012/11/1,雲林縣,二崙鄉,8863,29073,15526,13547
2012/11/1,雲林縣,崙背鄉,8460,26591,14031,12560
2012/11/1,雲林縣,麥寮鄉,13321,40942,20947,19995
2012/11/1,雲林縣,東勢鄉,5796,16109,8813,7296
2012/11/1,雲林縣,褒忠鄉,4386,13876,7416,6460
2012/11/1,雲林縣,臺西鄉,8852,25111,13518,11593
2012/11/1,雲林縣,元長鄉,9412,28011,15268,12743
2012/11/1,雲林縣,四湖鄉,9081,25903,14071,11832
2012/11/1,雲林縣,口湖鄉,9685,29627,15798,13829
2012/11/1,雲林縣,水林鄉,10372,27852,15238,12614
2012/11/1,嘉義縣,太保市,11757,36898,19027,17871
2012/11/1,嘉義縣,朴子市,15111,43846,22268,21578
2012/11/1,嘉義縣,布袋鎮,10186,29245,15026,14219
2012/11/1,嘉義縣,大林鎮,11390,32947,16939,16008
2012/11/1,嘉義縣,民雄鄉,23468,72297,37064,35233
2012/11/1,嘉義縣,溪口鄉,5441,15840,8454,7386
2012/11/1,嘉義縣,新港鄉,10492,33884,17886,15998
2012/11/1,嘉義縣,六腳鄉,9132,25343,13447,11896
2012/11/1,嘉義縣,東石鄉,9498,26752,14207,12545
2012/11/1,嘉義縣,義竹鄉,7524,20194,10489,9705
2012/11/1,嘉義縣,鹿草鄉,5836,16839,9039,7800
2012/11/1,嘉義縣,水上鄉,17588,51525,26606,24919
2012/11/1,嘉義縣,中埔鄉,15730,47064,24512,22552
2012/11/1,嘉義縣,竹崎鄉,11504,37932,20203,17729
2012/11/1,嘉義縣,梅山鄉,6755,20856,11050,9806
2012/11/1,嘉義縣,番路鄉,4222,12182,6636,5546
2012/11/1,嘉義縣,大埔鄉,1927,4538,2382,2156
2012/11/1,嘉義縣,阿里山鄉,1943,5751,3068,2683
2012/11/1,屏東縣,屏東市,72907,207967,103384,104583
2012/11/1,屏東縣,潮州鎮,18630,55233,27722,27511
2012/11/1,屏東縣,東港鎮,16028,49207,24854,24353
2012/11/1,屏東縣,恆春鎮,11057,30754,15771,14983
2012/11/1,屏東縣,萬丹鄉,14569,53136,27547,25589
2012/11/1,屏東縣,長治鄉,9869,30609,16007,14602
2012/11/1,屏東縣,麟洛鄉,3644,11303,5863,5440
2012/11/1,屏東縣,九如鄉,6688,22566,11719,10847
2012/11/1,屏東縣,里港鄉,8003,26260,13402,12858
2012/11/1,屏東縣,鹽埔鄉,7799,26825,13975,12850
2012/11/1,屏東縣,高樹鄉,9439,26025,13909,12116
2012/11/1,屏東縣,萬巒鄉,6456,21387,11275,10112
2012/11/1,屏東縣,內埔鄉,18157,57108,29650,27458
2012/11/1,屏東縣,竹田鄉,5621,18045,9564,8481
2012/11/1,屏東縣,新埤鄉,3391,10373,5510,4863
2012/11/1,屏東縣,枋寮鄉,8551,25975,13642,12333
2012/11/1,屏東縣,新園鄉,11662,37455,19393,18062
2012/11/1,屏東縣,崁頂鄉,4347,16664,8469,8195
2012/11/1,屏東縣,林邊鄉,7106,19928,10260,9668
2012/11/1,屏東縣,南州鄉,3666,11286,5780,5506
2012/11/1,屏東縣,佳冬鄉,7126,20808,10852,9956
2012/11/1,屏東縣,琉球鄉,4044,12125,6748,5377
2012/11/1,屏東縣,車城鄉,3489,9237,4988,4249
2012/11/1,屏東縣,滿州鄉,3055,8261,4560,3701
2012/11/1,屏東縣,枋山鄉,2120,5846,3140,2706
2012/11/1,屏東縣,三地門鄉,2227,7524,3835,3689
2012/11/1,屏東縣,霧臺鄉,1023,3098,1616,1482
2012/11/1,屏東縣,瑪家鄉,1947,6579,3397,3182
2012/11/1,屏東縣,泰武鄉,1242,5060,2651,2409
2012/11/1,屏東縣,來義鄉,2216,7648,3930,3718
2012/11/1,屏東縣,春日鄉,1326,4826,2495,2331
2012/11/1,屏東縣,獅子鄉,1492,4790,2524,2266
2012/11/1,屏東縣,牡丹鄉,1893,4831,2503,2328
2012/11/1,臺東縣,臺東市,38450,107715,54385,53330
2012/11/1,臺東縣,成功鎮,5428,15292,8085,7207
2012/11/1,臺東縣,關山鎮,3254,9428,4953,4475
2012/11/1,臺東縣,卑南鄉,6635,17842,9566,8276
2012/11/1,臺東縣,大武鄉,2512,6635,3455,3180
2012/11/1,臺東縣,太麻里鄉,4560,11684,6230,5454
2012/11/1,臺東縣,東河鄉,3738,9141,5073,4068
2012/11/1,臺東縣,長濱鄉,2911,7891,4496,3395
2012/11/1,臺東縣,鹿野鄉,3135,8315,4479,3836
2012/11/1,臺東縣,池上鄉,3288,8857,4646,4211
2012/11/1,臺東縣,綠島鄉,1062,3469,1844,1625
2012/11/1,臺東縣,延平鄉,1066,3551,1937,1614
2012/11/1,臺東縣,海端鄉,1098,4385,2382,2003
2012/11/1,臺東縣,達仁鄉,1492,3824,2081,1743
2012/11/1,臺東縣,金峰鄉,1074,3518,1828,1690
2012/11/1,臺東縣,蘭嶼鄉,1629,4836,2465,2371
2012/11/1,花蓮縣,花蓮市,41022,108119,52782,55337
2012/11/1,花蓮縣,鳳林鎮,4413,11547,6106,5441
2012/11/1,花蓮縣,玉里鎮,8917,26077,14079,11998
2012/11/1,花蓮縣,新城鄉,7410,20134,10446,9688
2012/11/1,花蓮縣,吉安鄉,30056,81205,41331,39874
2012/11/1,花蓮縣,壽豐鄉,6875,18299,9865,8434
2012/11/1,花蓮縣,光復鄉,5033,13637,7274,6363
2012/11/1,花蓮縣,豐濱鄉,1767,4679,2608,2071
2012/11/1,花蓮縣,瑞穗鄉,4663,12389,6692,5697
2012/11/1,花蓮縣,富里鄉,4023,11200,6111,5089
2012/11/1,花蓮縣,秀林鄉,4697,15144,7853,7291
2012/11/1,花蓮縣,萬榮鄉,2101,6609,3526,3083
2012/11/1,花蓮縣,卓溪鄉,1660,6184,3440,2744
2012/11/1,澎湖縣,馬公市,21710,58408,29644,28764
2012/11/1,澎湖縣,湖西鄉,5014,13916,7265,6651
2012/11/1,澎湖縣,白沙鄉,3213,9487,4984,4503
2012/11/1,澎湖縣,西嶼鄉,2899,8341,4294,4047
2012/11/1,澎湖縣,望安鄉,1987,4997,2672,2325
2012/11/1,澎湖縣,七美鄉,1299,3596,1886,1710
2012/11/1,基隆市,中正區,22269,54056,27714,26342
2012/11/1,基隆市,七堵區,20447,54256,27501,26755
2012/11/1,基隆市,暖暖區,14719,37832,19191,18641
2012/11/1,基隆市,仁愛區,19677,47803,23530,24273
2012/11/1,基隆市,中山區,19288,49821,25445,24376
2012/11/1,基隆市,安樂區,31945,82309,41065,41244
2012/11/1,基隆市,信義區,20477,51182,25547,25635
2012/11/1,新竹市,東區,72254,202837,100091,102746
2012/11/1,新竹市,北區,52587,147419,72624,74795
2012/11/1,新竹市,香山區,24039,74277,37878,36399
2012/11/1,嘉義市,東區,44740,124290,60591,63699
2012/11/1,嘉義市,西區,52228,146993,72562,74431
2012/11/1,金門縣,金城鎮,11918,36773,18486,18287
2012/11/1,金門縣,金湖鎮,7864,24465,12407,12058
2012/11/1,金門縣,金沙鎮,5759,17425,8725,8700
2012/11/1,金門縣,金寧鄉,6743,22808,11652,11156
2012/11/1,金門縣,烈嶼鄉,2846,10366,5138,5228
2012/11/1,金門縣,烏坵鄉,134,607,302,305
2012/11/1,連江縣,南竿鄉,1319,6693,3787,2906
2012/11/1,連江縣,北竿鄉,436,2047,1131,916
2012/11/1,連江縣,莒光鄉,267,1329,791,538
2012/11/1,連江縣,東引鄉,287,1127,669,458
2012/12/1,總計,新北市,1458292,3939305,1946607,1992698
2012/12/1,總計,臺北市,1017063,2673226,1285361,1387865
2012/12/1,總計,臺中市,883302,2684893,1333194,1351699
2012/12/1,總計,臺南市,656402,1881645,945004,936641
2012/12/1,總計,高雄市,1046588,2778659,1387931,1390728
2012/12/1,總計,臺灣省,3087093,9233673,4711712,4521961
2012/12/1,總計,宜蘭縣,159031,458595,233276,225319
2012/12/1,總計,桃園市,701827,2030161,1020819,1009342
2012/12/1,總計,新竹縣,170476,523993,268829,255164
2012/12/1,總計,苗栗縣,178404,563976,291598,272378
2012/12/1,總計,彰化縣,372303,1299868,665895,633973
2012/12/1,總計,南投縣,174398,520196,267300,252896
2012/12/1,總計,雲林縣,235001,710991,370508,340483
2012/12/1,總計,嘉義縣,179676,533723,278219,255504
2012/12/1,總計,屏東縣,280934,858441,440761,417680
2012/12/1,總計,臺東縣,81342,226252,117808,108444
2012/12/1,總計,花蓮縣,122651,335190,172064,163126
2012/12/1,總計,澎湖縣,36171,98843,50817,48026
2012/12/1,總計,基隆市,148805,377153,189951,187202
2012/12/1,總計,新竹市,149056,425071,210777,214294
2012/12/1,總計,嘉義市,97018,271220,133090,138130
2012/12/1,總計,福建省,37692,124421,63510,60911
2012/12/1,總計,金門縣,35374,113111,57062,56049
2012/12/1,總計,連江縣,2318,11310,6448,4862
2012/12/1,新北市,板橋區,201973,557440,274286,283154
2012/12/1,新北市,三重區,144286,390090,193586,196504
2012/12/1,新北市,中和區,159724,416499,204605,211894
2012/12/1,新北市,永和區,90478,230768,110388,120380
2012/12/1,新北市,新莊區,142061,407012,200359,206653
2012/12/1,新北市,新店區,119383,297637,144858,152779
2012/12/1,新北市,樹林區,63613,182012,91286,90726
2012/12/1,新北市,鶯歌區,28560,88336,44480,43856
2012/12/1,新北市,三峽區,38502,107794,54662,53132
2012/12/1,新北市,淡水區,62655,150687,72932,77755
2012/12/1,新北市,汐止區,81979,192676,95129,97547
2012/12/1,新北市,瑞芳區,15967,41617,21116,20501
2012/12/1,新北市,土城區,84453,239717,119321,120396
2012/12/1,新北市,蘆洲區,67478,199490,98452,101038
2012/12/1,新北市,五股區,28290,81225,41085,40140
2012/12/1,新北市,泰山區,26968,77617,38784,38833
2012/12/1,新北市,林口區,34026,89886,44244,45642
2012/12/1,新北市,深坑區,9198,23569,11862,11707
2012/12/1,新北市,石碇區,3350,7895,4360,3535
2012/12/1,新北市,坪林區,2476,6483,3610,2873
2012/12/1,新北市,三芝區,9078,23460,12083,11377
2012/12/1,新北市,石門區,4236,12798,6695,6103
2012/12/1,新北市,八里區,12948,35721,17991,17730
2012/12/1,新北市,平溪區,2388,5109,2841,2268
2012/12/1,新北市,雙溪區,3834,9465,5102,4363
2012/12/1,新北市,貢寮區,4461,13412,6904,6508
2012/12/1,新北市,金山區,6910,22486,11203,11283
2012/12/1,新北市,萬里區,7259,22429,11387,11042
2012/12/1,新北市,烏來區,1758,5975,2996,2979
2012/12/1,臺北市,松山區,79619,210905,99878,111027
2012/12/1,臺北市,信義區,88021,227734,109454,118280
2012/12/1,臺北市,大安區,118969,313426,147104,166322
2012/12/1,臺北市,中山區,96025,226659,106173,120486
2012/12/1,臺北市,中正區,63952,162154,77924,84230
2012/12/1,臺北市,大同區,49850,128809,63230,65579
2012/12/1,臺北市,萬華區,76572,192628,95577,97051
2012/12/1,臺北市,文山區,100822,269310,130055,139255
2012/12/1,臺北市,南港區,44251,118490,58025,60465
2012/12/1,臺北市,內湖區,102207,280025,134591,145434
2012/12/1,臺北市,士林區,104022,288894,140090,148804
2012/12/1,臺北市,北投區,92753,254192,123260,130932
2012/12/1,臺中市,中區,8058,20647,10259,10388
2012/12/1,臺中市,東區,26552,74282,37317,36965
2012/12/1,臺中市,南區,44238,116807,56518,60289
2012/12/1,臺中市,西區,44186,116784,55745,61039
2012/12/1,臺中市,北區,57229,147798,71381,76417
2012/12/1,臺中市,西屯區,76920,212750,102739,110011
2012/12/1,臺中市,南屯區,55935,158300,76345,81955
2012/12/1,臺中市,北屯區,87538,252668,122197,130471
2012/12/1,臺中市,豐原區,51085,166085,82343,83742
2012/12/1,臺中市,東勢區,17163,52403,27138,25265
2012/12/1,臺中市,大甲區,22118,77986,39542,38444
2012/12/1,臺中市,清水區,25516,85734,44201,41533
2012/12/1,臺中市,沙鹿區,25472,84797,43073,41724
2012/12/1,臺中市,梧棲區,16406,55857,28222,27635
2012/12/1,臺中市,后里區,15124,54089,27668,26421
2012/12/1,臺中市,神岡區,18215,64534,33166,31368
2012/12/1,臺中市,潭子區,33754,103516,51456,52060
2012/12/1,臺中市,大雅區,27054,91367,45918,45449
2012/12/1,臺中市,新社區,7409,25378,13240,12138
2012/12/1,臺中市,石岡區,4881,15763,8196,7567
2012/12/1,臺中市,外埔區,9058,31797,16361,15436
2012/12/1,臺中市,大安區,5315,19910,10458,9452
2012/12/1,臺中市,烏日區,21523,70068,35428,34640
2012/12/1,臺中市,大肚區,16254,55863,28634,27229
2012/12/1,臺中市,龍井區,21349,75138,38104,37034
2012/12/1,臺中市,霧峰區,19095,64183,32909,31274
2012/12/1,臺中市,太平區,56822,176594,88434,88160
2012/12/1,臺中市,大里區,64642,203239,100504,102735
2012/12/1,臺中市,和平區,4391,10556,5698,4858
2012/12/1,臺南市,新營區,27905,78475,39029,39446
2012/12/1,臺南市,鹽水區,10074,26695,13889,12806
2012/12/1,臺南市,白河區,11034,30602,16036,14566
2012/12/1,臺南市,柳營區,7824,22160,11575,10585
2012/12/1,臺南市,後壁區,8940,25280,13176,12104
2012/12/1,臺南市,東山區,8285,22529,11929,10600
2012/12/1,臺南市,麻豆區,15311,45377,23150,22227
2012/12/1,臺南市,下營區,9146,25612,13231,12381
2012/12/1,臺南市,六甲區,7733,23346,12123,11223
2012/12/1,臺南市,官田區,7717,21912,11198,10714
2012/12/1,臺南市,大內區,4026,10537,5627,4910
2012/12/1,臺南市,佳里區,19805,59289,29443,29846
2012/12/1,臺南市,學甲區,9658,27414,14018,13396
2012/12/1,臺南市,西港區,7948,25034,12701,12333
2012/12/1,臺南市,七股區,8050,24225,12632,11593
2012/12/1,臺南市,將軍區,7420,21005,10673,10332
2012/12/1,臺南市,北門區,4393,12083,6116,5967
2012/12/1,臺南市,新化區,13984,43940,22533,21407
2012/12/1,臺南市,善化區,15424,44619,22484,22135
2012/12/1,臺南市,新市區,11190,35187,17697,17490
2012/12/1,臺南市,安定區,9558,30298,15656,14642
2012/12/1,臺南市,山上區,2733,7696,4026,3670
2012/12/1,臺南市,玉井區,5117,15058,7835,7223
2012/12/1,臺南市,楠西區,3542,10272,5455,4817
2012/12/1,臺南市,南化區,2830,8814,4818,3996
2012/12/1,臺南市,左鎮區,1992,5294,2964,2330
2012/12/1,臺南市,仁德區,25629,71270,36402,34868
2012/12/1,臺南市,歸仁區,21296,66655,33935,32720
2012/12/1,臺南市,關廟區,10811,35353,18316,17037
2012/12/1,臺南市,龍崎區,1591,4325,2349,1976
2012/12/1,臺南市,永康區,78784,224303,111219,113084
2012/12/1,臺南市,東區,71718,192972,93011,99961
2012/12/1,臺南市,南區,44122,126018,63011,63007
2012/12/1,臺南市,北區,49049,132233,64890,67343
2012/12/1,臺南市,安南區,57244,182749,92644,90105
2012/12/1,臺南市,安平區,24001,64348,30760,33588
2012/12/1,臺南市,中西區,30518,78666,38453,40213
2012/12/1,高雄市,鹽埕區,11022,26222,13082,13140
2012/12/1,高雄市,鼓山區,53984,133964,65230,68734
2012/12/1,高雄市,左營區,75669,194815,95194,99621
2012/12/1,高雄市,楠梓區,63870,175798,87060,88738
2012/12/1,高雄市,三民區,133194,349710,170476,179234
2012/12/1,高雄市,新興區,22808,53749,25990,27759
2012/12/1,高雄市,前金區,12567,28250,13716,14534
2012/12/1,高雄市,苓雅區,72166,179512,87073,92439
2012/12/1,高雄市,前鎮區,77282,196246,97221,99025
2012/12/1,高雄市,旗津區,10988,29468,15286,14182
2012/12/1,高雄市,小港區,65076,155779,77934,77845
2012/12/1,高雄市,鳳山區,131913,349816,173207,176609
2012/12/1,高雄市,林園區,24965,70383,35981,34402
2012/12/1,高雄市,大寮區,39667,109780,56812,52968
2012/12/1,高雄市,大樹區,13148,43429,22440,20989
2012/12/1,高雄市,大社區,12114,33766,17289,16477
2012/12/1,高雄市,仁武區,28374,77371,39735,37636
2012/12/1,高雄市,鳥松區,17211,43696,22191,21505
2012/12/1,高雄市,岡山區,33994,97587,48723,48864
2012/12/1,高雄市,橋頭區,13016,36962,18870,18092
2012/12/1,高雄市,燕巢區,10176,30758,16336,14422
2012/12/1,高雄市,田寮區,3487,7852,4386,3466
2012/12/1,高雄市,阿蓮區,9318,30033,15151,14882
2012/12/1,高雄市,路竹區,16324,53145,27168,25977
2012/12/1,高雄市,湖內區,10027,29120,14973,14147
2012/12/1,高雄市,茄萣區,10291,30999,16097,14902
2012/12/1,高雄市,永安區,5829,14129,7154,6975
2012/12/1,高雄市,彌陀區,6708,20123,10454,9669
2012/12/1,高雄市,梓官區,12290,36519,18930,17589
2012/12/1,高雄市,旗山區,13882,39038,20247,18791
2012/12/1,高雄市,美濃區,14392,42157,22018,20139
2012/12/1,高雄市,六龜區,5735,14203,7675,6528
2012/12/1,高雄市,甲仙區,2412,6625,3530,3095
2012/12/1,高雄市,杉林區,4827,12577,6858,5719
2012/12/1,高雄市,內門區,5054,15510,8474,7036
2012/12/1,高雄市,茂林區,578,1839,925,914
2012/12/1,高雄市,桃源區,1349,4559,2408,2151
2012/12/1,高雄市,那瑪夏區,881,3170,1637,1533
2012/12/1,宜蘭縣,宜蘭市,34492,96016,47066,48950
2012/12/1,宜蘭縣,羅東鎮,25442,72468,34735,37733
2012/12/1,宜蘭縣,蘇澳鎮,13785,41855,21413,20442
2012/12/1,宜蘭縣,頭城鎮,9937,30304,15673,14631
2012/12/1,宜蘭縣,礁溪鄉,12948,36010,18801,17209
2012/12/1,宜蘭縣,壯圍鄉,8315,24551,13015,11536
2012/12/1,宜蘭縣,員山鄉,11058,32106,17184,14922
2012/12/1,宜蘭縣,冬山鄉,18088,53363,27418,25945
2012/12/1,宜蘭縣,五結鄉,13479,38999,20195,18804
2012/12/1,宜蘭縣,三星鄉,7768,21122,11432,9690
2012/12/1,宜蘭縣,大同鄉,1855,5915,3215,2700
2012/12/1,宜蘭縣,南澳鄉,1864,5886,3129,2757
2012/12/1,桃園市,桃園區,150281,413488,202276,211212
2012/12/1,桃園市,中壢區,133288,376217,187410,188807
2012/12/1,桃園市,平鎮區,69270,209552,105330,104222
2012/12/1,桃園市,八德區,60739,178889,90667,88222
2012/12/1,桃園市,楊梅區,51368,154324,78292,76032
2012/12/1,桃園市,大溪區,30009,91891,47304,44587
2012/12/1,桃園市,蘆竹區,50991,146779,73405,73374
2012/12/1,桃園市,大園區,27118,82756,42792,39964
2012/12/1,桃園市,龜山區,52071,139605,70392,69213
2012/12/1,桃園市,龍潭區,37838,115146,58313,56833
2012/12/1,桃園市,新屋區,15186,48276,25848,22428
2012/12/1,桃園市,觀音區,19960,62612,32885,29727
2012/12/1,桃園市,復興區,3708,10626,5905,4721
2012/12/1,新竹縣,竹北市,52390,152617,76199,76418
2012/12/1,新竹縣,關西鎮,9477,31239,16636,14603
2012/12/1,新竹縣,新埔鎮,10555,34960,18608,16352
2012/12/1,新竹縣,竹東鎮,31635,96594,48631,47963
2012/12/1,新竹縣,湖口鄉,24329,76501,38968,37533
2012/12/1,新竹縣,橫山鄉,4485,14013,7591,6422
2012/12/1,新竹縣,新豐鄉,16562,54427,27942,26485
2012/12/1,新竹縣,芎林鄉,6376,20354,10728,9626
2012/12/1,新竹縣,寶山鄉,4954,14085,7616,6469
2012/12/1,新竹縣,北埔鄉,3140,9883,5352,4531
2012/12/1,新竹縣,峨眉鄉,2065,5831,3245,2586
2012/12/1,新竹縣,尖石鄉,2783,8964,4825,4139
2012/12/1,新竹縣,五峰鄉,1725,4525,2488,2037
2012/12/1,苗栗縣,苗栗市,29969,91007,45657,45350
2012/12/1,苗栗縣,苑裡鎮,14135,48452,25192,23260
2012/12/1,苗栗縣,通霄鎮,11504,37449,19787,17662
2012/12/1,苗栗縣,竹南鎮,25574,80864,40996,39868
2012/12/1,苗栗縣,頭份市,31373,99993,50675,49318
2012/12/1,苗栗縣,後龍鎮,11864,38777,20426,18351
2012/12/1,苗栗縣,卓蘭鎮,6106,18480,9715,8765
2012/12/1,苗栗縣,大湖鄉,5402,15798,8383,7415
2012/12/1,苗栗縣,公館鄉,10486,34932,18189,16743
2012/12/1,苗栗縣,銅鑼鄉,6077,19178,10181,8997
2012/12/1,苗栗縣,南庄鄉,3987,10863,5968,4895
2012/12/1,苗栗縣,頭屋鄉,3591,11454,6049,5405
2012/12/1,苗栗縣,三義鄉,5409,17495,9160,8335
2012/12/1,苗栗縣,西湖鄉,2717,7748,4290,3458
2012/12/1,苗栗縣,造橋鄉,4085,13626,7171,6455
2012/12/1,苗栗縣,三灣鄉,2432,7191,3916,3275
2012/12/1,苗栗縣,獅潭鄉,1719,4777,2677,2100
2012/12/1,苗栗縣,泰安鄉,1974,5892,3166,2726
2012/12/1,彰化縣,彰化市,73818,236636,117580,119056
2012/12/1,彰化縣,鹿港鎮,23093,85858,43865,41993
2012/12/1,彰化縣,和美鎮,25032,90298,46199,44099
2012/12/1,彰化縣,北斗鎮,10206,33280,16820,16460
2012/12/1,彰化縣,員林市,37639,125141,62768,62373
2012/12/1,彰化縣,溪湖鎮,15591,55899,28536,27363
2012/12/1,彰化縣,田中鎮,12753,43428,22502,20926
2012/12/1,彰化縣,二林鎮,14572,53198,27444,25754
2012/12/1,彰化縣,線西鄉,4186,17056,8812,8244
2012/12/1,彰化縣,伸港鄉,9251,36037,18493,17544
2012/12/1,彰化縣,福興鄉,12302,48182,25157,23025
2012/12/1,彰化縣,秀水鄉,10117,39429,20374,19055
2012/12/1,彰化縣,花壇鄉,13291,46017,23700,22317
2012/12/1,彰化縣,芬園鄉,6886,24457,12904,11553
2012/12/1,彰化縣,大村鄉,10512,36469,18966,17503
2012/12/1,彰化縣,埔鹽鄉,8927,33712,17680,16032
2012/12/1,彰化縣,埔心鄉,10174,35186,18164,17022
2012/12/1,彰化縣,永靖鄉,10619,38718,20139,18579
2012/12/1,彰化縣,社頭鄉,12561,44211,22716,21495
2012/12/1,彰化縣,二水鄉,5354,16133,8472,7661
2012/12/1,彰化縣,田尾鄉,7751,28050,14608,13442
2012/12/1,彰化縣,埤頭鄉,8783,31415,16393,15022
2012/12/1,彰化縣,芳苑鄉,10053,35337,18689,16648
2012/12/1,彰化縣,大城鄉,5392,18337,9971,8366
2012/12/1,彰化縣,竹塘鄉,4633,16201,8542,7659
2012/12/1,彰化縣,溪州鄉,8807,31183,16401,14782
2012/12/1,南投縣,南投市,33926,103285,51884,51401
2012/12/1,南投縣,埔里鎮,28756,84300,42374,41926
2012/12/1,南投縣,草屯鎮,31831,99374,50240,49134
2012/12/1,南投縣,竹山鎮,19783,57560,29626,27934
2012/12/1,南投縣,集集鎮,4344,11576,6048,5528
2012/12/1,南投縣,名間鄉,12405,40682,21386,19296
2012/12/1,南投縣,鹿谷鄉,7164,18878,10015,8863
2012/12/1,南投縣,中寮鄉,5667,15901,8624,7277
2012/12/1,南投縣,魚池鄉,5776,16747,8801,7946
2012/12/1,南投縣,國姓鄉,7278,20165,10968,9197
2012/12/1,南投縣,水里鄉,7275,19341,10145,9196
2012/12/1,南投縣,信義鄉,5261,16802,9073,7729
2012/12/1,南投縣,仁愛鄉,4932,15585,8116,7469
2012/12/1,雲林縣,斗六市,36062,107727,53930,53797
2012/12/1,雲林縣,斗南鎮,15535,46570,23692,22878
2012/12/1,雲林縣,虎尾鎮,23415,70423,35804,34619
2012/12/1,雲林縣,西螺鎮,14232,47791,24318,23473
2012/12/1,雲林縣,土庫鎮,8990,29957,15670,14287
2012/12/1,雲林縣,北港鎮,15786,42257,22015,20242
2012/12/1,雲林縣,古坑鄉,10833,33280,17573,15707
2012/12/1,雲林縣,大埤鄉,6767,20582,11073,9509
2012/12/1,雲林縣,莿桐鄉,9187,29906,15719,14187
2012/12/1,雲林縣,林內鄉,5856,19352,10085,9267
2012/12/1,雲林縣,二崙鄉,8879,29060,15509,13551
2012/12/1,雲林縣,崙背鄉,8474,26570,14023,12547
2012/12/1,雲林縣,麥寮鄉,13352,41096,21007,20089
2012/12/1,雲林縣,東勢鄉,5807,16100,8804,7296
2012/12/1,雲林縣,褒忠鄉,4393,13869,7407,6462
2012/12/1,雲林縣,臺西鄉,8850,25068,13489,11579
2012/12/1,雲林縣,元長鄉,9429,28002,15270,12732
2012/12/1,雲林縣,四湖鄉,9086,25907,14082,11825
2012/12/1,雲林縣,口湖鄉,9694,29646,15807,13839
2012/12/1,雲林縣,水林鄉,10374,27828,15231,12597
2012/12/1,嘉義縣,太保市,11775,36946,19039,17907
2012/12/1,嘉義縣,朴子市,15123,43855,22274,21581
2012/12/1,嘉義縣,布袋鎮,10194,29244,15013,14231
2012/12/1,嘉義縣,大林鎮,11396,32917,16918,15999
2012/12/1,嘉義縣,民雄鄉,23498,72286,37092,35194
2012/12/1,嘉義縣,溪口鄉,5444,15823,8442,7381
2012/12/1,嘉義縣,新港鄉,10496,33830,17853,15977
2012/12/1,嘉義縣,六腳鄉,9132,25356,13451,11905
2012/12/1,嘉義縣,東石鄉,9504,26713,14198,12515
2012/12/1,嘉義縣,義竹鄉,7533,20158,10474,9684
2012/12/1,嘉義縣,鹿草鄉,5846,16832,9041,7791
2012/12/1,嘉義縣,水上鄉,17608,51497,26599,24898
2012/12/1,嘉義縣,中埔鄉,15756,47025,24496,22529
2012/12/1,嘉義縣,竹崎鄉,11518,37923,20190,17733
2012/12/1,嘉義縣,梅山鄉,6759,20842,11047,9795
2012/12/1,嘉義縣,番路鄉,4246,12227,6661,5566
2012/12/1,嘉義縣,大埔鄉,1923,4547,2384,2163
2012/12/1,嘉義縣,阿里山鄉,1925,5702,3047,2655
2012/12/1,屏東縣,屏東市,72940,207862,103340,104522
2012/12/1,屏東縣,潮州鎮,18637,55205,27706,27499
2012/12/1,屏東縣,東港鎮,16036,49185,24837,24348
2012/12/1,屏東縣,恆春鎮,11058,30758,15769,14989
2012/12/1,屏東縣,萬丹鄉,14586,53125,27545,25580
2012/12/1,屏東縣,長治鄉,9882,30600,16006,14594
2012/12/1,屏東縣,麟洛鄉,3648,11301,5861,5440
2012/12/1,屏東縣,九如鄉,6695,22563,11707,10856
2012/12/1,屏東縣,里港鄉,8009,26282,13403,12879
2012/12/1,屏東縣,鹽埔鄉,7803,26802,13970,12832
2012/12/1,屏東縣,高樹鄉,9443,25999,13899,12100
2012/12/1,屏東縣,萬巒鄉,6454,21391,11267,10124
2012/12/1,屏東縣,內埔鄉,18160,57070,29632,27438
2012/12/1,屏東縣,竹田鄉,5629,18041,9569,8472
2012/12/1,屏東縣,新埤鄉,3395,10373,5514,4859
2012/12/1,屏東縣,枋寮鄉,8557,25971,13639,12332
2012/12/1,屏東縣,新園鄉,11658,37429,19379,18050
2012/12/1,屏東縣,崁頂鄉,4354,16680,8479,8201
2012/12/1,屏東縣,林邊鄉,7102,19909,10253,9656
2012/12/1,屏東縣,南州鄉,3663,11276,5770,5506
2012/12/1,屏東縣,佳冬鄉,7130,20799,10846,9953
2012/12/1,屏東縣,琉球鄉,4057,12145,6755,5390
2012/12/1,屏東縣,車城鄉,3485,9196,4968,4228
2012/12/1,屏東縣,滿州鄉,3051,8243,4549,3694
2012/12/1,屏東縣,枋山鄉,2125,5855,3141,2714
2012/12/1,屏東縣,三地門鄉,2228,7522,3837,3685
2012/12/1,屏東縣,霧臺鄉,1026,3106,1619,1487
2012/12/1,屏東縣,瑪家鄉,1949,6584,3402,3182
2012/12/1,屏東縣,泰武鄉,1241,5062,2654,2408
2012/12/1,屏東縣,來義鄉,2214,7651,3930,3721
2012/12/1,屏東縣,春日鄉,1327,4831,2495,2336
2012/12/1,屏東縣,獅子鄉,1495,4789,2517,2272
2012/12/1,屏東縣,牡丹鄉,1897,4836,2503,2333
2012/12/1,臺東縣,臺東市,38461,107720,54374,53346
2012/12/1,臺東縣,成功鎮,5425,15253,8065,7188
2012/12/1,臺東縣,關山鎮,3254,9425,4950,4475
2012/12/1,臺東縣,卑南鄉,6635,17834,9554,8280
2012/12/1,臺東縣,大武鄉,2511,6632,3457,3175
2012/12/1,臺東縣,太麻里鄉,4570,11669,6219,5450
2012/12/1,臺東縣,東河鄉,3727,9108,5051,4057
2012/12/1,臺東縣,長濱鄉,2908,7869,4486,3383
2012/12/1,臺東縣,鹿野鄉,3136,8304,4470,3834
2012/12/1,臺東縣,池上鄉,3288,8824,4637,4187
2012/12/1,臺東縣,綠島鄉,1062,3462,1839,1623
2012/12/1,臺東縣,延平鄉,1067,3551,1934,1617
2012/12/1,臺東縣,海端鄉,1098,4379,2377,2002
2012/12/1,臺東縣,達仁鄉,1491,3832,2084,1748
2012/12/1,臺東縣,金峰鄉,1078,3520,1831,1689
2012/12/1,臺東縣,蘭嶼鄉,1631,4870,2480,2390
2012/12/1,花蓮縣,花蓮市,41000,108077,52737,55340
2012/12/1,花蓮縣,鳳林鎮,4411,11532,6098,5434
2012/12/1,花蓮縣,玉里鎮,8912,26055,14068,11987
2012/12/1,花蓮縣,新城鄉,7397,20131,10434,9697
2012/12/1,花蓮縣,吉安鄉,30107,81325,41417,39908
2012/12/1,花蓮縣,壽豐鄉,6873,18265,9844,8421
2012/12/1,花蓮縣,光復鄉,5026,13613,7259,6354
2012/12/1,花蓮縣,豐濱鄉,1766,4668,2601,2067
2012/12/1,花蓮縣,瑞穗鄉,4673,12372,6690,5682
2012/12/1,花蓮縣,富里鄉,4023,11189,6098,5091
2012/12/1,花蓮縣,秀林鄉,4708,15167,7856,7311
2012/12/1,花蓮縣,萬榮鄉,2097,6612,3521,3091
2012/12/1,花蓮縣,卓溪鄉,1658,6184,3441,2743
2012/12/1,澎湖縣,馬公市,21745,58490,29692,28798
2012/12/1,澎湖縣,湖西鄉,5022,13915,7273,6642
2012/12/1,澎湖縣,白沙鄉,3215,9491,4986,4505
2012/12/1,澎湖縣,西嶼鄉,2904,8354,4310,4044
2012/12/1,澎湖縣,望安鄉,1987,4995,2673,2322
2012/12/1,澎湖縣,七美鄉,1298,3598,1883,1715
2012/12/1,基隆市,中正區,22263,54020,27687,26333
2012/12/1,基隆市,七堵區,20438,54217,27491,26726
2012/12/1,基隆市,暖暖區,14724,37851,19195,18656
2012/12/1,基隆市,仁愛區,19666,47741,23516,24225
2012/12/1,基隆市,中山區,19285,49794,25437,24357
2012/12/1,基隆市,安樂區,31942,82285,41051,41234
2012/12/1,基隆市,信義區,20487,51245,25574,25671
2012/12/1,新竹市,東區,72345,203119,100181,102938
2012/12/1,新竹市,北區,52629,147561,72647,74914
2012/12/1,新竹市,香山區,24082,74391,37949,36442
2012/12/1,嘉義市,東區,44770,124242,60565,63677
2012/12/1,嘉義市,西區,52248,146978,72525,74453
2012/12/1,金門縣,金城鎮,11956,36974,18596,18378
2012/12/1,金門縣,金湖鎮,7884,24623,12504,12119
2012/12/1,金門縣,金沙鎮,5779,17543,8781,8762
2012/12/1,金門縣,金寧鄉,6772,22939,11720,11219
2012/12/1,金門縣,烈嶼鄉,2849,10424,5158,5266
2012/12/1,金門縣,烏坵鄉,134,608,303,305
2012/12/1,連江縣,南竿鄉,1327,6780,3839,2941
2012/12/1,連江縣,北竿鄉,435,2071,1147,924
2012/12/1,連江縣,莒光鄉,267,1327,789,538
2012/12/1,連江縣,東引鄉,289,1132,673,459
2013/1/1,總計,新北市,1459306,3941239,1947131,1994108
2013/1/1,總計,臺北市,1017406,2675033,1286134,1388899
2013/1/1,總計,臺中市,884193,2687052,1334080,1352972
2013/1/1,總計,臺南市,656912,1881905,944947,936958
2013/1/1,總計,高雄市,1047093,2778798,1387738,1391060
2013/1/1,總計,臺灣省,3089754,9234893,4711741,4523152
2013/1/1,總計,宜蘭縣,159188,458599,233264,225335
2013/1/1,總計,桃園市,702807,2031837,1021498,1010339
2013/1/1,總計,新竹縣,170758,524559,269049,255510
2013/1/1,總計,苗栗縣,178600,564223,291684,272539
2013/1/1,總計,彰化縣,372515,1299724,665777,633947
2013/1/1,總計,南投縣,174511,520043,267200,252843
2013/1/1,總計,雲林縣,235137,710829,370387,340442
2013/1/1,總計,嘉義縣,179863,533404,278030,255374
2013/1/1,總計,屏東縣,280992,857939,440489,417450
2013/1/1,總計,臺東縣,81316,226093,117723,108370
2013/1/1,總計,花蓮縣,122685,334989,171926,163063
2013/1/1,總計,澎湖縣,36245,98927,50868,48059
2013/1/1,總計,基隆市,148857,377021,189859,187162
2013/1/1,總計,新竹市,149212,425450,210897,214553
2013/1/1,總計,嘉義市,97068,271256,133090,138166
2013/1/1,總計,福建省,37788,125172,63887,61285
2013/1/1,總計,金門縣,35457,113755,57375,56380
2013/1/1,總計,連江縣,2331,11417,6512,4905
2013/1/1,新北市,板橋區,202011,557417,274215,283202
2013/1/1,新北市,三重區,144354,390207,193564,196643
2013/1/1,新北市,中和區,159804,416503,204526,211977
2013/1/1,新北市,永和區,90473,230745,110340,120405
2013/1/1,新北市,新莊區,142172,407370,200540,206830
2013/1/1,新北市,新店區,119432,297653,144868,152785
2013/1/1,新北市,樹林區,63651,182197,91374,90823
2013/1/1,新北市,鶯歌區,28584,88427,44534,43893
2013/1/1,新北市,三峽區,38541,107937,54721,53216
2013/1/1,新北市,淡水區,62877,151096,73118,77978
2013/1/1,新北市,汐止區,82041,192816,95162,97654
2013/1/1,新北市,瑞芳區,15975,41627,21124,20503
2013/1/1,新北市,土城區,84507,239694,119253,120441
2013/1/1,新北市,蘆洲區,67499,199615,98504,101111
2013/1/1,新北市,五股區,28307,81302,41110,40192
2013/1/1,新北市,泰山區,26984,77682,38814,38868
2013/1/1,新北市,林口區,34120,90171,44360,45811
2013/1/1,新北市,深坑區,9192,23547,11853,11694
2013/1/1,新北市,石碇區,3349,7882,4346,3536
2013/1/1,新北市,坪林區,2478,6471,3604,2867
2013/1/1,新北市,三芝區,9082,23477,12093,11384
2013/1/1,新北市,石門區,4243,12788,6691,6097
2013/1/1,新北市,八里區,12978,35744,17999,17745
2013/1/1,新北市,平溪區,2387,5102,2830,2272
2013/1/1,新北市,雙溪區,3846,9474,5102,4372
2013/1/1,新北市,貢寮區,4467,13396,6889,6507
2013/1/1,新北市,金山區,6918,22469,11204,11265
2013/1/1,新北市,萬里區,7274,22455,11401,11054
2013/1/1,新北市,烏來區,1760,5975,2992,2983
2013/1/1,臺北市,松山區,79641,211009,99930,111079
2013/1/1,臺北市,信義區,88041,227907,109531,118376
2013/1/1,臺北市,大安區,118946,313542,147172,166370
2013/1/1,臺北市,中山區,96120,227037,106350,120687
2013/1/1,臺北市,中正區,63976,162295,77959,84336
2013/1/1,臺北市,大同區,49858,128921,63277,65644
2013/1/1,臺北市,萬華區,76559,192703,95596,97107
2013/1/1,臺北市,文山區,100854,269516,130170,139346
2013/1/1,臺北市,南港區,44255,118540,58010,60530
2013/1/1,臺北市,內湖區,102277,280219,134671,145548
2013/1/1,臺北市,士林區,104103,289164,140210,148954
2013/1/1,臺北市,北投區,92776,254180,123258,130922
2013/1/1,臺中市,中區,8052,20637,10242,10395
2013/1/1,臺中市,東區,26574,74311,37309,37002
2013/1/1,臺中市,南區,44267,116948,56582,60366
2013/1/1,臺中市,西區,44191,116830,55800,61030
2013/1/1,臺中市,北區,57239,147856,71385,76471
2013/1/1,臺中市,西屯區,77076,213176,102906,110270
2013/1/1,臺中市,南屯區,56019,158485,76430,82055
2013/1/1,臺中市,北屯區,87701,252887,122297,130590
2013/1/1,臺中市,豐原區,51099,166111,82351,83760
2013/1/1,臺中市,東勢區,17158,52340,27129,25211
2013/1/1,臺中市,大甲區,22123,78035,39569,38466
2013/1/1,臺中市,清水區,25511,85738,44180,41558
2013/1/1,臺中市,沙鹿區,25547,85000,43163,41837
2013/1/1,臺中市,梧棲區,16411,55847,28230,27617
2013/1/1,臺中市,后里區,15133,54131,27681,26450
2013/1/1,臺中市,神岡區,18231,64635,33207,31428
2013/1/1,臺中市,潭子區,33768,103573,51457,52116
2013/1/1,臺中市,大雅區,27112,91446,45945,45501
2013/1/1,臺中市,新社區,7400,25370,13226,12144
2013/1/1,臺中市,石岡區,4883,15755,8187,7568
2013/1/1,臺中市,外埔區,9056,31763,16334,15429
2013/1/1,臺中市,大安區,5311,19870,10453,9417
2013/1/1,臺中市,烏日區,21536,70122,35482,34640
2013/1/1,臺中市,大肚區,16273,55896,28631,27265
2013/1/1,臺中市,龍井區,21357,75150,38113,37037
2013/1/1,臺中市,霧峰區,19116,64186,32924,31262
2013/1/1,臺中市,太平區,56927,176889,88546,88343
2013/1/1,臺中市,大里區,64728,203481,100614,102867
2013/1/1,臺中市,和平區,4394,10584,5707,4877
2013/1/1,臺南市,新營區,27934,78535,39043,39492
2013/1/1,臺南市,鹽水區,10065,26662,13864,12798
2013/1/1,臺南市,白河區,11032,30557,16010,14547
2013/1/1,臺南市,柳營區,7828,22147,11571,10576
2013/1/1,臺南市,後壁區,8945,25224,13144,12080
2013/1/1,臺南市,東山區,8282,22509,11919,10590
2013/1/1,臺南市,麻豆區,15322,45380,23133,22247
2013/1/1,臺南市,下營區,9139,25571,13201,12370
2013/1/1,臺南市,六甲區,7733,23335,12118,11217
2013/1/1,臺南市,官田區,7724,21917,11200,10717
2013/1/1,臺南市,大內區,4027,10514,5616,4898
2013/1/1,臺南市,佳里區,19824,59306,29462,29844
2013/1/1,臺南市,學甲區,9658,27440,14024,13416
2013/1/1,臺南市,西港區,7951,25021,12696,12325
2013/1/1,臺南市,七股區,8112,24223,12635,11588
2013/1/1,臺南市,將軍區,7427,20993,10673,10320
2013/1/1,臺南市,北門區,4397,12054,6093,5961
2013/1/1,臺南市,新化區,13984,43902,22509,21393
2013/1/1,臺南市,善化區,15433,44628,22485,22143
2013/1/1,臺南市,新市區,11205,35209,17713,17496
2013/1/1,臺南市,安定區,9567,30278,15645,14633
2013/1/1,臺南市,山上區,2734,7702,4030,3672
2013/1/1,臺南市,玉井區,5118,15033,7823,7210
2013/1/1,臺南市,楠西區,3547,10290,5461,4829
2013/1/1,臺南市,南化區,2834,8836,4828,4008
2013/1/1,臺南市,左鎮區,1989,5287,2959,2328
2013/1/1,臺南市,仁德區,25654,71363,36446,34917
2013/1/1,臺南市,歸仁區,21346,66680,33939,32741
2013/1/1,臺南市,關廟區,10814,35315,18307,17008
2013/1/1,臺南市,龍崎區,1591,4330,2349,1981
2013/1/1,臺南市,永康區,78834,224399,111238,113161
2013/1/1,臺南市,東區,71735,192953,92998,99955
2013/1/1,臺南市,南區,44124,125979,62990,62989
2013/1/1,臺南市,北區,49097,132285,64877,67408
2013/1/1,臺南市,安南區,57346,182947,92745,90202
2013/1/1,臺南市,安平區,23999,64346,30744,33602
2013/1/1,臺南市,中西區,30561,78755,38459,40296
2013/1/1,高雄市,鹽埕區,11017,26238,13092,13146
2013/1/1,高雄市,鼓山區,54044,133977,65212,68765
2013/1/1,高雄市,左營區,75689,194878,95190,99688
2013/1/1,高雄市,楠梓區,63970,175973,87120,88853
2013/1/1,高雄市,三民區,133208,349671,170463,179208
2013/1/1,高雄市,新興區,22801,53717,25983,27734
2013/1/1,高雄市,前金區,12557,28201,13687,14514
2013/1/1,高雄市,苓雅區,72107,179328,87010,92318
2013/1/1,高雄市,前鎮區,77274,195988,97061,98927
2013/1/1,高雄市,旗津區,10979,29371,15232,14139
2013/1/1,高雄市,小港區,65091,155874,77916,77958
2013/1/1,高雄市,鳳山區,132101,350282,173375,176907
2013/1/1,高雄市,林園區,24995,70407,35982,34425
2013/1/1,高雄市,大寮區,39720,109827,56830,52997
2013/1/1,高雄市,大樹區,13147,43369,22420,20949
2013/1/1,高雄市,大社區,12118,33827,17321,16506
2013/1/1,高雄市,仁武區,28413,77468,39766,37702
2013/1/1,高雄市,鳥松區,17224,43663,22153,21510
2013/1/1,高雄市,岡山區,34011,97644,48783,48861
2013/1/1,高雄市,橋頭區,13019,36988,18873,18115
2013/1/1,高雄市,燕巢區,10197,30736,16326,14410
2013/1/1,高雄市,田寮區,3480,7812,4366,3446
2013/1/1,高雄市,阿蓮區,9322,30023,15147,14876
2013/1/1,高雄市,路竹區,16335,53147,27167,25980
2013/1/1,高雄市,湖內區,10036,29142,14985,14157
2013/1/1,高雄市,茄萣區,10295,30974,16075,14899
2013/1/1,高雄市,永安區,5828,14122,7146,6976
2013/1/1,高雄市,彌陀區,6698,20079,10429,9650
2013/1/1,高雄市,梓官區,12289,36507,18938,17569
2013/1/1,高雄市,旗山區,13901,39036,20244,18792
2013/1/1,高雄市,美濃區,14400,42107,21983,20124
2013/1/1,高雄市,六龜區,5731,14185,7658,6527
2013/1/1,高雄市,甲仙區,2405,6614,3516,3098
2013/1/1,高雄市,杉林區,4830,12589,6867,5722
2013/1/1,高雄市,內門區,5056,15484,8456,7028
2013/1/1,高雄市,茂林區,577,1832,922,910
2013/1/1,高雄市,桃源區,1349,4547,2404,2143
2013/1/1,高雄市,那瑪夏區,879,3171,1640,1531
2013/1/1,宜蘭縣,宜蘭市,34521,96013,47066,48947
2013/1/1,宜蘭縣,羅東鎮,25459,72489,34738,37751
2013/1/1,宜蘭縣,蘇澳鎮,13805,41830,21389,20441
2013/1/1,宜蘭縣,頭城鎮,9950,30280,15663,14617
2013/1/1,宜蘭縣,礁溪鄉,12947,36006,18811,17195
2013/1/1,宜蘭縣,壯圍鄉,8320,24534,13003,11531
2013/1/1,宜蘭縣,員山鄉,11075,32141,17197,14944
2013/1/1,宜蘭縣,冬山鄉,18121,53388,27435,25953
2013/1/1,宜蘭縣,五結鄉,13484,38994,20185,18809
2013/1/1,宜蘭縣,三星鄉,7788,21106,11430,9676
2013/1/1,宜蘭縣,大同鄉,1855,5930,3219,2711
2013/1/1,宜蘭縣,南澳鄉,1863,5888,3128,2760
2013/1/1,桃園市,桃園區,150519,413917,202441,211476
2013/1/1,桃園市,中壢區,133415,376491,187470,189021
2013/1/1,桃園市,平鎮區,69385,209821,105423,104398
2013/1/1,桃園市,八德區,60800,178949,90716,88233
2013/1/1,桃園市,楊梅區,51424,154427,78358,76069
2013/1/1,桃園市,大溪區,30002,91855,47287,44568
2013/1/1,桃園市,蘆竹區,51104,147068,73520,73548
2013/1/1,桃園市,大園區,27277,82933,42885,40048
2013/1/1,桃園市,龜山區,52140,139706,70417,69289
2013/1/1,桃園市,龍潭區,37862,115183,58357,56826
2013/1/1,桃園市,新屋區,15195,48221,25831,22390
2013/1/1,桃園市,觀音區,19978,62650,32898,29752
2013/1/1,桃園市,復興區,3706,10616,5895,4721
2013/1/1,新竹縣,竹北市,52551,153069,76449,76620
2013/1/1,新竹縣,關西鎮,9482,31225,16627,14598
2013/1/1,新竹縣,新埔鎮,10554,34935,18582,16353
2013/1/1,新竹縣,竹東鎮,31661,96612,48622,47990
2013/1/1,新竹縣,湖口鄉,24362,76540,38964,37576
2013/1/1,新竹縣,橫山鄉,4483,14015,7591,6424
2013/1/1,新竹縣,新豐鄉,16599,54524,27984,26540
2013/1/1,新竹縣,芎林鄉,6380,20344,10720,9624
2013/1/1,新竹縣,寶山鄉,4967,14083,7605,6478
2013/1/1,新竹縣,北埔鄉,3145,9886,5354,4532
2013/1/1,新竹縣,峨眉鄉,2063,5819,3237,2582
2013/1/1,新竹縣,尖石鄉,2787,8985,4828,4157
2013/1/1,新竹縣,五峰鄉,1724,4522,2486,2036
2013/1/1,苗栗縣,苗栗市,29968,91043,45681,45362
2013/1/1,苗栗縣,苑裡鎮,14149,48476,25199,23277
2013/1/1,苗栗縣,通霄鎮,11516,37417,19761,17656
2013/1/1,苗栗縣,竹南鎮,25626,81017,41064,39953
2013/1/1,苗栗縣,頭份市,31440,100170,50749,49421
2013/1/1,苗栗縣,後龍鎮,11874,38760,20414,18346
2013/1/1,苗栗縣,卓蘭鎮,6112,18468,9714,8754
2013/1/1,苗栗縣,大湖鄉,5408,15793,8382,7411
2013/1/1,苗栗縣,公館鄉,10496,34925,18188,16737
2013/1/1,苗栗縣,銅鑼鄉,6087,19169,10175,8994
2013/1/1,苗栗縣,南庄鄉,3985,10850,5955,4895
2013/1/1,苗栗縣,頭屋鄉,3590,11455,6039,5416
2013/1/1,苗栗縣,三義鄉,5407,17466,9148,8318
2013/1/1,苗栗縣,西湖鄉,2716,7725,4282,3443
2013/1/1,苗栗縣,造橋鄉,4094,13620,7171,6449
2013/1/1,苗栗縣,三灣鄉,2436,7199,3924,3275
2013/1/1,苗栗縣,獅潭鄉,1723,4768,2673,2095
2013/1/1,苗栗縣,泰安鄉,1973,5902,3165,2737
2013/1/1,彰化縣,彰化市,73844,236633,117567,119066
2013/1/1,彰化縣,鹿港鎮,23122,85943,43907,42036
2013/1/1,彰化縣,和美鎮,25067,90337,46219,44118
2013/1/1,彰化縣,北斗鎮,10208,33254,16811,16443
2013/1/1,彰化縣,員林市,37657,125157,62771,62386
2013/1/1,彰化縣,溪湖鎮,15603,55932,28541,27391
2013/1/1,彰化縣,田中鎮,12762,43398,22466,20932
2013/1/1,彰化縣,二林鎮,14574,53149,27406,25743
2013/1/1,彰化縣,線西鄉,4183,17053,8813,8240
2013/1/1,彰化縣,伸港鄉,9265,36052,18505,17547
2013/1/1,彰化縣,福興鄉,12306,48181,25160,23021
2013/1/1,彰化縣,秀水鄉,10126,39408,20365,19043
2013/1/1,彰化縣,花壇鄉,13297,46067,23724,22343
2013/1/1,彰化縣,芬園鄉,6887,24429,12890,11539
2013/1/1,彰化縣,大村鄉,10514,36450,18946,17504
2013/1/1,彰化縣,埔鹽鄉,8941,33698,17682,16016
2013/1/1,彰化縣,埔心鄉,10176,35168,18159,17009
2013/1/1,彰化縣,永靖鄉,10628,38720,20134,18586
2013/1/1,彰化縣,社頭鄉,12565,44173,22715,21458
2013/1/1,彰化縣,二水鄉,5351,16101,8451,7650
2013/1/1,彰化縣,田尾鄉,7757,28070,14605,13465
2013/1/1,彰化縣,埤頭鄉,8791,31416,16381,15035
2013/1/1,彰化縣,芳苑鄉,10054,35294,18673,16621
2013/1/1,彰化縣,大城鄉,5394,18315,9964,8351
2013/1/1,彰化縣,竹塘鄉,4628,16179,8536,7643
2013/1/1,彰化縣,溪州鄉,8815,31147,16386,14761
2013/1/1,南投縣,南投市,33917,103234,51851,51383
2013/1/1,南投縣,埔里鎮,28780,84299,42371,41928
2013/1/1,南投縣,草屯鎮,31843,99374,50247,49127
2013/1/1,南投縣,竹山鎮,19814,57546,29620,27926
2013/1/1,南投縣,集集鎮,4354,11581,6050,5531
2013/1/1,南投縣,名間鄉,12419,40679,21388,19291
2013/1/1,南投縣,鹿谷鄉,7187,18846,9998,8848
2013/1/1,南投縣,中寮鄉,5667,15884,8621,7263
2013/1/1,南投縣,魚池鄉,5776,16753,8802,7951
2013/1/1,南投縣,國姓鄉,7280,20120,10939,9181
2013/1/1,南投縣,水里鄉,7283,19331,10143,9188
2013/1/1,南投縣,信義鄉,5262,16795,9063,7732
2013/1/1,南投縣,仁愛鄉,4929,15601,8107,7494
2013/1/1,雲林縣,斗六市,36095,107781,53936,53845
2013/1/1,雲林縣,斗南鎮,15530,46528,23674,22854
2013/1/1,雲林縣,虎尾鎮,23459,70458,35810,34648
2013/1/1,雲林縣,西螺鎮,14242,47768,24298,23470
2013/1/1,雲林縣,土庫鎮,9011,29955,15668,14287
2013/1/1,雲林縣,北港鎮,15764,42241,22005,20236
2013/1/1,雲林縣,古坑鄉,10826,33267,17563,15704
2013/1/1,雲林縣,大埤鄉,6771,20544,11046,9498
2013/1/1,雲林縣,莿桐鄉,9188,29891,15714,14177
2013/1/1,雲林縣,林內鄉,5860,19340,10076,9264
2013/1/1,雲林縣,二崙鄉,8892,29016,15487,13529
2013/1/1,雲林縣,崙背鄉,8473,26533,14013,12520
2013/1/1,雲林縣,麥寮鄉,13383,41258,21069,20189
2013/1/1,雲林縣,東勢鄉,5813,16047,8786,7261
2013/1/1,雲林縣,褒忠鄉,4395,13850,7401,6449
2013/1/1,雲林縣,臺西鄉,8849,25037,13477,11560
2013/1/1,雲林縣,元長鄉,9441,27990,15271,12719
2013/1/1,雲林縣,四湖鄉,9086,25889,14075,11814
2013/1/1,雲林縣,口湖鄉,9688,29647,15804,13843
2013/1/1,雲林縣,水林鄉,10371,27789,15214,12575
2013/1/1,嘉義縣,太保市,11800,36970,19059,17911
2013/1/1,嘉義縣,朴子市,15140,43836,22249,21587
2013/1/1,嘉義縣,布袋鎮,10208,29223,15007,14216
2013/1/1,嘉義縣,大林鎮,11395,32900,16904,15996
2013/1/1,嘉義縣,民雄鄉,23517,72280,37089,35191
2013/1/1,嘉義縣,溪口鄉,5439,15800,8422,7378
2013/1/1,嘉義縣,新港鄉,10500,33803,17844,15959
2013/1/1,嘉義縣,六腳鄉,9132,25327,13435,11892
2013/1/1,嘉義縣,東石鄉,9512,26689,14184,12505
2013/1/1,嘉義縣,義竹鄉,7558,20122,10451,9671
2013/1/1,嘉義縣,鹿草鄉,5850,16814,9024,7790
2013/1/1,嘉義縣,水上鄉,17632,51490,26590,24900
2013/1/1,嘉義縣,中埔鄉,15778,46991,24487,22504
2013/1/1,嘉義縣,竹崎鄉,11530,37881,20175,17706
2013/1/1,嘉義縣,梅山鄉,6762,20803,11028,9775
2013/1/1,嘉義縣,番路鄉,4256,12212,6651,5561
2013/1/1,嘉義縣,大埔鄉,1929,4558,2385,2173
2013/1/1,嘉義縣,阿里山鄉,1925,5705,3046,2659
2013/1/1,屏東縣,屏東市,72932,207733,103284,104449
2013/1/1,屏東縣,潮州鎮,18643,55187,27701,27486
2013/1/1,屏東縣,東港鎮,16048,49160,24825,24335
2013/1/1,屏東縣,恆春鎮,11057,30719,15759,14960
2013/1/1,屏東縣,萬丹鄉,14577,53086,27532,25554
2013/1/1,屏東縣,長治鄉,9883,30598,16003,14595
2013/1/1,屏東縣,麟洛鄉,3648,11290,5847,5443
2013/1/1,屏東縣,九如鄉,6698,22553,11698,10855
2013/1/1,屏東縣,里港鄉,8004,26323,13435,12888
2013/1/1,屏東縣,鹽埔鄉,7805,26793,13964,12829
2013/1/1,屏東縣,高樹鄉,9448,25968,13875,12093
2013/1/1,屏東縣,萬巒鄉,6453,21368,11258,10110
2013/1/1,屏東縣,內埔鄉,18179,57035,29622,27413
2013/1/1,屏東縣,竹田鄉,5632,18014,9556,8458
2013/1/1,屏東縣,新埤鄉,3400,10360,5504,4856
2013/1/1,屏東縣,枋寮鄉,8564,25945,13619,12326
2013/1/1,屏東縣,新園鄉,11663,37389,19347,18042
2013/1/1,屏東縣,崁頂鄉,4361,16699,8486,8213
2013/1/1,屏東縣,林邊鄉,7104,19878,10237,9641
2013/1/1,屏東縣,南州鄉,3662,11274,5772,5502
2013/1/1,屏東縣,佳冬鄉,7127,20758,10821,9937
2013/1/1,屏東縣,琉球鄉,4060,12158,6764,5394
2013/1/1,屏東縣,車城鄉,3482,9167,4951,4216
2013/1/1,屏東縣,滿州鄉,3048,8223,4547,3676
2013/1/1,屏東縣,枋山鄉,2125,5849,3129,2720
2013/1/1,屏東縣,三地門鄉,2231,7528,3837,3691
2013/1/1,屏東縣,霧臺鄉,1028,3111,1620,1491
2013/1/1,屏東縣,瑪家鄉,1951,6591,3399,3192
2013/1/1,屏東縣,泰武鄉,1241,5065,2655,2410
2013/1/1,屏東縣,來義鄉,2214,7650,3927,3723
2013/1/1,屏東縣,春日鄉,1328,4829,2494,2335
2013/1/1,屏東縣,獅子鄉,1500,4801,2521,2280
2013/1/1,屏東縣,牡丹鄉,1896,4837,2500,2337
2013/1/1,臺東縣,臺東市,38445,107698,54343,53355
2013/1/1,臺東縣,成功鎮,5418,15222,8053,7169
2013/1/1,臺東縣,關山鎮,3256,9412,4945,4467
2013/1/1,臺東縣,卑南鄉,6634,17835,9561,8274
2013/1/1,臺東縣,大武鄉,2511,6635,3454,3181
2013/1/1,臺東縣,太麻里鄉,4572,11664,6220,5444
2013/1/1,臺東縣,東河鄉,3724,9111,5052,4059
2013/1/1,臺東縣,長濱鄉,2907,7848,4481,3367
2013/1/1,臺東縣,鹿野鄉,3132,8299,4467,3832
2013/1/1,臺東縣,池上鄉,3284,8800,4625,4175
2013/1/1,臺東縣,綠島鄉,1059,3450,1831,1619
2013/1/1,臺東縣,延平鄉,1067,3546,1927,1619
2013/1/1,臺東縣,海端鄉,1097,4375,2377,1998
2013/1/1,臺東縣,達仁鄉,1490,3829,2083,1746
2013/1/1,臺東縣,金峰鄉,1083,3516,1828,1688
2013/1/1,臺東縣,蘭嶼鄉,1637,4853,2476,2377
2013/1/1,花蓮縣,花蓮市,41015,108031,52717,55314
2013/1/1,花蓮縣,鳳林鎮,4416,11505,6083,5422
2013/1/1,花蓮縣,玉里鎮,8919,26018,14045,11973
2013/1/1,花蓮縣,新城鄉,7390,20099,10408,9691
2013/1/1,花蓮縣,吉安鄉,30141,81396,41446,39950
2013/1/1,花蓮縣,壽豐鄉,6869,18243,9834,8409
2013/1/1,花蓮縣,光復鄉,5029,13603,7252,6351
2013/1/1,花蓮縣,豐濱鄉,1762,4661,2596,2065
2013/1/1,花蓮縣,瑞穗鄉,4669,12336,6671,5665
2013/1/1,花蓮縣,富里鄉,4023,11170,6082,5088
2013/1/1,花蓮縣,秀林鄉,4702,15145,7842,7303
2013/1/1,花蓮縣,萬榮鄉,2096,6601,3514,3087
2013/1/1,花蓮縣,卓溪鄉,1654,6181,3436,2745
2013/1/1,澎湖縣,馬公市,21790,58579,29750,28829
2013/1/1,澎湖縣,湖西鄉,5039,13930,7276,6654
2013/1/1,澎湖縣,白沙鄉,3218,9481,4981,4500
2013/1/1,澎湖縣,西嶼鄉,2907,8359,4314,4045
2013/1/1,澎湖縣,望安鄉,1995,4985,2667,2318
2013/1/1,澎湖縣,七美鄉,1296,3593,1880,1713
2013/1/1,基隆市,中正區,22254,53988,27662,26326
2013/1/1,基隆市,七堵區,20455,54210,27489,26721
2013/1/1,基隆市,暖暖區,14715,37849,19185,18664
2013/1/1,基隆市,仁愛區,19651,47679,23496,24183
2013/1/1,基隆市,中山區,19308,49759,25405,24354
2013/1/1,基隆市,安樂區,31981,82322,41040,41282
2013/1/1,基隆市,信義區,20493,51214,25582,25632
2013/1/1,新竹市,東區,72386,203265,100216,103049
2013/1/1,新竹市,北區,52666,147601,72645,74956
2013/1/1,新竹市,香山區,24160,74584,38036,36548
2013/1/1,嘉義市,東區,44789,124227,60520,63707
2013/1/1,嘉義市,西區,52279,147029,72570,74459
2013/1/1,金門縣,金城鎮,11984,37200,18718,18482
2013/1/1,金門縣,金湖鎮,7905,24760,12577,12183
2013/1/1,金門縣,金沙鎮,5786,17624,8807,8817
2013/1/1,金門縣,金寧鄉,6794,23077,11787,11290
2013/1/1,金門縣,烈嶼鄉,2854,10486,5184,5302
2013/1/1,金門縣,烏坵鄉,134,608,302,306
2013/1/1,連江縣,南竿鄉,1336,6856,3888,2968
2013/1/1,連江縣,北竿鄉,437,2083,1153,930
2013/1/1,連江縣,莒光鄉,268,1330,791,539
2013/1/1,連江縣,東引鄉,290,1148,680,468
2013/2/1,總計,新北市,1459777,3942202,1947237,1994965
2013/2/1,總計,臺北市,1017691,2676128,1286627,1389501
2013/2/1,總計,臺中市,884857,2688216,1334506,1353710
2013/2/1,總計,臺南市,657246,1882118,944989,937129
2013/2/1,總計,高雄市,1047496,2779096,1387643,1391453
2013/2/1,總計,臺灣省,3091191,9235139,4711500,4523639
2013/2/1,總計,宜蘭縣,159262,458599,233240,225359
2013/2/1,總計,桃園市,703391,2032848,1021907,1010941
2013/2/1,總計,新竹縣,170921,524920,269217,255703
2013/2/1,總計,苗栗縣,178749,564343,291712,272631
2013/2/1,總計,彰化縣,372626,1299549,665659,633890
2013/2/1,總計,南投縣,174532,519921,267081,252840
2013/2/1,總計,雲林縣,235232,710574,370265,340309
2013/2/1,總計,嘉義縣,179918,533106,277845,255261
2013/2/1,總計,屏東縣,281059,857569,440273,417296
2013/2/1,總計,臺東縣,81340,226047,117711,108336
2013/2/1,總計,花蓮縣,122709,334991,171894,163097
2013/2/1,總計,澎湖縣,36276,98919,50866,48053
2013/2/1,總計,基隆市,148805,376856,189756,187100
2013/2/1,總計,新竹市,149288,425702,211005,214697
2013/2/1,總計,嘉義市,97083,271195,133069,138126
2013/2/1,總計,福建省,37910,125703,64152,61551
2013/2/1,總計,金門縣,35568,114191,57581,56610
2013/2/1,總計,連江縣,2342,11512,6571,4941
2013/2/1,新北市,板橋區,201993,557471,274174,283297
2013/2/1,新北市,三重區,144397,390213,193526,196687
2013/2/1,新北市,中和區,159817,416527,204514,212013
2013/2/1,新北市,永和區,90482,230708,110282,120426
2013/2/1,新北市,新莊區,142220,407498,200589,206909
2013/2/1,新北市,新店區,119426,297638,144814,152824
2013/2/1,新北市,樹林區,63673,182339,91429,90910
2013/2/1,新北市,鶯歌區,28574,88439,44519,43920
2013/2/1,新北市,三峽區,38589,108056,54763,53293
2013/2/1,新北市,淡水區,63017,151437,73286,78151
2013/2/1,新北市,汐止區,82062,192864,95172,97692
2013/2/1,新北市,瑞芳區,15971,41617,21114,20503
2013/2/1,新北市,土城區,84530,239652,119205,120447
2013/2/1,新北市,蘆洲區,67510,199619,98488,101131
2013/2/1,新北市,五股區,28301,81311,41103,40208
2013/2/1,新北市,泰山區,26958,77659,38813,38846
2013/2/1,新北市,林口區,34235,90399,44467,45932
2013/2/1,新北市,深坑區,9202,23587,11876,11711
2013/2/1,新北市,石碇區,3355,7865,4332,3533
2013/2/1,新北市,坪林區,2479,6474,3609,2865
2013/2/1,新北市,三芝區,9094,23480,12092,11388
2013/2/1,新北市,石門區,4245,12770,6683,6087
2013/2/1,新北市,八里區,12990,35771,18018,17753
2013/2/1,新北市,平溪區,2389,5081,2819,2262
2013/2/1,新北市,雙溪區,3849,9470,5095,4375
2013/2/1,新北市,貢寮區,4471,13409,6894,6515
2013/2/1,新北市,金山區,6914,22445,11188,11257
2013/2/1,新北市,萬里區,7278,22443,11395,11048
2013/2/1,新北市,烏來區,1756,5960,2978,2982
2013/2/1,臺北市,松山區,79637,210973,99927,111046
2013/2/1,臺北市,信義區,88005,227992,109542,118450
2013/2/1,臺北市,大安區,118927,313564,147198,166366
2013/2/1,臺北市,中山區,96171,227129,106411,120718
2013/2/1,臺北市,中正區,64016,162448,78058,84390
2013/2/1,臺北市,大同區,49882,129011,63330,65681
2013/2/1,臺北市,萬華區,76581,192747,95610,97137
2013/2/1,臺北市,文山區,100873,269727,130242,139485
2013/2/1,臺北市,南港區,44295,118618,58038,60580
2013/2/1,臺北市,內湖區,102359,280362,134755,145607
2013/2/1,臺北市,士林區,104106,289257,140220,149037
2013/2/1,臺北市,北投區,92839,254300,123296,131004
2013/2/1,臺中市,中區,8059,20615,10238,10377
2013/2/1,臺中市,東區,26567,74352,37308,37044
2013/2/1,臺中市,南區,44281,116977,56585,60392
2013/2/1,臺中市,西區,44203,116750,55741,61009
2013/2/1,臺中市,北區,57228,147752,71324,76428
2013/2/1,臺中市,西屯區,77140,213309,102952,110357
2013/2/1,臺中市,南屯區,56099,158620,76486,82134
2013/2/1,臺中市,北屯區,87824,253173,122442,130731
2013/2/1,臺中市,豐原區,51092,166101,82338,83763
2013/2/1,臺中市,東勢區,17150,52358,27133,25225
2013/2/1,臺中市,大甲區,22146,78050,39580,38470
2013/2/1,臺中市,清水區,25505,85732,44168,41564
2013/2/1,臺中市,沙鹿區,25613,85132,43212,41920
2013/2/1,臺中市,梧棲區,16415,55868,28232,27636
2013/2/1,臺中市,后里區,15141,54118,27675,26443
2013/2/1,臺中市,神岡區,18247,64645,33200,31445
2013/2/1,臺中市,潭子區,33806,103667,51512,52155
2013/2/1,臺中市,大雅區,27145,91530,45993,45537
2013/2/1,臺中市,新社區,7420,25384,13234,12150
2013/2/1,臺中市,石岡區,4882,15743,8186,7557
2013/2/1,臺中市,外埔區,9061,31770,16338,15432
2013/2/1,臺中市,大安區,5313,19849,10450,9399
2013/2/1,臺中市,烏日區,21564,70164,35492,34672
2013/2/1,臺中市,大肚區,16287,55960,28677,27283
2013/2/1,臺中市,龍井區,21373,75146,38132,37014
2013/2/1,臺中市,霧峰區,19125,64138,32900,31238
2013/2/1,臺中市,太平區,56977,177081,88606,88475
2013/2/1,臺中市,大里區,64799,203664,100673,102991
2013/2/1,臺中市,和平區,4395,10568,5699,4869
2013/2/1,臺南市,新營區,27931,78587,39078,39509
2013/2/1,臺南市,鹽水區,10058,26633,13862,12771
2013/2/1,臺南市,白河區,11023,30544,15996,14548
2013/2/1,臺南市,柳營區,7816,22086,11535,10551
2013/2/1,臺南市,後壁區,8947,25201,13127,12074
2013/2/1,臺南市,東山區,8278,22492,11909,10583
2013/2/1,臺南市,麻豆區,15325,45401,23143,22258
2013/2/1,臺南市,下營區,9138,25553,13187,12366
2013/2/1,臺南市,六甲區,7736,23348,12117,11231
2013/2/1,臺南市,官田區,7729,21894,11185,10709
2013/2/1,臺南市,大內區,4023,10504,5612,4892
2013/2/1,臺南市,佳里區,19824,59294,29452,29842
2013/2/1,臺南市,學甲區,9662,27417,14010,13407
2013/2/1,臺南市,西港區,7953,25012,12694,12318
2013/2/1,臺南市,七股區,8115,24215,12628,11587
2013/2/1,臺南市,將軍區,7426,20979,10663,10316
2013/2/1,臺南市,北門區,4398,12029,6075,5954
2013/2/1,臺南市,新化區,13980,43887,22509,21378
2013/2/1,臺南市,善化區,15444,44679,22511,22168
2013/2/1,臺南市,新市區,11214,35218,17721,17497
2013/2/1,臺南市,安定區,9572,30299,15651,14648
2013/2/1,臺南市,山上區,2732,7682,4018,3664
2013/2/1,臺南市,玉井區,5121,15031,7829,7202
2013/2/1,臺南市,楠西區,3550,10281,5455,4826
2013/2/1,臺南市,南化區,2832,8836,4828,4008
2013/2/1,臺南市,左鎮區,1989,5279,2953,2326
2013/2/1,臺南市,仁德區,25713,71398,36442,34956
2013/2/1,臺南市,歸仁區,21352,66735,33975,32760
2013/2/1,臺南市,關廟區,10815,35294,18291,17003
2013/2/1,臺南市,龍崎區,1590,4330,2349,1981
2013/2/1,臺南市,永康區,78915,224625,111356,113269
2013/2/1,臺南市,東區,71748,192966,93008,99958
2013/2/1,臺南市,南區,44130,125890,62929,62961
2013/2/1,臺南市,北區,49113,132209,64865,67344
2013/2/1,臺南市,安南區,57422,183052,92772,90280
2013/2/1,臺南市,安平區,24011,64375,30767,33608
2013/2/1,臺南市,中西區,30621,78863,38487,40376
2013/2/1,高雄市,鹽埕區,11013,26221,13086,13135
2013/2/1,高雄市,鼓山區,54036,134011,65214,68797
2013/2/1,高雄市,左營區,75752,194997,95225,99772
2013/2/1,高雄市,楠梓區,64030,176091,87162,88929
2013/2/1,高雄市,三民區,133265,349685,170448,179237
2013/2/1,高雄市,新興區,22792,53699,25977,27722
2013/2/1,高雄市,前金區,12559,28224,13708,14516
2013/2/1,高雄市,苓雅區,72112,179310,86993,92317
2013/2/1,高雄市,前鎮區,77259,195806,96946,98860
2013/2/1,高雄市,旗津區,10972,29337,15207,14130
2013/2/1,高雄市,小港區,65105,155953,77969,77984
2013/2/1,高雄市,鳳山區,132231,350447,173439,177008
2013/2/1,高雄市,林園區,25015,70434,35974,34460
2013/2/1,高雄市,大寮區,39741,109839,56809,53030
2013/2/1,高雄市,大樹區,13152,43370,22413,20957
2013/2/1,高雄市,大社區,12114,33831,17313,16518
2013/2/1,高雄市,仁武區,28464,77612,39823,37789
2013/2/1,高雄市,鳥松區,17233,43672,22142,21530
2013/2/1,高雄市,岡山區,34036,97683,48781,48902
2013/2/1,高雄市,橋頭區,13019,36977,18865,18112
2013/2/1,高雄市,燕巢區,10200,30732,16329,14403
2013/2/1,高雄市,田寮區,3476,7814,4364,3450
2013/2/1,高雄市,阿蓮區,9315,30001,15140,14861
2013/2/1,高雄市,路竹區,16337,53138,27151,25987
2013/2/1,高雄市,湖內區,10039,29127,14975,14152
2013/2/1,高雄市,茄萣區,10304,30942,16058,14884
2013/2/1,高雄市,永安區,5826,14133,7153,6980
2013/2/1,高雄市,彌陀區,6695,20057,10415,9642
2013/2/1,高雄市,梓官區,12298,36480,18919,17561
2013/2/1,高雄市,旗山區,13906,38987,20222,18765
2013/2/1,高雄市,美濃區,14393,42098,21978,20120
2013/2/1,高雄市,六龜區,5719,14162,7651,6511
2013/2/1,高雄市,甲仙區,2396,6594,3505,3089
2013/2/1,高雄市,杉林區,4828,12617,6886,5731
2013/2/1,高雄市,內門區,5061,15479,8448,7031
2013/2/1,高雄市,茂林區,577,1831,923,908
2013/2/1,高雄市,桃源區,1348,4531,2392,2139
2013/2/1,高雄市,那瑪夏區,878,3174,1640,1534
2013/2/1,宜蘭縣,宜蘭市,34535,96059,47106,48953
2013/2/1,宜蘭縣,羅東鎮,25487,72548,34765,37783
2013/2/1,宜蘭縣,蘇澳鎮,13815,41816,21377,20439
2013/2/1,宜蘭縣,頭城鎮,9956,30263,15657,14606
2013/2/1,宜蘭縣,礁溪鄉,12959,36038,18819,17219
2013/2/1,宜蘭縣,壯圍鄉,8315,24518,12986,11532
2013/2/1,宜蘭縣,員山鄉,11068,32097,17175,14922
2013/2/1,宜蘭縣,冬山鄉,18118,53351,27408,25943
2013/2/1,宜蘭縣,五結鄉,13492,38983,20173,18810
2013/2/1,宜蘭縣,三星鄉,7801,21115,11431,9684
2013/2/1,宜蘭縣,大同鄉,1858,5922,3216,2706
2013/2/1,宜蘭縣,南澳鄉,1858,5889,3127,2762
2013/2/1,桃園市,桃園區,150679,414190,202584,211606
2013/2/1,桃園市,中壢區,133489,376593,187479,189114
2013/2/1,桃園市,平鎮區,69465,210064,105496,104568
2013/2/1,桃園市,八德區,60845,179008,90737,88271
2013/2/1,桃園市,楊梅區,51466,154508,78405,76103
2013/2/1,桃園市,大溪區,30036,91868,47310,44558
2013/2/1,桃園市,蘆竹區,51153,147185,73557,73628
2013/2/1,桃園市,大園區,27329,83011,42920,40091
2013/2/1,桃園市,龜山區,52152,139754,70456,69298
2013/2/1,桃園市,龍潭區,37885,115202,58358,56844
2013/2/1,桃園市,新屋區,15195,48197,25820,22377
2013/2/1,桃園市,觀音區,20001,62673,32906,29767
2013/2/1,桃園市,復興區,3696,10595,5879,4716
2013/2/1,新竹縣,竹北市,52691,153406,76625,76781
2013/2/1,新竹縣,關西鎮,9479,31194,16611,14583
2013/2/1,新竹縣,新埔鎮,10559,34920,18576,16344
2013/2/1,新竹縣,竹東鎮,31650,96594,48629,47965
2013/2/1,新竹縣,湖口鄉,24369,76555,38947,37608
2013/2/1,新竹縣,橫山鄉,4482,14008,7588,6420
2013/2/1,新竹縣,新豐鄉,16630,54598,28027,26571
2013/2/1,新竹縣,芎林鄉,6374,20343,10718,9625
2013/2/1,新竹縣,寶山鄉,4962,14074,7602,6472
2013/2/1,新竹縣,北埔鄉,3149,9895,5355,4540
2013/2/1,新竹縣,峨眉鄉,2066,5813,3233,2580
2013/2/1,新竹縣,尖石鄉,2788,9002,4825,4177
2013/2/1,新竹縣,五峰鄉,1722,4518,2481,2037
2013/2/1,苗栗縣,苗栗市,29996,91077,45667,45410
2013/2/1,苗栗縣,苑裡鎮,14161,48481,25195,23286
2013/2/1,苗栗縣,通霄鎮,11517,37401,19752,17649
2013/2/1,苗栗縣,竹南鎮,25667,81133,41120,40013
2013/2/1,苗栗縣,頭份市,31494,100264,50791,49473
2013/2/1,苗栗縣,後龍鎮,11871,38743,20407,18336
2013/2/1,苗栗縣,卓蘭鎮,6118,18450,9713,8737
2013/2/1,苗栗縣,大湖鄉,5408,15786,8384,7402
2013/2/1,苗栗縣,公館鄉,10494,34931,18190,16741
2013/2/1,苗栗縣,銅鑼鄉,6092,19190,10177,9013
2013/2/1,苗栗縣,南庄鄉,3991,10844,5955,4889
2013/2/1,苗栗縣,頭屋鄉,3590,11428,6033,5395
2013/2/1,苗栗縣,三義鄉,5404,17431,9131,8300
2013/2/1,苗栗縣,西湖鄉,2718,7726,4282,3444
2013/2/1,苗栗縣,造橋鄉,4096,13603,7162,6441
2013/2/1,苗栗縣,三灣鄉,2437,7183,3911,3272
2013/2/1,苗栗縣,獅潭鄉,1726,4768,2674,2094
2013/2/1,苗栗縣,泰安鄉,1969,5904,3168,2736
2013/2/1,彰化縣,彰化市,73844,236570,117522,119048
2013/2/1,彰化縣,鹿港鎮,23127,85977,43912,42065
2013/2/1,彰化縣,和美鎮,25089,90413,46269,44144
2013/2/1,彰化縣,北斗鎮,10202,33254,16818,16436
2013/2/1,彰化縣,員林市,37681,125241,62821,62420
2013/2/1,彰化縣,溪湖鎮,15610,55969,28547,27422
2013/2/1,彰化縣,田中鎮,12767,43372,22442,20930
2013/2/1,彰化縣,二林鎮,14593,53131,27381,25750
2013/2/1,彰化縣,線西鄉,4192,17047,8819,8228
2013/2/1,彰化縣,伸港鄉,9267,36040,18487,17553
2013/2/1,彰化縣,福興鄉,12310,48160,25151,23009
2013/2/1,彰化縣,秀水鄉,10134,39410,20367,19043
2013/2/1,彰化縣,花壇鄉,13308,46049,23710,22339
2013/2/1,彰化縣,芬園鄉,6876,24402,12875,11527
2013/2/1,彰化縣,大村鄉,10520,36441,18938,17503
2013/2/1,彰化縣,埔鹽鄉,8940,33663,17668,15995
2013/2/1,彰化縣,埔心鄉,10183,35145,18151,16994
2013/2/1,彰化縣,永靖鄉,10631,38702,20131,18571
2013/2/1,彰化縣,社頭鄉,12553,44141,22694,21447
2013/2/1,彰化縣,二水鄉,5353,16093,8453,7640
2013/2/1,彰化縣,田尾鄉,7756,28057,14592,13465
2013/2/1,彰化縣,埤頭鄉,8792,31411,16381,15030
2013/2/1,彰化縣,芳苑鄉,10059,35276,18665,16611
2013/2/1,彰化縣,大城鄉,5395,18300,9954,8346
2013/2/1,彰化縣,竹塘鄉,4624,16144,8523,7621
2013/2/1,彰化縣,溪州鄉,8820,31141,16388,14753
2013/2/1,南投縣,南投市,33938,103295,51867,51428
2013/2/1,南投縣,埔里鎮,28775,84289,42355,41934
2013/2/1,南投縣,草屯鎮,31846,99382,50246,49136
2013/2/1,南投縣,竹山鎮,19808,57489,29594,27895
2013/2/1,南投縣,集集鎮,4358,11561,6038,5523
2013/2/1,南投縣,名間鄉,12424,40658,21369,19289
2013/2/1,南投縣,鹿谷鄉,7192,18822,9987,8835
2013/2/1,南投縣,中寮鄉,5663,15861,8604,7257
2013/2/1,南投縣,魚池鄉,5778,16761,8801,7960
2013/2/1,南投縣,國姓鄉,7275,20085,10923,9162
2013/2/1,南投縣,水里鄉,7280,19320,10133,9187
2013/2/1,南投縣,信義鄉,5267,16788,9054,7734
2013/2/1,南投縣,仁愛鄉,4928,15610,8110,7500
2013/2/1,雲林縣,斗六市,36171,107854,53969,53885
2013/2/1,雲林縣,斗南鎮,15532,46533,23698,22835
2013/2/1,雲林縣,虎尾鎮,23492,70494,35818,34676
2013/2/1,雲林縣,西螺鎮,14237,47711,24283,23428
2013/2/1,雲林縣,土庫鎮,9012,29961,15668,14293
2013/2/1,雲林縣,北港鎮,15768,42235,21996,20239
2013/2/1,雲林縣,古坑鄉,10821,33248,17543,15705
2013/2/1,雲林縣,大埤鄉,6768,20507,11026,9481
2013/2/1,雲林縣,莿桐鄉,9185,29860,15707,14153
2013/2/1,雲林縣,林內鄉,5862,19321,10064,9257
2013/2/1,雲林縣,二崙鄉,8894,29011,15490,13521
2013/2/1,雲林縣,崙背鄉,8467,26475,13995,12480
2013/2/1,雲林縣,麥寮鄉,13405,41339,21091,20248
2013/2/1,雲林縣,東勢鄉,5811,16046,8774,7272
2013/2/1,雲林縣,褒忠鄉,4394,13831,7391,6440
2013/2/1,雲林縣,臺西鄉,8844,25022,13474,11548
2013/2/1,雲林縣,元長鄉,9442,27954,15252,12702
2013/2/1,雲林縣,四湖鄉,9083,25839,14052,11787
2013/2/1,雲林縣,口湖鄉,9680,29579,15776,13803
2013/2/1,雲林縣,水林鄉,10364,27754,15198,12556
2013/2/1,嘉義縣,太保市,11816,36964,19052,17912
2013/2/1,嘉義縣,朴子市,15145,43793,22217,21576
2013/2/1,嘉義縣,布袋鎮,10195,29159,14980,14179
2013/2/1,嘉義縣,大林鎮,11394,32895,16885,16010
2013/2/1,嘉義縣,民雄鄉,23535,72297,37084,35213
2013/2/1,嘉義縣,溪口鄉,5444,15792,8421,7371
2013/2/1,嘉義縣,新港鄉,10505,33777,17840,15937
2013/2/1,嘉義縣,六腳鄉,9131,25311,13431,11880
2013/2/1,嘉義縣,東石鄉,9503,26658,14169,12489
2013/2/1,嘉義縣,義竹鄉,7565,20108,10446,9662
2013/2/1,嘉義縣,鹿草鄉,5851,16799,9024,7775
2013/2/1,嘉義縣,水上鄉,17638,51508,26592,24916
2013/2/1,嘉義縣,中埔鄉,15782,46945,24463,22482
2013/2/1,嘉義縣,竹崎鄉,11528,37825,20148,17677
2013/2/1,嘉義縣,梅山鄉,6770,20788,11019,9769
2013/2/1,嘉義縣,番路鄉,4262,12218,6648,5570
2013/2/1,嘉義縣,大埔鄉,1929,4564,2384,2180
2013/2/1,嘉義縣,阿里山鄉,1925,5705,3042,2663
2013/2/1,屏東縣,屏東市,72910,207602,103230,104372
2013/2/1,屏東縣,潮州鎮,18660,55200,27698,27502
2013/2/1,屏東縣,東港鎮,16064,49168,24829,24339
2013/2/1,屏東縣,恆春鎮,11073,30715,15762,14953
2013/2/1,屏東縣,萬丹鄉,14566,53062,27509,25553
2013/2/1,屏東縣,長治鄉,9888,30588,15999,14589
2013/2/1,屏東縣,麟洛鄉,3651,11294,5851,5443
2013/2/1,屏東縣,九如鄉,6700,22552,11693,10859
2013/2/1,屏東縣,里港鄉,8005,26329,13434,12895
2013/2/1,屏東縣,鹽埔鄉,7807,26773,13949,12824
2013/2/1,屏東縣,高樹鄉,9441,25954,13874,12080
2013/2/1,屏東縣,萬巒鄉,6457,21356,11248,10108
2013/2/1,屏東縣,內埔鄉,18189,57006,29605,27401
2013/2/1,屏東縣,竹田鄉,5631,18003,9553,8450
2013/2/1,屏東縣,新埤鄉,3400,10346,5492,4854
2013/2/1,屏東縣,枋寮鄉,8564,25917,13606,12311
2013/2/1,屏東縣,新園鄉,11665,37341,19334,18007
2013/2/1,屏東縣,崁頂鄉,4363,16687,8480,8207
2013/2/1,屏東縣,林邊鄉,7108,19862,10226,9636
2013/2/1,屏東縣,南州鄉,3662,11264,5772,5492
2013/2/1,屏東縣,佳冬鄉,7133,20782,10830,9952
2013/2/1,屏東縣,琉球鄉,4063,12166,6755,5411
2013/2/1,屏東縣,車城鄉,3484,9160,4947,4213
2013/2/1,屏東縣,滿州鄉,3050,8200,4528,3672
2013/2/1,屏東縣,枋山鄉,2129,5846,3128,2718
2013/2/1,屏東縣,三地門鄉,2231,7515,3832,3683
2013/2/1,屏東縣,霧臺鄉,1029,3117,1624,1493
2013/2/1,屏東縣,瑪家鄉,1951,6588,3400,3188
2013/2/1,屏東縣,泰武鄉,1241,5061,2653,2408
2013/2/1,屏東縣,來義鄉,2217,7651,3922,3729
2013/2/1,屏東縣,春日鄉,1330,4830,2494,2336
2013/2/1,屏東縣,獅子鄉,1502,4802,2517,2285
2013/2/1,屏東縣,牡丹鄉,1895,4832,2499,2333
2013/2/1,臺東縣,臺東市,38450,107719,54349,53370
2013/2/1,臺東縣,成功鎮,5415,15225,8057,7168
2013/2/1,臺東縣,關山鎮,3263,9403,4936,4467
2013/2/1,臺東縣,卑南鄉,6624,17782,9536,8246
2013/2/1,臺東縣,大武鄉,2514,6645,3468,3177
2013/2/1,臺東縣,太麻里鄉,4577,11662,6209,5453
2013/2/1,臺東縣,東河鄉,3720,9091,5044,4047
2013/2/1,臺東縣,長濱鄉,2910,7852,4484,3368
2013/2/1,臺東縣,鹿野鄉,3137,8301,4471,3830
2013/2/1,臺東縣,池上鄉,3287,8801,4623,4178
2013/2/1,臺東縣,綠島鄉,1059,3449,1829,1620
2013/2/1,臺東縣,延平鄉,1067,3551,1932,1619
2013/2/1,臺東縣,海端鄉,1096,4370,2375,1995
2013/2/1,臺東縣,達仁鄉,1492,3826,2088,1738
2013/2/1,臺東縣,金峰鄉,1089,3522,1831,1691
2013/2/1,臺東縣,蘭嶼鄉,1640,4848,2479,2369
2013/2/1,花蓮縣,花蓮市,40999,108032,52677,55355
2013/2/1,花蓮縣,鳳林鎮,4419,11495,6076,5419
2013/2/1,花蓮縣,玉里鎮,8921,26007,14029,11978
2013/2/1,花蓮縣,新城鄉,7400,20123,10421,9702
2013/2/1,花蓮縣,吉安鄉,30173,81463,41492,39971
2013/2/1,花蓮縣,壽豐鄉,6876,18225,9825,8400
2013/2/1,花蓮縣,光復鄉,5025,13598,7247,6351
2013/2/1,花蓮縣,豐濱鄉,1759,4661,2596,2065
2013/2/1,花蓮縣,瑞穗鄉,4667,12325,6661,5664
2013/2/1,花蓮縣,富里鄉,4024,11159,6086,5073
2013/2/1,花蓮縣,秀林鄉,4696,15137,7845,7292
2013/2/1,花蓮縣,萬榮鄉,2093,6600,3511,3089
2013/2/1,花蓮縣,卓溪鄉,1657,6166,3428,2738
2013/2/1,澎湖縣,馬公市,21816,58594,29756,28838
2013/2/1,澎湖縣,湖西鄉,5048,13918,7271,6647
2013/2/1,澎湖縣,白沙鄉,3217,9475,4974,4501
2013/2/1,澎湖縣,西嶼鄉,2908,8360,4321,4039
2013/2/1,澎湖縣,望安鄉,1996,4983,2668,2315
2013/2/1,澎湖縣,七美鄉,1291,3589,1876,1713
2013/2/1,基隆市,中正區,22228,53959,27629,26330
2013/2/1,基隆市,七堵區,20455,54197,27480,26717
2013/2/1,基隆市,暖暖區,14714,37827,19169,18658
2013/2/1,基隆市,仁愛區,19622,47598,23450,24148
2013/2/1,基隆市,中山區,19301,49753,25391,24362
2013/2/1,基隆市,安樂區,31984,82333,41061,41272
2013/2/1,基隆市,信義區,20501,51189,25576,25613
2013/2/1,新竹市,東區,72392,203361,100270,103091
2013/2/1,新竹市,北區,52678,147631,72651,74980
2013/2/1,新竹市,香山區,24218,74710,38084,36626
2013/2/1,嘉義市,東區,44803,124189,60527,63662
2013/2/1,嘉義市,西區,52280,147006,72542,74464
2013/2/1,金門縣,金城鎮,12006,37327,18777,18550
2013/2/1,金門縣,金湖鎮,7925,24852,12613,12239
2013/2/1,金門縣,金沙鎮,5801,17692,8836,8856
2013/2/1,金門縣,金寧鄉,6839,23148,11835,11313
2013/2/1,金門縣,烈嶼鄉,2863,10560,5216,5344
2013/2/1,金門縣,烏坵鄉,134,612,304,308
2013/2/1,連江縣,南竿鄉,1342,6915,3917,2998
2013/2/1,連江縣,北竿鄉,442,2110,1174,936
2013/2/1,連江縣,莒光鄉,268,1338,799,539
2013/2/1,連江縣,東引鄉,290,1149,681,468
2013/3/1,總計,新北市,1460870,3942882,1947002,1995880
2013/3/1,總計,臺北市,1018618,2677771,1287311,1390460
2013/3/1,總計,臺中市,886117,2689659,1335031,1354628
2013/3/1,總計,臺南市,657871,1882369,944967,937402
2013/3/1,總計,高雄市,1048194,2778936,1387382,1391554
2013/3/1,總計,臺灣省,3094171,9234626,4710939,4523687
2013/3/1,總計,宜蘭縣,159357,458599,233196,225403
2013/3/1,總計,桃園市,704515,2033634,1022277,1011357
2013/3/1,總計,新竹縣,171204,525327,269408,255919
2013/3/1,總計,苗栗縣,178918,564386,291696,272690
2013/3/1,總計,彰化縣,372944,1299274,665540,633734
2013/3/1,總計,南投縣,174688,519733,266958,252775
2013/3/1,總計,雲林縣,235386,710269,370087,340182
2013/3/1,總計,嘉義縣,179971,532541,277621,254920
2013/3/1,總計,屏東縣,281125,857017,439859,417158
2013/3/1,總計,臺東縣,81414,225898,117638,108260
2013/3/1,總計,花蓮縣,122804,334872,171810,163062
2013/3/1,總計,澎湖縣,36339,99032,50932,48100
2013/3/1,總計,基隆市,148834,376659,189660,186999
2013/3/1,總計,新竹市,149518,426145,211187,214958
2013/3/1,總計,嘉義市,97154,271240,133070,138170
2013/3/1,總計,福建省,38034,126462,64510,61952
2013/3/1,總計,金門縣,35680,114867,57900,56967
2013/3/1,總計,連江縣,2354,11595,6610,4985
2013/3/1,新北市,板橋區,202141,557540,274061,283479
2013/3/1,新北市,三重區,144490,390189,193458,196731
2013/3/1,新北市,中和區,159815,416235,204262,211973
2013/3/1,新北市,永和區,90539,230740,110266,120474
2013/3/1,新北市,新莊區,142392,407681,200683,206998
2013/3/1,新北市,新店區,119488,297606,144765,152841
2013/3/1,新北市,樹林區,63703,182439,91464,90975
2013/3/1,新北市,鶯歌區,28584,88417,44484,43933
2013/3/1,新北市,三峽區,38586,108240,54826,53414
2013/3/1,新北市,淡水區,63189,151776,73407,78369
2013/3/1,新北市,汐止區,82109,192952,95142,97810
2013/3/1,新北市,瑞芳區,15975,41570,21086,20484
2013/3/1,新北市,土城區,84552,239636,119186,120450
2013/3/1,新北市,蘆洲區,67548,199543,98453,101090
2013/3/1,新北市,五股區,28315,81265,41083,40182
2013/3/1,新北市,泰山區,26986,77723,38840,38883
2013/3/1,新北市,林口區,34400,90737,44639,46098
2013/3/1,新北市,深坑區,9193,23565,11858,11707
2013/3/1,新北市,石碇區,3354,7855,4325,3530
2013/3/1,新北市,坪林區,2482,6479,3615,2864
2013/3/1,新北市,三芝區,9118,23485,12104,11381
2013/3/1,新北市,石門區,4245,12764,6675,6089
2013/3/1,新北市,八里區,13009,35765,18033,17732
2013/3/1,新北市,平溪區,2391,5071,2814,2257
2013/3/1,新北市,雙溪區,3846,9451,5080,4371
2013/3/1,新北市,貢寮區,4470,13398,6888,6510
2013/3/1,新北市,金山區,6910,22410,11160,11250
2013/3/1,新北市,萬里區,7285,22417,11378,11039
2013/3/1,新北市,烏來區,1755,5933,2967,2966
2013/3/1,臺北市,松山區,79626,211020,99963,111057
2013/3/1,臺北市,信義區,88016,227991,109531,118460
2013/3/1,臺北市,大安區,118945,313587,147186,166401
2013/3/1,臺北市,中山區,96262,227289,106460,120829
2013/3/1,臺北市,中正區,64140,162782,78229,84553
2013/3/1,臺北市,大同區,49987,129173,63399,65774
2013/3/1,臺北市,萬華區,76641,192646,95587,97059
2013/3/1,臺北市,文山區,100980,269939,130354,139585
2013/3/1,臺北市,南港區,44374,118687,58080,60607
2013/3/1,臺北市,內湖區,102562,280753,134880,145873
2013/3/1,臺北市,士林區,104157,289364,140258,149106
2013/3/1,臺北市,北投區,92928,254540,123384,131156
2013/3/1,臺中市,中區,8041,20567,10211,10356
2013/3/1,臺中市,東區,26559,74324,37319,37005
2013/3/1,臺中市,南區,44349,117073,56655,60418
2013/3/1,臺中市,西區,44263,116751,55743,61008
2013/3/1,臺中市,北區,57307,147836,71394,76442
2013/3/1,臺中市,西屯區,77259,213554,103020,110534
2013/3/1,臺中市,南屯區,56225,158836,76597,82239
2013/3/1,臺中市,北屯區,87995,253499,122561,130938
2013/3/1,臺中市,豐原區,51178,166157,82346,83811
2013/3/1,臺中市,東勢區,17170,52341,27113,25228
2013/3/1,臺中市,大甲區,22157,78075,39579,38496
2013/3/1,臺中市,清水區,25537,85756,44169,41587
2013/3/1,臺中市,沙鹿區,25678,85236,43268,41968
2013/3/1,臺中市,梧棲區,16418,55908,28248,27660
2013/3/1,臺中市,后里區,15147,54106,27672,26434
2013/3/1,臺中市,神岡區,18252,64579,33163,31416
2013/3/1,臺中市,潭子區,33844,103707,51526,52181
2013/3/1,臺中市,大雅區,27206,91649,46036,45613
2013/3/1,臺中市,新社區,7425,25371,13221,12150
2013/3/1,臺中市,石岡區,4875,15703,8173,7530
2013/3/1,臺中市,外埔區,9073,31764,16332,15432
2013/3/1,臺中市,大安區,5313,19809,10433,9376
2013/3/1,臺中市,烏日區,21599,70214,35518,34696
2013/3/1,臺中市,大肚區,16323,55979,28670,27309
2013/3/1,臺中市,龍井區,21411,75179,38148,37031
2013/3/1,臺中市,霧峰區,19160,64146,32891,31255
2013/3/1,臺中市,太平區,57076,177145,88609,88536
2013/3/1,臺中市,大里區,64876,203801,100700,103101
2013/3/1,臺中市,和平區,4401,10594,5716,4878
2013/3/1,臺南市,新營區,27960,78703,39127,39576
2013/3/1,臺南市,鹽水區,10043,26617,13859,12758
2013/3/1,臺南市,白河區,11026,30509,15983,14526
2013/3/1,臺南市,柳營區,7819,22073,11530,10543
2013/3/1,臺南市,後壁區,8942,25153,13098,12055
2013/3/1,臺南市,東山區,8279,22430,11866,10564
2013/3/1,臺南市,麻豆區,15350,45402,23127,22275
2013/3/1,臺南市,下營區,9135,25486,13146,12340
2013/3/1,臺南市,六甲區,7740,23328,12105,11223
2013/3/1,臺南市,官田區,7735,21855,11167,10688
2013/3/1,臺南市,大內區,4025,10504,5616,4888
2013/3/1,臺南市,佳里區,19839,59303,29476,29827
2013/3/1,臺南市,學甲區,9666,27413,14010,13403
2013/3/1,臺南市,西港區,7947,24980,12675,12305
2013/3/1,臺南市,七股區,8109,24190,12608,11582
2013/3/1,臺南市,將軍區,7417,20940,10648,10292
2013/3/1,臺南市,北門區,4398,12001,6058,5943
2013/3/1,臺南市,新化區,13985,43915,22523,21392
2013/3/1,臺南市,善化區,15463,44736,22540,22196
2013/3/1,臺南市,新市區,11217,35217,17725,17492
2013/3/1,臺南市,安定區,9584,30286,15639,14647
2013/3/1,臺南市,山上區,2731,7667,4008,3659
2013/3/1,臺南市,玉井區,5122,15004,7822,7182
2013/3/1,臺南市,楠西區,3549,10248,5439,4809
2013/3/1,臺南市,南化區,2832,8822,4821,4001
2013/3/1,臺南市,左鎮區,1992,5265,2945,2320
2013/3/1,臺南市,仁德區,25769,71441,36449,34992
2013/3/1,臺南市,歸仁區,21377,66797,33992,32805
2013/3/1,臺南市,關廟區,10823,35265,18273,16992
2013/3/1,臺南市,龍崎區,1588,4328,2348,1980
2013/3/1,臺南市,永康區,79057,224966,111508,113458
2013/3/1,臺南市,東區,71788,192962,93008,99954
2013/3/1,臺南市,南區,44162,125781,62868,62913
2013/3/1,臺南市,北區,49130,132156,64825,67331
2013/3/1,臺南市,安南區,57535,183224,92834,90390
2013/3/1,臺南市,安平區,24040,64370,30763,33607
2013/3/1,臺南市,中西區,30697,79032,38538,40494
2013/3/1,高雄市,鹽埕區,11013,26185,13068,13117
2013/3/1,高雄市,鼓山區,54073,134068,65218,68850
2013/3/1,高雄市,左營區,75837,195164,95339,99825
2013/3/1,高雄市,楠梓區,64078,176194,87197,88997
2013/3/1,高雄市,三民區,133295,349483,170339,179144
2013/3/1,高雄市,新興區,22782,53666,25948,27718
2013/3/1,高雄市,前金區,12560,28210,13712,14498
2013/3/1,高雄市,苓雅區,72112,179182,86909,92273
2013/3/1,高雄市,前鎮區,77234,195572,96822,98750
2013/3/1,高雄市,旗津區,10969,29301,15185,14116
2013/3/1,高雄市,小港區,65138,155928,77926,78002
2013/3/1,高雄市,鳳山區,132437,350814,173573,177241
2013/3/1,高雄市,林園區,25052,70433,35963,34470
2013/3/1,高雄市,大寮區,39782,109854,56815,53039
2013/3/1,高雄市,大樹區,13149,43360,22408,20952
2013/3/1,高雄市,大社區,12122,33828,17306,16522
2013/3/1,高雄市,仁武區,28550,77772,39902,37870
2013/3/1,高雄市,鳥松區,17240,43666,22154,21512
2013/3/1,高雄市,岡山區,34066,97676,48741,48935
2013/3/1,高雄市,橋頭區,13029,36979,18869,18110
2013/3/1,高雄市,燕巢區,10219,30732,16333,14399
2013/3/1,高雄市,田寮區,3475,7818,4356,3462
2013/3/1,高雄市,阿蓮區,9323,29954,15119,14835
2013/3/1,高雄市,路竹區,16368,53161,27176,25985
2013/3/1,高雄市,湖內區,10053,29103,14972,14131
2013/3/1,高雄市,茄萣區,10302,30896,16043,14853
2013/3/1,高雄市,永安區,5828,14130,7141,6989
2013/3/1,高雄市,彌陀區,6692,20040,10405,9635
2013/3/1,高雄市,梓官區,12315,36475,18896,17579
2013/3/1,高雄市,旗山區,13903,38955,20201,18754
2013/3/1,高雄市,美濃區,14408,42073,21974,20099
2013/3/1,高雄市,六龜區,5712,14136,7644,6492
2013/3/1,高雄市,甲仙區,2389,6559,3486,3073
2013/3/1,高雄市,杉林區,4829,12616,6877,5739
2013/3/1,高雄市,內門區,5061,15458,8434,7024
2013/3/1,高雄市,茂林區,577,1825,920,905
2013/3/1,高雄市,桃源區,1347,4514,2378,2136
2013/3/1,高雄市,那瑪夏區,875,3156,1633,1523
2013/3/1,宜蘭縣,宜蘭市,34556,96104,47114,48990
2013/3/1,宜蘭縣,羅東鎮,25491,72572,34756,37816
2013/3/1,宜蘭縣,蘇澳鎮,13811,41730,21318,20412
2013/3/1,宜蘭縣,頭城鎮,9955,30224,15636,14588
2013/3/1,宜蘭縣,礁溪鄉,12948,36053,18820,17233
2013/3/1,宜蘭縣,壯圍鄉,8317,24500,12975,11525
2013/3/1,宜蘭縣,員山鄉,11072,32099,17174,14925
2013/3/1,宜蘭縣,冬山鄉,18148,53368,27405,25963
2013/3/1,宜蘭縣,五結鄉,13522,39025,20204,18821
2013/3/1,宜蘭縣,三星鄉,7822,21121,11446,9675
2013/3/1,宜蘭縣,大同鄉,1861,5914,3212,2702
2013/3/1,宜蘭縣,南澳鄉,1854,5889,3136,2753
2013/3/1,桃園市,桃園區,150940,414531,202751,211780
2013/3/1,桃園市,中壢區,133706,376811,187621,189190
2013/3/1,桃園市,平鎮區,69567,210069,105446,104623
2013/3/1,桃園市,八德區,60928,178998,90747,88251
2013/3/1,桃園市,楊梅區,51564,154565,78444,76121
2013/3/1,桃園市,大溪區,30077,91862,47292,44570
2013/3/1,桃園市,蘆竹區,51259,147298,73643,73655
2013/3/1,桃園市,大園區,27403,83083,42942,40141
2013/3/1,桃園市,龜山區,52232,139817,70471,69346
2013/3/1,桃園市,龍潭區,37952,115156,58354,56802
2013/3/1,桃園市,新屋區,15176,48158,25799,22359
2013/3/1,桃園市,觀音區,20015,62689,32895,29794
2013/3/1,桃園市,復興區,3696,10597,5872,4725
2013/3/1,新竹縣,竹北市,52833,153832,76852,76980
2013/3/1,新竹縣,關西鎮,9483,31178,16597,14581
2013/3/1,新竹縣,新埔鎮,10572,34897,18567,16330
2013/3/1,新竹縣,竹東鎮,31666,96601,48630,47971
2013/3/1,新竹縣,湖口鄉,24410,76539,38955,37584
2013/3/1,新竹縣,橫山鄉,4480,13982,7568,6414
2013/3/1,新竹縣,新豐鄉,16688,54712,28066,26646
2013/3/1,新竹縣,芎林鄉,6374,20319,10697,9622
2013/3/1,新竹縣,寶山鄉,4975,14091,7609,6482
2013/3/1,新竹縣,北埔鄉,3151,9891,5351,4540
2013/3/1,新竹縣,峨眉鄉,2064,5802,3228,2574
2013/3/1,新竹縣,尖石鄉,2786,8974,4810,4164
2013/3/1,新竹縣,五峰鄉,1722,4509,2478,2031
2013/3/1,苗栗縣,苗栗市,30014,91094,45656,45438
2013/3/1,苗栗縣,苑裡鎮,14172,48470,25195,23275
2013/3/1,苗栗縣,通霄鎮,11516,37349,19727,17622
2013/3/1,苗栗縣,竹南鎮,25715,81244,41177,40067
2013/3/1,苗栗縣,頭份市,31554,100402,50848,49554
2013/3/1,苗栗縣,後龍鎮,11864,38691,20370,18321
2013/3/1,苗栗縣,卓蘭鎮,6116,18433,9703,8730
2013/3/1,苗栗縣,大湖鄉,5421,15800,8388,7412
2013/3/1,苗栗縣,公館鄉,10508,34899,18185,16714
2013/3/1,苗栗縣,銅鑼鄉,6104,19181,10169,9012
2013/3/1,苗栗縣,南庄鄉,3985,10846,5953,4893
2013/3/1,苗栗縣,頭屋鄉,3599,11418,6024,5394
2013/3/1,苗栗縣,三義鄉,5401,17433,9133,8300
2013/3/1,苗栗縣,西湖鄉,2719,7706,4282,3424
2013/3/1,苗栗縣,造橋鄉,4098,13602,7151,6451
2013/3/1,苗栗縣,三灣鄉,2434,7154,3899,3255
2013/3/1,苗栗縣,獅潭鄉,1730,4769,2669,2100
2013/3/1,苗栗縣,泰安鄉,1968,5895,3167,2728
2013/3/1,彰化縣,彰化市,73911,236521,117500,119021
2013/3/1,彰化縣,鹿港鎮,23159,86007,43934,42073
2013/3/1,彰化縣,和美鎮,25140,90393,46280,44113
2013/3/1,彰化縣,北斗鎮,10198,33237,16815,16422
2013/3/1,彰化縣,員林市,37725,125336,62850,62486
2013/3/1,彰化縣,溪湖鎮,15622,55952,28538,27414
2013/3/1,彰化縣,田中鎮,12772,43352,22440,20912
2013/3/1,彰化縣,二林鎮,14620,53146,27395,25751
2013/3/1,彰化縣,線西鄉,4196,17070,8820,8250
2013/3/1,彰化縣,伸港鄉,9281,36042,18484,17558
2013/3/1,彰化縣,福興鄉,12306,48118,25138,22980
2013/3/1,彰化縣,秀水鄉,10142,39424,20369,19055
2013/3/1,彰化縣,花壇鄉,13335,46042,23713,22329
2013/3/1,彰化縣,芬園鄉,6871,24389,12875,11514
2013/3/1,彰化縣,大村鄉,10518,36409,18919,17490
2013/3/1,彰化縣,埔鹽鄉,8946,33660,17658,16002
2013/3/1,彰化縣,埔心鄉,10185,35140,18139,17001
2013/3/1,彰化縣,永靖鄉,10647,38689,20137,18552
2013/3/1,彰化縣,社頭鄉,12557,44102,22672,21430
2013/3/1,彰化縣,二水鄉,5354,16103,8462,7641
2013/3/1,彰化縣,田尾鄉,7765,28030,14590,13440
2013/3/1,彰化縣,埤頭鄉,8805,31400,16364,15036
2013/3/1,彰化縣,芳苑鄉,10049,35233,18655,16578
2013/3/1,彰化縣,大城鄉,5392,18269,9930,8339
2013/3/1,彰化縣,竹塘鄉,4628,16134,8519,7615
2013/3/1,彰化縣,溪州鄉,8820,31076,16344,14732
2013/3/1,南投縣,南投市,33957,103258,51877,51381
2013/3/1,南投縣,埔里鎮,28787,84263,42321,41942
2013/3/1,南投縣,草屯鎮,31878,99382,50238,49144
2013/3/1,南投縣,竹山鎮,19811,57447,29563,27884
2013/3/1,南投縣,集集鎮,4361,11547,6027,5520
2013/3/1,南投縣,名間鄉,12440,40638,21345,19293
2013/3/1,南投縣,鹿谷鄉,7219,18794,9981,8813
2013/3/1,南投縣,中寮鄉,5665,15848,8595,7253
2013/3/1,南投縣,魚池鄉,5776,16731,8787,7944
2013/3/1,南投縣,國姓鄉,7276,20080,10917,9163
2013/3/1,南投縣,水里鄉,7284,19291,10124,9167
2013/3/1,南投縣,信義鄉,5275,16777,9038,7739
2013/3/1,南投縣,仁愛鄉,4959,15677,8145,7532
2013/3/1,雲林縣,斗六市,36229,107905,53997,53908
2013/3/1,雲林縣,斗南鎮,15535,46469,23659,22810
2013/3/1,雲林縣,虎尾鎮,23529,70510,35823,34687
2013/3/1,雲林縣,西螺鎮,14255,47705,24272,23433
2013/3/1,雲林縣,土庫鎮,9023,29950,15660,14290
2013/3/1,雲林縣,北港鎮,15769,42214,21985,20229
2013/3/1,雲林縣,古坑鄉,10841,33240,17537,15703
2013/3/1,雲林縣,大埤鄉,6765,20464,11010,9454
2013/3/1,雲林縣,莿桐鄉,9181,29867,15709,14158
2013/3/1,雲林縣,林內鄉,5861,19293,10058,9235
2013/3/1,雲林縣,二崙鄉,8900,28947,15461,13486
2013/3/1,雲林縣,崙背鄉,8490,26452,13985,12467
2013/3/1,雲林縣,麥寮鄉,13409,41442,21131,20311
2013/3/1,雲林縣,東勢鄉,5802,16005,8755,7250
2013/3/1,雲林縣,褒忠鄉,4402,13822,7383,6439
2013/3/1,雲林縣,臺西鄉,8844,24998,13466,11532
2013/3/1,雲林縣,元長鄉,9446,27918,15227,12691
2013/3/1,雲林縣,四湖鄉,9077,25807,14031,11776
2013/3/1,雲林縣,口湖鄉,9667,29562,15764,13798
2013/3/1,雲林縣,水林鄉,10361,27699,15174,12525
2013/3/1,嘉義縣,太保市,11825,36969,19051,17918
2013/3/1,嘉義縣,朴子市,15144,43824,22227,21597
2013/3/1,嘉義縣,布袋鎮,10186,29047,14934,14113
2013/3/1,嘉義縣,大林鎮,11404,32874,16874,16000
2013/3/1,嘉義縣,民雄鄉,23550,72251,37091,35160
2013/3/1,嘉義縣,溪口鄉,5448,15745,8399,7346
2013/3/1,嘉義縣,新港鄉,10512,33777,17848,15929
2013/3/1,嘉義縣,六腳鄉,9117,25263,13405,11858
2013/3/1,嘉義縣,東石鄉,9499,26589,14141,12448
2013/3/1,嘉義縣,義竹鄉,7564,20072,10436,9636
2013/3/1,嘉義縣,鹿草鄉,5849,16760,9006,7754
2013/3/1,嘉義縣,水上鄉,17650,51434,26567,24867
2013/3/1,嘉義縣,中埔鄉,15782,46895,24433,22462
2013/3/1,嘉義縣,竹崎鄉,11538,37808,20150,17658
2013/3/1,嘉義縣,梅山鄉,6773,20770,11009,9761
2013/3/1,嘉義縣,番路鄉,4273,12210,6641,5569
2013/3/1,嘉義縣,大埔鄉,1931,4560,2376,2184
2013/3/1,嘉義縣,阿里山鄉,1926,5693,3033,2660
2013/3/1,屏東縣,屏東市,72904,207449,103118,104331
2013/3/1,屏東縣,潮州鎮,18689,55244,27716,27528
2013/3/1,屏東縣,東港鎮,16074,49129,24800,24329
2013/3/1,屏東縣,恆春鎮,11070,30701,15745,14956
2013/3/1,屏東縣,萬丹鄉,14569,52983,27461,25522
2013/3/1,屏東縣,長治鄉,9895,30556,15977,14579
2013/3/1,屏東縣,麟洛鄉,3653,11302,5858,5444
2013/3/1,屏東縣,九如鄉,6709,22539,11686,10853
2013/3/1,屏東縣,里港鄉,8007,26356,13449,12907
2013/3/1,屏東縣,鹽埔鄉,7805,26730,13924,12806
2013/3/1,屏東縣,高樹鄉,9447,25937,13859,12078
2013/3/1,屏東縣,萬巒鄉,6462,21348,11247,10101
2013/3/1,屏東縣,內埔鄉,18213,57024,29598,27426
2013/3/1,屏東縣,竹田鄉,5632,17984,9551,8433
2013/3/1,屏東縣,新埤鄉,3397,10323,5478,4845
2013/3/1,屏東縣,枋寮鄉,8559,25866,13574,12292
2013/3/1,屏東縣,新園鄉,11666,37310,19308,18002
2013/3/1,屏東縣,崁頂鄉,4370,16649,8457,8192
2013/3/1,屏東縣,林邊鄉,7100,19829,10212,9617
2013/3/1,屏東縣,南州鄉,3660,11256,5763,5493
2013/3/1,屏東縣,佳冬鄉,7126,20770,10813,9957
2013/3/1,屏東縣,琉球鄉,4067,12173,6753,5420
2013/3/1,屏東縣,車城鄉,3481,9150,4943,4207
2013/3/1,屏東縣,滿州鄉,3050,8190,4521,3669
2013/3/1,屏東縣,枋山鄉,2123,5835,3120,2715
2013/3/1,屏東縣,三地門鄉,2233,7526,3833,3693
2013/3/1,屏東縣,霧臺鄉,1032,3115,1626,1489
2013/3/1,屏東縣,瑪家鄉,1953,6586,3396,3190
2013/3/1,屏東縣,泰武鄉,1244,5063,2656,2407
2013/3/1,屏東縣,來義鄉,2218,7631,3911,3720
2013/3/1,屏東縣,春日鄉,1327,4833,2495,2338
2013/3/1,屏東縣,獅子鄉,1501,4809,2518,2291
2013/3/1,屏東縣,牡丹鄉,1889,4821,2493,2328
2013/3/1,臺東縣,臺東市,38498,107735,54357,53378
2013/3/1,臺東縣,成功鎮,5423,15203,8041,7162
2013/3/1,臺東縣,關山鎮,3267,9381,4922,4459
2013/3/1,臺東縣,卑南鄉,6617,17765,9518,8247
2013/3/1,臺東縣,大武鄉,2515,6622,3454,3168
2013/3/1,臺東縣,太麻里鄉,4581,11655,6207,5448
2013/3/1,臺東縣,東河鄉,3734,9096,5052,4044
2013/3/1,臺東縣,長濱鄉,2918,7849,4481,3368
2013/3/1,臺東縣,鹿野鄉,3139,8298,4468,3830
2013/3/1,臺東縣,池上鄉,3282,8778,4615,4163
2013/3/1,臺東縣,綠島鄉,1061,3455,1837,1618
2013/3/1,臺東縣,延平鄉,1066,3550,1928,1622
2013/3/1,臺東縣,海端鄉,1095,4364,2374,1990
2013/3/1,臺東縣,達仁鄉,1488,3810,2075,1735
2013/3/1,臺東縣,金峰鄉,1088,3510,1828,1682
2013/3/1,臺東縣,蘭嶼鄉,1642,4827,2481,2346
2013/3/1,花蓮縣,花蓮市,41026,107998,52678,55320
2013/3/1,花蓮縣,鳳林鎮,4417,11472,6062,5410
2013/3/1,花蓮縣,玉里鎮,8933,25980,14008,11972
2013/3/1,花蓮縣,新城鄉,7407,20108,10420,9688
2013/3/1,花蓮縣,吉安鄉,30208,81569,41510,40059
2013/3/1,花蓮縣,壽豐鄉,6877,18216,9820,8396
2013/3/1,花蓮縣,光復鄉,5023,13583,7240,6343
2013/3/1,花蓮縣,豐濱鄉,1761,4655,2594,2061
2013/3/1,花蓮縣,瑞穗鄉,4670,12292,6633,5659
2013/3/1,花蓮縣,富里鄉,4026,11148,6081,5067
2013/3/1,花蓮縣,秀林鄉,4703,15130,7853,7277
2013/3/1,花蓮縣,萬榮鄉,2091,6577,3501,3076
2013/3/1,花蓮縣,卓溪鄉,1662,6144,3410,2734
2013/3/1,澎湖縣,馬公市,21874,58701,29801,28900
2013/3/1,澎湖縣,湖西鄉,5055,13926,7284,6642
2013/3/1,澎湖縣,白沙鄉,3224,9488,4979,4509
2013/3/1,澎湖縣,西嶼鄉,2906,8359,4319,4040
2013/3/1,澎湖縣,望安鄉,1989,4944,2658,2286
2013/3/1,澎湖縣,七美鄉,1291,3614,1891,1723
2013/3/1,基隆市,中正區,22261,53952,27620,26332
2013/3/1,基隆市,七堵區,20468,54195,27481,26714
2013/3/1,基隆市,暖暖區,14729,37832,19167,18665
2013/3/1,基隆市,仁愛區,19612,47568,23432,24136
2013/3/1,基隆市,中山區,19288,49697,25369,24328
2013/3/1,基隆市,安樂區,31971,82325,41051,41274
2013/3/1,基隆市,信義區,20505,51090,25540,25550
2013/3/1,新竹市,東區,72462,203581,100358,103223
2013/3/1,新竹市,北區,52749,147696,72670,75026
2013/3/1,新竹市,香山區,24307,74868,38159,36709
2013/3/1,嘉義市,東區,44835,124166,60491,63675
2013/3/1,嘉義市,西區,52319,147074,72579,74495
2013/3/1,金門縣,金城鎮,12046,37507,18874,18633
2013/3/1,金門縣,金湖鎮,7939,24961,12655,12306
2013/3/1,金門縣,金沙鎮,5813,17798,8888,8910
2013/3/1,金門縣,金寧鄉,6884,23382,11943,11439
2013/3/1,金門縣,烈嶼鄉,2864,10607,5237,5370
2013/3/1,金門縣,烏坵鄉,134,612,303,309
2013/3/1,連江縣,南竿鄉,1351,6968,3944,3024
2013/3/1,連江縣,北竿鄉,443,2135,1187,948
2013/3/1,連江縣,莒光鄉,269,1339,796,543
2013/3/1,連江縣,東引鄉,291,1153,683,470
2013/4/1,總計,新北市,1462215,3943421,1947101,1996320
2013/4/1,總計,臺北市,1019228,2679051,1287663,1391388
2013/4/1,總計,臺中市,887180,2690837,1335469,1355368
2013/4/1,總計,臺南市,658433,1882475,944999,937476
2013/4/1,總計,高雄市,1048943,2778793,1387120,1391673
2013/4/1,總計,臺灣省,3096685,9233765,4710128,4523637
2013/4/1,總計,宜蘭縣,159454,458552,233187,225365
2013/4/1,總計,桃園市,705455,2034381,1022644,1011737
2013/4/1,總計,新竹縣,171503,525825,269632,256193
2013/4/1,總計,苗栗縣,179091,564354,291636,272718
2013/4/1,總計,彰化縣,373196,1298913,665317,633596
2013/4/1,總計,南投縣,174780,519426,266778,252648
2013/4/1,總計,雲林縣,235469,709814,369856,339958
2013/4/1,總計,嘉義縣,180018,531949,277322,254627
2013/4/1,總計,屏東縣,281213,856522,439523,416999
2013/4/1,總計,臺東縣,81424,225834,117572,108262
2013/4/1,總計,花蓮縣,122838,334712,171697,163015
2013/4/1,總計,澎湖縣,36376,99117,50972,48145
2013/4/1,總計,基隆市,148913,376564,189589,186975
2013/4/1,總計,新竹市,149730,426464,211331,215133
2013/4/1,總計,嘉義市,97225,271338,133072,138266
2013/4/1,總計,福建省,38162,127238,64910,62328
2013/4/1,總計,金門縣,35801,115601,58295,57306
2013/4/1,總計,連江縣,2361,11637,6615,5022
2013/4/1,新北市,板橋區,202302,557351,273892,283459
2013/4/1,新北市,三重區,144568,389858,193332,196526
2013/4/1,新北市,中和區,159830,416113,204155,211958
2013/4/1,新北市,永和區,90580,230732,110263,120469
2013/4/1,新北市,新莊區,142601,408037,200822,207215
2013/4/1,新北市,新店區,119518,297476,144694,152782
2013/4/1,新北市,樹林區,63784,182626,91557,91069
2013/4/1,新北市,鶯歌區,28593,88405,44460,43945
2013/4/1,新北市,三峽區,38641,108403,54923,53480
2013/4/1,新北市,淡水區,63374,152142,73592,78550
2013/4/1,新北市,汐止區,82183,193041,95172,97869
2013/4/1,新北市,瑞芳區,15975,41551,21069,20482
2013/4/1,新北市,土城區,84596,239592,119145,120447
2013/4/1,新北市,蘆洲區,67619,199496,98439,101057
2013/4/1,新北市,五股區,28337,81258,41074,40184
2013/4/1,新北市,泰山區,27001,77769,38857,38912
2013/4/1,新北市,林口區,34577,91082,44834,46248
2013/4/1,新北市,深坑區,9207,23583,11858,11725
2013/4/1,新北市,石碇區,3358,7842,4319,3523
2013/4/1,新北市,坪林區,2483,6474,3613,2861
2013/4/1,新北市,三芝區,9121,23473,12094,11379
2013/4/1,新北市,石門區,4250,12737,6654,6083
2013/4/1,新北市,八里區,13050,35790,18051,17739
2013/4/1,新北市,平溪區,2392,5053,2806,2247
2013/4/1,新北市,雙溪區,3865,9460,5086,4374
2013/4/1,新北市,貢寮區,4465,13383,6877,6506
2013/4/1,新北市,金山區,6906,22394,11150,11244
2013/4/1,新北市,萬里區,7283,22367,11350,11017
2013/4/1,新北市,烏來區,1756,5933,2963,2970
2013/4/1,臺北市,松山區,79624,210988,99923,111065
2013/4/1,臺北市,信義區,88027,228011,109508,118503
2013/4/1,臺北市,大安區,118967,313786,147301,166485
2013/4/1,臺北市,中山區,96354,227477,106545,120932
2013/4/1,臺北市,中正區,64201,162922,78257,84665
2013/4/1,臺北市,大同區,50059,129375,63465,65910
2013/4/1,臺北市,萬華區,76665,192671,95560,97111
2013/4/1,臺北市,文山區,101061,270073,130374,139699
2013/4/1,臺北市,南港區,44442,118823,58129,60694
2013/4/1,臺北市,內湖區,102631,280954,134960,145994
2013/4/1,臺北市,士林區,104183,289253,140193,149060
2013/4/1,臺北市,北投區,93014,254718,123448,131270
2013/4/1,臺中市,中區,8037,20529,10172,10357
2013/4/1,臺中市,東區,26555,74311,37291,37020
2013/4/1,臺中市,南區,44394,117172,56676,60496
2013/4/1,臺中市,西區,44313,116726,55727,60999
2013/4/1,臺中市,北區,57369,147903,71407,76496
2013/4/1,臺中市,西屯區,77411,213787,103129,110658
2013/4/1,臺中市,南屯區,56328,158976,76677,82299
2013/4/1,臺中市,北屯區,88075,253569,122569,131000
2013/4/1,臺中市,豐原區,51209,166185,82346,83839
2013/4/1,臺中市,東勢區,17165,52295,27080,25215
2013/4/1,臺中市,大甲區,22174,78094,39577,38517
2013/4/1,臺中市,清水區,25564,85735,44149,41586
2013/4/1,臺中市,沙鹿區,25770,85394,43380,42014
2013/4/1,臺中市,梧棲區,16429,55883,28229,27654
2013/4/1,臺中市,后里區,15141,54077,27655,26422
2013/4/1,臺中市,神岡區,18288,64651,33189,31462
2013/4/1,臺中市,潭子區,33851,103733,51536,52197
2013/4/1,臺中市,大雅區,27236,91717,46065,45652
2013/4/1,臺中市,新社區,7429,25369,13224,12145
2013/4/1,臺中市,石岡區,4874,15671,8152,7519
2013/4/1,臺中市,外埔區,9085,31760,16337,15423
2013/4/1,臺中市,大安區,5316,19792,10427,9365
2013/4/1,臺中市,烏日區,21617,70235,35533,34702
2013/4/1,臺中市,大肚區,16332,55988,28678,27310
2013/4/1,臺中市,龍井區,21437,75192,38155,37037
2013/4/1,臺中市,霧峰區,19180,64144,32876,31268
2013/4/1,臺中市,太平區,57201,177348,88718,88630
2013/4/1,臺中市,大里區,65005,204006,100808,103198
2013/4/1,臺中市,和平區,4395,10595,5707,4888
2013/4/1,臺南市,新營區,27980,78664,39104,39560
2013/4/1,臺南市,鹽水區,10032,26606,13850,12756
2013/4/1,臺南市,白河區,11022,30451,15956,14495
2013/4/1,臺南市,柳營區,7820,22069,11526,10543
2013/4/1,臺南市,後壁區,8942,25128,13094,12034
2013/4/1,臺南市,東山區,8295,22423,11867,10556
2013/4/1,臺南市,麻豆區,15357,45391,23114,22277
2013/4/1,臺南市,下營區,9127,25456,13124,12332
2013/4/1,臺南市,六甲區,7740,23341,12109,11232
2013/4/1,臺南市,官田區,7742,21840,11175,10665
2013/4/1,臺南市,大內區,4027,10479,5605,4874
2013/4/1,臺南市,佳里區,19852,59313,29471,29842
2013/4/1,臺南市,學甲區,9668,27405,14014,13391
2013/4/1,臺南市,西港區,7954,24980,12675,12305
2013/4/1,臺南市,七股區,8108,24160,12598,11562
2013/4/1,臺南市,將軍區,7420,20917,10640,10277
2013/4/1,臺南市,北門區,4396,12000,6050,5950
2013/4/1,臺南市,新化區,14003,43947,22525,21422
2013/4/1,臺南市,善化區,15475,44775,22547,22228
2013/4/1,臺南市,新市區,11244,35221,17751,17470
2013/4/1,臺南市,安定區,9596,30302,15644,14658
2013/4/1,臺南市,山上區,2730,7656,4004,3652
2013/4/1,臺南市,玉井區,5124,14998,7818,7180
2013/4/1,臺南市,楠西區,3550,10243,5442,4801
2013/4/1,臺南市,南化區,2837,8809,4812,3997
2013/4/1,臺南市,左鎮區,1992,5244,2937,2307
2013/4/1,臺南市,仁德區,25839,71556,36517,35039
2013/4/1,臺南市,歸仁區,21429,66881,34049,32832
2013/4/1,臺南市,關廟區,10818,35230,18247,16983
2013/4/1,臺南市,龍崎區,1589,4313,2340,1973
2013/4/1,臺南市,永康區,79213,225220,111586,113634
2013/4/1,臺南市,東區,71757,192750,92934,99816
2013/4/1,臺南市,南區,44166,125722,62798,62924
2013/4/1,臺南市,北區,49145,132176,64849,67327
2013/4/1,臺南市,安南區,57658,183455,92939,90516
2013/4/1,臺南市,安平區,24049,64358,30766,33592
2013/4/1,臺南市,中西區,30737,78996,38522,40474
2013/4/1,高雄市,鹽埕區,10986,26139,13046,13093
2013/4/1,高雄市,鼓山區,54115,134098,65203,68895
2013/4/1,高雄市,左營區,75871,195175,95327,99848
2013/4/1,高雄市,楠梓區,64173,176328,87262,89066
2013/4/1,高雄市,三民區,133355,349446,170291,179155
2013/4/1,高雄市,新興區,22768,53568,25900,27668
2013/4/1,高雄市,前金區,12561,28158,13667,14491
2013/4/1,高雄市,苓雅區,72135,179016,86822,92194
2013/4/1,高雄市,前鎮區,77245,195417,96745,98672
2013/4/1,高雄市,旗津區,10968,29216,15150,14066
2013/4/1,高雄市,小港區,65191,155982,77948,78034
2013/4/1,高雄市,鳳山區,132692,351091,173626,177465
2013/4/1,高雄市,林園區,25056,70455,35987,34468
2013/4/1,高雄市,大寮區,39847,109928,56855,53073
2013/4/1,高雄市,大樹區,13162,43356,22411,20945
2013/4/1,高雄市,大社區,12155,33852,17328,16524
2013/4/1,高雄市,仁武區,28644,78021,40016,38005
2013/4/1,高雄市,鳥松區,17247,43641,22165,21476
2013/4/1,高雄市,岡山區,34076,97725,48759,48966
2013/4/1,高雄市,橋頭區,13029,36938,18855,18083
2013/4/1,高雄市,燕巢區,10221,30690,16317,14373
2013/4/1,高雄市,田寮區,3461,7810,4354,3456
2013/4/1,高雄市,阿蓮區,9322,29926,15104,14822
2013/4/1,高雄市,路竹區,16363,53133,27159,25974
2013/4/1,高雄市,湖內區,10063,29117,14974,14143
2013/4/1,高雄市,茄萣區,10309,30879,16028,14851
2013/4/1,高雄市,永安區,5827,14112,7128,6984
2013/4/1,高雄市,彌陀區,6690,20014,10394,9620
2013/4/1,高雄市,梓官區,12315,36431,18870,17561
2013/4/1,高雄市,旗山區,13898,38927,20179,18748
2013/4/1,高雄市,美濃區,14410,42027,21933,20094
2013/4/1,高雄市,六龜區,5711,14099,7623,6476
2013/4/1,高雄市,甲仙區,2387,6551,3482,3069
2013/4/1,高雄市,杉林區,4828,12623,6875,5748
2013/4/1,高雄市,內門區,5065,15442,8423,7019
2013/4/1,高雄市,茂林區,576,1814,914,900
2013/4/1,高雄市,桃源區,1346,4489,2363,2126
2013/4/1,高雄市,那瑪夏區,875,3159,1637,1522
2013/4/1,宜蘭縣,宜蘭市,34617,96222,47197,49025
2013/4/1,宜蘭縣,羅東鎮,25495,72553,34736,37817
2013/4/1,宜蘭縣,蘇澳鎮,13819,41665,21286,20379
2013/4/1,宜蘭縣,頭城鎮,9939,30175,15605,14570
2013/4/1,宜蘭縣,礁溪鄉,12946,36015,18802,17213
2013/4/1,宜蘭縣,壯圍鄉,8314,24486,12960,11526
2013/4/1,宜蘭縣,員山鄉,11070,32066,17160,14906
2013/4/1,宜蘭縣,冬山鄉,18167,53434,27448,25986
2013/4/1,宜蘭縣,五結鄉,13547,39044,20216,18828
2013/4/1,宜蘭縣,三星鄉,7823,21119,11450,9669
2013/4/1,宜蘭縣,大同鄉,1860,5904,3209,2695
2013/4/1,宜蘭縣,南澳鄉,1857,5869,3118,2751
2013/4/1,桃園市,桃園區,151125,414676,202780,211896
2013/4/1,桃園市,中壢區,133831,376873,187640,189233
2013/4/1,桃園市,平鎮區,69689,210247,105514,104733
2013/4/1,桃園市,八德區,60999,179055,90793,88262
2013/4/1,桃園市,楊梅區,51655,154605,78478,76127
2013/4/1,桃園市,大溪區,30085,91794,47275,44519
2013/4/1,桃園市,蘆竹區,51373,147422,73734,73688
2013/4/1,桃園市,大園區,27466,83118,42949,40169
2013/4/1,桃園市,龜山區,52297,139807,70480,69327
2013/4/1,桃園市,龍潭區,37991,115252,58404,56848
2013/4/1,桃園市,新屋區,15187,48167,25799,22368
2013/4/1,桃園市,觀音區,20058,62769,32930,29839
2013/4/1,桃園市,復興區,3699,10596,5868,4728
2013/4/1,新竹縣,竹北市,53052,154358,77098,77260
2013/4/1,新竹縣,關西鎮,9484,31153,16581,14572
2013/4/1,新竹縣,新埔鎮,10567,34863,18539,16324
2013/4/1,新竹縣,竹東鎮,31691,96639,48626,48013
2013/4/1,新竹縣,湖口鄉,24428,76562,38960,37602
2013/4/1,新竹縣,橫山鄉,4484,13992,7580,6412
2013/4/1,新竹縣,新豐鄉,16718,54789,28117,26672
2013/4/1,新竹縣,芎林鄉,6381,20286,10684,9602
2013/4/1,新竹縣,寶山鄉,4979,14067,7598,6469
2013/4/1,新竹縣,北埔鄉,3151,9879,5345,4534
2013/4/1,新竹縣,峨眉鄉,2065,5786,3224,2562
2013/4/1,新竹縣,尖石鄉,2784,8954,4806,4148
2013/4/1,新竹縣,五峰鄉,1719,4497,2474,2023
2013/4/1,苗栗縣,苗栗市,30053,91067,45641,45426
2013/4/1,苗栗縣,苑裡鎮,14178,48444,25180,23264
2013/4/1,苗栗縣,通霄鎮,11520,37315,19708,17607
2013/4/1,苗栗縣,竹南鎮,25756,81319,41226,40093
2013/4/1,苗栗縣,頭份市,31618,100514,50898,49616
2013/4/1,苗栗縣,後龍鎮,11855,38646,20330,18316
2013/4/1,苗栗縣,卓蘭鎮,6121,18434,9699,8735
2013/4/1,苗栗縣,大湖鄉,5424,15791,8383,7408
2013/4/1,苗栗縣,公館鄉,10529,34907,18186,16721
2013/4/1,苗栗縣,銅鑼鄉,6104,19151,10152,8999
2013/4/1,苗栗縣,南庄鄉,3983,10837,5946,4891
2013/4/1,苗栗縣,頭屋鄉,3597,11405,6011,5394
2013/4/1,苗栗縣,三義鄉,5402,17433,9140,8293
2013/4/1,苗栗縣,西湖鄉,2720,7699,4277,3422
2013/4/1,苗栗縣,造橋鄉,4098,13607,7148,6459
2013/4/1,苗栗縣,三灣鄉,2434,7140,3896,3244
2013/4/1,苗栗縣,獅潭鄉,1730,4759,2659,2100
2013/4/1,苗栗縣,泰安鄉,1969,5886,3156,2730
2013/4/1,彰化縣,彰化市,73958,236537,117503,119034
2013/4/1,彰化縣,鹿港鎮,23194,86039,43957,42082
2013/4/1,彰化縣,和美鎮,25159,90416,46302,44114
2013/4/1,彰化縣,北斗鎮,10224,33244,16817,16427
2013/4/1,彰化縣,員林市,37746,125245,62806,62439
2013/4/1,彰化縣,溪湖鎮,15636,55962,28524,27438
2013/4/1,彰化縣,田中鎮,12775,43324,22428,20896
2013/4/1,彰化縣,二林鎮,14636,53116,27383,25733
2013/4/1,彰化縣,線西鄉,4199,17057,8815,8242
2013/4/1,彰化縣,伸港鄉,9287,36036,18481,17555
2013/4/1,彰化縣,福興鄉,12317,48078,25105,22973
2013/4/1,彰化縣,秀水鄉,10149,39391,20355,19036
2013/4/1,彰化縣,花壇鄉,13350,46034,23707,22327
2013/4/1,彰化縣,芬園鄉,6867,24376,12861,11515
2013/4/1,彰化縣,大村鄉,10536,36458,18956,17502
2013/4/1,彰化縣,埔鹽鄉,8953,33617,17639,15978
2013/4/1,彰化縣,埔心鄉,10172,35091,18109,16982
2013/4/1,彰化縣,永靖鄉,10664,38695,20135,18560
2013/4/1,彰化縣,社頭鄉,12557,44079,22651,21428
2013/4/1,彰化縣,二水鄉,5359,16082,8453,7629
2013/4/1,彰化縣,田尾鄉,7772,28032,14588,13444
2013/4/1,彰化縣,埤頭鄉,8801,31389,16353,15036
2013/4/1,彰化縣,芳苑鄉,10054,35231,18659,16572
2013/4/1,彰化縣,大城鄉,5384,18220,9890,8330
2013/4/1,彰化縣,竹塘鄉,4625,16129,8514,7615
2013/4/1,彰化縣,溪州鄉,8822,31035,16326,14709
2013/4/1,南投縣,南投市,33997,103286,51881,51405
2013/4/1,南投縣,埔里鎮,28790,84173,42293,41880
2013/4/1,南投縣,草屯鎮,31897,99348,50218,49130
2013/4/1,南投縣,竹山鎮,19813,57398,29535,27863
2013/4/1,南投縣,集集鎮,4359,11514,6006,5508
2013/4/1,南投縣,名間鄉,12449,40570,21315,19255
2013/4/1,南投縣,鹿谷鄉,7224,18779,9970,8809
2013/4/1,南投縣,中寮鄉,5667,15831,8587,7244
2013/4/1,南投縣,魚池鄉,5785,16760,8791,7969
2013/4/1,南投縣,國姓鄉,7285,20063,10908,9155
2013/4/1,南投縣,水里鄉,7284,19259,10108,9151
2013/4/1,南投縣,信義鄉,5269,16768,9026,7742
2013/4/1,南投縣,仁愛鄉,4961,15677,8140,7537
2013/4/1,雲林縣,斗六市,36278,107978,54039,53939
2013/4/1,雲林縣,斗南鎮,15540,46453,23645,22808
2013/4/1,雲林縣,虎尾鎮,23545,70536,35824,34712
2013/4/1,雲林縣,西螺鎮,14259,47675,24256,23419
2013/4/1,雲林縣,土庫鎮,9024,29943,15653,14290
2013/4/1,雲林縣,北港鎮,15771,42217,21974,20243
2013/4/1,雲林縣,古坑鄉,10836,33083,17462,15621
2013/4/1,雲林縣,大埤鄉,6761,20420,10994,9426
2013/4/1,雲林縣,莿桐鄉,9178,29840,15692,14148
2013/4/1,雲林縣,林內鄉,5863,19287,10069,9218
2013/4/1,雲林縣,二崙鄉,8906,28916,15444,13472
2013/4/1,雲林縣,崙背鄉,8483,26422,13968,12454
2013/4/1,雲林縣,麥寮鄉,13428,41541,21169,20372
2013/4/1,雲林縣,東勢鄉,5802,15996,8757,7239
2013/4/1,雲林縣,褒忠鄉,4402,13812,7386,6426
2013/4/1,雲林縣,臺西鄉,8840,24972,13457,11515
2013/4/1,雲林縣,元長鄉,9441,27826,15184,12642
2013/4/1,雲林縣,四湖鄉,9075,25754,14004,11750
2013/4/1,雲林縣,口湖鄉,9670,29511,15749,13762
2013/4/1,雲林縣,水林鄉,10367,27632,15130,12502
2013/4/1,嘉義縣,太保市,11837,36967,19063,17904
2013/4/1,嘉義縣,朴子市,15159,43813,22220,21593
2013/4/1,嘉義縣,布袋鎮,10190,28990,14900,14090
2013/4/1,嘉義縣,大林鎮,11405,32849,16847,16002
2013/4/1,嘉義縣,民雄鄉,23567,72164,37047,35117
2013/4/1,嘉義縣,溪口鄉,5445,15700,8385,7315
2013/4/1,嘉義縣,新港鄉,10525,33760,17842,15918
2013/4/1,嘉義縣,六腳鄉,9112,25220,13381,11839
2013/4/1,嘉義縣,東石鄉,9489,26519,14100,12419
2013/4/1,嘉義縣,義竹鄉,7568,20054,10426,9628
2013/4/1,嘉義縣,鹿草鄉,5843,16758,9006,7752
2013/4/1,嘉義縣,水上鄉,17647,51392,26539,24853
2013/4/1,嘉義縣,中埔鄉,15796,46819,24388,22431
2013/4/1,嘉義縣,竹崎鄉,11524,37760,20127,17633
2013/4/1,嘉義縣,梅山鄉,6774,20742,10999,9743
2013/4/1,嘉義縣,番路鄉,4277,12209,6644,5565
2013/4/1,嘉義縣,大埔鄉,1930,4533,2370,2163
2013/4/1,嘉義縣,阿里山鄉,1930,5700,3038,2662
2013/4/1,屏東縣,屏東市,72929,207335,103042,104293
2013/4/1,屏東縣,潮州鎮,18692,55290,27740,27550
2013/4/1,屏東縣,東港鎮,16089,49143,24808,24335
2013/4/1,屏東縣,恆春鎮,11082,30707,15752,14955
2013/4/1,屏東縣,萬丹鄉,14588,52951,27435,25516
2013/4/1,屏東縣,長治鄉,9888,30531,15966,14565
2013/4/1,屏東縣,麟洛鄉,3661,11287,5847,5440
2013/4/1,屏東縣,九如鄉,6715,22530,11678,10852
2013/4/1,屏東縣,里港鄉,8012,26388,13451,12937
2013/4/1,屏東縣,鹽埔鄉,7807,26692,13903,12789
2013/4/1,屏東縣,高樹鄉,9448,25924,13843,12081
2013/4/1,屏東縣,萬巒鄉,6459,21322,11232,10090
2013/4/1,屏東縣,內埔鄉,18221,56951,29562,27389
2013/4/1,屏東縣,竹田鄉,5635,17974,9547,8427
2013/4/1,屏東縣,新埤鄉,3395,10301,5469,4832
2013/4/1,屏東縣,枋寮鄉,8556,25855,13567,12288
2013/4/1,屏東縣,新園鄉,11667,37274,19277,17997
2013/4/1,屏東縣,崁頂鄉,4371,16607,8423,8184
2013/4/1,屏東縣,林邊鄉,7098,19815,10201,9614
2013/4/1,屏東縣,南州鄉,3664,11246,5757,5489
2013/4/1,屏東縣,佳冬鄉,7120,20741,10793,9948
2013/4/1,屏東縣,琉球鄉,4069,12164,6752,5412
2013/4/1,屏東縣,車城鄉,3483,9148,4943,4205
2013/4/1,屏東縣,滿州鄉,3045,8179,4514,3665
2013/4/1,屏東縣,枋山鄉,2116,5808,3107,2701
2013/4/1,屏東縣,三地門鄉,2238,7523,3826,3697
2013/4/1,屏東縣,霧臺鄉,1033,3131,1636,1495
2013/4/1,屏東縣,瑪家鄉,1954,6580,3396,3184
2013/4/1,屏東縣,泰武鄉,1245,5062,2660,2402
2013/4/1,屏東縣,來義鄉,2214,7614,3902,3712
2013/4/1,屏東縣,春日鄉,1328,4831,2495,2336
2013/4/1,屏東縣,獅子鄉,1502,4811,2517,2294
2013/4/1,屏東縣,牡丹鄉,1889,4807,2482,2325
2013/4/1,臺東縣,臺東市,38505,107700,54320,53380
2013/4/1,臺東縣,成功鎮,5437,15199,8042,7157
2013/4/1,臺東縣,關山鎮,3259,9374,4917,4457
2013/4/1,臺東縣,卑南鄉,6622,17775,9515,8260
2013/4/1,臺東縣,大武鄉,2512,6603,3447,3156
2013/4/1,臺東縣,太麻里鄉,4589,11672,6218,5454
2013/4/1,臺東縣,東河鄉,3724,9084,5048,4036
2013/4/1,臺東縣,長濱鄉,2918,7832,4466,3366
2013/4/1,臺東縣,鹿野鄉,3134,8290,4458,3832
2013/4/1,臺東縣,池上鄉,3281,8770,4612,4158
2013/4/1,臺東縣,綠島鄉,1064,3472,1846,1626
2013/4/1,臺東縣,延平鄉,1066,3547,1925,1622
2013/4/1,臺東縣,海端鄉,1094,4361,2374,1987
2013/4/1,臺東縣,達仁鄉,1487,3815,2078,1737
2013/4/1,臺東縣,金峰鄉,1086,3502,1822,1680
2013/4/1,臺東縣,蘭嶼鄉,1646,4838,2484,2354
2013/4/1,花蓮縣,花蓮市,41013,107902,52608,55294
2013/4/1,花蓮縣,鳳林鎮,4425,11476,6060,5416
2013/4/1,花蓮縣,玉里鎮,8941,25951,13991,11960
2013/4/1,花蓮縣,新城鄉,7400,20100,10413,9687
2013/4/1,花蓮縣,吉安鄉,30243,81624,41540,40084
2013/4/1,花蓮縣,壽豐鄉,6880,18219,9825,8394
2013/4/1,花蓮縣,光復鄉,5018,13544,7219,6325
2013/4/1,花蓮縣,豐濱鄉,1761,4658,2595,2063
2013/4/1,花蓮縣,瑞穗鄉,4670,12290,6630,5660
2013/4/1,花蓮縣,富里鄉,4029,11121,6070,5051
2013/4/1,花蓮縣,秀林鄉,4710,15146,7861,7285
2013/4/1,花蓮縣,萬榮鄉,2089,6555,3488,3067
2013/4/1,花蓮縣,卓溪鄉,1659,6126,3397,2729
2013/4/1,澎湖縣,馬公市,21900,58785,29832,28953
2013/4/1,澎湖縣,湖西鄉,5061,13941,7298,6643
2013/4/1,澎湖縣,白沙鄉,3231,9481,4983,4498
2013/4/1,澎湖縣,西嶼鄉,2904,8350,4312,4038
2013/4/1,澎湖縣,望安鄉,1990,4944,2659,2285
2013/4/1,澎湖縣,七美鄉,1290,3616,1888,1728
2013/4/1,基隆市,中正區,22278,53965,27617,26348
2013/4/1,基隆市,七堵區,20490,54167,27472,26695
2013/4/1,基隆市,暖暖區,14741,37829,19155,18674
2013/4/1,基隆市,仁愛區,19615,47556,23432,24124
2013/4/1,基隆市,中山區,19275,49639,25310,24329
2013/4/1,基隆市,安樂區,32017,82351,41063,41288
2013/4/1,基隆市,信義區,20497,51057,25540,25517
2013/4/1,新竹市,東區,72573,203875,100484,103391
2013/4/1,新竹市,北區,52801,147668,72659,75009
2013/4/1,新竹市,香山區,24356,74921,38188,36733
2013/4/1,嘉義市,東區,44878,124229,60513,63716
2013/4/1,嘉義市,西區,52347,147109,72559,74550
2013/4/1,金門縣,金城鎮,12076,37696,18968,18728
2013/4/1,金門縣,金湖鎮,7958,25153,12766,12387
2013/4/1,金門縣,金沙鎮,5823,17909,8947,8962
2013/4/1,金門縣,金寧鄉,6939,23537,12026,11511
2013/4/1,金門縣,烈嶼鄉,2871,10692,5284,5408
2013/4/1,金門縣,烏坵鄉,134,614,304,310
2013/4/1,連江縣,南竿鄉,1355,6992,3952,3040
2013/4/1,連江縣,北竿鄉,446,2146,1189,957
2013/4/1,連江縣,莒光鄉,269,1346,795,551
2013/4/1,連江縣,東引鄉,291,1153,679,474
2013/5/1,總計,新北市,1464475,3944955,1947539,1997416
2013/5/1,總計,臺北市,1020396,2680296,1288081,1392215
2013/5/1,總計,臺中市,888855,2692563,1336236,1356327
2013/5/1,總計,臺南市,658926,1882352,944840,937512
2013/5/1,總計,高雄市,1049834,2778920,1386915,1392005
2013/5/1,總計,臺灣省,3100919,9233180,4709324,4523856
2013/5/1,總計,宜蘭縣,159679,458582,233178,225404
2013/5/1,總計,桃園市,706908,2035552,1023102,1012450
2013/5/1,總計,新竹縣,172021,526438,269933,256505
2013/5/1,總計,苗栗縣,179304,564492,291626,272866
2013/5/1,總計,彰化縣,373622,1298286,664975,633311
2013/5/1,總計,南投縣,174869,519055,266629,252426
2013/5/1,總計,雲林縣,235655,709698,369747,339951
2013/5/1,總計,嘉義縣,180134,531492,277029,254463
2013/5/1,總計,屏東縣,281405,855733,439067,416666
2013/5/1,總計,臺東縣,81455,225558,117413,108145
2013/5/1,總計,花蓮縣,122928,334513,171544,162969
2013/5/1,總計,澎湖縣,36453,99241,51020,48221
2013/5/1,總計,基隆市,149049,376372,189462,186910
2013/5/1,總計,新竹市,150153,426856,211547,215309
2013/5/1,總計,嘉義市,97284,271312,133052,138260
2013/5/1,總計,福建省,38322,127870,65216,62654
2013/5/1,總計,金門縣,35952,116168,58570,57598
2013/5/1,總計,連江縣,2370,11702,6646,5056
2013/5/1,新北市,板橋區,202558,557544,273924,283620
2013/5/1,新北市,三重區,144767,389828,193274,196554
2013/5/1,新北市,中和區,159929,415878,204004,211874
2013/5/1,新北市,永和區,90644,230622,110184,120438
2013/5/1,新北市,新莊區,142886,408304,200931,207373
2013/5/1,新北市,新店區,119644,297416,144605,152811
2013/5/1,新北市,樹林區,63844,182777,91623,91154
2013/5/1,新北市,鶯歌區,28631,88436,44438,43998
2013/5/1,新北市,三峽區,38764,108684,55057,53627
2013/5/1,新北市,淡水區,63685,152586,73788,78798
2013/5/1,新北市,汐止區,82343,193287,95258,98029
2013/5/1,新北市,瑞芳區,15983,41552,21066,20486
2013/5/1,新北市,土城區,84683,239548,119124,120424
2013/5/1,新北市,蘆洲區,67691,199455,98437,101018
2013/5/1,新北市,五股區,28371,81301,41103,40198
2013/5/1,新北市,泰山區,27048,77780,38863,38917
2013/5/1,新北市,林口區,34821,91507,45050,46457
2013/5/1,新北市,深坑區,9201,23570,11863,11707
2013/5/1,新北市,石碇區,3359,7845,4323,3522
2013/5/1,新北市,坪林區,2480,6477,3627,2850
2013/5/1,新北市,三芝區,9133,23471,12092,11379
2013/5/1,新北市,石門區,4252,12740,6656,6084
2013/5/1,新北市,八里區,13079,35832,18065,17767
2013/5/1,新北市,平溪區,2389,5040,2799,2241
2013/5/1,新北市,雙溪區,3876,9451,5083,4368
2013/5/1,新北市,貢寮區,4463,13358,6863,6495
2013/5/1,新北市,金山區,6910,22378,11141,11237
2013/5/1,新北市,萬里區,7286,22365,11342,11023
2013/5/1,新北市,烏來區,1755,5923,2956,2967
2013/5/1,臺北市,松山區,79677,211051,99928,111123
2013/5/1,臺北市,信義區,88044,228000,109501,118499
2013/5/1,臺北市,大安區,119106,313866,147339,166527
2013/5/1,臺北市,中山區,96469,227599,106563,121036
2013/5/1,臺北市,中正區,64272,162986,78269,84717
2013/5/1,臺北市,大同區,50180,129524,63501,66023
2013/5/1,臺北市,萬華區,76685,192750,95562,97188
2013/5/1,臺北市,文山區,101222,270279,130508,139771
2013/5/1,臺北市,南港區,44535,118885,58159,60726
2013/5/1,臺北市,內湖區,102767,281217,135062,146155
2013/5/1,臺北市,士林區,104280,289411,140231,149180
2013/5/1,臺北市,北投區,93159,254728,123458,131270
2013/5/1,臺中市,中區,8043,20492,10173,10319
2013/5/1,臺中市,東區,26590,74225,37244,36981
2013/5/1,臺中市,南區,44511,117363,56756,60607
2013/5/1,臺中市,西區,44342,116705,55711,60994
2013/5/1,臺中市,北區,57428,147877,71404,76473
2013/5/1,臺中市,西屯區,77636,214005,103233,110772
2013/5/1,臺中市,南屯區,56466,159139,76693,82446
2013/5/1,臺中市,北屯區,88299,253930,122724,131206
2013/5/1,臺中市,豐原區,51238,166147,82307,83840
2013/5/1,臺中市,東勢區,17165,52228,27042,25186
2013/5/1,臺中市,大甲區,22220,78117,39581,38536
2013/5/1,臺中市,清水區,25603,85788,44174,41614
2013/5/1,臺中市,沙鹿區,25860,85482,43431,42051
2013/5/1,臺中市,梧棲區,16444,55908,28245,27663
2013/5/1,臺中市,后里區,15147,54071,27645,26426
2013/5/1,臺中市,神岡區,18324,64732,33230,31502
2013/5/1,臺中市,潭子區,33923,103878,51580,52298
2013/5/1,臺中市,大雅區,27289,91843,46134,45709
2013/5/1,臺中市,新社區,7438,25369,13224,12145
2013/5/1,臺中市,石岡區,4878,15684,8164,7520
2013/5/1,臺中市,外埔區,9105,31767,16341,15426
2013/5/1,臺中市,大安區,5316,19768,10418,9350
2013/5/1,臺中市,烏日區,21673,70280,35563,34717
2013/5/1,臺中市,大肚區,16374,56011,28684,27327
2013/5/1,臺中市,龍井區,21494,75265,38224,37041
2013/5/1,臺中市,霧峰區,19201,64121,32859,31262
2013/5/1,臺中市,太平區,57352,177595,88823,88772
2013/5/1,臺中市,大里區,65106,204199,100936,103263
2013/5/1,臺中市,和平區,4390,10574,5693,4881
2013/5/1,臺南市,新營區,27985,78622,39081,39541
2013/5/1,臺南市,鹽水區,10026,26579,13846,12733
2013/5/1,臺南市,白河區,11022,30438,15952,14486
2013/5/1,臺南市,柳營區,7806,22040,11505,10535
2013/5/1,臺南市,後壁區,8944,25104,13080,12024
2013/5/1,臺南市,東山區,8294,22387,11853,10534
2013/5/1,臺南市,麻豆區,15362,45354,23087,22267
2013/5/1,臺南市,下營區,9130,25461,13117,12344
2013/5/1,臺南市,六甲區,7737,23313,12093,11220
2013/5/1,臺南市,官田區,7740,21837,11175,10662
2013/5/1,臺南市,大內區,4027,10469,5594,4875
2013/5/1,臺南市,佳里區,19862,59370,29492,29878
2013/5/1,臺南市,學甲區,9666,27383,14012,13371
2013/5/1,臺南市,西港區,7951,24982,12680,12302
2013/5/1,臺南市,七股區,8106,24027,12523,11504
2013/5/1,臺南市,將軍區,7413,20891,10631,10260
2013/5/1,臺南市,北門區,4395,11988,6048,5940
2013/5/1,臺南市,新化區,14018,43938,22509,21429
2013/5/1,臺南市,善化區,15506,44828,22561,22267
2013/5/1,臺南市,新市區,11285,35248,17761,17487
2013/5/1,臺南市,安定區,9607,30323,15649,14674
2013/5/1,臺南市,山上區,2729,7642,3994,3648
2013/5/1,臺南市,玉井區,5129,14981,7807,7174
2013/5/1,臺南市,楠西區,3553,10238,5436,4802
2013/5/1,臺南市,南化區,2839,8833,4829,4004
2013/5/1,臺南市,左鎮區,1991,5234,2932,2302
2013/5/1,臺南市,仁德區,25898,71627,36538,35089
2013/5/1,臺南市,歸仁區,21471,66959,34086,32873
2013/5/1,臺南市,關廟區,10819,35215,18240,16975
2013/5/1,臺南市,龍崎區,1589,4320,2344,1976
2013/5/1,臺南市,永康區,79342,225432,111663,113769
2013/5/1,臺南市,東區,71785,192571,92829,99742
2013/5/1,臺南市,南區,44169,125672,62779,62893
2013/5/1,臺南市,北區,49160,132127,64827,67300
2013/5/1,臺南市,安南區,57802,183690,93059,90631
2013/5/1,臺南市,安平區,24069,64363,30765,33598
2013/5/1,臺南市,中西區,30699,78866,38463,40403
2013/5/1,高雄市,鹽埕區,10978,26089,13021,13068
2013/5/1,高雄市,鼓山區,54184,134216,65250,68966
2013/5/1,高雄市,左營區,75975,195339,95375,99964
2013/5/1,高雄市,楠梓區,64279,176511,87353,89158
2013/5/1,高雄市,三民區,133438,349283,170151,179132
2013/5/1,高雄市,新興區,22759,53510,25856,27654
2013/5/1,高雄市,前金區,12577,28174,13668,14506
2013/5/1,高雄市,苓雅區,72111,178755,86660,92095
2013/5/1,高雄市,前鎮區,77284,195380,96672,98708
2013/5/1,高雄市,旗津區,10953,29133,15093,14040
2013/5/1,高雄市,小港區,65255,156083,78007,78076
2013/5/1,高雄市,鳳山區,132885,351355,173719,177636
2013/5/1,高雄市,林園區,25095,70453,35980,34473
2013/5/1,高雄市,大寮區,39907,109937,56865,53072
2013/5/1,高雄市,大樹區,13169,43343,22389,20954
2013/5/1,高雄市,大社區,12155,33851,17337,16514
2013/5/1,高雄市,仁武區,28713,78137,40070,38067
2013/5/1,高雄市,鳥松區,17253,43640,22172,21468
2013/5/1,高雄市,岡山區,34111,97808,48789,49019
2013/5/1,高雄市,橋頭區,13032,36916,18836,18080
2013/5/1,高雄市,燕巢區,10238,30671,16310,14361
2013/5/1,高雄市,田寮區,3456,7800,4347,3453
2013/5/1,高雄市,阿蓮區,9329,29909,15099,14810
2013/5/1,高雄市,路竹區,16380,53111,27143,25968
2013/5/1,高雄市,湖內區,10080,29168,14995,14173
2013/5/1,高雄市,茄萣區,10324,30880,16036,14844
2013/5/1,高雄市,永安區,5830,14101,7134,6967
2013/5/1,高雄市,彌陀區,6682,19991,10382,9609
2013/5/1,高雄市,梓官區,12322,36416,18861,17555
2013/5/1,高雄市,旗山區,13897,38879,20152,18727
2013/5/1,高雄市,美濃區,14400,41976,21909,20067
2013/5/1,高雄市,六龜區,5708,14070,7609,6461
2013/5/1,高雄市,甲仙區,2383,6537,3473,3064
2013/5/1,高雄市,杉林區,4828,12618,6873,5745
2013/5/1,高雄市,內門區,5066,15426,8413,7013
2013/5/1,高雄市,茂林區,578,1814,918,896
2013/5/1,高雄市,桃源區,1345,4483,2364,2119
2013/5/1,高雄市,那瑪夏區,875,3157,1634,1523
2013/5/1,宜蘭縣,宜蘭市,34660,96205,47169,49036
2013/5/1,宜蘭縣,羅東鎮,25503,72544,34709,37835
2013/5/1,宜蘭縣,蘇澳鎮,13830,41624,21268,20356
2013/5/1,宜蘭縣,頭城鎮,9958,30162,15594,14568
2013/5/1,宜蘭縣,礁溪鄉,12957,35991,18804,17187
2013/5/1,宜蘭縣,壯圍鄉,8335,24469,12966,11503
2013/5/1,宜蘭縣,員山鄉,11086,32091,17167,14924
2013/5/1,宜蘭縣,冬山鄉,18212,53518,27505,26013
2013/5/1,宜蘭縣,五結鄉,13574,39057,20206,18851
2013/5/1,宜蘭縣,三星鄉,7847,21138,11454,9684
2013/5/1,宜蘭縣,大同鄉,1859,5899,3209,2690
2013/5/1,宜蘭縣,南澳鄉,1858,5884,3127,2757
2013/5/1,桃園市,桃園區,151476,414985,202972,212013
2013/5/1,桃園市,中壢區,134079,377104,187693,189411
2013/5/1,桃園市,平鎮區,69901,210348,105556,104792
2013/5/1,桃園市,八德區,61107,179103,90773,88330
2013/5/1,桃園市,楊梅區,51750,154765,78534,76231
2013/5/1,桃園市,大溪區,30107,91814,47267,44547
2013/5/1,桃園市,蘆竹區,51555,147647,73845,73802
2013/5/1,桃園市,大園區,27551,83207,42981,40226
2013/5/1,桃園市,龜山區,52377,139817,70496,69321
2013/5/1,桃園市,龍潭區,38037,115272,58416,56856
2013/5/1,桃園市,新屋區,15182,48115,25769,22346
2013/5/1,桃園市,觀音區,20084,62785,32933,29852
2013/5/1,桃園市,復興區,3702,10590,5867,4723
2013/5/1,新竹縣,竹北市,53413,155011,77423,77588
2013/5/1,新竹縣,關西鎮,9483,31125,16565,14560
2013/5/1,新竹縣,新埔鎮,10569,34838,18525,16313
2013/5/1,新竹縣,竹東鎮,31718,96563,48601,47962
2013/5/1,新竹縣,湖口鄉,24468,76537,38928,37609
2013/5/1,新竹縣,橫山鄉,4492,13973,7569,6404
2013/5/1,新竹縣,新豐鄉,16789,54913,28173,26740
2013/5/1,新竹縣,芎林鄉,6383,20276,10685,9591
2013/5/1,新竹縣,寶山鄉,4991,14069,7601,6468
2013/5/1,新竹縣,北埔鄉,3149,9894,5352,4542
2013/5/1,新竹縣,峨眉鄉,2065,5774,3217,2557
2013/5/1,新竹縣,尖石鄉,2783,8957,4810,4147
2013/5/1,新竹縣,五峰鄉,1718,4508,2484,2024
2013/5/1,苗栗縣,苗栗市,30076,91054,45623,45431
2013/5/1,苗栗縣,苑裡鎮,14182,48445,25167,23278
2013/5/1,苗栗縣,通霄鎮,11517,37278,19680,17598
2013/5/1,苗栗縣,竹南鎮,25838,81420,41268,40152
2013/5/1,苗栗縣,頭份市,31715,100721,50967,49754
2013/5/1,苗栗縣,後龍鎮,11849,38611,20312,18299
2013/5/1,苗栗縣,卓蘭鎮,6123,18404,9678,8726
2013/5/1,苗栗縣,大湖鄉,5429,15783,8381,7402
2013/5/1,苗栗縣,公館鄉,10534,34893,18173,16720
2013/5/1,苗栗縣,銅鑼鄉,6095,19111,10144,8967
2013/5/1,苗栗縣,南庄鄉,3986,10829,5939,4890
2013/5/1,苗栗縣,頭屋鄉,3601,11408,6009,5399
2013/5/1,苗栗縣,三義鄉,5409,17435,9140,8295
2013/5/1,苗栗縣,西湖鄉,2711,7677,4268,3409
2013/5/1,苗栗縣,造橋鄉,4106,13620,7150,6470
2013/5/1,苗栗縣,三灣鄉,2436,7137,3899,3238
2013/5/1,苗栗縣,獅潭鄉,1729,4755,2657,2098
2013/5/1,苗栗縣,泰安鄉,1968,5911,3171,2740
2013/5/1,彰化縣,彰化市,74027,236463,117450,119013
2013/5/1,彰化縣,鹿港鎮,23218,86056,43971,42085
2013/5/1,彰化縣,和美鎮,25222,90443,46328,44115
2013/5/1,彰化縣,北斗鎮,10248,33236,16809,16427
2013/5/1,彰化縣,員林市,37767,125160,62778,62382
2013/5/1,彰化縣,溪湖鎮,15666,55929,28510,27419
2013/5/1,彰化縣,田中鎮,12781,43281,22415,20866
2013/5/1,彰化縣,二林鎮,14647,53049,27351,25698
2013/5/1,彰化縣,線西鄉,4207,17047,8804,8243
2013/5/1,彰化縣,伸港鄉,9310,36029,18482,17547
2013/5/1,彰化縣,福興鄉,12318,48030,25078,22952
2013/5/1,彰化縣,秀水鄉,10161,39372,20324,19048
2013/5/1,彰化縣,花壇鄉,13364,46015,23696,22319
2013/5/1,彰化縣,芬園鄉,6871,24349,12846,11503
2013/5/1,彰化縣,大村鄉,10549,36432,18938,17494
2013/5/1,彰化縣,埔鹽鄉,8964,33590,17627,15963
2013/5/1,彰化縣,埔心鄉,10191,35078,18100,16978
2013/5/1,彰化縣,永靖鄉,10681,38704,20142,18562
2013/5/1,彰化縣,社頭鄉,12572,44045,22616,21429
2013/5/1,彰化縣,二水鄉,5362,16058,8437,7621
2013/5/1,彰化縣,田尾鄉,7773,28016,14590,13426
2013/5/1,彰化縣,埤頭鄉,8821,31397,16355,15042
2013/5/1,彰化縣,芳苑鄉,10066,35224,18648,16576
2013/5/1,彰化縣,大城鄉,5384,18176,9866,8310
2013/5/1,彰化縣,竹塘鄉,4622,16092,8490,7602
2013/5/1,彰化縣,溪州鄉,8830,31015,16324,14691
2013/5/1,南投縣,南投市,34007,103240,51875,51365
2013/5/1,南投縣,埔里鎮,28830,84166,42309,41857
2013/5/1,南投縣,草屯鎮,31929,99325,50216,49109
2013/5/1,南投縣,竹山鎮,19825,57341,29504,27837
2013/5/1,南投縣,集集鎮,4360,11506,6004,5502
2013/5/1,南投縣,名間鄉,12462,40531,21305,19226
2013/5/1,南投縣,鹿谷鄉,7224,18718,9934,8784
2013/5/1,南投縣,中寮鄉,5666,15823,8592,7231
2013/5/1,南投縣,魚池鄉,5785,16741,8778,7963
2013/5/1,南投縣,國姓鄉,7288,20041,10885,9156
2013/5/1,南投縣,水里鄉,7285,19244,10097,9147
2013/5/1,南投縣,信義鄉,5256,16752,9017,7735
2013/5/1,南投縣,仁愛鄉,4952,15627,8113,7514
2013/5/1,雲林縣,斗六市,36353,108013,54052,53961
2013/5/1,雲林縣,斗南鎮,15544,46451,23644,22807
2013/5/1,雲林縣,虎尾鎮,23581,70563,35856,34707
2013/5/1,雲林縣,西螺鎮,14281,47662,24234,23428
2013/5/1,雲林縣,土庫鎮,9034,29914,15645,14269
2013/5/1,雲林縣,北港鎮,15783,42223,21983,20240
2013/5/1,雲林縣,古坑鄉,10830,33043,17453,15590
2013/5/1,雲林縣,大埤鄉,6759,20388,10975,9413
2013/5/1,雲林縣,莿桐鄉,9191,29824,15670,14154
2013/5/1,雲林縣,林內鄉,5868,19367,10115,9252
2013/5/1,雲林縣,二崙鄉,8909,28879,15418,13461
2013/5/1,雲林縣,崙背鄉,8477,26371,13936,12435
2013/5/1,雲林縣,麥寮鄉,13444,41611,21201,20410
2013/5/1,雲林縣,東勢鄉,5809,15970,8745,7225
2013/5/1,雲林縣,褒忠鄉,4405,13794,7379,6415
2013/5/1,雲林縣,臺西鄉,8830,24954,13441,11513
2013/5/1,雲林縣,元長鄉,9448,27778,15138,12640
2013/5/1,雲林縣,四湖鄉,9069,25774,14012,11762
2013/5/1,雲林縣,口湖鄉,9675,29536,15740,13796
2013/5/1,雲林縣,水林鄉,10365,27583,15110,12473
2013/5/1,嘉義縣,太保市,11859,36965,19062,17903
2013/5/1,嘉義縣,朴子市,15175,43769,22179,21590
2013/5/1,嘉義縣,布袋鎮,10190,28946,14869,14077
2013/5/1,嘉義縣,大林鎮,11391,32813,16830,15983
2013/5/1,嘉義縣,民雄鄉,23601,72188,37038,35150
2013/5/1,嘉義縣,溪口鄉,5447,15683,8373,7310
2013/5/1,嘉義縣,新港鄉,10525,33706,17820,15886
2013/5/1,嘉義縣,六腳鄉,9107,25178,13356,11822
2013/5/1,嘉義縣,東石鄉,9488,26482,14074,12408
2013/5/1,嘉義縣,義竹鄉,7574,20021,10407,9614
2013/5/1,嘉義縣,鹿草鄉,5845,16719,8980,7739
2013/5/1,嘉義縣,水上鄉,17654,51378,26534,24844
2013/5/1,嘉義縣,中埔鄉,15810,46792,24383,22409
2013/5/1,嘉義縣,竹崎鄉,11533,37703,20107,17596
2013/5/1,嘉義縣,梅山鄉,6780,20721,10982,9739
2013/5/1,嘉義縣,番路鄉,4287,12212,6639,5573
2013/5/1,嘉義縣,大埔鄉,1931,4526,2365,2161
2013/5/1,嘉義縣,阿里山鄉,1937,5690,3031,2659
2013/5/1,屏東縣,屏東市,72984,207171,102992,104179
2013/5/1,屏東縣,潮州鎮,18739,55332,27781,27551
2013/5/1,屏東縣,東港鎮,16103,49097,24766,24331
2013/5/1,屏東縣,恆春鎮,11100,30693,15737,14956
2013/5/1,屏東縣,萬丹鄉,14590,52890,27402,25488
2013/5/1,屏東縣,長治鄉,9895,30518,15940,14578
2013/5/1,屏東縣,麟洛鄉,3670,11300,5847,5453
2013/5/1,屏東縣,九如鄉,6721,22526,11674,10852
2013/5/1,屏東縣,里港鄉,8012,26381,13429,12952
2013/5/1,屏東縣,鹽埔鄉,7813,26675,13892,12783
2013/5/1,屏東縣,高樹鄉,9440,25871,13811,12060
2013/5/1,屏東縣,萬巒鄉,6460,21301,11220,10081
2013/5/1,屏東縣,內埔鄉,18244,56924,29536,27388
2013/5/1,屏東縣,竹田鄉,5634,17948,9535,8413
2013/5/1,屏東縣,新埤鄉,3395,10292,5465,4827
2013/5/1,屏東縣,枋寮鄉,8556,25827,13557,12270
2013/5/1,屏東縣,新園鄉,11679,37243,19261,17982
2013/5/1,屏東縣,崁頂鄉,4371,16549,8397,8152
2013/5/1,屏東縣,林邊鄉,7097,19766,10174,9592
2013/5/1,屏東縣,南州鄉,3663,11212,5734,5478
2013/5/1,屏東縣,佳冬鄉,7108,20682,10757,9925
2013/5/1,屏東縣,琉球鄉,4080,12146,6741,5405
2013/5/1,屏東縣,車城鄉,3481,9148,4939,4209
2013/5/1,屏東縣,滿州鄉,3040,8152,4502,3650
2013/5/1,屏東縣,枋山鄉,2115,5793,3093,2700
2013/5/1,屏東縣,三地門鄉,2240,7505,3817,3688
2013/5/1,屏東縣,霧臺鄉,1039,3135,1641,1494
2013/5/1,屏東縣,瑪家鄉,1952,6582,3392,3190
2013/5/1,屏東縣,泰武鄉,1251,5065,2669,2396
2013/5/1,屏東縣,來義鄉,2222,7600,3894,3706
2013/5/1,屏東縣,春日鄉,1327,4828,2495,2333
2013/5/1,屏東縣,獅子鄉,1499,4794,2504,2290
2013/5/1,屏東縣,牡丹鄉,1885,4787,2473,2314
2013/5/1,臺東縣,臺東市,38534,107611,54259,53352
2013/5/1,臺東縣,成功鎮,5435,15163,8026,7137
2013/5/1,臺東縣,關山鎮,3255,9355,4897,4458
2013/5/1,臺東縣,卑南鄉,6634,17752,9510,8242
2013/5/1,臺東縣,大武鄉,2510,6584,3436,3148
2013/5/1,臺東縣,太麻里鄉,4591,11673,6219,5454
2013/5/1,臺東縣,東河鄉,3731,9076,5047,4029
2013/5/1,臺東縣,長濱鄉,2914,7817,4457,3360
2013/5/1,臺東縣,鹿野鄉,3128,8261,4447,3814
2013/5/1,臺東縣,池上鄉,3280,8766,4609,4157
2013/5/1,臺東縣,綠島鄉,1065,3482,1851,1631
2013/5/1,臺東縣,延平鄉,1066,3544,1922,1622
2013/5/1,臺東縣,海端鄉,1094,4362,2372,1990
2013/5/1,臺東縣,達仁鄉,1485,3794,2067,1727
2013/5/1,臺東縣,金峰鄉,1089,3493,1818,1675
2013/5/1,臺東縣,蘭嶼鄉,1644,4825,2476,2349
2013/5/1,花蓮縣,花蓮市,41021,107767,52512,55255
2013/5/1,花蓮縣,鳳林鎮,4420,11469,6061,5408
2013/5/1,花蓮縣,玉里鎮,8943,25876,13947,11929
2013/5/1,花蓮縣,新城鄉,7404,20111,10411,9700
2013/5/1,花蓮縣,吉安鄉,30316,81740,41586,40154
2013/5/1,花蓮縣,壽豐鄉,6894,18202,9816,8386
2013/5/1,花蓮縣,光復鄉,5019,13523,7212,6311
2013/5/1,花蓮縣,豐濱鄉,1761,4654,2591,2063
2013/5/1,花蓮縣,瑞穗鄉,4671,12267,6616,5651
2013/5/1,花蓮縣,富里鄉,4023,11098,6058,5040
2013/5/1,花蓮縣,秀林鄉,4710,15135,7866,7269
2013/5/1,花蓮縣,萬榮鄉,2087,6543,3477,3066
2013/5/1,花蓮縣,卓溪鄉,1659,6128,3391,2737
2013/5/1,澎湖縣,馬公市,21964,58885,29881,29004
2013/5/1,澎湖縣,湖西鄉,5076,13957,7307,6650
2013/5/1,澎湖縣,白沙鄉,3239,9481,4978,4503
2013/5/1,澎湖縣,西嶼鄉,2903,8350,4307,4043
2013/5/1,澎湖縣,望安鄉,1983,4952,2658,2294
2013/5/1,澎湖縣,七美鄉,1288,3616,1889,1727
2013/5/1,基隆市,中正區,22312,53965,27627,26338
2013/5/1,基隆市,七堵區,20535,54211,27474,26737
2013/5/1,基隆市,暖暖區,14746,37814,19151,18663
2013/5/1,基隆市,仁愛區,19631,47514,23394,24120
2013/5/1,基隆市,中山區,19272,49554,25272,24282
2013/5/1,基隆市,安樂區,32036,82314,41039,41275
2013/5/1,基隆市,信義區,20517,51000,25505,25495
2013/5/1,新竹市,東區,72838,204141,100626,103515
2013/5/1,新竹市,北區,52868,147622,72654,74968
2013/5/1,新竹市,香山區,24447,75093,38267,36826
2013/5/1,嘉義市,東區,44902,124165,60483,63682
2013/5/1,嘉義市,西區,52382,147147,72569,74578
2013/5/1,金門縣,金城鎮,12113,37856,19056,18800
2013/5/1,金門縣,金湖鎮,7991,25264,12826,12438
2013/5/1,金門縣,金沙鎮,5840,17979,8975,9004
2013/5/1,金門縣,金寧鄉,6987,23698,12102,11596
2013/5/1,金門縣,烈嶼鄉,2887,10752,5305,5447
2013/5/1,金門縣,烏坵鄉,134,619,306,313
2013/5/1,連江縣,南竿鄉,1363,7042,3978,3064
2013/5/1,連江縣,北竿鄉,448,2160,1196,964
2013/5/1,連江縣,莒光鄉,268,1342,791,551
2013/5/1,連江縣,東引鄉,291,1158,681,477
2013/6/1,總計,新北市,1465941,3945789,1947525,1998264
2013/6/1,總計,臺北市,1021435,2681554,1288596,1392958
2013/6/1,總計,臺中市,889989,2693892,1336717,1357175
2013/6/1,總計,臺南市,659561,1882526,944883,937643
2013/6/1,總計,高雄市,1050752,2779092,1386830,1392262
2013/6/1,總計,臺灣省,3103962,9233019,4708851,4524168
2013/6/1,總計,宜蘭縣,159807,458602,233198,225404
2013/6/1,總計,桃園市,708149,2036708,1023601,1013107
2013/6/1,總計,新竹縣,172418,526920,270157,256763
2013/6/1,總計,苗栗縣,179484,564647,291688,272959
2013/6/1,總計,彰化縣,373945,1297968,664800,633168
2013/6/1,總計,南投縣,174926,518738,266428,252310
2013/6/1,總計,雲林縣,235810,709491,369598,339893
2013/6/1,總計,嘉義縣,180202,531026,276781,254245
2013/6/1,總計,屏東縣,281553,855345,438844,416501
2013/6/1,總計,臺東縣,81482,225407,117309,108098
2013/6/1,總計,花蓮縣,123004,334468,171503,162965
2013/6/1,總計,澎湖縣,36364,99276,51054,48222
2013/6/1,總計,基隆市,149091,376082,189295,186787
2013/6/1,總計,新竹市,150366,427050,211594,215456
2013/6/1,總計,嘉義市,97361,271291,133001,138290
2013/6/1,總計,福建省,38424,128341,65457,62884
2013/6/1,總計,金門縣,36046,116570,58775,57795
2013/6/1,總計,連江縣,2378,11771,6682,5089
2013/6/1,新北市,板橋區,202726,557403,273771,283632
2013/6/1,新北市,三重區,144948,389797,193270,196527
2013/6/1,新北市,中和區,159998,415794,203910,211884
2013/6/1,新北市,永和區,90623,230449,110076,120373
2013/6/1,新北市,新莊區,143080,408400,200953,207447
2013/6/1,新北市,新店區,119782,297495,144582,152913
2013/6/1,新北市,樹林區,63901,182885,91652,91233
2013/6/1,新北市,鶯歌區,28650,88422,44395,44027
2013/6/1,新北市,三峽區,38848,108861,55112,53749
2013/6/1,新北市,淡水區,63879,152887,73924,78963
2013/6/1,新北市,汐止區,82388,193313,95246,98067
2013/6/1,新北市,瑞芳區,15992,41548,21061,20487
2013/6/1,新北市,土城區,84726,239501,119062,120439
2013/6/1,新北市,蘆洲區,67720,199402,98411,100991
2013/6/1,新北市,五股區,28394,81400,41148,40252
2013/6/1,新北市,泰山區,27074,77792,38871,38921
2013/6/1,新北市,林口區,35009,91953,45266,46687
2013/6/1,新北市,深坑區,9217,23582,11858,11724
2013/6/1,新北市,石碇區,3354,7840,4318,3522
2013/6/1,新北市,坪林區,2480,6470,3621,2849
2013/6/1,新北市,三芝區,9131,23494,12101,11393
2013/6/1,新北市,石門區,4249,12723,6646,6077
2013/6/1,新北市,八里區,13108,35859,18081,17778
2013/6/1,新北市,平溪區,2389,5032,2799,2233
2013/6/1,新北市,雙溪區,3876,9445,5087,4358
2013/6/1,新北市,貢寮區,4454,13331,6854,6477
2013/6/1,新北市,金山區,6902,22358,11132,11226
2013/6/1,新北市,萬里區,7288,22420,11362,11058
2013/6/1,新北市,烏來區,1755,5933,2956,2977
2013/6/1,臺北市,松山區,79702,211065,99895,111170
2013/6/1,臺北市,信義區,88048,227951,109443,118508
2013/6/1,臺北市,大安區,119148,313762,147300,166462
2013/6/1,臺北市,中山區,96623,227825,106697,121128
2013/6/1,臺北市,中正區,64351,163158,78336,84822
2013/6/1,臺北市,大同區,50251,129498,63491,66007
2013/6/1,臺北市,萬華區,76726,192753,95582,97171
2013/6/1,臺北市,文山區,101377,270557,130621,139936
2013/6/1,臺北市,南港區,44622,119053,58252,60801
2013/6/1,臺北市,內湖區,102935,281528,135203,146325
2013/6/1,臺北市,士林區,104374,289454,140229,149225
2013/6/1,臺北市,北投區,93278,254950,123547,131403
2013/6/1,臺中市,中區,8036,20401,10131,10270
2013/6/1,臺中市,東區,26608,74231,37233,36998
2013/6/1,臺中市,南區,44568,117465,56821,60644
2013/6/1,臺中市,西區,44364,116633,55675,60958
2013/6/1,臺中市,北區,57441,147873,71392,76481
2013/6/1,臺中市,西屯區,77771,214176,103311,110865
2013/6/1,臺中市,南屯區,56555,159239,76744,82495
2013/6/1,臺中市,北屯區,88523,254329,122889,131440
2013/6/1,臺中市,豐原區,51234,166073,82280,83793
2013/6/1,臺中市,東勢區,17179,52201,27025,25176
2013/6/1,臺中市,大甲區,22224,78052,39529,38523
2013/6/1,臺中市,清水區,25631,85829,44193,41636
2013/6/1,臺中市,沙鹿區,25937,85562,43447,42115
2013/6/1,臺中市,梧棲區,16454,55919,28252,27667
2013/6/1,臺中市,后里區,15169,54078,27631,26447
2013/6/1,臺中市,神岡區,18339,64789,33254,31535
2013/6/1,臺中市,潭子區,33977,104003,51642,52361
2013/6/1,臺中市,大雅區,27326,91897,46151,45746
2013/6/1,臺中市,新社區,7449,25372,13220,12152
2013/6/1,臺中市,石岡區,4885,15676,8156,7520
2013/6/1,臺中市,外埔區,9113,31764,16341,15423
2013/6/1,臺中市,大安區,5315,19764,10405,9359
2013/6/1,臺中市,烏日區,21719,70365,35601,34764
2013/6/1,臺中市,大肚區,16402,56033,28694,27339
2013/6/1,臺中市,龍井區,21529,75313,38251,37062
2013/6/1,臺中市,霧峰區,19213,64129,32856,31273
2013/6/1,臺中市,太平區,57472,177822,88895,88927
2013/6/1,臺中市,大里區,65166,204329,101009,103320
2013/6/1,臺中市,和平區,4390,10575,5689,4886
2013/6/1,臺南市,新營區,28006,78589,39068,39521
2013/6/1,臺南市,鹽水區,10034,26565,13840,12725
2013/6/1,臺南市,白河區,11025,30414,15948,14466
2013/6/1,臺南市,柳營區,7804,22017,11486,10531
2013/6/1,臺南市,後壁區,8948,25081,13072,12009
2013/6/1,臺南市,東山區,8292,22372,11852,10520
2013/6/1,臺南市,麻豆區,15372,45350,23079,22271
2013/6/1,臺南市,下營區,9128,25448,13103,12345
2013/6/1,臺南市,六甲區,7736,23317,12098,11219
2013/6/1,臺南市,官田區,7741,21827,11181,10646
2013/6/1,臺南市,大內區,4025,10451,5582,4869
2013/6/1,臺南市,佳里區,19890,59398,29511,29887
2013/6/1,臺南市,學甲區,9675,27347,14009,13338
2013/6/1,臺南市,西港區,7948,24971,12678,12293
2013/6/1,臺南市,七股區,8113,23989,12501,11488
2013/6/1,臺南市,將軍區,7417,20885,10632,10253
2013/6/1,臺南市,北門區,4395,11970,6039,5931
2013/6/1,臺南市,新化區,14027,43908,22493,21415
2013/6/1,臺南市,善化區,15492,44775,22546,22229
2013/6/1,臺南市,新市區,11292,35254,17747,17507
2013/6/1,臺南市,安定區,9623,30310,15649,14661
2013/6/1,臺南市,山上區,2730,7640,3997,3643
2013/6/1,臺南市,玉井區,5132,14959,7794,7165
2013/6/1,臺南市,楠西區,3549,10227,5433,4794
2013/6/1,臺南市,南化區,2837,8827,4827,4000
2013/6/1,臺南市,左鎮區,1991,5239,2937,2302
2013/6/1,臺南市,仁德區,25953,71747,36606,35141
2013/6/1,臺南市,歸仁區,21525,67011,34107,32904
2013/6/1,臺南市,關廟區,10822,35194,18228,16966
2013/6/1,臺南市,龍崎區,1590,4323,2339,1984
2013/6/1,臺南市,永康區,79447,225597,111717,113880
2013/6/1,臺南市,東區,71802,192425,92733,99692
2013/6/1,臺南市,南區,44198,125639,62750,62889
2013/6/1,臺南市,北區,49241,132297,64902,67395
2013/6/1,臺南市,安南區,57952,183842,93134,90708
2013/6/1,臺南市,安平區,24095,64445,30802,33643
2013/6/1,臺南市,中西區,30714,78876,38463,40413
2013/6/1,高雄市,鹽埕區,10975,26068,13016,13052
2013/6/1,高雄市,鼓山區,54299,134371,65327,69044
2013/6/1,高雄市,左營區,76005,195367,95380,99987
2013/6/1,高雄市,楠梓區,64378,176597,87366,89231
2013/6/1,高雄市,三民區,133514,349203,170080,179123
2013/6/1,高雄市,新興區,22763,53512,25843,27669
2013/6/1,高雄市,前金區,12569,28177,13670,14507
2013/6/1,高雄市,苓雅區,72163,178611,86559,92052
2013/6/1,高雄市,前鎮區,77247,195196,96585,98611
2013/6/1,高雄市,旗津區,10951,29116,15074,14042
2013/6/1,高雄市,小港區,65356,156118,78016,78102
2013/6/1,高雄市,鳳山區,133091,351621,173831,177790
2013/6/1,高雄市,林園區,25105,70388,35945,34443
2013/6/1,高雄市,大寮區,39957,109955,56856,53099
2013/6/1,高雄市,大樹區,13171,43354,22390,20964
2013/6/1,高雄市,大社區,12169,33839,17342,16497
2013/6/1,高雄市,仁武區,28811,78321,40153,38168
2013/6/1,高雄市,鳥松區,17264,43665,22174,21491
2013/6/1,高雄市,岡山區,34142,97868,48812,49056
2013/6/1,高雄市,橋頭區,13045,36941,18852,18089
2013/6/1,高雄市,燕巢區,10250,30666,16311,14355
2013/6/1,高雄市,田寮區,3457,7794,4343,3451
2013/6/1,高雄市,阿蓮區,9333,29883,15082,14801
2013/6/1,高雄市,路竹區,16394,53103,27128,25975
2013/6/1,高雄市,湖內區,10090,29155,14995,14160
2013/6/1,高雄市,茄萣區,10336,30882,16054,14828
2013/6/1,高雄市,永安區,5824,14106,7126,6980
2013/6/1,高雄市,彌陀區,6688,19983,10374,9609
2013/6/1,高雄市,梓官區,12333,36424,18866,17558
2013/6/1,高雄市,旗山區,13899,38818,20133,18685
2013/6/1,高雄市,美濃區,14399,41950,21904,20046
2013/6/1,高雄市,六龜區,5702,14063,7601,6462
2013/6/1,高雄市,甲仙區,2382,6523,3467,3056
2013/6/1,高雄市,杉林區,4828,12600,6863,5737
2013/6/1,高雄市,內門區,5065,15414,8400,7014
2013/6/1,高雄市,茂林區,579,1815,920,895
2013/6/1,高雄市,桃源區,1343,4460,2351,2109
2013/6/1,高雄市,那瑪夏區,875,3165,1641,1524
2013/6/1,宜蘭縣,宜蘭市,34689,96195,47164,49031
2013/6/1,宜蘭縣,羅東鎮,25489,72474,34669,37805
2013/6/1,宜蘭縣,蘇澳鎮,13837,41615,21256,20359
2013/6/1,宜蘭縣,頭城鎮,9967,30148,15594,14554
2013/6/1,宜蘭縣,礁溪鄉,12960,35979,18800,17179
2013/6/1,宜蘭縣,壯圍鄉,8345,24477,12984,11493
2013/6/1,宜蘭縣,員山鄉,11095,32137,17174,14963
2013/6/1,宜蘭縣,冬山鄉,18252,53588,27539,26049
2013/6/1,宜蘭縣,五結鄉,13606,39076,20227,18849
2013/6/1,宜蘭縣,三星鄉,7848,21132,11452,9680
2013/6/1,宜蘭縣,大同鄉,1860,5916,3223,2693
2013/6/1,宜蘭縣,南澳鄉,1859,5865,3116,2749
2013/6/1,桃園市,桃園區,151738,415171,203068,212103
2013/6/1,桃園市,中壢區,134332,377412,187845,189567
2013/6/1,桃園市,平鎮區,70054,210507,105604,104903
2013/6/1,桃園市,八德區,61156,179055,90738,88317
2013/6/1,桃園市,楊梅區,51858,154880,78607,76273
2013/6/1,桃園市,大溪區,30140,91831,47277,44554
2013/6/1,桃園市,蘆竹區,51657,147819,73923,73896
2013/6/1,桃園市,大園區,27605,83234,42988,40246
2013/6/1,桃園市,龜山區,52502,139953,70542,69411
2013/6/1,桃園市,龍潭區,38105,115322,58435,56887
2013/6/1,桃園市,新屋區,15194,48132,25777,22355
2013/6/1,桃園市,觀音區,20101,62804,32930,29874
2013/6/1,桃園市,復興區,3707,10588,5867,4721
2013/6/1,新竹縣,竹北市,53658,155567,77660,77907
2013/6/1,新竹縣,關西鎮,9485,31089,16566,14523
2013/6/1,新竹縣,新埔鎮,10567,34799,18499,16300
2013/6/1,新竹縣,竹東鎮,31765,96577,48608,47969
2013/6/1,新竹縣,湖口鄉,24505,76519,38917,37602
2013/6/1,新竹縣,橫山鄉,4493,13947,7551,6396
2013/6/1,新竹縣,新豐鄉,16838,54950,28205,26745
2013/6/1,新竹縣,芎林鄉,6383,20270,10688,9582
2013/6/1,新竹縣,寶山鄉,4999,14050,7594,6456
2013/6/1,新竹縣,北埔鄉,3147,9891,5346,4545
2013/6/1,新竹縣,峨眉鄉,2067,5777,3217,2560
2013/6/1,新竹縣,尖石鄉,2787,8967,4816,4151
2013/6/1,新竹縣,五峰鄉,1724,4517,2490,2027
2013/6/1,苗栗縣,苗栗市,30100,91057,45626,45431
2013/6/1,苗栗縣,苑裡鎮,14191,48486,25177,23309
2013/6/1,苗栗縣,通霄鎮,11516,37254,19677,17577
2013/6/1,苗栗縣,竹南鎮,25879,81556,41333,40223
2013/6/1,苗栗縣,頭份市,31792,100832,51013,49819
2013/6/1,苗栗縣,後龍鎮,11862,38586,20302,18284
2013/6/1,苗栗縣,卓蘭鎮,6121,18416,9678,8738
2013/6/1,苗栗縣,大湖鄉,5434,15764,8372,7392
2013/6/1,苗栗縣,公館鄉,10543,34883,18175,16708
2013/6/1,苗栗縣,銅鑼鄉,6100,19103,10140,8963
2013/6/1,苗栗縣,南庄鄉,3983,10810,5932,4878
2013/6/1,苗栗縣,頭屋鄉,3599,11403,6005,5398
2013/6/1,苗栗縣,三義鄉,5410,17433,9134,8299
2013/6/1,苗栗縣,西湖鄉,2708,7676,4264,3412
2013/6/1,苗栗縣,造橋鄉,4110,13599,7138,6461
2013/6/1,苗栗縣,三灣鄉,2440,7133,3901,3232
2013/6/1,苗栗縣,獅潭鄉,1726,4750,2653,2097
2013/6/1,苗栗縣,泰安鄉,1970,5906,3168,2738
2013/6/1,彰化縣,彰化市,74106,236520,117474,119046
2013/6/1,彰化縣,鹿港鎮,23230,86065,43977,42088
2013/6/1,彰化縣,和美鎮,25249,90415,46314,44101
2013/6/1,彰化縣,北斗鎮,10267,33228,16798,16430
2013/6/1,彰化縣,員林市,37797,125097,62734,62363
2013/6/1,彰化縣,溪湖鎮,15684,55897,28502,27395
2013/6/1,彰化縣,田中鎮,12779,43248,22388,20860
2013/6/1,彰化縣,二林鎮,14659,52992,27330,25662
2013/6/1,彰化縣,線西鄉,4212,17059,8811,8248
2013/6/1,彰化縣,伸港鄉,9321,36039,18471,17568
2013/6/1,彰化縣,福興鄉,12337,48003,25070,22933
2013/6/1,彰化縣,秀水鄉,10165,39371,20324,19047
2013/6/1,彰化縣,花壇鄉,13379,46001,23689,22312
2013/6/1,彰化縣,芬園鄉,6870,24313,12830,11483
2013/6/1,彰化縣,大村鄉,10557,36426,18935,17491
2013/6/1,彰化縣,埔鹽鄉,8967,33592,17625,15967
2013/6/1,彰化縣,埔心鄉,10206,35073,18110,16963
2013/6/1,彰化縣,永靖鄉,10702,38714,20156,18558
2013/6/1,彰化縣,社頭鄉,12578,44037,22613,21424
2013/6/1,彰化縣,二水鄉,5370,16048,8433,7615
2013/6/1,彰化縣,田尾鄉,7779,28033,14598,13435
2013/6/1,彰化縣,埤頭鄉,8822,31363,16339,15024
2013/6/1,彰化縣,芳苑鄉,10069,35204,18640,16564
2013/6/1,彰化縣,大城鄉,5382,18162,9851,8311
2013/6/1,彰化縣,竹塘鄉,4625,16085,8489,7596
2013/6/1,彰化縣,溪州鄉,8833,30983,16299,14684
2013/6/1,南投縣,南投市,34026,103170,51828,51342
2013/6/1,南投縣,埔里鎮,28837,84130,42294,41836
2013/6/1,南投縣,草屯鎮,31944,99299,50203,49096
2013/6/1,南投縣,竹山鎮,19838,57293,29474,27819
2013/6/1,南投縣,集集鎮,4353,11481,5996,5485
2013/6/1,南投縣,名間鄉,12468,40516,21284,19232
2013/6/1,南投縣,鹿谷鄉,7237,18696,9922,8774
2013/6/1,南投縣,中寮鄉,5667,15841,8593,7248
2013/6/1,南投縣,魚池鄉,5789,16737,8776,7961
2013/6/1,南投縣,國姓鄉,7276,20025,10872,9153
2013/6/1,南投縣,水里鄉,7284,19219,10086,9133
2013/6/1,南投縣,信義鄉,5252,16696,8998,7698
2013/6/1,南投縣,仁愛鄉,4955,15635,8102,7533
2013/6/1,雲林縣,斗六市,36367,107947,54028,53919
2013/6/1,雲林縣,斗南鎮,15556,46415,23612,22803
2013/6/1,雲林縣,虎尾鎮,23600,70562,35856,34706
2013/6/1,雲林縣,西螺鎮,14286,47618,24213,23405
2013/6/1,雲林縣,土庫鎮,9035,29910,15647,14263
2013/6/1,雲林縣,北港鎮,15803,42248,22004,20244
2013/6/1,雲林縣,古坑鄉,10839,33019,17440,15579
2013/6/1,雲林縣,大埤鄉,6764,20377,10964,9413
2013/6/1,雲林縣,莿桐鄉,9203,29854,15673,14181
2013/6/1,雲林縣,林內鄉,5876,19378,10127,9251
2013/6/1,雲林縣,二崙鄉,8912,28849,15402,13447
2013/6/1,雲林縣,崙背鄉,8484,26353,13929,12424
2013/6/1,雲林縣,麥寮鄉,13476,41705,21245,20460
2013/6/1,雲林縣,東勢鄉,5810,15965,8746,7219
2013/6/1,雲林縣,褒忠鄉,4408,13786,7373,6413
2013/6/1,雲林縣,臺西鄉,8826,24933,13428,11505
2013/6/1,雲林縣,元長鄉,9451,27758,15138,12620
2013/6/1,雲林縣,四湖鄉,9065,25781,13995,11786
2013/6/1,雲林縣,口湖鄉,9688,29505,15708,13797
2013/6/1,雲林縣,水林鄉,10361,27528,15070,12458
2013/6/1,嘉義縣,太保市,11864,36956,19075,17881
2013/6/1,嘉義縣,朴子市,15187,43747,22151,21596
2013/6/1,嘉義縣,布袋鎮,10184,28904,14836,14068
2013/6/1,嘉義縣,大林鎮,11387,32776,16809,15967
2013/6/1,嘉義縣,民雄鄉,23620,72151,37000,35151
2013/6/1,嘉義縣,溪口鄉,5438,15648,8351,7297
2013/6/1,嘉義縣,新港鄉,10531,33692,17810,15882
2013/6/1,嘉義縣,六腳鄉,9105,25132,13329,11803
2013/6/1,嘉義縣,東石鄉,9485,26440,14059,12381
2013/6/1,嘉義縣,義竹鄉,7571,19989,10390,9599
2013/6/1,嘉義縣,鹿草鄉,5847,16711,8976,7735
2013/6/1,嘉義縣,水上鄉,17673,51345,26525,24820
2013/6/1,嘉義縣,中埔鄉,15822,46756,24377,22379
2013/6/1,嘉義縣,竹崎鄉,11534,37640,20084,17556
2013/6/1,嘉義縣,梅山鄉,6783,20701,10973,9728
2013/6/1,嘉義縣,番路鄉,4299,12205,6636,5569
2013/6/1,嘉義縣,大埔鄉,1934,4529,2360,2169
2013/6/1,嘉義縣,阿里山鄉,1938,5704,3040,2664
2013/6/1,屏東縣,屏東市,73036,207043,102920,104123
2013/6/1,屏東縣,潮州鎮,18763,55345,27790,27555
2013/6/1,屏東縣,東港鎮,16118,49020,24722,24298
2013/6/1,屏東縣,恆春鎮,11111,30690,15720,14970
2013/6/1,屏東縣,萬丹鄉,14585,52849,27371,25478
2013/6/1,屏東縣,長治鄉,9907,30505,15926,14579
2013/6/1,屏東縣,麟洛鄉,3666,11307,5856,5451
2013/6/1,屏東縣,九如鄉,6726,22517,11669,10848
2013/6/1,屏東縣,里港鄉,8030,26411,13444,12967
2013/6/1,屏東縣,鹽埔鄉,7817,26697,13890,12807
2013/6/1,屏東縣,高樹鄉,9430,25842,13787,12055
2013/6/1,屏東縣,萬巒鄉,6461,21270,11200,10070
2013/6/1,屏東縣,內埔鄉,18252,56883,29512,27371
2013/6/1,屏東縣,竹田鄉,5633,17915,9522,8393
2013/6/1,屏東縣,新埤鄉,3396,10297,5469,4828
2013/6/1,屏東縣,枋寮鄉,8558,25819,13556,12263
2013/6/1,屏東縣,新園鄉,11673,37237,19280,17957
2013/6/1,屏東縣,崁頂鄉,4372,16499,8380,8119
2013/6/1,屏東縣,林邊鄉,7100,19748,10168,9580
2013/6/1,屏東縣,南州鄉,3664,11211,5741,5470
2013/6/1,屏東縣,佳冬鄉,7102,20690,10759,9931
2013/6/1,屏東縣,琉球鄉,4095,12134,6739,5395
2013/6/1,屏東縣,車城鄉,3477,9172,4942,4230
2013/6/1,屏東縣,滿州鄉,3039,8134,4495,3639
2013/6/1,屏東縣,枋山鄉,2115,5785,3092,2693
2013/6/1,屏東縣,三地門鄉,2241,7519,3827,3692
2013/6/1,屏東縣,霧臺鄉,1039,3149,1642,1507
2013/6/1,屏東縣,瑪家鄉,1951,6579,3397,3182
2013/6/1,屏東縣,泰武鄉,1254,5069,2674,2395
2013/6/1,屏東縣,來義鄉,2223,7597,3891,3706
2013/6/1,屏東縣,春日鄉,1330,4828,2492,2336
2013/6/1,屏東縣,獅子鄉,1501,4786,2495,2291
2013/6/1,屏東縣,牡丹鄉,1888,4798,2476,2322
2013/6/1,臺東縣,臺東市,38563,107584,54248,53336
2013/6/1,臺東縣,成功鎮,5427,15141,8013,7128
2013/6/1,臺東縣,關山鎮,3251,9342,4891,4451
2013/6/1,臺東縣,卑南鄉,6625,17716,9478,8238
2013/6/1,臺東縣,大武鄉,2510,6571,3425,3146
2013/6/1,臺東縣,太麻里鄉,4596,11673,6214,5459
2013/6/1,臺東縣,東河鄉,3729,9061,5030,4031
2013/6/1,臺東縣,長濱鄉,2915,7805,4450,3355
2013/6/1,臺東縣,鹿野鄉,3127,8251,4442,3809
2013/6/1,臺東縣,池上鄉,3284,8749,4605,4144
2013/6/1,臺東縣,綠島鄉,1073,3492,1852,1640
2013/6/1,臺東縣,延平鄉,1066,3549,1927,1622
2013/6/1,臺東縣,海端鄉,1093,4366,2375,1991
2013/6/1,臺東縣,達仁鄉,1483,3787,2064,1723
2013/6/1,臺東縣,金峰鄉,1091,3482,1810,1672
2013/6/1,臺東縣,蘭嶼鄉,1649,4838,2485,2353
2013/6/1,花蓮縣,花蓮市,41030,107679,52458,55221
2013/6/1,花蓮縣,鳳林鎮,4416,11453,6052,5401
2013/6/1,花蓮縣,玉里鎮,8932,25872,13938,11934
2013/6/1,花蓮縣,新城鄉,7418,20136,10425,9711
2013/6/1,花蓮縣,吉安鄉,30396,81854,41642,40212
2013/6/1,花蓮縣,壽豐鄉,6889,18186,9801,8385
2013/6/1,花蓮縣,光復鄉,5024,13527,7213,6314
2013/6/1,花蓮縣,豐濱鄉,1758,4652,2587,2065
2013/6/1,花蓮縣,瑞穗鄉,4662,12231,6596,5635
2013/6/1,花蓮縣,富里鄉,4028,11086,6053,5033
2013/6/1,花蓮縣,秀林鄉,4709,15150,7872,7278
2013/6/1,花蓮縣,萬榮鄉,2083,6530,3477,3053
2013/6/1,花蓮縣,卓溪鄉,1659,6112,3389,2723
2013/6/1,澎湖縣,馬公市,21854,58824,29873,28951
2013/6/1,澎湖縣,湖西鄉,5087,13988,7314,6674
2013/6/1,澎湖縣,白沙鄉,3242,9510,4989,4521
2013/6/1,澎湖縣,西嶼鄉,2902,8354,4306,4048
2013/6/1,澎湖縣,望安鄉,1986,4972,2674,2298
2013/6/1,澎湖縣,七美鄉,1293,3628,1898,1730
2013/6/1,基隆市,中正區,22308,53878,27564,26314
2013/6/1,基隆市,七堵區,20561,54187,27448,26739
2013/6/1,基隆市,暖暖區,14744,37789,19143,18646
2013/6/1,基隆市,仁愛區,19626,47449,23365,24084
2013/6/1,基隆市,中山區,19283,49488,25256,24232
2013/6/1,基隆市,安樂區,32039,82255,40997,41258
2013/6/1,基隆市,信義區,20530,51036,25522,25514
2013/6/1,新竹市,東區,72895,204198,100649,103549
2013/6/1,新竹市,北區,52955,147688,72648,75040
2013/6/1,新竹市,香山區,24516,75164,38297,36867
2013/6/1,嘉義市,東區,44934,124128,60458,63670
2013/6/1,嘉義市,西區,52427,147163,72543,74620
2013/6/1,金門縣,金城鎮,12125,38051,19149,18902
2013/6/1,金門縣,金湖鎮,8018,25384,12890,12494
2013/6/1,金門縣,金沙鎮,5854,18049,8999,9050
2013/6/1,金門縣,金寧鄉,7023,23647,12093,11554
2013/6/1,金門縣,烈嶼鄉,2892,10815,5335,5480
2013/6/1,金門縣,烏坵鄉,134,624,309,315
2013/6/1,連江縣,南竿鄉,1370,7081,3998,3083
2013/6/1,連江縣,北竿鄉,449,2184,1209,975
2013/6/1,連江縣,莒光鄉,268,1350,796,554
2013/6/1,連江縣,東引鄉,291,1156,679,477
2013/7/1,總計,新北市,1467926,3947608,1948002,1999606
2013/7/1,總計,臺北市,1022200,2682372,1288816,1393556
2013/7/1,總計,臺中市,891363,2695353,1337319,1358034
2013/7/1,總計,臺南市,660193,1882620,944855,937765
2013/7/1,總計,高雄市,1052035,2779416,1386731,1392685
2013/7/1,總計,臺灣省,3107949,9233257,4708521,4524736
2013/7/1,總計,宜蘭縣,160096,458636,233182,225454
2013/7/1,總計,桃園市,709658,2038147,1024257,1013890
2013/7/1,總計,新竹縣,172889,527609,270534,257075
2013/7/1,總計,苗栗縣,179737,564806,291781,273025
2013/7/1,總計,彰化縣,374331,1297666,664629,633037
2013/7/1,總計,南投縣,175020,518531,266291,252240
2013/7/1,總計,雲林縣,235923,709202,369365,339837
2013/7/1,總計,嘉義縣,180303,530718,276615,254103
2013/7/1,總計,屏東縣,281751,854789,438526,416263
2013/7/1,總計,臺東縣,81521,225270,117231,108039
2013/7/1,總計,花蓮縣,123055,334302,171358,162944
2013/7/1,總計,澎湖縣,36414,99387,51104,48283
2013/7/1,總計,基隆市,149212,375834,189131,186703
2013/7/1,總計,新竹市,150610,427137,211600,215537
2013/7/1,總計,嘉義市,97429,271223,132917,138306
2013/7/1,總計,福建省,38551,129098,65773,63325
2013/7/1,總計,金門縣,36162,117229,59041,58188
2013/7/1,總計,連江縣,2389,11869,6732,5137
2013/7/1,新北市,板橋區,202859,557267,273667,283600
2013/7/1,新北市,三重區,145069,389669,193150,196519
2013/7/1,新北市,中和區,160176,415812,203898,211914
2013/7/1,新北市,永和區,90626,230217,109947,120270
2013/7/1,新北市,新莊區,143319,408685,201059,207626
2013/7/1,新北市,新店區,119870,297822,144723,153099
2013/7/1,新北市,樹林區,63973,183028,91694,91334
2013/7/1,新北市,鶯歌區,28694,88434,44422,44012
2013/7/1,新北市,三峽區,38993,109149,55239,53910
2013/7/1,新北市,淡水區,64208,153378,74134,79244
2013/7/1,新北市,汐止區,82580,193541,95306,98235
2013/7/1,新北市,瑞芳區,15995,41562,21051,20511
2013/7/1,新北市,土城區,84773,239444,118962,120482
2013/7/1,新北市,蘆洲區,67802,199374,98404,100970
2013/7/1,新北市,五股區,28431,81464,41185,40279
2013/7/1,新北市,泰山區,27095,77791,38859,38932
2013/7/1,新北市,林口區,35210,92317,45411,46906
2013/7/1,新北市,深坑區,9213,23583,11857,11726
2013/7/1,新北市,石碇區,3359,7858,4324,3534
2013/7/1,新北市,坪林區,2479,6465,3619,2846
2013/7/1,新北市,三芝區,9136,23468,12091,11377
2013/7/1,新北市,石門區,4244,12746,6658,6088
2013/7/1,新北市,八里區,13140,35920,18116,17804
2013/7/1,新北市,平溪區,2387,5036,2806,2230
2013/7/1,新北市,雙溪區,3873,9428,5085,4343
2013/7/1,新北市,貢寮區,4453,13324,6845,6479
2013/7/1,新北市,金山區,6915,22370,11148,11222
2013/7/1,新北市,萬里區,7296,22493,11382,11111
2013/7/1,新北市,烏來區,1758,5963,2960,3003
2013/7/1,臺北市,松山區,79700,210873,99797,111076
2013/7/1,臺北市,信義區,88169,228164,109538,118626
2013/7/1,臺北市,大安區,119195,313759,147225,166534
2013/7/1,臺北市,中山區,96727,228072,106799,121273
2013/7/1,臺北市,中正區,64365,163147,78305,84842
2013/7/1,臺北市,大同區,50266,129518,63501,66017
2013/7/1,臺北市,萬華區,76802,192840,95633,97207
2013/7/1,臺北市,文山區,101480,270724,130701,140023
2013/7/1,臺北市,南港區,44707,119191,58314,60877
2013/7/1,臺北市,內湖區,103058,281715,135255,146460
2013/7/1,臺北市,士林區,104401,289434,140207,149227
2013/7/1,臺北市,北投區,93330,254935,123541,131394
2013/7/1,臺中市,中區,8014,20256,10072,10184
2013/7/1,臺中市,東區,26635,74255,37234,37021
2013/7/1,臺中市,南區,44622,117638,56899,60739
2013/7/1,臺中市,西區,44396,116556,55624,60932
2013/7/1,臺中市,北區,57525,147883,71387,76496
2013/7/1,臺中市,西屯區,77913,214431,103438,110993
2013/7/1,臺中市,南屯區,56636,159369,76773,82596
2013/7/1,臺中市,北屯區,88772,254713,123065,131648
2013/7/1,臺中市,豐原區,51260,165957,82228,83729
2013/7/1,臺中市,東勢區,17181,52156,27011,25145
2013/7/1,臺中市,大甲區,22256,78029,39513,38516
2013/7/1,臺中市,清水區,25700,85894,44226,41668
2013/7/1,臺中市,沙鹿區,26029,85765,43560,42205
2013/7/1,臺中市,梧棲區,16473,55961,28284,27677
2013/7/1,臺中市,后里區,15186,54107,27640,26467
2013/7/1,臺中市,神岡區,18362,64827,33266,31561
2013/7/1,臺中市,潭子區,34017,104104,51667,52437
2013/7/1,臺中市,大雅區,27343,91896,46134,45762
2013/7/1,臺中市,新社區,7444,25347,13210,12137
2013/7/1,臺中市,石岡區,4891,15674,8157,7517
2013/7/1,臺中市,外埔區,9123,31743,16330,15413
2013/7/1,臺中市,大安區,5322,19777,10406,9371
2013/7/1,臺中市,烏日區,21766,70447,35634,34813
2013/7/1,臺中市,大肚區,16428,56007,28679,27328
2013/7/1,臺中市,龍井區,21562,75322,38267,37055
2013/7/1,臺中市,霧峰區,19240,64163,32863,31300
2013/7/1,臺中市,太平區,57631,178069,89009,89060
2013/7/1,臺中市,大里區,65249,204447,101054,103393
2013/7/1,臺中市,和平區,4387,10560,5689,4871
2013/7/1,臺南市,新營區,28064,78542,39031,39511
2013/7/1,臺南市,鹽水區,10025,26525,13824,12701
2013/7/1,臺南市,白河區,11023,30377,15924,14453
2013/7/1,臺南市,柳營區,7804,22033,11485,10548
2013/7/1,臺南市,後壁區,8954,25055,13059,11996
2013/7/1,臺南市,東山區,8285,22338,11835,10503
2013/7/1,臺南市,麻豆區,15371,45348,23067,22281
2013/7/1,臺南市,下營區,9125,25414,13088,12326
2013/7/1,臺南市,六甲區,7741,23291,12090,11201
2013/7/1,臺南市,官田區,7741,21818,11180,10638
2013/7/1,臺南市,大內區,4026,10459,5587,4872
2013/7/1,臺南市,佳里區,19894,59360,29504,29856
2013/7/1,臺南市,學甲區,9676,27335,13998,13337
2013/7/1,臺南市,西港區,7941,24959,12673,12286
2013/7/1,臺南市,七股區,8110,23927,12477,11450
2013/7/1,臺南市,將軍區,7409,20879,10631,10248
2013/7/1,臺南市,北門區,4390,11950,6027,5923
2013/7/1,臺南市,新化區,14032,43886,22478,21408
2013/7/1,臺南市,善化區,15506,44779,22565,22214
2013/7/1,臺南市,新市區,11310,35252,17746,17506
2013/7/1,臺南市,安定區,9635,30292,15632,14660
2013/7/1,臺南市,山上區,2724,7625,3989,3636
2013/7/1,臺南市,玉井區,5133,14922,7778,7144
2013/7/1,臺南市,楠西區,3550,10200,5418,4782
2013/7/1,臺南市,南化區,2839,8838,4833,4005
2013/7/1,臺南市,左鎮區,1991,5240,2937,2303
2013/7/1,臺南市,仁德區,26027,71938,36705,35233
2013/7/1,臺南市,歸仁區,21564,67079,34126,32953
2013/7/1,臺南市,關廟區,10831,35180,18211,16969
2013/7/1,臺南市,龍崎區,1587,4332,2345,1987
2013/7/1,臺南市,永康區,79576,225846,111804,114042
2013/7/1,臺南市,東區,71836,192241,92671,99570
2013/7/1,臺南市,南區,44211,125573,62712,62861
2013/7/1,臺南市,北區,49272,132345,64907,67438
2013/7/1,臺南市,安南區,58139,184159,93282,90877
2013/7/1,臺南市,安平區,24140,64489,30808,33681
2013/7/1,臺南市,中西區,30711,78794,38428,40366
2013/7/1,高雄市,鹽埕區,10975,26021,12984,13037
2013/7/1,高雄市,鼓山區,54408,134461,65351,69110
2013/7/1,高雄市,左營區,76091,195371,95365,100006
2013/7/1,高雄市,楠梓區,64544,176776,87467,89309
2013/7/1,高雄市,三民區,133647,349074,170022,179052
2013/7/1,高雄市,新興區,22787,53471,25825,27646
2013/7/1,高雄市,前金區,12581,28194,13669,14525
2013/7/1,高雄市,苓雅區,72154,178429,86456,91973
2013/7/1,高雄市,前鎮區,77360,195259,96582,98677
2013/7/1,高雄市,旗津區,10951,29083,15056,14027
2013/7/1,高雄市,小港區,65388,156125,78022,78103
2013/7/1,高雄市,鳳山區,133310,351860,173911,177949
2013/7/1,高雄市,林園區,25123,70404,35941,34463
2013/7/1,高雄市,大寮區,40054,110037,56873,53164
2013/7/1,高雄市,大樹區,13188,43327,22372,20955
2013/7/1,高雄市,大社區,12204,33859,17354,16505
2013/7/1,高雄市,仁武區,28890,78485,40203,38282
2013/7/1,高雄市,鳥松區,17296,43716,22201,21515
2013/7/1,高雄市,岡山區,34183,97847,48814,49033
2013/7/1,高雄市,橋頭區,13066,36991,18865,18126
2013/7/1,高雄市,燕巢區,10252,30652,16308,14344
2013/7/1,高雄市,田寮區,3455,7787,4331,3456
2013/7/1,高雄市,阿蓮區,9343,29872,15069,14803
2013/7/1,高雄市,路竹區,16403,53072,27105,25967
2013/7/1,高雄市,湖內區,10085,29173,14996,14177
2013/7/1,高雄市,茄萣區,10351,30876,16041,14835
2013/7/1,高雄市,永安區,5827,14151,7147,7004
2013/7/1,高雄市,彌陀區,6684,19955,10348,9607
2013/7/1,高雄市,梓官區,12350,36422,18857,17565
2013/7/1,高雄市,旗山區,13891,38788,20116,18672
2013/7/1,高雄市,美濃區,14415,41915,21881,20034
2013/7/1,高雄市,六龜區,5695,14018,7572,6446
2013/7/1,高雄市,甲仙區,2386,6509,3463,3046
2013/7/1,高雄市,杉林區,4834,12606,6864,5742
2013/7/1,高雄市,內門區,5065,15404,8393,7011
2013/7/1,高雄市,茂林區,581,1817,919,898
2013/7/1,高雄市,桃源區,1344,4450,2346,2104
2013/7/1,高雄市,那瑪夏區,874,3159,1642,1517
2013/7/1,宜蘭縣,宜蘭市,34744,96219,47166,49053
2013/7/1,宜蘭縣,羅東鎮,25516,72460,34633,37827
2013/7/1,宜蘭縣,蘇澳鎮,13842,41587,21229,20358
2013/7/1,宜蘭縣,頭城鎮,9981,30117,15569,14548
2013/7/1,宜蘭縣,礁溪鄉,12991,35996,18827,17169
2013/7/1,宜蘭縣,壯圍鄉,8357,24503,12990,11513
2013/7/1,宜蘭縣,員山鄉,11123,32160,17183,14977
2013/7/1,宜蘭縣,冬山鄉,18307,53616,27562,26054
2013/7/1,宜蘭縣,五結鄉,13637,39029,20210,18819
2013/7/1,宜蘭縣,三星鄉,7878,21145,11465,9680
2013/7/1,宜蘭縣,大同鄉,1860,5927,3227,2700
2013/7/1,宜蘭縣,南澳鄉,1860,5877,3121,2756
2013/7/1,桃園市,桃園區,152028,415337,203144,212193
2013/7/1,桃園市,中壢區,134590,377615,187937,189678
2013/7/1,桃園市,平鎮區,70232,210710,105717,104993
2013/7/1,桃園市,八德區,61269,179121,90695,88426
2013/7/1,桃園市,楊梅區,51983,155045,78708,76337
2013/7/1,桃園市,大溪區,30170,91921,47314,44607
2013/7/1,桃園市,蘆竹區,51841,148037,74012,74025
2013/7/1,桃園市,大園區,27665,83228,42974,40254
2013/7/1,桃園市,龜山區,52644,140154,70669,69485
2013/7/1,桃園市,龍潭區,38190,115453,58501,56952
2013/7/1,桃園市,新屋區,15210,48123,25777,22346
2013/7/1,桃園市,觀音區,20133,62820,32944,29876
2013/7/1,桃園市,復興區,3703,10583,5865,4718
2013/7/1,新竹縣,竹北市,53933,156130,77967,78163
2013/7/1,新竹縣,關西鎮,9491,31071,16571,14500
2013/7/1,新竹縣,新埔鎮,10572,34794,18475,16319
2013/7/1,新竹縣,竹東鎮,31816,96568,48608,47960
2013/7/1,新竹縣,湖口鄉,24558,76569,38953,37616
2013/7/1,新竹縣,橫山鄉,4499,13950,7554,6396
2013/7/1,新竹縣,新豐鄉,16895,55059,28257,26802
2013/7/1,新竹縣,芎林鄉,6390,20254,10682,9572
2013/7/1,新竹縣,寶山鄉,5006,14061,7599,6462
2013/7/1,新竹縣,北埔鄉,3146,9887,5344,4543
2013/7/1,新竹縣,峨眉鄉,2070,5777,3219,2558
2013/7/1,新竹縣,尖石鄉,2782,8977,4820,4157
2013/7/1,新竹縣,五峰鄉,1731,4512,2485,2027
2013/7/1,苗栗縣,苗栗市,30134,91059,45625,45434
2013/7/1,苗栗縣,苑裡鎮,14200,48488,25177,23311
2013/7/1,苗栗縣,通霄鎮,11511,37238,19677,17561
2013/7/1,苗栗縣,竹南鎮,25988,81761,41429,40332
2013/7/1,苗栗縣,頭份市,31888,100946,51089,49857
2013/7/1,苗栗縣,後龍鎮,11870,38552,20282,18270
2013/7/1,苗栗縣,卓蘭鎮,6117,18414,9672,8742
2013/7/1,苗栗縣,大湖鄉,5426,15740,8359,7381
2013/7/1,苗栗縣,公館鄉,10544,34877,18166,16711
2013/7/1,苗栗縣,銅鑼鄉,6098,19080,10128,8952
2013/7/1,苗栗縣,南庄鄉,3982,10791,5927,4864
2013/7/1,苗栗縣,頭屋鄉,3605,11412,6008,5404
2013/7/1,苗栗縣,三義鄉,5408,17421,9127,8294
2013/7/1,苗栗縣,西湖鄉,2710,7671,4262,3409
2013/7/1,苗栗縣,造橋鄉,4117,13578,7128,6450
2013/7/1,苗栗縣,三灣鄉,2442,7131,3903,3228
2013/7/1,苗栗縣,獅潭鄉,1726,4745,2655,2090
2013/7/1,苗栗縣,泰安鄉,1971,5902,3167,2735
2013/7/1,彰化縣,彰化市,74171,236487,117467,119020
2013/7/1,彰化縣,鹿港鎮,23269,86094,44002,42092
2013/7/1,彰化縣,和美鎮,25299,90448,46332,44116
2013/7/1,彰化縣,北斗鎮,10272,33251,16803,16448
2013/7/1,彰化縣,員林市,37830,124990,62673,62317
2013/7/1,彰化縣,溪湖鎮,15706,55859,28480,27379
2013/7/1,彰化縣,田中鎮,12798,43230,22392,20838
2013/7/1,彰化縣,二林鎮,14672,52962,27309,25653
2013/7/1,彰化縣,線西鄉,4222,17074,8816,8258
2013/7/1,彰化縣,伸港鄉,9336,36061,18484,17577
2013/7/1,彰化縣,福興鄉,12350,47993,25055,22938
2013/7/1,彰化縣,秀水鄉,10171,39339,20306,19033
2013/7/1,彰化縣,花壇鄉,13401,45986,23681,22305
2013/7/1,彰化縣,芬園鄉,6865,24309,12818,11491
2013/7/1,彰化縣,大村鄉,10579,36447,18938,17509
2013/7/1,彰化縣,埔鹽鄉,8972,33569,17619,15950
2013/7/1,彰化縣,埔心鄉,10220,35105,18124,16981
2013/7/1,彰化縣,永靖鄉,10711,38666,20119,18547
2013/7/1,彰化縣,社頭鄉,12577,44001,22596,21405
2013/7/1,彰化縣,二水鄉,5368,16033,8427,7606
2013/7/1,彰化縣,田尾鄉,7794,28029,14591,13438
2013/7/1,彰化縣,埤頭鄉,8831,31358,16350,15008
2013/7/1,彰化縣,芳苑鄉,10081,35208,18648,16560
2013/7/1,彰化縣,大城鄉,5381,18148,9842,8306
2013/7/1,彰化縣,竹塘鄉,4623,16060,8469,7591
2013/7/1,彰化縣,溪州鄉,8832,30959,16288,14671
2013/7/1,南投縣,南投市,34035,103124,51798,51326
2013/7/1,南投縣,埔里鎮,28831,84095,42264,41831
2013/7/1,南投縣,草屯鎮,31995,99289,50191,49098
2013/7/1,南投縣,竹山鎮,19851,57250,29448,27802
2013/7/1,南投縣,集集鎮,4342,11462,5994,5468
2013/7/1,南投縣,名間鄉,12481,40532,21290,19242
2013/7/1,南投縣,鹿谷鄉,7256,18701,9927,8774
2013/7/1,南投縣,中寮鄉,5662,15817,8581,7236
2013/7/1,南投縣,魚池鄉,5794,16735,8778,7957
2013/7/1,南投縣,國姓鄉,7279,20014,10862,9152
2013/7/1,南投縣,水里鄉,7286,19196,10075,9121
2013/7/1,南投縣,信義鄉,5258,16695,8994,7701
2013/7/1,南投縣,仁愛鄉,4950,15621,8089,7532
2013/7/1,雲林縣,斗六市,36443,107994,54027,53967
2013/7/1,雲林縣,斗南鎮,15559,46424,23607,22817
2013/7/1,雲林縣,虎尾鎮,23611,70529,35827,34702
2013/7/1,雲林縣,西螺鎮,14289,47579,24192,23387
2013/7/1,雲林縣,土庫鎮,9031,29880,15634,14246
2013/7/1,雲林縣,北港鎮,15804,42225,21982,20243
2013/7/1,雲林縣,古坑鄉,10845,33000,17432,15568
2013/7/1,雲林縣,大埤鄉,6758,20356,10945,9411
2013/7/1,雲林縣,莿桐鄉,9210,29845,15663,14182
2013/7/1,雲林縣,林內鄉,5872,19340,10114,9226
2013/7/1,雲林縣,二崙鄉,8908,28843,15389,13454
2013/7/1,雲林縣,崙背鄉,8486,26326,13913,12413
2013/7/1,雲林縣,麥寮鄉,13497,41817,21313,20504
2013/7/1,雲林縣,東勢鄉,5810,15940,8732,7208
2013/7/1,雲林縣,褒忠鄉,4418,13773,7372,6401
2013/7/1,雲林縣,臺西鄉,8823,24912,13407,11505
2013/7/1,雲林縣,元長鄉,9455,27735,15133,12602
2013/7/1,雲林縣,四湖鄉,9064,25728,13955,11773
2013/7/1,雲林縣,口湖鄉,9681,29487,15688,13799
2013/7/1,雲林縣,水林鄉,10359,27469,15040,12429
2013/7/1,嘉義縣,太保市,11882,36957,19083,17874
2013/7/1,嘉義縣,朴子市,15225,43736,22160,21576
2013/7/1,嘉義縣,布袋鎮,10171,28841,14801,14040
2013/7/1,嘉義縣,大林鎮,11394,32735,16796,15939
2013/7/1,嘉義縣,民雄鄉,23643,72142,36989,35153
2013/7/1,嘉義縣,溪口鄉,5438,15623,8329,7294
2013/7/1,嘉義縣,新港鄉,10542,33660,17784,15876
2013/7/1,嘉義縣,六腳鄉,9098,25096,13301,11795
2013/7/1,嘉義縣,東石鄉,9476,26428,14048,12380
2013/7/1,嘉義縣,義竹鄉,7564,19937,10367,9570
2013/7/1,嘉義縣,鹿草鄉,5855,16725,8977,7748
2013/7/1,嘉義縣,水上鄉,17683,51367,26532,24835
2013/7/1,嘉義縣,中埔鄉,15840,46748,24382,22366
2013/7/1,嘉義縣,竹崎鄉,11535,37608,20065,17543
2013/7/1,嘉義縣,梅山鄉,6791,20670,10960,9710
2013/7/1,嘉義縣,番路鄉,4300,12211,6640,5571
2013/7/1,嘉義縣,大埔鄉,1931,4535,2361,2174
2013/7/1,嘉義縣,阿里山鄉,1935,5699,3040,2659
2013/7/1,屏東縣,屏東市,73110,206910,102849,104061
2013/7/1,屏東縣,潮州鎮,18795,55361,27793,27568
2013/7/1,屏東縣,東港鎮,16121,48936,24690,24246
2013/7/1,屏東縣,恆春鎮,11122,30688,15722,14966
2013/7/1,屏東縣,萬丹鄉,14604,52826,27370,25456
2013/7/1,屏東縣,長治鄉,9917,30503,15936,14567
2013/7/1,屏東縣,麟洛鄉,3671,11304,5857,5447
2013/7/1,屏東縣,九如鄉,6724,22493,11655,10838
2013/7/1,屏東縣,里港鄉,8041,26426,13449,12977
2013/7/1,屏東縣,鹽埔鄉,7821,26676,13880,12796
2013/7/1,屏東縣,高樹鄉,9428,25815,13761,12054
2013/7/1,屏東縣,萬巒鄉,6456,21228,11174,10054
2013/7/1,屏東縣,內埔鄉,18272,56867,29479,27388
2013/7/1,屏東縣,竹田鄉,5626,17883,9514,8369
2013/7/1,屏東縣,新埤鄉,3397,10297,5472,4825
2013/7/1,屏東縣,枋寮鄉,8569,25780,13531,12249
2013/7/1,屏東縣,新園鄉,11676,37207,19275,17932
2013/7/1,屏東縣,崁頂鄉,4368,16455,8346,8109
2013/7/1,屏東縣,林邊鄉,7091,19702,10141,9561
2013/7/1,屏東縣,南州鄉,3661,11196,5731,5465
2013/7/1,屏東縣,佳冬鄉,7104,20675,10753,9922
2013/7/1,屏東縣,琉球鄉,4106,12149,6742,5407
2013/7/1,屏東縣,車城鄉,3478,9163,4929,4234
2013/7/1,屏東縣,滿州鄉,3044,8151,4496,3655
2013/7/1,屏東縣,枋山鄉,2116,5777,3092,2685
2013/7/1,屏東縣,三地門鄉,2242,7527,3830,3697
2013/7/1,屏東縣,霧臺鄉,1042,3142,1638,1504
2013/7/1,屏東縣,瑪家鄉,1952,6580,3406,3174
2013/7/1,屏東縣,泰武鄉,1254,5083,2678,2405
2013/7/1,屏東縣,來義鄉,2227,7604,3895,3709
2013/7/1,屏東縣,春日鄉,1326,4812,2482,2330
2013/7/1,屏東縣,獅子鄉,1503,4772,2485,2287
2013/7/1,屏東縣,牡丹鄉,1887,4801,2475,2326
2013/7/1,臺東縣,臺東市,38583,107541,54227,53314
2013/7/1,臺東縣,成功鎮,5431,15129,8003,7126
2013/7/1,臺東縣,關山鎮,3260,9336,4893,4443
2013/7/1,臺東縣,卑南鄉,6614,17711,9470,8241
2013/7/1,臺東縣,大武鄉,2514,6555,3418,3137
2013/7/1,臺東縣,太麻里鄉,4597,11663,6203,5460
2013/7/1,臺東縣,東河鄉,3734,9063,5026,4037
2013/7/1,臺東縣,長濱鄉,2922,7796,4448,3348
2013/7/1,臺東縣,鹿野鄉,3123,8239,4439,3800
2013/7/1,臺東縣,池上鄉,3281,8731,4599,4132
2013/7/1,臺東縣,綠島鄉,1074,3500,1854,1646
2013/7/1,臺東縣,延平鄉,1070,3543,1919,1624
2013/7/1,臺東縣,海端鄉,1090,4343,2366,1977
2013/7/1,臺東縣,達仁鄉,1484,3779,2060,1719
2013/7/1,臺東縣,金峰鄉,1087,3492,1818,1674
2013/7/1,臺東縣,蘭嶼鄉,1657,4849,2488,2361
2013/7/1,花蓮縣,花蓮市,41079,107636,52447,55189
2013/7/1,花蓮縣,鳳林鎮,4423,11461,6055,5406
2013/7/1,花蓮縣,玉里鎮,8932,25837,13903,11934
2013/7/1,花蓮縣,新城鄉,7411,20099,10398,9701
2013/7/1,花蓮縣,吉安鄉,30416,81899,41627,40272
2013/7/1,花蓮縣,壽豐鄉,6877,18143,9776,8367
2013/7/1,花蓮縣,光復鄉,5028,13520,7212,6308
2013/7/1,花蓮縣,豐濱鄉,1755,4637,2579,2058
2013/7/1,花蓮縣,瑞穗鄉,4665,12234,6595,5639
2013/7/1,花蓮縣,富里鄉,4019,11056,6034,5022
2013/7/1,花蓮縣,秀林鄉,4704,15142,7868,7274
2013/7/1,花蓮縣,萬榮鄉,2086,6515,3473,3042
2013/7/1,花蓮縣,卓溪鄉,1660,6123,3391,2732
2013/7/1,澎湖縣,馬公市,21855,58808,29855,28953
2013/7/1,澎湖縣,湖西鄉,5122,14055,7358,6697
2013/7/1,澎湖縣,白沙鄉,3246,9539,5008,4531
2013/7/1,澎湖縣,西嶼鄉,2906,8378,4311,4067
2013/7/1,澎湖縣,望安鄉,1988,4975,2676,2299
2013/7/1,澎湖縣,七美鄉,1297,3632,1896,1736
2013/7/1,基隆市,中正區,22322,53823,27537,26286
2013/7/1,基隆市,七堵區,20572,54098,27392,26706
2013/7/1,基隆市,暖暖區,14785,37816,19167,18649
2013/7/1,基隆市,仁愛區,19628,47368,23305,24063
2013/7/1,基隆市,中山區,19292,49455,25219,24236
2013/7/1,基隆市,安樂區,32064,82225,40990,41235
2013/7/1,基隆市,信義區,20549,51049,25521,25528
2013/7/1,新竹市,東區,72971,204114,100593,103521
2013/7/1,新竹市,北區,53061,147870,72727,75143
2013/7/1,新竹市,香山區,24578,75153,38280,36873
2013/7/1,嘉義市,東區,44944,124131,60416,63715
2013/7/1,嘉義市,西區,52485,147092,72501,74591
2013/7/1,金門縣,金城鎮,12165,38263,19253,19010
2013/7/1,金門縣,金湖鎮,8040,25508,12926,12582
2013/7/1,金門縣,金沙鎮,5859,18127,9031,9096
2013/7/1,金門縣,金寧鄉,7060,23778,12125,11653
2013/7/1,金門縣,烈嶼鄉,2904,10923,5393,5530
2013/7/1,金門縣,烏坵鄉,134,630,313,317
2013/7/1,連江縣,南竿鄉,1376,7132,4018,3114
2013/7/1,連江縣,北竿鄉,452,2200,1220,980
2013/7/1,連江縣,莒光鄉,270,1378,812,566
2013/7/1,連江縣,東引鄉,291,1159,682,477
2013/8/1,總計,新北市,1470704,3949765,1948850,2000915
2013/8/1,總計,臺北市,1023610,2682017,1288485,1393532
2013/8/1,總計,臺中市,892930,2696712,1337853,1358859
2013/8/1,總計,臺南市,661170,1882774,944839,937935
2013/8/1,總計,高雄市,1053515,2779448,1386529,1392919
2013/8/1,總計,臺灣省,3112930,9233545,4708017,4525528
2013/8/1,總計,宜蘭縣,160372,458648,233142,225506
2013/8/1,總計,桃園市,711438,2039557,1024797,1014760
2013/8/1,總計,新竹縣,173458,528376,270873,257503
2013/8/1,總計,苗栗縣,180048,565023,291852,273171
2013/8/1,總計,彰化縣,374747,1297167,664288,632879
2013/8/1,總計,南投縣,175171,518312,266083,252229
2013/8/1,總計,雲林縣,236175,708864,369148,339716
2013/8/1,總計,嘉義縣,180360,530365,276379,253986
2013/8/1,總計,屏東縣,281919,854226,438173,416053
2013/8/1,總計,臺東縣,81564,225137,117125,108012
2013/8/1,總計,花蓮縣,123253,334128,171255,162873
2013/8/1,總計,澎湖縣,36454,99462,51150,48312
2013/8/1,總計,基隆市,149386,375755,189094,186661
2013/8/1,總計,新竹市,151034,427265,211740,215525
2013/8/1,總計,嘉義市,97551,271260,132918,138342
2013/8/1,總計,福建省,38661,129800,66133,63667
2013/8/1,總計,金門縣,36271,117845,59351,58494
2013/8/1,總計,連江縣,2390,11955,6782,5173
2013/8/1,新北市,板橋區,203020,557062,273558,283504
2013/8/1,新北市,三重區,145218,389777,193173,196604
2013/8/1,新北市,中和區,160419,415819,203873,211946
2013/8/1,新北市,永和區,90684,230041,109841,120200
2013/8/1,新北市,新莊區,143667,409001,201164,207837
2013/8/1,新北市,新店區,120115,298081,144851,153230
2013/8/1,新北市,樹林區,64089,183141,91745,91396
2013/8/1,新北市,鶯歌區,28715,88479,44447,44032
2013/8/1,新北市,三峽區,39163,109393,55350,54043
2013/8/1,新北市,淡水區,64536,153832,74327,79505
2013/8/1,新北市,汐止區,82853,193872,95441,98431
2013/8/1,新北市,瑞芳區,15997,41564,21054,20510
2013/8/1,新北市,土城區,84883,239504,118979,120525
2013/8/1,新北市,蘆洲區,67916,199425,98406,101019
2013/8/1,新北市,五股區,28516,81555,41242,40313
2013/8/1,新北市,泰山區,27157,77834,38889,38945
2013/8/1,新北市,林口區,35456,92749,45666,47083
2013/8/1,新北市,深坑區,9231,23587,11844,11743
2013/8/1,新北市,石碇區,3354,7845,4320,3525
2013/8/1,新北市,坪林區,2482,6464,3619,2845
2013/8/1,新北市,三芝區,9153,23450,12085,11365
2013/8/1,新北市,石門區,4243,12748,6657,6091
2013/8/1,新北市,八里區,13169,35974,18126,17848
2013/8/1,新北市,平溪區,2382,5028,2802,2226
2013/8/1,新北市,雙溪區,3864,9405,5070,4335
2013/8/1,新北市,貢寮區,4449,13316,6835,6481
2013/8/1,新北市,金山區,6921,22358,11143,11215
2013/8/1,新北市,萬里區,7294,22505,11389,11116
2013/8/1,新北市,烏來區,1758,5956,2954,3002
2013/8/1,臺北市,松山區,79658,210335,99519,110816
2013/8/1,臺北市,信義區,88271,228125,109507,118618
2013/8/1,臺北市,大安區,119312,313490,147082,166408
2013/8/1,臺北市,中山區,96923,228208,106855,121353
2013/8/1,臺北市,中正區,64451,163076,78284,84792
2013/8/1,臺北市,大同區,50339,129508,63481,66027
2013/8/1,臺北市,萬華區,76924,192882,95648,97234
2013/8/1,臺北市,文山區,101645,270789,130693,140096
2013/8/1,臺北市,南港區,44831,119398,58390,61008
2013/8/1,臺北市,內湖區,103258,281855,135299,146556
2013/8/1,臺北市,士林區,104474,289285,140126,149159
2013/8/1,臺北市,北投區,93524,255066,123601,131465
2013/8/1,臺中市,中區,8001,20161,10016,10145
2013/8/1,臺中市,東區,26669,74347,37268,37079
2013/8/1,臺中市,南區,44696,117715,56933,60782
2013/8/1,臺中市,西區,44448,116482,55580,60902
2013/8/1,臺中市,北區,57617,147953,71412,76541
2013/8/1,臺中市,西屯區,78110,214693,103529,111164
2013/8/1,臺中市,南屯區,56721,159512,76842,82670
2013/8/1,臺中市,北屯區,89045,255005,123175,131830
2013/8/1,臺中市,豐原區,51318,165973,82260,83713
2013/8/1,臺中市,東勢區,17188,52116,26981,25135
2013/8/1,臺中市,大甲區,22275,77964,39482,38482
2013/8/1,臺中市,清水區,25776,85917,44253,41664
2013/8/1,臺中市,沙鹿區,26136,85982,43666,42316
2013/8/1,臺中市,梧棲區,16477,55930,28269,27661
2013/8/1,臺中市,后里區,15207,54083,27622,26461
2013/8/1,臺中市,神岡區,18373,64837,33261,31576
2013/8/1,臺中市,潭子區,34085,104211,51723,52488
2013/8/1,臺中市,大雅區,27371,91946,46132,45814
2013/8/1,臺中市,新社區,7441,25341,13204,12137
2013/8/1,臺中市,石岡區,4887,15648,8142,7506
2013/8/1,臺中市,外埔區,9136,31763,16328,15435
2013/8/1,臺中市,大安區,5331,19798,10412,9386
2013/8/1,臺中市,烏日區,21816,70505,35685,34820
2013/8/1,臺中市,大肚區,16448,55982,28678,27304
2013/8/1,臺中市,龍井區,21603,75318,38277,37041
2013/8/1,臺中市,霧峰區,19257,64201,32864,31337
2013/8/1,臺中市,太平區,57767,178259,89091,89168
2013/8/1,臺中市,大里區,65335,204496,101074,103422
2013/8/1,臺中市,和平區,4396,10574,5694,4880
2013/8/1,臺南市,新營區,28124,78548,39031,39517
2013/8/1,臺南市,鹽水區,10031,26503,13819,12684
2013/8/1,臺南市,白河區,11013,30331,15903,14428
2013/8/1,臺南市,柳營區,7804,21999,11463,10536
2013/8/1,臺南市,後壁區,8952,25024,13051,11973
2013/8/1,臺南市,東山區,8286,22296,11812,10484
2013/8/1,臺南市,麻豆區,15387,45299,23048,22251
2013/8/1,臺南市,下營區,9125,25416,13097,12319
2013/8/1,臺南市,六甲區,7747,23274,12082,11192
2013/8/1,臺南市,官田區,7739,21797,11167,10630
2013/8/1,臺南市,大內區,4028,10447,5574,4873
2013/8/1,臺南市,佳里區,19925,59337,29475,29862
2013/8/1,臺南市,學甲區,9682,27305,13979,13326
2013/8/1,臺南市,西港區,7951,24967,12674,12293
2013/8/1,臺南市,七股區,8115,23918,12475,11443
2013/8/1,臺南市,將軍區,7396,20849,10622,10227
2013/8/1,臺南市,北門區,4392,11916,6013,5903
2013/8/1,臺南市,新化區,14057,43895,22480,21415
2013/8/1,臺南市,善化區,15542,44839,22608,22231
2013/8/1,臺南市,新市區,11340,35297,17768,17529
2013/8/1,臺南市,安定區,9651,30312,15646,14666
2013/8/1,臺南市,山上區,2720,7607,3980,3627
2013/8/1,臺南市,玉井區,5134,14889,7769,7120
2013/8/1,臺南市,楠西區,3548,10190,5416,4774
2013/8/1,臺南市,南化區,2843,8839,4826,4013
2013/8/1,臺南市,左鎮區,1991,5228,2929,2299
2013/8/1,臺南市,仁德區,26119,72071,36753,35318
2013/8/1,臺南市,歸仁區,21614,67103,34135,32968
2013/8/1,臺南市,關廟區,10837,35138,18185,16953
2013/8/1,臺南市,龍崎區,1587,4337,2349,1988
2013/8/1,臺南市,永康區,79791,226197,111966,114231
2013/8/1,臺南市,東區,71897,192015,92530,99485
2013/8/1,臺南市,南區,44243,125611,62694,62917
2013/8/1,臺南市,北區,49274,132272,64863,67409
2013/8/1,臺南市,安南區,58346,184462,93438,91024
2013/8/1,臺南市,安平區,24203,64556,30842,33714
2013/8/1,臺南市,中西區,30736,78690,38377,40313
2013/8/1,高雄市,鹽埕區,10999,26015,12977,13038
2013/8/1,高雄市,鼓山區,54559,134559,65373,69186
2013/8/1,高雄市,左營區,76198,195471,95387,100084
2013/8/1,高雄市,楠梓區,64676,176911,87547,89364
2013/8/1,高雄市,三民區,133772,348835,169834,179001
2013/8/1,高雄市,新興區,22782,53319,25752,27567
2013/8/1,高雄市,前金區,12589,28157,13647,14510
2013/8/1,高雄市,苓雅區,72247,178254,86376,91878
2013/8/1,高雄市,前鎮區,77404,195202,96502,98700
2013/8/1,高雄市,旗津區,10944,29054,15049,14005
2013/8/1,高雄市,小港區,65423,156071,78002,78069
2013/8/1,高雄市,鳳山區,133620,352068,173967,178101
2013/8/1,高雄市,林園區,25141,70378,35908,34470
2013/8/1,高雄市,大寮區,40125,110176,56926,53250
2013/8/1,高雄市,大樹區,13209,43341,22371,20970
2013/8/1,高雄市,大社區,12247,33908,17375,16533
2013/8/1,高雄市,仁武區,29035,78672,40308,38364
2013/8/1,高雄市,鳥松區,17313,43767,22247,21520
2013/8/1,高雄市,岡山區,34227,97895,48839,49056
2013/8/1,高雄市,橋頭區,13084,36994,18876,18118
2013/8/1,高雄市,燕巢區,10246,30642,16308,14334
2013/8/1,高雄市,田寮區,3452,7772,4328,3444
2013/8/1,高雄市,阿蓮區,9358,29859,15062,14797
2013/8/1,高雄市,路竹區,16424,53076,27108,25968
2013/8/1,高雄市,湖內區,10117,29198,15012,14186
2013/8/1,高雄市,茄萣區,10348,30866,16026,14840
2013/8/1,高雄市,永安區,5829,14156,7143,7013
2013/8/1,高雄市,彌陀區,6688,19964,10354,9610
2013/8/1,高雄市,梓官區,12363,36406,18840,17566
2013/8/1,高雄市,旗山區,13900,38733,20090,18643
2013/8/1,高雄市,美濃區,14429,41861,21853,20008
2013/8/1,高雄市,六龜區,5693,13990,7559,6431
2013/8/1,高雄市,甲仙區,2383,6487,3453,3034
2013/8/1,高雄市,杉林區,4833,12602,6862,5740
2013/8/1,高雄市,內門區,5069,15396,8379,7017
2013/8/1,高雄市,茂林區,581,1817,919,898
2013/8/1,高雄市,桃源區,1338,4427,2336,2091
2013/8/1,高雄市,那瑪夏區,870,3149,1634,1515
2013/8/1,宜蘭縣,宜蘭市,34817,96268,47177,49091
2013/8/1,宜蘭縣,羅東鎮,25552,72402,34580,37822
2013/8/1,宜蘭縣,蘇澳鎮,13858,41537,21203,20334
2013/8/1,宜蘭縣,頭城鎮,9986,30103,15558,14545
2013/8/1,宜蘭縣,礁溪鄉,13027,35982,18828,17154
2013/8/1,宜蘭縣,壯圍鄉,8362,24464,12972,11492
2013/8/1,宜蘭縣,員山鄉,11150,32181,17193,14988
2013/8/1,宜蘭縣,冬山鄉,18329,53646,27555,26091
2013/8/1,宜蘭縣,五結鄉,13680,39085,20236,18849
2013/8/1,宜蘭縣,三星鄉,7883,21138,11471,9667
2013/8/1,宜蘭縣,大同鄉,1860,5951,3244,2707
2013/8/1,宜蘭縣,南澳鄉,1868,5891,3125,2766
2013/8/1,桃園市,桃園區,152333,415367,203087,212280
2013/8/1,桃園市,中壢區,134853,377855,188016,189839
2013/8/1,桃園市,平鎮區,70447,210932,105803,105129
2013/8/1,桃園市,八德區,61446,179218,90711,88507
2013/8/1,桃園市,楊梅區,52119,155219,78810,76409
2013/8/1,桃園市,大溪區,30250,91973,47339,44634
2013/8/1,桃園市,蘆竹區,52072,148381,74198,74183
2013/8/1,桃園市,大園區,27765,83353,43008,40345
2013/8/1,桃園市,龜山區,52790,140288,70726,69562
2013/8/1,桃園市,龍潭區,38232,115455,58504,56951
2013/8/1,桃園市,新屋區,15229,48050,25741,22309
2013/8/1,桃園市,觀音區,20197,62895,32994,29901
2013/8/1,桃園市,復興區,3705,10571,5860,4711
2013/8/1,新竹縣,竹北市,54274,156774,78313,78461
2013/8/1,新竹縣,關西鎮,9498,31053,16549,14504
2013/8/1,新竹縣,新埔鎮,10582,34791,18477,16314
2013/8/1,新竹縣,竹東鎮,31868,96575,48585,47990
2013/8/1,新竹縣,湖口鄉,24611,76609,38955,37654
2013/8/1,新竹縣,橫山鄉,4511,13949,7553,6396
2013/8/1,新竹縣,新豐鄉,16964,55168,28316,26852
2013/8/1,新竹縣,芎林鄉,6397,20269,10687,9582
2013/8/1,新竹縣,寶山鄉,5014,14070,7602,6468
2013/8/1,新竹縣,北埔鄉,3150,9870,5332,4538
2013/8/1,新竹縣,峨眉鄉,2066,5765,3212,2553
2013/8/1,新竹縣,尖石鄉,2795,8983,4813,4170
2013/8/1,新竹縣,五峰鄉,1728,4500,2479,2021
2013/8/1,苗栗縣,苗栗市,30170,91032,45614,45418
2013/8/1,苗栗縣,苑裡鎮,14206,48474,25160,23314
2013/8/1,苗栗縣,通霄鎮,11518,37207,19662,17545
2013/8/1,苗栗縣,竹南鎮,26094,81919,41524,40395
2013/8/1,苗栗縣,頭份市,32000,101113,51160,49953
2013/8/1,苗栗縣,後龍鎮,11866,38528,20256,18272
2013/8/1,苗栗縣,卓蘭鎮,6131,18411,9663,8748
2013/8/1,苗栗縣,大湖鄉,5432,15762,8365,7397
2013/8/1,苗栗縣,公館鄉,10547,34844,18152,16692
2013/8/1,苗栗縣,銅鑼鄉,6112,19096,10128,8968
2013/8/1,苗栗縣,南庄鄉,3981,10775,5918,4857
2013/8/1,苗栗縣,頭屋鄉,3618,11423,6011,5412
2013/8/1,苗栗縣,三義鄉,5413,17409,9118,8291
2013/8/1,苗栗縣,西湖鄉,2715,7664,4258,3406
2013/8/1,苗栗縣,造橋鄉,4121,13565,7127,6438
2013/8/1,苗栗縣,三灣鄉,2431,7128,3900,3228
2013/8/1,苗栗縣,獅潭鄉,1725,4743,2653,2090
2013/8/1,苗栗縣,泰安鄉,1968,5930,3183,2747
2013/8/1,彰化縣,彰化市,74276,236416,117393,119023
2013/8/1,彰化縣,鹿港鎮,23292,86113,43976,42137
2013/8/1,彰化縣,和美鎮,25342,90420,46313,44107
2013/8/1,彰化縣,北斗鎮,10266,33239,16799,16440
2013/8/1,彰化縣,員林市,37867,124918,62628,62290
2013/8/1,彰化縣,溪湖鎮,15728,55844,28473,27371
2013/8/1,彰化縣,田中鎮,12811,43209,22394,20815
2013/8/1,彰化縣,二林鎮,14679,52920,27299,25621
2013/8/1,彰化縣,線西鄉,4236,17090,8825,8265
2013/8/1,彰化縣,伸港鄉,9355,36052,18475,17577
2013/8/1,彰化縣,福興鄉,12360,47959,25039,22920
2013/8/1,彰化縣,秀水鄉,10173,39321,20307,19014
2013/8/1,彰化縣,花壇鄉,13444,46015,23681,22334
2013/8/1,彰化縣,芬園鄉,6872,24309,12826,11483
2013/8/1,彰化縣,大村鄉,10591,36417,18920,17497
2013/8/1,彰化縣,埔鹽鄉,8988,33550,17610,15940
2013/8/1,彰化縣,埔心鄉,10231,35079,18102,16977
2013/8/1,彰化縣,永靖鄉,10719,38653,20116,18537
2013/8/1,彰化縣,社頭鄉,12590,43952,22567,21385
2013/8/1,彰化縣,二水鄉,5368,16031,8430,7601
2013/8/1,彰化縣,田尾鄉,7799,28011,14575,13436
2013/8/1,彰化縣,埤頭鄉,8839,31320,16319,15001
2013/8/1,彰化縣,芳苑鄉,10087,35192,18647,16545
2013/8/1,彰化縣,大城鄉,5373,18118,9823,8295
2013/8/1,彰化縣,竹塘鄉,4627,16063,8472,7591
2013/8/1,彰化縣,溪州鄉,8834,30956,16279,14677
2013/8/1,南投縣,南投市,34081,103106,51765,51341
2013/8/1,南投縣,埔里鎮,28833,84051,42226,41825
2013/8/1,南投縣,草屯鎮,32056,99268,50156,49112
2013/8/1,南投縣,竹山鎮,19866,57238,29434,27804
2013/8/1,南投縣,集集鎮,4355,11478,5991,5487
2013/8/1,南投縣,名間鄉,12486,40510,21269,19241
2013/8/1,南投縣,鹿谷鄉,7267,18682,9913,8769
2013/8/1,南投縣,中寮鄉,5665,15784,8564,7220
2013/8/1,南投縣,魚池鄉,5792,16715,8767,7948
2013/8/1,南投縣,國姓鄉,7277,19998,10851,9147
2013/8/1,南投縣,水里鄉,7282,19162,10058,9104
2013/8/1,南投縣,信義鄉,5256,16702,9001,7701
2013/8/1,南投縣,仁愛鄉,4955,15618,8088,7530
2013/8/1,雲林縣,斗六市,36501,108008,54032,53976
2013/8/1,雲林縣,斗南鎮,15589,46392,23578,22814
2013/8/1,雲林縣,虎尾鎮,23659,70555,35845,34710
2013/8/1,雲林縣,西螺鎮,14319,47549,24188,23361
2013/8/1,雲林縣,土庫鎮,9045,29858,15625,14233
2013/8/1,雲林縣,北港鎮,15825,42199,21961,20238
2013/8/1,雲林縣,古坑鄉,10854,32947,17398,15549
2013/8/1,雲林縣,大埤鄉,6763,20347,10937,9410
2013/8/1,雲林縣,莿桐鄉,9224,29844,15667,14177
2013/8/1,雲林縣,林內鄉,5872,19303,10088,9215
2013/8/1,雲林縣,二崙鄉,8912,28801,15374,13427
2013/8/1,雲林縣,崙背鄉,8499,26336,13901,12435
2013/8/1,雲林縣,麥寮鄉,13510,41938,21367,20571
2013/8/1,雲林縣,東勢鄉,5804,15924,8728,7196
2013/8/1,雲林縣,褒忠鄉,4418,13739,7360,6379
2013/8/1,雲林縣,臺西鄉,8827,24870,13380,11490
2013/8/1,雲林縣,元長鄉,9457,27703,15112,12591
2013/8/1,雲林縣,四湖鄉,9071,25696,13937,11759
2013/8/1,雲林縣,口湖鄉,9678,29448,15664,13784
2013/8/1,雲林縣,水林鄉,10348,27407,15006,12401
2013/8/1,嘉義縣,太保市,11917,37016,19098,17918
2013/8/1,嘉義縣,朴子市,15228,43707,22149,21558
2013/8/1,嘉義縣,布袋鎮,10176,28783,14774,14009
2013/8/1,嘉義縣,大林鎮,11400,32708,16776,15932
2013/8/1,嘉義縣,民雄鄉,23639,72143,36967,35176
2013/8/1,嘉義縣,溪口鄉,5432,15608,8311,7297
2013/8/1,嘉義縣,新港鄉,10549,33605,17758,15847
2013/8/1,嘉義縣,六腳鄉,9087,25062,13291,11771
2013/8/1,嘉義縣,東石鄉,9465,26403,14029,12374
2013/8/1,嘉義縣,義竹鄉,7559,19910,10356,9554
2013/8/1,嘉義縣,鹿草鄉,5848,16697,8963,7734
2013/8/1,嘉義縣,水上鄉,17709,51369,26536,24833
2013/8/1,嘉義縣,中埔鄉,15862,46744,24376,22368
2013/8/1,嘉義縣,竹崎鄉,11536,37532,20024,17508
2013/8/1,嘉義縣,梅山鄉,6789,20658,10952,9706
2013/8/1,嘉義縣,番路鄉,4298,12194,6628,5566
2013/8/1,嘉義縣,大埔鄉,1933,4530,2355,2175
2013/8/1,嘉義縣,阿里山鄉,1933,5696,3036,2660
2013/8/1,屏東縣,屏東市,73172,206741,102734,104007
2013/8/1,屏東縣,潮州鎮,18823,55395,27788,27607
2013/8/1,屏東縣,東港鎮,16154,48913,24697,24216
2013/8/1,屏東縣,恆春鎮,11120,30701,15722,14979
2013/8/1,屏東縣,萬丹鄉,14614,52775,27344,25431
2013/8/1,屏東縣,長治鄉,9923,30469,15926,14543
2013/8/1,屏東縣,麟洛鄉,3675,11292,5847,5445
2013/8/1,屏東縣,九如鄉,6726,22471,11644,10827
2013/8/1,屏東縣,里港鄉,8038,26428,13444,12984
2013/8/1,屏東縣,鹽埔鄉,7820,26694,13884,12810
2013/8/1,屏東縣,高樹鄉,9428,25806,13767,12039
2013/8/1,屏東縣,萬巒鄉,6457,21224,11176,10048
2013/8/1,屏東縣,內埔鄉,18282,56850,29471,27379
2013/8/1,屏東縣,竹田鄉,5627,17857,9498,8359
2013/8/1,屏東縣,新埤鄉,3404,10267,5459,4808
2013/8/1,屏東縣,枋寮鄉,8570,25753,13504,12249
2013/8/1,屏東縣,新園鄉,11685,37170,19250,17920
2013/8/1,屏東縣,崁頂鄉,4376,16422,8333,8089
2013/8/1,屏東縣,林邊鄉,7087,19669,10127,9542
2013/8/1,屏東縣,南州鄉,3664,11174,5718,5456
2013/8/1,屏東縣,佳冬鄉,7098,20653,10736,9917
2013/8/1,屏東縣,琉球鄉,4107,12133,6728,5405
2013/8/1,屏東縣,車城鄉,3479,9151,4922,4229
2013/8/1,屏東縣,滿州鄉,3041,8147,4494,3653
2013/8/1,屏東縣,枋山鄉,2119,5785,3095,2690
2013/8/1,屏東縣,三地門鄉,2243,7528,3832,3696
2013/8/1,屏東縣,霧臺鄉,1043,3130,1631,1499
2013/8/1,屏東縣,瑪家鄉,1949,6577,3403,3174
2013/8/1,屏東縣,泰武鄉,1255,5091,2678,2413
2013/8/1,屏東縣,來義鄉,2223,7596,3887,3709
2013/8/1,屏東縣,春日鄉,1329,4817,2481,2336
2013/8/1,屏東縣,獅子鄉,1503,4747,2475,2272
2013/8/1,屏東縣,牡丹鄉,1885,4800,2478,2322
2013/8/1,臺東縣,臺東市,38620,107508,54206,53302
2013/8/1,臺東縣,成功鎮,5440,15103,7976,7127
2013/8/1,臺東縣,關山鎮,3257,9311,4877,4434
2013/8/1,臺東縣,卑南鄉,6617,17729,9465,8264
2013/8/1,臺東縣,大武鄉,2516,6539,3414,3125
2013/8/1,臺東縣,太麻里鄉,4589,11639,6191,5448
2013/8/1,臺東縣,東河鄉,3732,9047,5022,4025
2013/8/1,臺東縣,長濱鄉,2924,7780,4438,3342
2013/8/1,臺東縣,鹿野鄉,3122,8254,4444,3810
2013/8/1,臺東縣,池上鄉,3275,8703,4585,4118
2013/8/1,臺東縣,綠島鄉,1081,3504,1857,1647
2013/8/1,臺東縣,延平鄉,1070,3543,1918,1625
2013/8/1,臺東縣,海端鄉,1089,4344,2366,1978
2013/8/1,臺東縣,達仁鄉,1486,3781,2062,1719
2013/8/1,臺東縣,金峰鄉,1086,3505,1826,1679
2013/8/1,臺東縣,蘭嶼鄉,1660,4847,2478,2369
2013/8/1,花蓮縣,花蓮市,41156,107424,52308,55116
2013/8/1,花蓮縣,鳳林鎮,4423,11448,6054,5394
2013/8/1,花蓮縣,玉里鎮,8945,25812,13887,11925
2013/8/1,花蓮縣,新城鄉,7433,20101,10394,9707
2013/8/1,花蓮縣,吉安鄉,30502,82004,41710,40294
2013/8/1,花蓮縣,壽豐鄉,6887,18131,9777,8354
2013/8/1,花蓮縣,光復鄉,5023,13524,7213,6311
2013/8/1,花蓮縣,豐濱鄉,1754,4630,2574,2056
2013/8/1,花蓮縣,瑞穗鄉,4662,12233,6587,5646
2013/8/1,花蓮縣,富里鄉,4015,11028,6013,5015
2013/8/1,花蓮縣,秀林鄉,4710,15160,7870,7290
2013/8/1,花蓮縣,萬榮鄉,2084,6520,3480,3040
2013/8/1,花蓮縣,卓溪鄉,1659,6113,3388,2725
2013/8/1,澎湖縣,馬公市,21864,58820,29858,28962
2013/8/1,澎湖縣,湖西鄉,5138,14082,7379,6703
2013/8/1,澎湖縣,白沙鄉,3252,9552,5015,4537
2013/8/1,澎湖縣,西嶼鄉,2911,8376,4306,4070
2013/8/1,澎湖縣,望安鄉,1994,5002,2697,2305
2013/8/1,澎湖縣,七美鄉,1295,3630,1895,1735
2013/8/1,基隆市,中正區,22350,53753,27512,26241
2013/8/1,基隆市,七堵區,20611,54114,27395,26719
2013/8/1,基隆市,暖暖區,14856,37855,19175,18680
2013/8/1,基隆市,仁愛區,19605,47288,23284,24004
2013/8/1,基隆市,中山區,19306,49436,25210,24226
2013/8/1,基隆市,安樂區,32076,82180,40969,41211
2013/8/1,基隆市,信義區,20582,51129,25549,25580
2013/8/1,新竹市,東區,73125,204077,100613,103464
2013/8/1,新竹市,北區,53192,147850,72752,75098
2013/8/1,新竹市,香山區,24717,75338,38375,36963
2013/8/1,嘉義市,東區,45007,124157,60430,63727
2013/8/1,嘉義市,西區,52544,147103,72488,74615
2013/8/1,金門縣,金城鎮,12187,38453,19343,19110
2013/8/1,金門縣,金湖鎮,8065,25652,13000,12652
2013/8/1,金門縣,金沙鎮,5876,18185,9057,9128
2013/8/1,金門縣,金寧鄉,7102,23961,12232,11729
2013/8/1,金門縣,烈嶼鄉,2907,10962,5404,5558
2013/8/1,金門縣,烏坵鄉,134,632,315,317
2013/8/1,連江縣,南竿鄉,1378,7171,4040,3131
2013/8/1,連江縣,北竿鄉,452,2219,1231,988
2013/8/1,連江縣,莒光鄉,268,1404,829,575
2013/8/1,連江縣,東引鄉,292,1161,682,479
2013/9/1,總計,新北市,1474545,3951381,1949191,2002190
2013/9/1,總計,臺北市,1025984,2681584,1288195,1393389
2013/9/1,總計,臺中市,894779,2697665,1338235,1359430
2013/9/1,總計,臺南市,662444,1882803,944760,938043
2013/9/1,總計,高雄市,1055340,2779246,1386293,1392953
2013/9/1,總計,臺灣省,3118828,9232944,4707389,4525555
2013/9/1,總計,宜蘭縣,160647,458580,233097,225483
2013/9/1,總計,桃園市,713505,2040629,1025241,1015388
2013/9/1,總計,新竹縣,174144,529175,271310,257865
2013/9/1,總計,苗栗縣,180534,565107,291915,273192
2013/9/1,總計,彰化縣,375282,1296660,663990,632670
2013/9/1,總計,南投縣,175299,517984,265873,252111
2013/9/1,總計,雲林縣,236470,708574,368958,339616
2013/9/1,總計,嘉義縣,180452,530004,276127,253877
2013/9/1,總計,屏東縣,282111,853607,437844,415763
2013/9/1,總計,臺東縣,81634,224989,117029,107960
2013/9/1,總計,花蓮縣,123301,334039,171196,162843
2013/9/1,總計,澎湖縣,36524,99516,51182,48334
2013/9/1,總計,基隆市,149609,375413,188911,186502
2013/9/1,總計,新竹市,151681,427561,211875,215686
2013/9/1,總計,嘉義市,97635,271106,132841,138265
2013/9/1,總計,福建省,38769,130965,66666,64299
2013/9/1,總計,金門縣,36371,118924,59844,59080
2013/9/1,總計,連江縣,2398,12041,6822,5219
2013/9/1,新北市,板橋區,203327,556843,273444,283399
2013/9/1,新北市,三重區,145415,389705,193098,196607
2013/9/1,新北市,中和區,160770,416048,203928,212120
2013/9/1,新北市,永和區,90743,229609,109602,120007
2013/9/1,新北市,新莊區,144132,409240,201281,207959
2013/9/1,新北市,新店區,120713,298390,144896,153494
2013/9/1,新北市,樹林區,64201,183152,91741,91411
2013/9/1,新北市,鶯歌區,28792,88542,44485,44057
2013/9/1,新北市,三峽區,39282,109549,55403,54146
2013/9/1,新北市,淡水區,64915,154239,74505,79734
2013/9/1,新北市,汐止區,83137,194020,95447,98573
2013/9/1,新北市,瑞芳區,16025,41566,21049,20517
2013/9/1,新北市,土城區,85013,239452,118986,120466
2013/9/1,新北市,蘆洲區,68052,199460,98397,101063
2013/9/1,新北市,五股區,28591,81608,41248,40360
2013/9/1,新北市,泰山區,27232,77837,38869,38968
2013/9/1,新北市,林口區,35773,93276,45872,47404
2013/9/1,新北市,深坑區,9255,23614,11850,11764
2013/9/1,新北市,石碇區,3362,7852,4324,3528
2013/9/1,新北市,坪林區,2483,6472,3627,2845
2013/9/1,新北市,三芝區,9165,23441,12079,11362
2013/9/1,新北市,石門區,4249,12763,6660,6103
2013/9/1,新北市,八里區,13232,36079,18179,17900
2013/9/1,新北市,平溪區,2379,5021,2796,2225
2013/9/1,新北市,雙溪區,3865,9398,5066,4332
2013/9/1,新北市,貢寮區,4453,13320,6834,6486
2013/9/1,新北市,金山區,6930,22346,11129,11217
2013/9/1,新北市,萬里區,7301,22547,11419,11128
2013/9/1,新北市,烏來區,1758,5992,2977,3015
2013/9/1,臺北市,松山區,79801,210003,99347,110656
2013/9/1,臺北市,信義區,88405,228067,109503,118564
2013/9/1,臺北市,大安區,119481,313168,146916,166252
2013/9/1,臺北市,中山區,97272,228392,106900,121492
2013/9/1,臺北市,中正區,64576,162904,78191,84713
2013/9/1,臺北市,大同區,50460,129498,63494,66004
2013/9/1,臺北市,萬華區,77093,192987,95690,97297
2013/9/1,臺北市,文山區,101867,270750,130663,140087
2013/9/1,臺北市,南港區,45014,119527,58463,61064
2013/9/1,臺北市,內湖區,103603,282107,135391,146716
2013/9/1,臺北市,士林區,104693,289222,140099,149123
2013/9/1,臺北市,北投區,93719,254959,123538,131421
2013/9/1,臺中市,中區,7987,20120,9989,10131
2013/9/1,臺中市,東區,26768,74383,37265,37118
2013/9/1,臺中市,南區,44851,117933,57041,60892
2013/9/1,臺中市,西區,44512,116412,55544,60868
2013/9/1,臺中市,北區,57712,147914,71360,76554
2013/9/1,臺中市,西屯區,78314,214855,103643,111212
2013/9/1,臺中市,南屯區,56823,159578,76884,82694
2013/9/1,臺中市,北屯區,89373,255303,123299,132004
2013/9/1,臺中市,豐原區,51377,165981,82251,83730
2013/9/1,臺中市,東勢區,17205,52039,26940,25099
2013/9/1,臺中市,大甲區,22297,77888,39453,38435
2013/9/1,臺中市,清水區,25824,85953,44276,41677
2013/9/1,臺中市,沙鹿區,26259,86134,43751,42383
2013/9/1,臺中市,梧棲區,16507,55949,28266,27683
2013/9/1,臺中市,后里區,15222,54020,27586,26434
2013/9/1,臺中市,神岡區,18405,64877,33272,31605
2013/9/1,臺中市,潭子區,34136,104291,51775,52516
2013/9/1,臺中市,大雅區,27386,91868,46100,45768
2013/9/1,臺中市,新社區,7446,25309,13185,12124
2013/9/1,臺中市,石岡區,4896,15650,8141,7509
2013/9/1,臺中市,外埔區,9159,31764,16330,15434
2013/9/1,臺中市,大安區,5323,19776,10395,9381
2013/9/1,臺中市,烏日區,21871,70556,35721,34835
2013/9/1,臺中市,大肚區,16471,55961,28665,27296
2013/9/1,臺中市,龍井區,21649,75412,38296,37116
2013/9/1,臺中市,霧峰區,19276,64162,32826,31336
2013/9/1,臺中市,太平區,57901,178414,89158,89256
2013/9/1,臺中市,大里區,65439,204594,101131,103463
2013/9/1,臺中市,和平區,4390,10569,5692,4877
2013/9/1,臺南市,新營區,28175,78479,38975,39504
2013/9/1,臺南市,鹽水區,10032,26488,13814,12674
2013/9/1,臺南市,白河區,11005,30291,15874,14417
2013/9/1,臺南市,柳營區,7802,22013,11477,10536
2013/9/1,臺南市,後壁區,8951,25002,13024,11978
2013/9/1,臺南市,東山區,8290,22270,11801,10469
2013/9/1,臺南市,麻豆區,15404,45264,23036,22228
2013/9/1,臺南市,下營區,9119,25374,13084,12290
2013/9/1,臺南市,六甲區,7759,23249,12071,11178
2013/9/1,臺南市,官田區,7744,21808,11169,10639
2013/9/1,臺南市,大內區,4028,10451,5571,4880
2013/9/1,臺南市,佳里區,19985,59334,29474,29860
2013/9/1,臺南市,學甲區,9683,27274,13959,13315
2013/9/1,臺南市,西港區,7957,24927,12653,12274
2013/9/1,臺南市,七股區,8126,23889,12458,11431
2013/9/1,臺南市,將軍區,7389,20852,10629,10223
2013/9/1,臺南市,北門區,4397,11915,6008,5907
2013/9/1,臺南市,新化區,14065,43858,22463,21395
2013/9/1,臺南市,善化區,15607,44916,22646,22270
2013/9/1,臺南市,新市區,11353,35314,17773,17541
2013/9/1,臺南市,安定區,9655,30278,15619,14659
2013/9/1,臺南市,山上區,2717,7601,3981,3620
2013/9/1,臺南市,玉井區,5136,14862,7747,7115
2013/9/1,臺南市,楠西區,3550,10175,5411,4764
2013/9/1,臺南市,南化區,2841,8857,4830,4027
2013/9/1,臺南市,左鎮區,1993,5229,2931,2298
2013/9/1,臺南市,仁德區,26250,72260,36863,35397
2013/9/1,臺南市,歸仁區,21657,67103,34150,32953
2013/9/1,臺南市,關廟區,10848,35141,18187,16954
2013/9/1,臺南市,龍崎區,1588,4337,2349,1988
2013/9/1,臺南市,永康區,79994,226309,112007,114302
2013/9/1,臺南市,東區,71959,191790,92396,99394
2013/9/1,臺南市,南區,44359,125640,62683,62957
2013/9/1,臺南市,北區,49337,132253,64835,67418
2013/9/1,臺南市,安南區,58646,184854,93641,91213
2013/9/1,臺南市,安平區,24248,64584,30853,33731
2013/9/1,臺南市,中西區,30795,78562,38318,40244
2013/9/1,高雄市,鹽埕區,10985,25931,12942,12989
2013/9/1,高雄市,鼓山區,54777,134771,65503,69268
2013/9/1,高雄市,左營區,76324,195389,95308,100081
2013/9/1,高雄市,楠梓區,64927,177191,87673,89518
2013/9/1,高雄市,三民區,133955,348708,169730,178978
2013/9/1,高雄市,新興區,22813,53261,25723,27538
2013/9/1,高雄市,前金區,12591,28090,13611,14479
2013/9/1,高雄市,苓雅區,72351,178009,86260,91749
2013/9/1,高雄市,前鎮區,77565,195071,96432,98639
2013/9/1,高雄市,旗津區,10953,29050,15040,14010
2013/9/1,高雄市,小港區,65514,156017,77982,78035
2013/9/1,高雄市,鳳山區,133920,352307,174051,178256
2013/9/1,高雄市,林園區,25150,70360,35891,34469
2013/9/1,高雄市,大寮區,40187,110288,56985,53303
2013/9/1,高雄市,大樹區,13220,43319,22363,20956
2013/9/1,高雄市,大社區,12276,33961,17390,16571
2013/9/1,高雄市,仁武區,29183,78863,40419,38444
2013/9/1,高雄市,鳥松區,17345,43749,22235,21514
2013/9/1,高雄市,岡山區,34251,97854,48813,49041
2013/9/1,高雄市,橋頭區,13090,36999,18879,18120
2013/9/1,高雄市,燕巢區,10257,30595,16270,14325
2013/9/1,高雄市,田寮區,3451,7758,4317,3441
2013/9/1,高雄市,阿蓮區,9371,29852,15057,14795
2013/9/1,高雄市,路竹區,16440,53051,27107,25944
2013/9/1,高雄市,湖內區,10127,29188,14998,14190
2013/9/1,高雄市,茄萣區,10352,30852,16012,14840
2013/9/1,高雄市,永安區,5825,14137,7133,7004
2013/9/1,高雄市,彌陀區,6682,19949,10354,9595
2013/9/1,高雄市,梓官區,12369,36391,18830,17561
2013/9/1,高雄市,旗山區,13890,38678,20054,18624
2013/9/1,高雄市,美濃區,14438,41770,21800,19970
2013/9/1,高雄市,六龜區,5698,13968,7544,6424
2013/9/1,高雄市,甲仙區,2379,6480,3452,3028
2013/9/1,高雄市,杉林區,4826,12603,6868,5735
2013/9/1,高雄市,內門區,5075,15389,8378,7011
2013/9/1,高雄市,茂林區,581,1820,918,902
2013/9/1,高雄市,桃源區,1335,4433,2338,2095
2013/9/1,高雄市,那瑪夏區,867,3144,1633,1511
2013/9/1,宜蘭縣,宜蘭市,34856,96151,47113,49038
2013/9/1,宜蘭縣,羅東鎮,25592,72312,34521,37791
2013/9/1,宜蘭縣,蘇澳鎮,13849,41499,21178,20321
2013/9/1,宜蘭縣,頭城鎮,9994,30089,15555,14534
2013/9/1,宜蘭縣,礁溪鄉,13068,36000,18844,17156
2013/9/1,宜蘭縣,壯圍鄉,8379,24482,12979,11503
2013/9/1,宜蘭縣,員山鄉,11179,32218,17194,15024
2013/9/1,宜蘭縣,冬山鄉,18362,53658,27558,26100
2013/9/1,宜蘭縣,五結鄉,13729,39158,20281,18877
2013/9/1,宜蘭縣,三星鄉,7905,21146,11489,9657
2013/9/1,宜蘭縣,大同鄉,1865,5969,3253,2716
2013/9/1,宜蘭縣,南澳鄉,1869,5898,3132,2766
2013/9/1,桃園市,桃園區,152707,415166,202984,212182
2013/9/1,桃園市,中壢區,135343,378233,188182,190051
2013/9/1,桃園市,平鎮區,70629,211028,105850,105178
2013/9/1,桃園市,八德區,61627,179358,90764,88594
2013/9/1,桃園市,楊梅區,52237,155347,78854,76493
2013/9/1,桃園市,大溪區,30321,91969,47333,44636
2013/9/1,桃園市,蘆竹區,52360,148769,74406,74363
2013/9/1,桃園市,大園區,27839,83384,43011,40373
2013/9/1,桃園市,龜山區,52961,140394,70761,69633
2013/9/1,桃園市,龍潭區,38316,115453,58496,56957
2013/9/1,桃園市,新屋區,15250,48025,25712,22313
2013/9/1,桃園市,觀音區,20208,62885,32999,29886
2013/9/1,桃園市,復興區,3707,10618,5889,4729
2013/9/1,新竹縣,竹北市,54755,157552,78717,78835
2013/9/1,新竹縣,關西鎮,9503,31010,16529,14481
2013/9/1,新竹縣,新埔鎮,10586,34740,18451,16289
2013/9/1,新竹縣,竹東鎮,31919,96478,48561,47917
2013/9/1,新竹縣,湖口鄉,24669,76675,38982,37693
2013/9/1,新竹縣,橫山鄉,4511,13939,7549,6390
2013/9/1,新竹縣,新豐鄉,17040,55249,28358,26891
2013/9/1,新竹縣,芎林鄉,6400,20286,10702,9584
2013/9/1,新竹縣,寶山鄉,5022,14076,7615,6461
2013/9/1,新竹縣,北埔鄉,3150,9857,5325,4532
2013/9/1,新竹縣,峨眉鄉,2063,5767,3208,2559
2013/9/1,新竹縣,尖石鄉,2797,9035,4831,4204
2013/9/1,新竹縣,五峰鄉,1729,4511,2482,2029
2013/9/1,苗栗縣,苗栗市,30236,91015,45589,45426
2013/9/1,苗栗縣,苑裡鎮,14218,48458,25156,23302
2013/9/1,苗栗縣,通霄鎮,11518,37183,19663,17520
2013/9/1,苗栗縣,竹南鎮,26306,82096,41605,40491
2013/9/1,苗栗縣,頭份市,32161,101269,51237,50032
2013/9/1,苗栗縣,後龍鎮,11874,38465,20232,18233
2013/9/1,苗栗縣,卓蘭鎮,6152,18417,9681,8736
2013/9/1,苗栗縣,大湖鄉,5428,15737,8348,7389
2013/9/1,苗栗縣,公館鄉,10552,34818,18138,16680
2013/9/1,苗栗縣,銅鑼鄉,6117,19082,10132,8950
2013/9/1,苗栗縣,南庄鄉,3981,10769,5914,4855
2013/9/1,苗栗縣,頭屋鄉,3613,11387,5994,5393
2013/9/1,苗栗縣,三義鄉,5427,17418,9126,8292
2013/9/1,苗栗縣,西湖鄉,2710,7653,4252,3401
2013/9/1,苗栗縣,造橋鄉,4120,13537,7118,6419
2013/9/1,苗栗縣,三灣鄉,2430,7133,3900,3233
2013/9/1,苗栗縣,獅潭鄉,1720,4725,2642,2083
2013/9/1,苗栗縣,泰安鄉,1971,5945,3188,2757
2013/9/1,彰化縣,彰化市,74406,236282,117309,118973
2013/9/1,彰化縣,鹿港鎮,23324,86081,43947,42134
2013/9/1,彰化縣,和美鎮,25399,90475,46332,44143
2013/9/1,彰化縣,北斗鎮,10275,33181,16769,16412
2013/9/1,彰化縣,員林市,37941,124861,62603,62258
2013/9/1,彰化縣,溪湖鎮,15765,55822,28461,27361
2013/9/1,彰化縣,田中鎮,12838,43197,22395,20802
2013/9/1,彰化縣,二林鎮,14716,52880,27285,25595
2013/9/1,彰化縣,線西鄉,4241,17089,8829,8260
2013/9/1,彰化縣,伸港鄉,9368,36093,18491,17602
2013/9/1,彰化縣,福興鄉,12387,47973,25058,22915
2013/9/1,彰化縣,秀水鄉,10183,39339,20304,19035
2013/9/1,彰化縣,花壇鄉,13470,45997,23669,22328
2013/9/1,彰化縣,芬園鄉,6871,24293,12806,11487
2013/9/1,彰化縣,大村鄉,10604,36429,18915,17514
2013/9/1,彰化縣,埔鹽鄉,8995,33524,17598,15926
2013/9/1,彰化縣,埔心鄉,10242,35074,18109,16965
2013/9/1,彰化縣,永靖鄉,10715,38606,20089,18517
2013/9/1,彰化縣,社頭鄉,12601,43917,22555,21362
2013/9/1,彰化縣,二水鄉,5363,16018,8420,7598
2013/9/1,彰化縣,田尾鄉,7806,28005,14562,13443
2013/9/1,彰化縣,埤頭鄉,8843,31269,16293,14976
2013/9/1,彰化縣,芳苑鄉,10090,35168,18646,16522
2013/9/1,彰化縣,大城鄉,5366,18089,9807,8282
2013/9/1,彰化縣,竹塘鄉,4625,16036,8457,7579
2013/9/1,彰化縣,溪州鄉,8848,30962,16281,14681
2013/9/1,南投縣,南投市,34110,102953,51679,51274
2013/9/1,南投縣,埔里鎮,28826,83978,42195,41783
2013/9/1,南投縣,草屯鎮,32128,99299,50177,49122
2013/9/1,南投縣,竹山鎮,19879,57170,29384,27786
2013/9/1,南投縣,集集鎮,4357,11459,5978,5481
2013/9/1,南投縣,名間鄉,12496,40476,21250,19226
2013/9/1,南投縣,鹿谷鄉,7289,18693,9919,8774
2013/9/1,南投縣,中寮鄉,5664,15765,8549,7216
2013/9/1,南投縣,魚池鄉,5785,16710,8762,7948
2013/9/1,南投縣,國姓鄉,7273,19964,10831,9133
2013/9/1,南投縣,水里鄉,7280,19146,10041,9105
2013/9/1,南投縣,信義鄉,5256,16714,8999,7715
2013/9/1,南投縣,仁愛鄉,4956,15657,8109,7548
2013/9/1,雲林縣,斗六市,36581,108037,54061,53976
2013/9/1,雲林縣,斗南鎮,15601,46354,23562,22792
2013/9/1,雲林縣,虎尾鎮,23743,70584,35848,34736
2013/9/1,雲林縣,西螺鎮,14351,47534,24190,23344
2013/9/1,雲林縣,土庫鎮,9061,29822,15596,14226
2013/9/1,雲林縣,北港鎮,15868,42138,21932,20206
2013/9/1,雲林縣,古坑鄉,10864,32945,17381,15564
2013/9/1,雲林縣,大埤鄉,6774,20340,10930,9410
2013/9/1,雲林縣,莿桐鄉,9234,29815,15649,14166
2013/9/1,雲林縣,林內鄉,5877,19269,10066,9203
2013/9/1,雲林縣,二崙鄉,8917,28765,15359,13406
2013/9/1,雲林縣,崙背鄉,8509,26320,13895,12425
2013/9/1,雲林縣,麥寮鄉,13529,42070,21425,20645
2013/9/1,雲林縣,東勢鄉,5800,15906,8711,7195
2013/9/1,雲林縣,褒忠鄉,4411,13727,7350,6377
2013/9/1,雲林縣,臺西鄉,8823,24851,13365,11486
2013/9/1,雲林縣,元長鄉,9457,27670,15095,12575
2013/9/1,雲林縣,四湖鄉,9063,25642,13908,11734
2013/9/1,雲林縣,口湖鄉,9669,29428,15648,13780
2013/9/1,雲林縣,水林鄉,10338,27357,14987,12370
2013/9/1,嘉義縣,太保市,11942,37019,19091,17928
2013/9/1,嘉義縣,朴子市,15240,43676,22129,21547
2013/9/1,嘉義縣,布袋鎮,10180,28782,14773,14009
2013/9/1,嘉義縣,大林鎮,11401,32670,16755,15915
2013/9/1,嘉義縣,民雄鄉,23680,72138,36954,35184
2013/9/1,嘉義縣,溪口鄉,5428,15585,8291,7294
2013/9/1,嘉義縣,新港鄉,10550,33550,17735,15815
2013/9/1,嘉義縣,六腳鄉,9077,25026,13265,11761
2013/9/1,嘉義縣,東石鄉,9466,26386,14021,12365
2013/9/1,嘉義縣,義竹鄉,7560,19881,10349,9532
2013/9/1,嘉義縣,鹿草鄉,5845,16675,8944,7731
2013/9/1,嘉義縣,水上鄉,17712,51324,26499,24825
2013/9/1,嘉義縣,中埔鄉,15882,46746,24371,22375
2013/9/1,嘉義縣,竹崎鄉,11534,37470,19992,17478
2013/9/1,嘉義縣,梅山鄉,6784,20630,10940,9690
2013/9/1,嘉義縣,番路鄉,4302,12190,6618,5572
2013/9/1,嘉義縣,大埔鄉,1933,4539,2356,2183
2013/9/1,嘉義縣,阿里山鄉,1936,5717,3044,2673
2013/9/1,屏東縣,屏東市,73249,206552,102615,103937
2013/9/1,屏東縣,潮州鎮,18845,55336,27777,27559
2013/9/1,屏東縣,東港鎮,16152,48825,24669,24156
2013/9/1,屏東縣,恆春鎮,11131,30686,15714,14972
2013/9/1,屏東縣,萬丹鄉,14619,52696,27300,25396
2013/9/1,屏東縣,長治鄉,9932,30498,15939,14559
2013/9/1,屏東縣,麟洛鄉,3677,11294,5850,5444
2013/9/1,屏東縣,九如鄉,6748,22457,11639,10818
2013/9/1,屏東縣,里港鄉,8044,26440,13447,12993
2013/9/1,屏東縣,鹽埔鄉,7821,26665,13877,12788
2013/9/1,屏東縣,高樹鄉,9425,25785,13752,12033
2013/9/1,屏東縣,萬巒鄉,6458,21230,11169,10061
2013/9/1,屏東縣,內埔鄉,18291,56749,29422,27327
2013/9/1,屏東縣,竹田鄉,5624,17833,9484,8349
2013/9/1,屏東縣,新埤鄉,3406,10238,5448,4790
2013/9/1,屏東縣,枋寮鄉,8574,25722,13482,12240
2013/9/1,屏東縣,新園鄉,11689,37199,19257,17942
2013/9/1,屏東縣,崁頂鄉,4376,16411,8328,8083
2013/9/1,屏東縣,林邊鄉,7079,19638,10111,9527
2013/9/1,屏東縣,南州鄉,3674,11162,5717,5445
2013/9/1,屏東縣,佳冬鄉,7103,20624,10715,9909
2013/9/1,屏東縣,琉球鄉,4113,12153,6740,5413
2013/9/1,屏東縣,車城鄉,3475,9119,4915,4204
2013/9/1,屏東縣,滿州鄉,3044,8153,4500,3653
2013/9/1,屏東縣,枋山鄉,2125,5778,3093,2685
2013/9/1,屏東縣,三地門鄉,2247,7552,3839,3713
2013/9/1,屏東縣,霧臺鄉,1044,3149,1640,1509
2013/9/1,屏東縣,瑪家鄉,1949,6581,3403,3178
2013/9/1,屏東縣,泰武鄉,1258,5104,2685,2419
2013/9/1,屏東縣,來義鄉,2223,7606,3887,3719
2013/9/1,屏東縣,春日鄉,1329,4823,2482,2341
2013/9/1,屏東縣,獅子鄉,1506,4755,2472,2283
2013/9/1,屏東縣,牡丹鄉,1881,4794,2476,2318
2013/9/1,臺東縣,臺東市,38651,107415,54155,53260
2013/9/1,臺東縣,成功鎮,5439,15064,7962,7102
2013/9/1,臺東縣,關山鎮,3254,9312,4882,4430
2013/9/1,臺東縣,卑南鄉,6625,17741,9471,8270
2013/9/1,臺東縣,大武鄉,2512,6515,3400,3115
2013/9/1,臺東縣,太麻里鄉,4596,11628,6175,5453
2013/9/1,臺東縣,東河鄉,3739,9037,5020,4017
2013/9/1,臺東縣,長濱鄉,2919,7774,4432,3342
2013/9/1,臺東縣,鹿野鄉,3128,8247,4441,3806
2013/9/1,臺東縣,池上鄉,3279,8697,4584,4113
2013/9/1,臺東縣,綠島鄉,1083,3512,1858,1654
2013/9/1,臺東縣,延平鄉,1071,3543,1912,1631
2013/9/1,臺東縣,海端鄉,1090,4357,2368,1989
2013/9/1,臺東縣,達仁鄉,1484,3775,2058,1717
2013/9/1,臺東縣,金峰鄉,1088,3505,1824,1681
2013/9/1,臺東縣,蘭嶼鄉,1676,4867,2487,2380
2013/9/1,花蓮縣,花蓮市,41163,107329,52269,55060
2013/9/1,花蓮縣,鳳林鎮,4425,11454,6050,5404
2013/9/1,花蓮縣,玉里鎮,8943,25786,13875,11911
2013/9/1,花蓮縣,新城鄉,7440,20116,10412,9704
2013/9/1,花蓮縣,吉安鄉,30544,82095,41747,40348
2013/9/1,花蓮縣,壽豐鄉,6891,18103,9768,8335
2013/9/1,花蓮縣,光復鄉,5029,13491,7189,6302
2013/9/1,花蓮縣,豐濱鄉,1748,4617,2572,2045
2013/9/1,花蓮縣,瑞穗鄉,4654,12204,6572,5632
2013/9/1,花蓮縣,富里鄉,4006,11008,6005,5003
2013/9/1,花蓮縣,秀林鄉,4711,15199,7873,7326
2013/9/1,花蓮縣,萬榮鄉,2084,6511,3475,3036
2013/9/1,花蓮縣,卓溪鄉,1663,6126,3389,2737
2013/9/1,澎湖縣,馬公市,21909,58834,29873,28961
2013/9/1,澎湖縣,湖西鄉,5154,14094,7376,6718
2013/9/1,澎湖縣,白沙鄉,3263,9569,5027,4542
2013/9/1,澎湖縣,西嶼鄉,2907,8374,4306,4068
2013/9/1,澎湖縣,望安鄉,1996,5010,2702,2308
2013/9/1,澎湖縣,七美鄉,1295,3635,1898,1737
2013/9/1,基隆市,中正區,22370,53672,27478,26194
2013/9/1,基隆市,七堵區,20636,54073,27392,26681
2013/9/1,基隆市,暖暖區,14888,37820,19151,18669
2013/9/1,基隆市,仁愛區,19611,47184,23230,23954
2013/9/1,基隆市,中山區,19340,49422,25200,24222
2013/9/1,基隆市,安樂區,32108,82051,40890,41161
2013/9/1,基隆市,信義區,20656,51191,25570,25621
2013/9/1,新竹市,東區,73360,204077,100580,103497
2013/9/1,新竹市,北區,53338,147854,72754,75100
2013/9/1,新竹市,香山區,24983,75630,38541,37089
2013/9/1,嘉義市,東區,45027,124010,60366,63644
2013/9/1,嘉義市,西區,52608,147096,72475,74621
2013/9/1,金門縣,金城鎮,12205,38555,19389,19166
2013/9/1,金門縣,金湖鎮,8081,25744,13044,12700
2013/9/1,金門縣,金沙鎮,5885,18321,9119,9202
2013/9/1,金門縣,金寧鄉,7155,24642,12534,12108
2013/9/1,金門縣,烈嶼鄉,2911,11020,5438,5582
2013/9/1,金門縣,烏坵鄉,134,642,320,322
2013/9/1,連江縣,南竿鄉,1381,7206,4060,3146
2013/9/1,連江縣,北竿鄉,455,2242,1240,1002
2013/9/1,連江縣,莒光鄉,269,1429,838,591
2013/9/1,連江縣,東引鄉,293,1164,684,480
2013/10/1,總計,新北市,1475305,3952335,1949412,2002923
2013/10/1,總計,臺北市,1026025,2682839,1288549,1394290
2013/10/1,總計,臺中市,895471,2698811,1338644,1360167
2013/10/1,總計,臺南市,662494,1882777,944612,938165
2013/10/1,總計,高雄市,1055414,2779427,1386156,1393271
2013/10/1,總計,臺灣省,3120977,9233345,4707091,4526254
2013/10/1,總計,宜蘭縣,160766,458558,233050,225508
2013/10/1,總計,桃園市,714289,2041544,1025583,1015961
2013/10/1,總計,新竹縣,174307,529554,271498,258056
2013/10/1,總計,苗栗縣,180651,565252,291919,273333
2013/10/1,總計,彰化縣,375414,1296420,663789,632631
2013/10/1,總計,南投縣,175364,517701,265740,251961
2013/10/1,總計,雲林縣,236538,708373,368837,339536
2013/10/1,總計,嘉義縣,180485,529750,275974,253776
2013/10/1,總計,屏東縣,282080,853130,437570,415560
2013/10/1,總計,臺東縣,81686,224936,116975,107961
2013/10/1,總計,花蓮縣,123370,334014,171128,162886
2013/10/1,總計,澎湖縣,36977,100090,51517,48573
2013/10/1,總計,基隆市,149619,375204,188806,186398
2013/10/1,總計,新竹市,151851,427850,211953,215897
2013/10/1,總計,嘉義市,97580,270969,132752,138217
2013/10/1,總計,福建省,38833,131613,66984,64629
2013/10/1,總計,金門縣,36426,119534,60135,59399
2013/10/1,總計,連江縣,2407,12079,6849,5230
2013/10/1,新北市,板橋區,203367,556838,273410,283428
2013/10/1,新北市,三重區,145463,389672,193090,196582
2013/10/1,新北市,中和區,160882,416039,203900,212139
2013/10/1,新北市,永和區,90690,229403,109463,119940
2013/10/1,新北市,新莊區,144242,409406,201361,208045
2013/10/1,新北市,新店區,120777,298578,144976,153602
2013/10/1,新北市,樹林區,64224,183180,91742,91438
2013/10/1,新北市,鶯歌區,28828,88607,44488,44119
2013/10/1,新北市,三峽區,39372,109734,55506,54228
2013/10/1,新北市,淡水區,65021,154512,74621,79891
2013/10/1,新北市,汐止區,83142,194084,95472,98612
2013/10/1,新北市,瑞芳區,16029,41524,21018,20506
2013/10/1,新北市,土城區,84999,239353,118870,120483
2013/10/1,新北市,蘆洲區,68078,199457,98411,101046
2013/10/1,新北市,五股區,28633,81630,41243,40387
2013/10/1,新北市,泰山區,27216,77805,38845,38960
2013/10/1,新北市,林口區,35874,93565,46017,47548
2013/10/1,新北市,深坑區,9262,23612,11846,11766
2013/10/1,新北市,石碇區,3362,7848,4323,3525
2013/10/1,新北市,坪林區,2477,6469,3629,2840
2013/10/1,新北市,三芝區,9168,23460,12091,11369
2013/10/1,新北市,石門區,4252,12789,6668,6121
2013/10/1,新北市,八里區,13248,36076,18186,17890
2013/10/1,新北市,平溪區,2380,5021,2789,2232
2013/10/1,新北市,雙溪區,3863,9412,5073,4339
2013/10/1,新北市,貢寮區,4455,13315,6826,6489
2013/10/1,新北市,金山區,6931,22358,11132,11226
2013/10/1,新北市,萬里區,7302,22564,11421,11143
2013/10/1,新北市,烏來區,1768,6024,2995,3029
2013/10/1,臺北市,松山區,79752,209992,99356,110636
2013/10/1,臺北市,信義區,88385,228190,109554,118636
2013/10/1,臺北市,大安區,119496,313178,146861,166317
2013/10/1,臺北市,中山區,97242,228422,106885,121537
2013/10/1,臺北市,中正區,64577,162962,78183,84779
2013/10/1,臺北市,大同區,50486,129576,63496,66080
2013/10/1,臺北市,萬華區,77107,193133,95742,97391
2013/10/1,臺北市,文山區,101860,270923,130701,140222
2013/10/1,臺北市,南港區,45031,119632,58518,61114
2013/10/1,臺北市,內湖區,103631,282362,135516,146846
2013/10/1,臺北市,士林區,104710,289408,140181,149227
2013/10/1,臺北市,北投區,93748,255061,123556,131505
2013/10/1,臺中市,中區,7976,20091,9984,10107
2013/10/1,臺中市,東區,26820,74448,37275,37173
2013/10/1,臺中市,南區,44870,118048,57085,60963
2013/10/1,臺中市,西區,44490,116364,55519,60845
2013/10/1,臺中市,北區,57720,147907,71347,76560
2013/10/1,臺中市,西屯區,78388,215049,103719,111330
2013/10/1,臺中市,南屯區,56840,159611,76878,82733
2013/10/1,臺中市,北屯區,89429,255477,123409,132068
2013/10/1,臺中市,豐原區,51456,166059,82274,83785
2013/10/1,臺中市,東勢區,17215,51999,26896,25103
2013/10/1,臺中市,大甲區,22298,77846,39437,38409
2013/10/1,臺中市,清水區,25851,85975,44298,41677
2013/10/1,臺中市,沙鹿區,26301,86187,43748,42439
2013/10/1,臺中市,梧棲區,16526,55962,28271,27691
2013/10/1,臺中市,后里區,15226,54039,27592,26447
2013/10/1,臺中市,神岡區,18422,64880,33273,31607
2013/10/1,臺中市,潭子區,34186,104407,51852,52555
2013/10/1,臺中市,大雅區,27393,91889,46089,45800
2013/10/1,臺中市,新社區,7447,25306,13178,12128
2013/10/1,臺中市,石岡區,4890,15650,8151,7499
2013/10/1,臺中市,外埔區,9173,31789,16355,15434
2013/10/1,臺中市,大安區,5326,19770,10393,9377
2013/10/1,臺中市,烏日區,21891,70598,35746,34852
2013/10/1,臺中市,大肚區,16449,55938,28653,27285
2013/10/1,臺中市,龍井區,21678,75550,38354,37196
2013/10/1,臺中市,霧峰區,19274,64194,32838,31356
2013/10/1,臺中市,太平區,58061,178568,89207,89361
2013/10/1,臺中市,大里區,65487,204640,101127,103513
2013/10/1,臺中市,和平區,4388,10570,5696,4874
2013/10/1,臺南市,新營區,28171,78425,38936,39489
2013/10/1,臺南市,鹽水區,10037,26469,13796,12673
2013/10/1,臺南市,白河區,10990,30252,15863,14389
2013/10/1,臺南市,柳營區,7802,21990,11465,10525
2013/10/1,臺南市,後壁區,8940,24985,13013,11972
2013/10/1,臺南市,東山區,8292,22253,11788,10465
2013/10/1,臺南市,麻豆區,15403,45243,23019,22224
2013/10/1,臺南市,下營區,9115,25357,13072,12285
2013/10/1,臺南市,六甲區,7763,23220,12041,11179
2013/10/1,臺南市,官田區,7749,21798,11160,10638
2013/10/1,臺南市,大內區,4029,10447,5567,4880
2013/10/1,臺南市,佳里區,19990,59338,29478,29860
2013/10/1,臺南市,學甲區,9675,27255,13948,13307
2013/10/1,臺南市,西港區,7957,24923,12644,12279
2013/10/1,臺南市,七股區,8128,23880,12448,11432
2013/10/1,臺南市,將軍區,7377,20833,10625,10208
2013/10/1,臺南市,北門區,4400,11906,5996,5910
2013/10/1,臺南市,新化區,14063,43830,22456,21374
2013/10/1,臺南市,善化區,15641,44981,22673,22308
2013/10/1,臺南市,新市區,11341,35297,17771,17526
2013/10/1,臺南市,安定區,9649,30262,15616,14646
2013/10/1,臺南市,山上區,2715,7585,3972,3613
2013/10/1,臺南市,玉井區,5128,14852,7740,7112
2013/10/1,臺南市,楠西區,3547,10176,5406,4770
2013/10/1,臺南市,南化區,2840,8872,4837,4035
2013/10/1,臺南市,左鎮區,1995,5230,2926,2304
2013/10/1,臺南市,仁德區,26264,72323,36883,35440
2013/10/1,臺南市,歸仁區,21690,67116,34143,32973
2013/10/1,臺南市,關廟區,10852,35145,18193,16952
2013/10/1,臺南市,龍崎區,1586,4326,2341,1985
2013/10/1,臺南市,永康區,80043,226510,112095,114415
2013/10/1,臺南市,東區,71898,191620,92302,99318
2013/10/1,臺南市,南區,44349,125666,62687,62979
2013/10/1,臺南市,北區,49311,132285,64824,67461
2013/10/1,臺南市,安南區,58727,185038,93756,91282
2013/10/1,臺南市,安平區,24239,64561,30845,33716
2013/10/1,臺南市,中西區,30798,78528,38287,40241
2013/10/1,高雄市,鹽埕區,10987,25904,12916,12988
2013/10/1,高雄市,鼓山區,54786,134859,65570,69289
2013/10/1,高雄市,左營區,76338,195385,95284,100101
2013/10/1,高雄市,楠梓區,64965,177339,87709,89630
2013/10/1,高雄市,三民區,133935,348599,169678,178921
2013/10/1,高雄市,新興區,22791,53232,25716,27516
2013/10/1,高雄市,前金區,12571,28021,13567,14454
2013/10/1,高雄市,苓雅區,72267,177892,86203,91689
2013/10/1,高雄市,前鎮區,77565,195031,96399,98632
2013/10/1,高雄市,旗津區,10950,29073,15045,14028
2013/10/1,高雄市,小港區,65509,156056,78007,78049
2013/10/1,高雄市,鳳山區,133956,352409,174084,178325
2013/10/1,高雄市,林園區,25165,70368,35881,34487
2013/10/1,高雄市,大寮區,40210,110368,56986,53382
2013/10/1,高雄市,大樹區,13228,43407,22361,21046
2013/10/1,高雄市,大社區,12290,33975,17394,16581
2013/10/1,高雄市,仁武區,29272,79081,40504,38577
2013/10/1,高雄市,鳥松區,17345,43775,22251,21524
2013/10/1,高雄市,岡山區,34234,97833,48810,49023
2013/10/1,高雄市,橋頭區,13085,36994,18874,18120
2013/10/1,高雄市,燕巢區,10251,30578,16261,14317
2013/10/1,高雄市,田寮區,3448,7752,4312,3440
2013/10/1,高雄市,阿蓮區,9368,29834,15051,14783
2013/10/1,高雄市,路竹區,16442,53011,27077,25934
2013/10/1,高雄市,湖內區,10138,29190,14993,14197
2013/10/1,高雄市,茄萣區,10360,30876,16012,14864
2013/10/1,高雄市,永安區,5823,14141,7131,7010
2013/10/1,高雄市,彌陀區,6685,19934,10346,9588
2013/10/1,高雄市,梓官區,12360,36371,18811,17560
2013/10/1,高雄市,旗山區,13893,38623,20027,18596
2013/10/1,高雄市,美濃區,14439,41713,21775,19938
2013/10/1,高雄市,六龜區,5704,13960,7541,6419
2013/10/1,高雄市,甲仙區,2379,6467,3442,3025
2013/10/1,高雄市,杉林區,4821,12602,6870,5732
2013/10/1,高雄市,內門區,5073,15381,8380,7001
2013/10/1,高雄市,茂林區,580,1820,918,902
2013/10/1,高雄市,桃源區,1335,4426,2338,2088
2013/10/1,高雄市,那瑪夏區,866,3147,1632,1515
2013/10/1,宜蘭縣,宜蘭市,34864,96088,47073,49015
2013/10/1,宜蘭縣,羅東鎮,25611,72311,34508,37803
2013/10/1,宜蘭縣,蘇澳鎮,13849,41481,21176,20305
2013/10/1,宜蘭縣,頭城鎮,9987,30060,15538,14522
2013/10/1,宜蘭縣,礁溪鄉,13088,36019,18855,17164
2013/10/1,宜蘭縣,壯圍鄉,8392,24475,12984,11491
2013/10/1,宜蘭縣,員山鄉,11180,32206,17189,15017
2013/10/1,宜蘭縣,冬山鄉,18377,53688,27565,26123
2013/10/1,宜蘭縣,五結鄉,13744,39153,20273,18880
2013/10/1,宜蘭縣,三星鄉,7941,21185,11497,9688
2013/10/1,宜蘭縣,大同鄉,1864,5984,3259,2725
2013/10/1,宜蘭縣,南澳鄉,1869,5908,3133,2775
2013/10/1,桃園市,桃園區,152781,415259,202983,212276
2013/10/1,桃園市,中壢區,135545,378362,188244,190118
2013/10/1,桃園市,平鎮區,70681,211015,105826,105189
2013/10/1,桃園市,八德區,61692,179446,90813,88633
2013/10/1,桃園市,楊梅區,52317,155559,78978,76581
2013/10/1,桃園市,大溪區,30347,91958,47324,44634
2013/10/1,桃園市,蘆竹區,52449,148968,74476,74492
2013/10/1,桃園市,大園區,27918,83418,43022,40396
2013/10/1,桃園市,龜山區,52977,140373,70717,69656
2013/10/1,桃園市,龍潭區,38367,115554,58556,56998
2013/10/1,桃園市,新屋區,15260,48001,25692,22309
2013/10/1,桃園市,觀音區,20246,62985,33049,29936
2013/10/1,桃園市,復興區,3709,10646,5903,4743
2013/10/1,新竹縣,竹北市,54866,157969,78913,79056
2013/10/1,新竹縣,關西鎮,9498,30978,16523,14455
2013/10/1,新竹縣,新埔鎮,10593,34743,18458,16285
2013/10/1,新竹縣,竹東鎮,31901,96387,48508,47879
2013/10/1,新竹縣,湖口鄉,24699,76714,38981,37733
2013/10/1,新竹縣,橫山鄉,4505,13924,7540,6384
2013/10/1,新竹縣,新豐鄉,17060,55265,28375,26890
2013/10/1,新竹縣,芎林鄉,6404,20266,10702,9564
2013/10/1,新竹縣,寶山鄉,5025,14082,7624,6458
2013/10/1,新竹縣,北埔鄉,3153,9863,5330,4533
2013/10/1,新竹縣,峨眉鄉,2067,5764,3205,2559
2013/10/1,新竹縣,尖石鄉,2801,9062,4844,4218
2013/10/1,新竹縣,五峰鄉,1735,4537,2495,2042
2013/10/1,苗栗縣,苗栗市,30255,91024,45572,45452
2013/10/1,苗栗縣,苑裡鎮,14231,48499,25175,23324
2013/10/1,苗栗縣,通霄鎮,11514,37180,19641,17539
2013/10/1,苗栗縣,竹南鎮,26340,82177,41653,40524
2013/10/1,苗栗縣,頭份市,32198,101360,51280,50080
2013/10/1,苗栗縣,後龍鎮,11866,38439,20215,18224
2013/10/1,苗栗縣,卓蘭鎮,6166,18447,9676,8771
2013/10/1,苗栗縣,大湖鄉,5420,15694,8328,7366
2013/10/1,苗栗縣,公館鄉,10554,34822,18141,16681
2013/10/1,苗栗縣,銅鑼鄉,6117,19042,10107,8935
2013/10/1,苗栗縣,南庄鄉,3987,10760,5907,4853
2013/10/1,苗栗縣,頭屋鄉,3611,11407,6003,5404
2013/10/1,苗栗縣,三義鄉,5434,17420,9117,8303
2013/10/1,苗栗縣,西湖鄉,2712,7665,4257,3408
2013/10/1,苗栗縣,造橋鄉,4120,13531,7126,6405
2013/10/1,苗栗縣,三灣鄉,2430,7125,3895,3230
2013/10/1,苗栗縣,獅潭鄉,1722,4706,2634,2072
2013/10/1,苗栗縣,泰安鄉,1974,5954,3192,2762
2013/10/1,彰化縣,彰化市,74396,236238,117257,118981
2013/10/1,彰化縣,鹿港鎮,23330,86054,43943,42111
2013/10/1,彰化縣,和美鎮,25401,90438,46314,44124
2013/10/1,彰化縣,北斗鎮,10294,33196,16773,16423
2013/10/1,彰化縣,員林市,37955,124855,62593,62262
2013/10/1,彰化縣,溪湖鎮,15785,55799,28438,27361
2013/10/1,彰化縣,田中鎮,12847,43156,22371,20785
2013/10/1,彰化縣,二林鎮,14722,52885,27286,25599
2013/10/1,彰化縣,線西鄉,4244,17102,8840,8262
2013/10/1,彰化縣,伸港鄉,9372,36101,18497,17604
2013/10/1,彰化縣,福興鄉,12402,47987,25071,22916
2013/10/1,彰化縣,秀水鄉,10192,39361,20320,19041
2013/10/1,彰化縣,花壇鄉,13482,45975,23653,22322
2013/10/1,彰化縣,芬園鄉,6867,24284,12799,11485
2013/10/1,彰化縣,大村鄉,10618,36460,18919,17541
2013/10/1,彰化縣,埔鹽鄉,8998,33524,17599,15925
2013/10/1,彰化縣,埔心鄉,10248,35051,18098,16953
2013/10/1,彰化縣,永靖鄉,10716,38566,20061,18505
2013/10/1,彰化縣,社頭鄉,12601,43925,22567,21358
2013/10/1,彰化縣,二水鄉,5357,16014,8413,7601
2013/10/1,彰化縣,田尾鄉,7806,27997,14548,13449
2013/10/1,彰化縣,埤頭鄉,8844,31250,16283,14967
2013/10/1,彰化縣,芳苑鄉,10096,35163,18635,16528
2013/10/1,彰化縣,大城鄉,5363,18069,9785,8284
2013/10/1,彰化縣,竹塘鄉,4629,16044,8457,7587
2013/10/1,彰化縣,溪州鄉,8849,30926,16269,14657
2013/10/1,南投縣,南投市,34106,102847,51625,51222
2013/10/1,南投縣,埔里鎮,28821,83887,42162,41725
2013/10/1,南投縣,草屯鎮,32174,99315,50180,49135
2013/10/1,南投縣,竹山鎮,19898,57164,29378,27786
2013/10/1,南投縣,集集鎮,4354,11441,5967,5474
2013/10/1,南投縣,名間鄉,12495,40424,21233,19191
2013/10/1,南投縣,鹿谷鄉,7303,18696,9927,8769
2013/10/1,南投縣,中寮鄉,5653,15744,8542,7202
2013/10/1,南投縣,魚池鄉,5781,16716,8759,7957
2013/10/1,南投縣,國姓鄉,7277,19941,10816,9125
2013/10/1,南投縣,水里鄉,7285,19122,10030,9092
2013/10/1,南投縣,信義鄉,5263,16724,9000,7724
2013/10/1,南投縣,仁愛鄉,4954,15680,8121,7559
2013/10/1,雲林縣,斗六市,36591,108012,54041,53971
2013/10/1,雲林縣,斗南鎮,15594,46318,23545,22773
2013/10/1,雲林縣,虎尾鎮,23767,70527,35828,34699
2013/10/1,雲林縣,西螺鎮,14346,47493,24155,23338
2013/10/1,雲林縣,土庫鎮,9066,29804,15596,14208
2013/10/1,雲林縣,北港鎮,15880,42103,21915,20188
2013/10/1,雲林縣,古坑鄉,10872,32953,17375,15578
2013/10/1,雲林縣,大埤鄉,6770,20336,10934,9402
2013/10/1,雲林縣,莿桐鄉,9234,29817,15657,14160
2013/10/1,雲林縣,林內鄉,5865,19216,10040,9176
2013/10/1,雲林縣,二崙鄉,8918,28754,15349,13405
2013/10/1,雲林縣,崙背鄉,8512,26275,13873,12402
2013/10/1,雲林縣,麥寮鄉,13568,42369,21549,20820
2013/10/1,雲林縣,東勢鄉,5800,15885,8694,7191
2013/10/1,雲林縣,褒忠鄉,4410,13727,7355,6372
2013/10/1,雲林縣,臺西鄉,8827,24823,13352,11471
2013/10/1,雲林縣,元長鄉,9461,27668,15103,12565
2013/10/1,雲林縣,四湖鄉,9053,25578,13868,11710
2013/10/1,雲林縣,口湖鄉,9669,29380,15619,13761
2013/10/1,雲林縣,水林鄉,10335,27335,14989,12346
2013/10/1,嘉義縣,太保市,11952,37005,19097,17908
2013/10/1,嘉義縣,朴子市,15248,43655,22103,21552
2013/10/1,嘉義縣,布袋鎮,10185,28753,14758,13995
2013/10/1,嘉義縣,大林鎮,11395,32636,16744,15892
2013/10/1,嘉義縣,民雄鄉,23699,72109,36922,35187
2013/10/1,嘉義縣,溪口鄉,5427,15584,8284,7300
2013/10/1,嘉義縣,新港鄉,10552,33536,17729,15807
2013/10/1,嘉義縣,六腳鄉,9071,24999,13247,11752
2013/10/1,嘉義縣,東石鄉,9460,26376,14016,12360
2013/10/1,嘉義縣,義竹鄉,7556,19879,10341,9538
2013/10/1,嘉義縣,鹿草鄉,5847,16658,8937,7721
2013/10/1,嘉義縣,水上鄉,17711,51298,26481,24817
2013/10/1,嘉義縣,中埔鄉,15890,46779,24392,22387
2013/10/1,嘉義縣,竹崎鄉,11539,37434,19974,17460
2013/10/1,嘉義縣,梅山鄉,6782,20607,10927,9680
2013/10/1,嘉義縣,番路鄉,4302,12178,6621,5557
2013/10/1,嘉義縣,大埔鄉,1934,4541,2356,2185
2013/10/1,嘉義縣,阿里山鄉,1935,5723,3045,2678
2013/10/1,屏東縣,屏東市,73233,206373,102520,103853
2013/10/1,屏東縣,潮州鎮,18851,55286,27753,27533
2013/10/1,屏東縣,東港鎮,16145,48747,24641,24106
2013/10/1,屏東縣,恆春鎮,11110,30752,15738,15014
2013/10/1,屏東縣,萬丹鄉,14606,52642,27277,25365
2013/10/1,屏東縣,長治鄉,9932,30469,15923,14546
2013/10/1,屏東縣,麟洛鄉,3682,11304,5850,5454
2013/10/1,屏東縣,九如鄉,6747,22455,11638,10817
2013/10/1,屏東縣,里港鄉,8045,26472,13459,13013
2013/10/1,屏東縣,鹽埔鄉,7828,26664,13866,12798
2013/10/1,屏東縣,高樹鄉,9420,25735,13723,12012
2013/10/1,屏東縣,萬巒鄉,6453,21208,11159,10049
2013/10/1,屏東縣,內埔鄉,18293,56667,29373,27294
2013/10/1,屏東縣,竹田鄉,5625,17833,9481,8352
2013/10/1,屏東縣,新埤鄉,3403,10244,5446,4798
2013/10/1,屏東縣,枋寮鄉,8574,25716,13482,12234
2013/10/1,屏東縣,新園鄉,11699,37192,19273,17919
2013/10/1,屏東縣,崁頂鄉,4378,16408,8322,8086
2013/10/1,屏東縣,林邊鄉,7076,19624,10111,9513
2013/10/1,屏東縣,南州鄉,3664,11140,5704,5436
2013/10/1,屏東縣,佳冬鄉,7094,20587,10692,9895
2013/10/1,屏東縣,琉球鄉,4127,12222,6776,5446
2013/10/1,屏東縣,車城鄉,3472,9101,4911,4190
2013/10/1,屏東縣,滿州鄉,3038,8134,4484,3650
2013/10/1,屏東縣,枋山鄉,2131,5779,3088,2691
2013/10/1,屏東縣,三地門鄉,2249,7543,3835,3708
2013/10/1,屏東縣,霧臺鄉,1044,3167,1643,1524
2013/10/1,屏東縣,瑪家鄉,1946,6580,3399,3181
2013/10/1,屏東縣,泰武鄉,1259,5099,2682,2417
2013/10/1,屏東縣,來義鄉,2223,7615,3890,3725
2013/10/1,屏東縣,春日鄉,1334,4814,2477,2337
2013/10/1,屏東縣,獅子鄉,1509,4765,2476,2289
2013/10/1,屏東縣,牡丹鄉,1890,4793,2478,2315
2013/10/1,臺東縣,臺東市,38699,107412,54166,53246
2013/10/1,臺東縣,成功鎮,5434,15055,7958,7097
2013/10/1,臺東縣,關山鎮,3257,9306,4878,4428
2013/10/1,臺東縣,卑南鄉,6628,17751,9449,8302
2013/10/1,臺東縣,大武鄉,2515,6520,3399,3121
2013/10/1,臺東縣,太麻里鄉,4602,11614,6177,5437
2013/10/1,臺東縣,東河鄉,3729,9000,4998,4002
2013/10/1,臺東縣,長濱鄉,2918,7752,4417,3335
2013/10/1,臺東縣,鹿野鄉,3131,8229,4430,3799
2013/10/1,臺東縣,池上鄉,3277,8687,4576,4111
2013/10/1,臺東縣,綠島鄉,1080,3533,1868,1665
2013/10/1,臺東縣,延平鄉,1069,3548,1914,1634
2013/10/1,臺東縣,海端鄉,1087,4358,2372,1986
2013/10/1,臺東縣,達仁鄉,1484,3770,2051,1719
2013/10/1,臺東縣,金峰鄉,1093,3505,1820,1685
2013/10/1,臺東縣,蘭嶼鄉,1683,4896,2502,2394
2013/10/1,花蓮縣,花蓮市,41182,107281,52227,55054
2013/10/1,花蓮縣,鳳林鎮,4422,11437,6039,5398
2013/10/1,花蓮縣,玉里鎮,8944,25761,13860,11901
2013/10/1,花蓮縣,新城鄉,7440,20095,10403,9692
2013/10/1,花蓮縣,吉安鄉,30586,82164,41765,40399
2013/10/1,花蓮縣,壽豐鄉,6892,18094,9767,8327
2013/10/1,花蓮縣,光復鄉,5033,13485,7185,6300
2013/10/1,花蓮縣,豐濱鄉,1749,4618,2571,2047
2013/10/1,花蓮縣,瑞穗鄉,4656,12193,6563,5630
2013/10/1,花蓮縣,富里鄉,4004,11004,5999,5005
2013/10/1,花蓮縣,秀林鄉,4714,15236,7886,7350
2013/10/1,花蓮縣,萬榮鄉,2082,6513,3476,3037
2013/10/1,花蓮縣,卓溪鄉,1666,6133,3387,2746
2013/10/1,澎湖縣,馬公市,22321,59309,30152,29157
2013/10/1,澎湖縣,湖西鄉,5190,14159,7422,6737
2013/10/1,澎湖縣,白沙鄉,3266,9572,5022,4550
2013/10/1,澎湖縣,西嶼鄉,2906,8381,4306,4075
2013/10/1,澎湖縣,望安鄉,1998,5019,2707,2312
2013/10/1,澎湖縣,七美鄉,1296,3650,1908,1742
2013/10/1,基隆市,中正區,22389,53652,27451,26201
2013/10/1,基隆市,七堵區,20665,54059,27385,26674
2013/10/1,基隆市,暖暖區,14889,37809,19149,18660
2013/10/1,基隆市,仁愛區,19568,47063,23179,23884
2013/10/1,基隆市,中山區,19317,49386,25182,24204
2013/10/1,基隆市,安樂區,32102,81973,40853,41120
2013/10/1,基隆市,信義區,20689,51262,25607,25655
2013/10/1,新竹市,東區,73424,204282,100659,103623
2013/10/1,新竹市,北區,53380,147829,72713,75116
2013/10/1,新竹市,香山區,25047,75739,38581,37158
2013/10/1,嘉義市,東區,44969,123889,60299,63590
2013/10/1,嘉義市,西區,52611,147080,72453,74627
2013/10/1,金門縣,金城鎮,12209,38707,19478,19229
2013/10/1,金門縣,金湖鎮,8091,25831,13092,12739
2013/10/1,金門縣,金沙鎮,5895,18392,9152,9240
2013/10/1,金門縣,金寧鄉,7183,24884,12638,12246
2013/10/1,金門縣,烈嶼鄉,2914,11072,5452,5620
2013/10/1,金門縣,烏坵鄉,134,648,323,325
2013/10/1,連江縣,南竿鄉,1388,7231,4086,3145
2013/10/1,連江縣,北竿鄉,459,2251,1242,1009
2013/10/1,連江縣,莒光鄉,268,1433,838,595
2013/10/1,連江縣,東引鄉,292,1164,683,481
2013/11/1,總計,新北市,1476668,3953858,1949850,2004008
2013/11/1,總計,臺北市,1026426,2684567,1289204,1395363
2013/11/1,總計,臺中市,896358,2700300,1339213,1361087
2013/11/1,總計,臺南市,662876,1883114,944658,938456
2013/11/1,總計,高雄市,1055962,2779563,1385984,1393579
2013/11/1,總計,臺灣省,3123688,9233770,4707028,4526742
2013/11/1,總計,宜蘭縣,160811,458514,233039,225475
2013/11/1,總計,桃園市,715623,2042668,1026076,1016592
2013/11/1,總計,新竹縣,174530,530004,271698,258306
2013/11/1,總計,苗栗縣,180763,565369,291958,273411
2013/11/1,總計,彰化縣,375631,1296160,663645,632515
2013/11/1,總計,南投縣,175451,517460,265633,251827
2013/11/1,總計,雲林縣,236592,708044,368644,339400
2013/11/1,總計,嘉義縣,180629,529568,275895,253673
2013/11/1,總計,屏東縣,282159,852837,437392,415445
2013/11/1,總計,臺東縣,81756,224875,116915,107960
2013/11/1,總計,花蓮縣,123411,333961,171080,162881
2013/11/1,總計,澎湖縣,37060,100233,51611,48622
2013/11/1,總計,基隆市,149667,375063,188726,186337
2013/11/1,總計,新竹市,152002,428080,212015,216065
2013/11/1,總計,嘉義市,97603,270934,132701,138233
2013/11/1,總計,福建省,38888,132148,67250,64898
2013/11/1,總計,金門縣,36474,120037,60370,59667
2013/11/1,總計,連江縣,2414,12111,6880,5231
2013/11/1,新北市,板橋區,203479,556934,273394,283540
2013/11/1,新北市,三重區,145604,389805,193123,196682
2013/11/1,新北市,中和區,160961,415973,203844,212129
2013/11/1,新北市,永和區,90672,229255,109402,119853
2013/11/1,新北市,新莊區,144408,409629,201463,208166
2013/11/1,新北市,新店區,120930,298737,145005,153732
2013/11/1,新北市,樹林區,64281,183335,91804,91531
2013/11/1,新北市,鶯歌區,28879,88637,44504,44133
2013/11/1,新北市,三峽區,39400,109830,55571,54259
2013/11/1,新北市,淡水區,65258,154872,74796,80076
2013/11/1,新北市,汐止區,83191,194145,95448,98697
2013/11/1,新北市,瑞芳區,16031,41501,21011,20490
2013/11/1,新北市,土城區,85003,239304,118860,120444
2013/11/1,新北市,蘆洲區,68123,199491,98376,101115
2013/11/1,新北市,五股區,28675,81690,41265,40425
2013/11/1,新北市,泰山區,27259,77900,38888,39012
2013/11/1,新北市,林口區,36009,93854,46131,47723
2013/11/1,新北市,深坑區,9265,23635,11867,11768
2013/11/1,新北市,石碇區,3364,7861,4334,3527
2013/11/1,新北市,坪林區,2477,6457,3621,2836
2013/11/1,新北市,三芝區,9175,23478,12095,11383
2013/11/1,新北市,石門區,4263,12791,6666,6125
2013/11/1,新北市,八里區,13256,36042,18165,17877
2013/11/1,新北市,平溪區,2375,5008,2779,2229
2013/11/1,新北市,雙溪區,3866,9424,5075,4349
2013/11/1,新北市,貢寮區,4454,13301,6817,6484
2013/11/1,新北市,金山區,6929,22360,11120,11240
2013/11/1,新北市,萬里區,7306,22586,11433,11153
2013/11/1,新北市,烏來區,1775,6023,2993,3030
2013/11/1,臺北市,松山區,79777,210148,99436,110712
2013/11/1,臺北市,信義區,88418,228355,109593,118762
2013/11/1,臺北市,大安區,119532,313310,146916,166394
2013/11/1,臺北市,中山區,97277,228543,106930,121613
2013/11/1,臺北市,中正區,64593,163052,78188,84864
2013/11/1,臺北市,大同區,50519,129709,63542,66167
2013/11/1,臺北市,萬華區,77169,193246,95775,97471
2013/11/1,臺北市,文山區,101883,271136,130785,140351
2013/11/1,臺北市,南港區,45020,119665,58549,61116
2013/11/1,臺北市,內湖區,103729,282594,135638,146956
2013/11/1,臺北市,士林區,104734,289528,140203,149325
2013/11/1,臺北市,北投區,93775,255281,123649,131632
2013/11/1,臺中市,中區,7979,20049,9963,10086
2013/11/1,臺中市,東區,26865,74556,37315,37241
2013/11/1,臺中市,南區,44938,118200,57155,61045
2013/11/1,臺中市,西區,44527,116362,55535,60827
2013/11/1,臺中市,北區,57758,147915,71348,76567
2013/11/1,臺中市,西屯區,78437,215174,103789,111385
2013/11/1,臺中市,南屯區,56913,159769,76934,82835
2013/11/1,臺中市,北屯區,89521,255676,123455,132221
2013/11/1,臺中市,豐原區,51475,166060,82263,83797
2013/11/1,臺中市,東勢區,17207,51969,26883,25086
2013/11/1,臺中市,大甲區,22306,77824,39402,38422
2013/11/1,臺中市,清水區,25863,85994,44300,41694
2013/11/1,臺中市,沙鹿區,26342,86231,43744,42487
2013/11/1,臺中市,梧棲區,16547,56011,28281,27730
2013/11/1,臺中市,后里區,15245,54056,27596,26460
2013/11/1,臺中市,神岡區,18448,64898,33280,31618
2013/11/1,臺中市,潭子區,34203,104428,51862,52566
2013/11/1,臺中市,大雅區,27427,91958,46130,45828
2013/11/1,臺中市,新社區,7445,25324,13177,12147
2013/11/1,臺中市,石岡區,4905,15669,8167,7502
2013/11/1,臺中市,外埔區,9202,31832,16379,15453
2013/11/1,臺中市,大安區,5325,19758,10391,9367
2013/11/1,臺中市,烏日區,21915,70608,35751,34857
2013/11/1,臺中市,大肚區,16465,56001,28681,27320
2013/11/1,臺中市,龍井區,21707,75648,38403,37245
2013/11/1,臺中市,霧峰區,19286,64214,32832,31382
2013/11/1,臺中市,太平區,58185,178771,89313,89458
2013/11/1,臺中市,大里區,65529,204758,101182,103576
2013/11/1,臺中市,和平區,4393,10587,5702,4885
2013/11/1,臺南市,新營區,28200,78462,38959,39503
2013/11/1,臺南市,鹽水區,10031,26451,13786,12665
2013/11/1,臺南市,白河區,10982,30212,15839,14373
2013/11/1,臺南市,柳營區,7804,21964,11452,10512
2013/11/1,臺南市,後壁區,8944,24969,13000,11969
2013/11/1,臺南市,東山區,8295,22231,11776,10455
2013/11/1,臺南市,麻豆區,15414,45239,23018,22221
2013/11/1,臺南市,下營區,9117,25336,13059,12277
2013/11/1,臺南市,六甲區,7756,23186,12016,11170
2013/11/1,臺南市,官田區,7753,21817,11159,10658
2013/11/1,臺南市,大內區,4026,10434,5559,4875
2013/11/1,臺南市,佳里區,19997,59371,29484,29887
2013/11/1,臺南市,學甲區,9662,27221,13926,13295
2013/11/1,臺南市,西港區,7955,24916,12645,12271
2013/11/1,臺南市,七股區,8126,23894,12463,11431
2013/11/1,臺南市,將軍區,7381,20828,10615,10213
2013/11/1,臺南市,北門區,4402,11886,5991,5895
2013/11/1,臺南市,新化區,14072,43857,22459,21398
2013/11/1,臺南市,善化區,15684,45058,22732,22326
2013/11/1,臺南市,新市區,11364,35320,17780,17540
2013/11/1,臺南市,安定區,9651,30239,15602,14637
2013/11/1,臺南市,山上區,2714,7576,3970,3606
2013/11/1,臺南市,玉井區,5130,14838,7735,7103
2013/11/1,臺南市,楠西區,3551,10180,5404,4776
2013/11/1,臺南市,南化區,2844,8869,4837,4032
2013/11/1,臺南市,左鎮區,1995,5227,2925,2302
2013/11/1,臺南市,仁德區,26291,72406,36914,35492
2013/11/1,臺南市,歸仁區,21702,67136,34123,33013
2013/11/1,臺南市,關廟區,10859,35130,18193,16937
2013/11/1,臺南市,龍崎區,1583,4311,2336,1975
2013/11/1,臺南市,永康區,80093,226729,112199,114530
2013/11/1,臺南市,東區,71904,191525,92261,99264
2013/11/1,臺南市,南區,44348,125633,62641,62992
2013/11/1,臺南市,北區,49340,132347,64842,67505
2013/11/1,臺南市,安南區,58810,185205,93838,91367
2013/11/1,臺南市,安平區,24260,64576,30833,33743
2013/11/1,臺南市,中西區,30836,78535,38287,40248
2013/11/1,高雄市,鹽埕區,10997,25904,12918,12986
2013/11/1,高雄市,鼓山區,54867,135022,65627,69395
2013/11/1,高雄市,左營區,76357,195373,95237,100136
2013/11/1,高雄市,楠梓區,65028,177477,87768,89709
2013/11/1,高雄市,三民區,133996,348595,169696,178899
2013/11/1,高雄市,新興區,22755,53158,25667,27491
2013/11/1,高雄市,前金區,12583,28050,13568,14482
2013/11/1,高雄市,苓雅區,72272,177796,86151,91645
2013/11/1,高雄市,前鎮區,77553,194866,96302,98564
2013/11/1,高雄市,旗津區,10957,29061,15040,14021
2013/11/1,高雄市,小港區,65536,156101,77990,78111
2013/11/1,高雄市,鳳山區,134006,352430,174063,178367
2013/11/1,高雄市,林園區,25193,70375,35877,34498
2013/11/1,高雄市,大寮區,40248,110392,56968,53424
2013/11/1,高雄市,大樹區,13234,43417,22363,21054
2013/11/1,高雄市,大社區,12350,34031,17419,16612
2013/11/1,高雄市,仁武區,29352,79230,40580,38650
2013/11/1,高雄市,鳥松區,17346,43782,22262,21520
2013/11/1,高雄市,岡山區,34253,97838,48816,49022
2013/11/1,高雄市,橋頭區,13094,36997,18878,18119
2013/11/1,高雄市,燕巢區,10263,30562,16244,14318
2013/11/1,高雄市,田寮區,3447,7747,4309,3438
2013/11/1,高雄市,阿蓮區,9364,29801,15032,14769
2013/11/1,高雄市,路竹區,16445,53004,27077,25927
2013/11/1,高雄市,湖內區,10138,29195,14991,14204
2013/11/1,高雄市,茄萣區,10360,30890,16022,14868
2013/11/1,高雄市,永安區,5827,14134,7120,7014
2013/11/1,高雄市,彌陀區,6689,19937,10353,9584
2013/11/1,高雄市,梓官區,12358,36372,18810,17562
2013/11/1,高雄市,旗山區,13889,38597,20003,18594
2013/11/1,高雄市,美濃區,14456,41700,21758,19942
2013/11/1,高雄市,六龜區,5698,13937,7528,6409
2013/11/1,高雄市,甲仙區,2382,6452,3433,3019
2013/11/1,高雄市,杉林區,4820,12591,6867,5724
2013/11/1,高雄市,內門區,5068,15364,8364,7000
2013/11/1,高雄市,茂林區,578,1818,918,900
2013/11/1,高雄市,桃源區,1337,4423,2339,2084
2013/11/1,高雄市,那瑪夏區,866,3144,1626,1518
2013/11/1,宜蘭縣,宜蘭市,34854,96083,47062,49021
2013/11/1,宜蘭縣,羅東鎮,25602,72322,34540,37782
2013/11/1,宜蘭縣,蘇澳鎮,13853,41423,21144,20279
2013/11/1,宜蘭縣,頭城鎮,9994,30043,15528,14515
2013/11/1,宜蘭縣,礁溪鄉,13097,36023,18862,17161
2013/11/1,宜蘭縣,壯圍鄉,8391,24462,12978,11484
2013/11/1,宜蘭縣,員山鄉,11192,32200,17177,15023
2013/11/1,宜蘭縣,冬山鄉,18397,53687,27566,26121
2013/11/1,宜蘭縣,五結鄉,13748,39184,20290,18894
2013/11/1,宜蘭縣,三星鄉,7952,21188,11497,9691
2013/11/1,宜蘭縣,大同鄉,1863,5987,3263,2724
2013/11/1,宜蘭縣,南澳鄉,1868,5912,3132,2780
2013/11/1,桃園市,桃園區,153058,415286,203002,212284
2013/11/1,桃園市,中壢區,135824,378632,188356,190276
2013/11/1,桃園市,平鎮區,70793,211129,105881,105248
2013/11/1,桃園市,八德區,61799,179500,90814,88686
2013/11/1,桃園市,楊梅區,52395,155649,79026,76623
2013/11/1,桃園市,大溪區,30384,91913,47309,44604
2013/11/1,桃園市,蘆竹區,52574,149287,74642,74645
2013/11/1,桃園市,大園區,28005,83528,43067,40461
2013/11/1,桃園市,龜山區,53068,140474,70738,69736
2013/11/1,桃園市,龍潭區,38455,115638,58588,57050
2013/11/1,桃園市,新屋區,15276,47996,25690,22306
2013/11/1,桃園市,觀音區,20282,62985,33051,29934
2013/11/1,桃園市,復興區,3710,10651,5912,4739
2013/11/1,新竹縣,竹北市,54980,158381,79089,79292
2013/11/1,新竹縣,關西鎮,9501,30971,16508,14463
2013/11/1,新竹縣,新埔鎮,10589,34715,18450,16265
2013/11/1,新竹縣,竹東鎮,31929,96365,48496,47869
2013/11/1,新竹縣,湖口鄉,24737,76759,39002,37757
2013/11/1,新竹縣,橫山鄉,4502,13909,7538,6371
2013/11/1,新竹縣,新豐鄉,17085,55310,28400,26910
2013/11/1,新竹縣,芎林鄉,6407,20252,10693,9559
2013/11/1,新竹縣,寶山鄉,5034,14096,7639,6457
2013/11/1,新竹縣,北埔鄉,3156,9859,5317,4542
2013/11/1,新竹縣,峨眉鄉,2071,5760,3205,2555
2013/11/1,新竹縣,尖石鄉,2806,9094,4862,4232
2013/11/1,新竹縣,五峰鄉,1733,4533,2499,2034
2013/11/1,苗栗縣,苗栗市,30280,91095,45620,45475
2013/11/1,苗栗縣,苑裡鎮,14251,48498,25161,23337
2013/11/1,苗栗縣,通霄鎮,11507,37155,19630,17525
2013/11/1,苗栗縣,竹南鎮,26371,82263,41683,40580
2013/11/1,苗栗縣,頭份市,32218,101424,51323,50101
2013/11/1,苗栗縣,後龍鎮,11852,38425,20208,18217
2013/11/1,苗栗縣,卓蘭鎮,6172,18448,9677,8771
2013/11/1,苗栗縣,大湖鄉,5423,15689,8322,7367
2013/11/1,苗栗縣,公館鄉,10555,34791,18124,16667
2013/11/1,苗栗縣,銅鑼鄉,6120,19039,10102,8937
2013/11/1,苗栗縣,南庄鄉,3986,10746,5899,4847
2013/11/1,苗栗縣,頭屋鄉,3621,11402,6001,5401
2013/11/1,苗栗縣,三義鄉,5439,17423,9117,8306
2013/11/1,苗栗縣,西湖鄉,2711,7654,4255,3399
2013/11/1,苗栗縣,造橋鄉,4123,13537,7128,6409
2013/11/1,苗栗縣,三灣鄉,2433,7132,3894,3238
2013/11/1,苗栗縣,獅潭鄉,1724,4690,2622,2068
2013/11/1,苗栗縣,泰安鄉,1977,5958,3192,2766
2013/11/1,彰化縣,彰化市,74422,236212,117217,118995
2013/11/1,彰化縣,鹿港鎮,23344,86000,43913,42087
2013/11/1,彰化縣,和美鎮,25449,90462,46328,44134
2013/11/1,彰化縣,北斗鎮,10282,33173,16765,16408
2013/11/1,彰化縣,員林市,37981,124871,62591,62280
2013/11/1,彰化縣,溪湖鎮,15797,55784,28449,27335
2013/11/1,彰化縣,田中鎮,12856,43121,22359,20762
2013/11/1,彰化縣,二林鎮,14747,52903,27289,25614
2013/11/1,彰化縣,線西鄉,4243,17105,8841,8264
2013/11/1,彰化縣,伸港鄉,9380,36125,18519,17606
2013/11/1,彰化縣,福興鄉,12416,47989,25069,22920
2013/11/1,彰化縣,秀水鄉,10204,39355,20315,19040
2013/11/1,彰化縣,花壇鄉,13497,45969,23659,22310
2013/11/1,彰化縣,芬園鄉,6864,24267,12790,11477
2013/11/1,彰化縣,大村鄉,10626,36456,18919,17537
2013/11/1,彰化縣,埔鹽鄉,8999,33505,17583,15922
2013/11/1,彰化縣,埔心鄉,10262,35074,18110,16964
2013/11/1,彰化縣,永靖鄉,10718,38537,20048,18489
2013/11/1,彰化縣,社頭鄉,12603,43892,22555,21337
2013/11/1,彰化縣,二水鄉,5359,16010,8403,7607
2013/11/1,彰化縣,田尾鄉,7805,27983,14542,13441
2013/11/1,彰化縣,埤頭鄉,8838,31243,16278,14965
2013/11/1,彰化縣,芳苑鄉,10088,35114,18615,16499
2013/11/1,彰化縣,大城鄉,5359,18053,9779,8274
2013/11/1,彰化縣,竹塘鄉,4634,16053,8457,7596
2013/11/1,彰化縣,溪州鄉,8858,30904,16252,14652
2013/11/1,南投縣,南投市,34123,102819,51618,51201
2013/11/1,南投縣,埔里鎮,28817,83777,42100,41677
2013/11/1,南投縣,草屯鎮,32215,99302,50152,49150
2013/11/1,南投縣,竹山鎮,19904,57150,29380,27770
2013/11/1,南投縣,集集鎮,4358,11427,5969,5458
2013/11/1,南投縣,名間鄉,12500,40397,21214,19183
2013/11/1,南投縣,鹿谷鄉,7323,18687,9926,8761
2013/11/1,南投縣,中寮鄉,5654,15732,8545,7187
2013/11/1,南投縣,魚池鄉,5772,16704,8765,7939
2013/11/1,南投縣,國姓鄉,7280,19941,10819,9122
2013/11/1,南投縣,水里鄉,7286,19102,10021,9081
2013/11/1,南投縣,信義鄉,5264,16721,8996,7725
2013/11/1,南投縣,仁愛鄉,4955,15701,8128,7573
2013/11/1,雲林縣,斗六市,36584,108016,54040,53976
2013/11/1,雲林縣,斗南鎮,15614,46306,23543,22763
2013/11/1,雲林縣,虎尾鎮,23778,70516,35820,34696
2013/11/1,雲林縣,西螺鎮,14359,47464,24147,23317
2013/11/1,雲林縣,土庫鎮,9098,29818,15601,14217
2013/11/1,雲林縣,北港鎮,15888,42061,21883,20178
2013/11/1,雲林縣,古坑鄉,10861,32909,17359,15550
2013/11/1,雲林縣,大埤鄉,6769,20319,10925,9394
2013/11/1,雲林縣,莿桐鄉,9242,29826,15657,14169
2013/11/1,雲林縣,林內鄉,5865,19153,9998,9155
2013/11/1,雲林縣,二崙鄉,8907,28747,15345,13402
2013/11/1,雲林縣,崙背鄉,8514,26257,13863,12394
2013/11/1,雲林縣,麥寮鄉,13586,42437,21586,20851
2013/11/1,雲林縣,東勢鄉,5795,15850,8674,7176
2013/11/1,雲林縣,褒忠鄉,4405,13706,7343,6363
2013/11/1,雲林縣,臺西鄉,8822,24804,13348,11456
2013/11/1,雲林縣,元長鄉,9463,27643,15087,12556
2013/11/1,雲林縣,四湖鄉,9049,25545,13843,11702
2013/11/1,雲林縣,口湖鄉,9667,29369,15610,13759
2013/11/1,雲林縣,水林鄉,10326,27298,14972,12326
2013/11/1,嘉義縣,太保市,11958,37002,19109,17893
2013/11/1,嘉義縣,朴子市,15263,43651,22101,21550
2013/11/1,嘉義縣,布袋鎮,10182,28726,14752,13974
2013/11/1,嘉義縣,大林鎮,11400,32608,16723,15885
2013/11/1,嘉義縣,民雄鄉,23753,72110,36918,35192
2013/11/1,嘉義縣,溪口鄉,5425,15562,8277,7285
2013/11/1,嘉義縣,新港鄉,10557,33529,17718,15811
2013/11/1,嘉義縣,六腳鄉,9069,24976,13240,11736
2013/11/1,嘉義縣,東石鄉,9460,26355,14001,12354
2013/11/1,嘉義縣,義竹鄉,7563,19858,10330,9528
2013/11/1,嘉義縣,鹿草鄉,5841,16654,8941,7713
2013/11/1,嘉義縣,水上鄉,17736,51302,26480,24822
2013/11/1,嘉義縣,中埔鄉,15917,46775,24390,22385
2013/11/1,嘉義縣,竹崎鄉,11550,37399,19958,17441
2013/11/1,嘉義縣,梅山鄉,6782,20602,10928,9674
2013/11/1,嘉義縣,番路鄉,4299,12178,6621,5557
2013/11/1,嘉義縣,大埔鄉,1933,4550,2363,2187
2013/11/1,嘉義縣,阿里山鄉,1941,5731,3045,2686
2013/11/1,屏東縣,屏東市,73229,206222,102463,103759
2013/11/1,屏東縣,潮州鎮,18866,55250,27720,27530
2013/11/1,屏東縣,東港鎮,16141,48652,24577,24075
2013/11/1,屏東縣,恆春鎮,11121,30792,15749,15043
2013/11/1,屏東縣,萬丹鄉,14619,52615,27258,25357
2013/11/1,屏東縣,長治鄉,9936,30475,15916,14559
2013/11/1,屏東縣,麟洛鄉,3677,11304,5842,5462
2013/11/1,屏東縣,九如鄉,6745,22422,11618,10804
2013/11/1,屏東縣,里港鄉,8051,26474,13472,13002
2013/11/1,屏東縣,鹽埔鄉,7839,26663,13857,12806
2013/11/1,屏東縣,高樹鄉,9426,25715,13726,11989
2013/11/1,屏東縣,萬巒鄉,6452,21177,11149,10028
2013/11/1,屏東縣,內埔鄉,18320,56638,29351,27287
2013/11/1,屏東縣,竹田鄉,5627,17830,9480,8350
2013/11/1,屏東縣,新埤鄉,3404,10243,5448,4795
2013/11/1,屏東縣,枋寮鄉,8574,25711,13469,12242
2013/11/1,屏東縣,新園鄉,11707,37165,19261,17904
2013/11/1,屏東縣,崁頂鄉,4380,16411,8334,8077
2013/11/1,屏東縣,林邊鄉,7072,19608,10099,9509
2013/11/1,屏東縣,南州鄉,3658,11132,5697,5435
2013/11/1,屏東縣,佳冬鄉,7085,20560,10679,9881
2013/11/1,屏東縣,琉球鄉,4134,12369,6862,5507
2013/11/1,屏東縣,車城鄉,3476,9104,4915,4189
2013/11/1,屏東縣,滿州鄉,3034,8118,4474,3644
2013/11/1,屏東縣,枋山鄉,2131,5762,3076,2686
2013/11/1,屏東縣,三地門鄉,2249,7553,3843,3710
2013/11/1,屏東縣,霧臺鄉,1045,3184,1647,1537
2013/11/1,屏東縣,瑪家鄉,1948,6585,3398,3187
2013/11/1,屏東縣,泰武鄉,1258,5110,2685,2425
2013/11/1,屏東縣,來義鄉,2222,7619,3892,3727
2013/11/1,屏東縣,春日鄉,1333,4818,2480,2338
2013/11/1,屏東縣,獅子鄉,1514,4772,2480,2292
2013/11/1,屏東縣,牡丹鄉,1886,4784,2475,2309
2013/11/1,臺東縣,臺東市,38728,107337,54106,53231
2013/11/1,臺東縣,成功鎮,5442,15049,7947,7102
2013/11/1,臺東縣,關山鎮,3257,9287,4867,4420
2013/11/1,臺東縣,卑南鄉,6625,17735,9450,8285
2013/11/1,臺東縣,大武鄉,2516,6530,3408,3122
2013/11/1,臺東縣,太麻里鄉,4614,11620,6173,5447
2013/11/1,臺東縣,東河鄉,3730,8998,4997,4001
2013/11/1,臺東縣,長濱鄉,2922,7748,4415,3333
2013/11/1,臺東縣,鹿野鄉,3125,8226,4429,3797
2013/11/1,臺東縣,池上鄉,3280,8692,4572,4120
2013/11/1,臺東縣,綠島鄉,1090,3561,1886,1675
2013/11/1,臺東縣,延平鄉,1068,3553,1914,1639
2013/11/1,臺東縣,海端鄉,1089,4358,2374,1984
2013/11/1,臺東縣,達仁鄉,1486,3781,2055,1726
2013/11/1,臺東縣,金峰鄉,1097,3504,1822,1682
2013/11/1,臺東縣,蘭嶼鄉,1687,4896,2500,2396
2013/11/1,花蓮縣,花蓮市,41172,107275,52231,55044
2013/11/1,花蓮縣,鳳林鎮,4416,11418,6036,5382
2013/11/1,花蓮縣,玉里鎮,8940,25724,13833,11891
2013/11/1,花蓮縣,新城鄉,7452,20128,10419,9709
2013/11/1,花蓮縣,吉安鄉,30621,82187,41767,40420
2013/11/1,花蓮縣,壽豐鄉,6893,18107,9771,8336
2013/11/1,花蓮縣,光復鄉,5035,13470,7170,6300
2013/11/1,花蓮縣,豐濱鄉,1746,4618,2572,2046
2013/11/1,花蓮縣,瑞穗鄉,4660,12168,6549,5619
2013/11/1,花蓮縣,富里鄉,4008,10983,5988,4995
2013/11/1,花蓮縣,秀林鄉,4716,15247,7896,7351
2013/11/1,花蓮縣,萬榮鄉,2084,6510,3470,3040
2013/11/1,花蓮縣,卓溪鄉,1668,6126,3378,2748
2013/11/1,澎湖縣,馬公市,22370,59391,30200,29191
2013/11/1,澎湖縣,湖西鄉,5212,14194,7457,6737
2013/11/1,澎湖縣,白沙鄉,3271,9580,5020,4560
2013/11/1,澎湖縣,西嶼鄉,2912,8384,4311,4073
2013/11/1,澎湖縣,望安鄉,1997,5031,2712,2319
2013/11/1,澎湖縣,七美鄉,1298,3653,1911,1742
2013/11/1,基隆市,中正區,22376,53617,27440,26177
2013/11/1,基隆市,七堵區,20692,54055,27372,26683
2013/11/1,基隆市,暖暖區,14916,37831,19160,18671
2013/11/1,基隆市,仁愛區,19554,47029,23167,23862
2013/11/1,基隆市,中山區,19325,49303,25139,24164
2013/11/1,基隆市,安樂區,32110,81963,40843,41120
2013/11/1,基隆市,信義區,20694,51265,25605,25660
2013/11/1,新竹市,東區,73456,204332,100621,103711
2013/11/1,新竹市,北區,53439,147942,72780,75162
2013/11/1,新竹市,香山區,25107,75806,38614,37192
2013/11/1,嘉義市,東區,44969,123869,60285,63584
2013/11/1,嘉義市,西區,52634,147065,72416,74649
2013/11/1,金門縣,金城鎮,12209,38862,19546,19316
2013/11/1,金門縣,金湖鎮,8093,25919,13143,12776
2013/11/1,金門縣,金沙鎮,5907,18461,9188,9273
2013/11/1,金門縣,金寧鄉,7213,24980,12682,12298
2013/11/1,金門縣,烈嶼鄉,2918,11163,5486,5677
2013/11/1,金門縣,烏坵鄉,134,652,325,327
2013/11/1,連江縣,南竿鄉,1392,7242,4093,3149
2013/11/1,連江縣,北竿鄉,462,2265,1257,1008
2013/11/1,連江縣,莒光鄉,269,1437,844,593
2013/11/1,連江縣,東引鄉,291,1167,686,481
2013/12/1,總計,新北市,1477857,3954929,1950060,2004869
2013/12/1,總計,臺北市,1026738,2686516,1289945,1396571
2013/12/1,總計,臺中市,897191,2701661,1339733,1361928
2013/12/1,總計,臺南市,663131,1883208,944555,938653
2013/12/1,總計,高雄市,1056421,2779877,1385895,1393982
2013/12/1,總計,臺灣省,3125941,9234448,4706876,4527572
2013/12/1,總計,宜蘭縣,160883,458456,233000,225456
2013/12/1,總計,桃園市,716582,2044023,1026657,1017366
2013/12/1,總計,新竹縣,174836,530486,271904,258582
2013/12/1,總計,苗栗縣,180916,565554,292024,273530
2013/12/1,總計,彰化縣,375940,1296013,663500,632513
2013/12/1,總計,南投縣,175452,517222,265474,251748
2013/12/1,總計,雲林縣,236632,707792,368457,339335
2013/12/1,總計,嘉義縣,180652,529229,275686,253543
2013/12/1,總計,屏東縣,282187,852286,437086,415200
2013/12/1,總計,臺東縣,81786,224821,116883,107938
2013/12/1,總計,花蓮縣,123440,333897,171016,162881
2013/12/1,總計,澎湖縣,37151,100400,51711,48689
2013/12/1,總計,基隆市,149678,374914,188649,186265
2013/12/1,總計,新竹市,152163,428483,212183,216300
2013/12/1,總計,嘉義市,97643,270872,132646,138226
2013/12/1,總計,福建省,38981,132878,67610,65268
2013/12/1,總計,金門縣,36558,120713,60687,60026
2013/12/1,總計,連江縣,2423,12165,6923,5242
2013/12/1,新北市,板橋區,203555,556920,273387,283533
2013/12/1,新北市,三重區,145732,389813,193129,196684
2013/12/1,新北市,中和區,160988,415742,203704,212038
2013/12/1,新北市,永和區,90630,229062,109292,119770
2013/12/1,新北市,新莊區,144609,409760,201476,208284
2013/12/1,新北市,新店區,121059,299017,145092,153925
2013/12/1,新北市,樹林區,64323,183407,91859,91548
2013/12/1,新北市,鶯歌區,28881,88637,44506,44131
2013/12/1,新北市,三峽區,39459,110010,55635,54375
2013/12/1,新北市,淡水區,65495,155241,74943,80298
2013/12/1,新北市,汐止區,83244,194200,95471,98729
2013/12/1,新北市,瑞芳區,16025,41490,21000,20490
2013/12/1,新北市,土城區,85009,239258,118787,120471
2013/12/1,新北市,蘆洲區,68130,199426,98338,101088
2013/12/1,新北市,五股區,28737,81744,41292,40452
2013/12/1,新北市,泰山區,27275,77939,38879,39060
2013/12/1,新北市,林口區,36121,94108,46239,47869
2013/12/1,新北市,深坑區,9265,23622,11865,11757
2013/12/1,新北市,石碇區,3363,7848,4328,3520
2013/12/1,新北市,坪林區,2478,6460,3621,2839
2013/12/1,新北市,三芝區,9197,23464,12093,11371
2013/12/1,新北市,石門區,4264,12794,6658,6136
2013/12/1,新北市,八里區,13289,36201,18218,17983
2013/12/1,新北市,平溪區,2380,5002,2776,2226
2013/12/1,新北市,雙溪區,3860,9412,5065,4347
2013/12/1,新北市,貢寮區,4456,13306,6820,6486
2013/12/1,新北市,金山區,6934,22392,11132,11260
2013/12/1,新北市,萬里區,7317,22618,11456,11162
2013/12/1,新北市,烏來區,1782,6036,2999,3037
2013/12/1,臺北市,松山區,79801,210343,99484,110859
2013/12/1,臺北市,信義區,88412,228496,109662,118834
2013/12/1,臺北市,大安區,119480,313363,146933,166430
2013/12/1,臺北市,中山區,97336,228753,106998,121755
2013/12/1,臺北市,中正區,64589,163140,78206,84934
2013/12/1,臺北市,大同區,50568,129820,63576,66244
2013/12/1,臺北市,萬華區,77218,193480,95823,97657
2013/12/1,臺北市,文山區,101903,271341,130887,140454
2013/12/1,臺北市,南港區,45045,119752,58603,61149
2013/12/1,臺北市,內湖區,103801,282842,135718,147124
2013/12/1,臺北市,士林區,104767,289742,140361,149381
2013/12/1,臺北市,北投區,93818,255444,123694,131750
2013/12/1,臺中市,中區,7961,20008,9938,10070
2013/12/1,臺中市,東區,26863,74572,37312,37260
2013/12/1,臺中市,南區,44990,118349,57236,61113
2013/12/1,臺中市,西區,44535,116397,55523,60874
2013/12/1,臺中市,北區,57755,147880,71311,76569
2013/12/1,臺中市,西屯區,78576,215485,103958,111527
2013/12/1,臺中市,南屯區,57025,159952,76988,82964
2013/12/1,臺中市,北屯區,89689,255978,123577,132401
2013/12/1,臺中市,豐原區,51512,166090,82290,83800
2013/12/1,臺中市,東勢區,17213,51953,26874,25079
2013/12/1,臺中市,大甲區,22312,77847,39424,38423
2013/12/1,臺中市,清水區,25869,86061,44301,41760
2013/12/1,臺中市,沙鹿區,26371,86305,43787,42518
2013/12/1,臺中市,梧棲區,16541,56008,28266,27742
2013/12/1,臺中市,后里區,15255,54076,27604,26472
2013/12/1,臺中市,神岡區,18466,64899,33272,31627
2013/12/1,臺中市,潭子區,34217,104471,51904,52567
2013/12/1,臺中市,大雅區,27438,91939,46103,45836
2013/12/1,臺中市,新社區,7456,25322,13173,12149
2013/12/1,臺中市,石岡區,4900,15636,8149,7487
2013/12/1,臺中市,外埔區,9219,31845,16380,15465
2013/12/1,臺中市,大安區,5325,19720,10375,9345
2013/12/1,臺中市,烏日區,21934,70624,35741,34883
2013/12/1,臺中市,大肚區,16463,55995,28689,27306
2013/12/1,臺中市,龍井區,21711,75664,38405,37259
2013/12/1,臺中市,霧峰區,19322,64280,32865,31415
2013/12/1,臺中市,太平區,58289,178870,89358,89512
2013/12/1,臺中市,大里區,65586,204846,101233,103613
2013/12/1,臺中市,和平區,4398,10589,5697,4892
2013/12/1,臺南市,新營區,28243,78521,38966,39555
2013/12/1,臺南市,鹽水區,10033,26426,13778,12648
2013/12/1,臺南市,白河區,10987,30178,15815,14363
2013/12/1,臺南市,柳營區,7808,21932,11434,10498
2013/12/1,臺南市,後壁區,8938,24910,12971,11939
2013/12/1,臺南市,東山區,8292,22195,11773,10422
2013/12/1,臺南市,麻豆區,15424,45230,23011,22219
2013/12/1,臺南市,下營區,9118,25333,13048,12285
2013/12/1,臺南市,六甲區,7748,23151,11988,11163
2013/12/1,臺南市,官田區,7754,21823,11162,10661
2013/12/1,臺南市,大內區,4019,10408,5546,4862
2013/12/1,臺南市,佳里區,20012,59372,29471,29901
2013/12/1,臺南市,學甲區,9658,27167,13905,13262
2013/12/1,臺南市,西港區,7948,24914,12639,12275
2013/12/1,臺南市,七股區,8120,23871,12452,11419
2013/12/1,臺南市,將軍區,7378,20808,10594,10214
2013/12/1,臺南市,北門區,4397,11876,5989,5887
2013/12/1,臺南市,新化區,14069,43836,22448,21388
2013/12/1,臺南市,善化區,15716,45167,22789,22378
2013/12/1,臺南市,新市區,11378,35336,17775,17561
2013/12/1,臺南市,安定區,9653,30215,15589,14626
2013/12/1,臺南市,山上區,2713,7570,3966,3604
2013/12/1,臺南市,玉井區,5135,14821,7729,7092
2013/12/1,臺南市,楠西區,3557,10186,5412,4774
2013/12/1,臺南市,南化區,2856,8894,4842,4052
2013/12/1,臺南市,左鎮區,1993,5211,2916,2295
2013/12/1,臺南市,仁德區,26293,72444,36923,35521
2013/12/1,臺南市,歸仁區,21714,67101,34114,32987
2013/12/1,臺南市,關廟區,10843,35105,18171,16934
2013/12/1,臺南市,龍崎區,1584,4310,2338,1972
2013/12/1,臺南市,永康區,80151,226875,112265,114610
2013/12/1,臺南市,東區,71910,191576,92277,99299
2013/12/1,臺南市,南區,44335,125611,62597,63014
2013/12/1,臺南市,北區,49366,132336,64828,67508
2013/12/1,臺南市,安南區,58918,185412,93910,91502
2013/12/1,臺南市,安平區,24266,64589,30850,33739
2013/12/1,臺南市,中西區,30804,78498,38274,40224
2013/12/1,高雄市,鹽埕區,10981,25847,12892,12955
2013/12/1,高雄市,鼓山區,54918,135102,65677,69425
2013/12/1,高雄市,左營區,76391,195436,95262,100174
2013/12/1,高雄市,楠梓區,65087,177579,87812,89767
2013/12/1,高雄市,三民區,134019,348488,169679,178809
2013/12/1,高雄市,新興區,22748,53170,25669,27501
2013/12/1,高雄市,前金區,12578,28038,13554,14484
2013/12/1,高雄市,苓雅區,72273,177716,86060,91656
2013/12/1,高雄市,前鎮區,77627,194835,96310,98525
2013/12/1,高雄市,旗津區,10962,29040,15020,14020
2013/12/1,高雄市,小港區,65553,156115,77933,78182
2013/12/1,高雄市,鳳山區,134035,352574,174049,178525
2013/12/1,高雄市,林園區,25218,70436,35925,34511
2013/12/1,高雄市,大寮區,40291,110449,56969,53480
2013/12/1,高雄市,大樹區,13235,43418,22349,21069
2013/12/1,高雄市,大社區,12402,34097,17445,16652
2013/12/1,高雄市,仁武區,29426,79392,40668,38724
2013/12/1,高雄市,鳥松區,17354,43781,22251,21530
2013/12/1,高雄市,岡山區,34234,97800,48780,49020
2013/12/1,高雄市,橋頭區,13084,37010,18879,18131
2013/12/1,高雄市,燕巢區,10259,30542,16223,14319
2013/12/1,高雄市,田寮區,3447,7732,4305,3427
2013/12/1,高雄市,阿蓮區,9365,29795,15028,14767
2013/12/1,高雄市,路竹區,16472,53036,27099,25937
2013/12/1,高雄市,湖內區,10146,29203,14984,14219
2013/12/1,高雄市,茄萣區,10373,30868,16013,14855
2013/12/1,高雄市,永安區,5828,14138,7117,7021
2013/12/1,高雄市,彌陀區,6687,19920,10335,9585
2013/12/1,高雄市,梓官區,12355,36381,18808,17573
2013/12/1,高雄市,旗山區,13874,38563,19989,18574
2013/12/1,高雄市,美濃區,14455,41668,21743,19925
2013/12/1,高雄市,六龜區,5699,13943,7534,6409
2013/12/1,高雄市,甲仙區,2377,6444,3431,3013
2013/12/1,高雄市,杉林區,4823,12587,6862,5725
2013/12/1,高雄市,內門區,5071,15351,8355,6996
2013/12/1,高雄市,茂林區,579,1832,927,905
2013/12/1,高雄市,桃源區,1330,4406,2330,2076
2013/12/1,高雄市,那瑪夏區,865,3145,1629,1516
2013/12/1,宜蘭縣,宜蘭市,34861,95985,47023,48962
2013/12/1,宜蘭縣,羅東鎮,25609,72352,34550,37802
2013/12/1,宜蘭縣,蘇澳鎮,13861,41382,21124,20258
2013/12/1,宜蘭縣,頭城鎮,10001,30043,15532,14511
2013/12/1,宜蘭縣,礁溪鄉,13102,35998,18845,17153
2013/12/1,宜蘭縣,壯圍鄉,8389,24468,12976,11492
2013/12/1,宜蘭縣,員山鄉,11198,32159,17147,15012
2013/12/1,宜蘭縣,冬山鄉,18409,53731,27575,26156
2013/12/1,宜蘭縣,五結鄉,13759,39230,20339,18891
2013/12/1,宜蘭縣,三星鄉,7961,21191,11489,9702
2013/12/1,宜蘭縣,大同鄉,1866,6005,3270,2735
2013/12/1,宜蘭縣,南澳鄉,1867,5912,3130,2782
2013/12/1,桃園市,桃園區,153199,415414,203112,212302
2013/12/1,桃園市,中壢區,136030,378918,188475,190443
2013/12/1,桃園市,平鎮區,70874,211146,105878,105268
2013/12/1,桃園市,八德區,61863,179502,90786,88716
2013/12/1,桃園市,楊梅區,52488,155754,79079,76675
2013/12/1,桃園市,大溪區,30416,91961,47333,44628
2013/12/1,桃園市,蘆竹區,52750,149852,74888,74964
2013/12/1,桃園市,大園區,28072,83586,43088,40498
2013/12/1,桃園市,龜山區,53100,140509,70758,69751
2013/12/1,桃園市,龍潭區,38515,115728,58606,57122
2013/12/1,桃園市,新屋區,15277,48025,25705,22320
2013/12/1,桃園市,觀音區,20289,63003,33056,29947
2013/12/1,桃園市,復興區,3709,10625,5893,4732
2013/12/1,新竹縣,竹北市,55194,158849,79305,79544
2013/12/1,新竹縣,關西鎮,9501,30919,16485,14434
2013/12/1,新竹縣,新埔鎮,10592,34674,18428,16246
2013/12/1,新竹縣,竹東鎮,31949,96326,48469,47857
2013/12/1,新竹縣,湖口鄉,24752,76753,39015,37738
2013/12/1,新竹縣,橫山鄉,4506,13912,7525,6387
2013/12/1,新竹縣,新豐鄉,17127,55386,28425,26961
2013/12/1,新竹縣,芎林鄉,6404,20256,10698,9558
2013/12/1,新竹縣,寶山鄉,5037,14103,7639,6464
2013/12/1,新竹縣,北埔鄉,3157,9838,5306,4532
2013/12/1,新竹縣,峨眉鄉,2074,5764,3207,2557
2013/12/1,新竹縣,尖石鄉,2810,9167,4897,4270
2013/12/1,新竹縣,五峰鄉,1733,4539,2505,2034
2013/12/1,苗栗縣,苗栗市,30310,91109,45602,45507
2013/12/1,苗栗縣,苑裡鎮,14254,48493,25153,23340
2013/12/1,苗栗縣,通霄鎮,11513,37155,19630,17525
2013/12/1,苗栗縣,竹南鎮,26412,82351,41746,40605
2013/12/1,苗栗縣,頭份市,32267,101527,51351,50176
2013/12/1,苗栗縣,後龍鎮,11854,38439,20233,18206
2013/12/1,苗栗縣,卓蘭鎮,6177,18460,9683,8777
2013/12/1,苗栗縣,大湖鄉,5431,15694,8333,7361
2013/12/1,苗栗縣,公館鄉,10554,34790,18115,16675
2013/12/1,苗栗縣,銅鑼鄉,6118,19036,10107,8929
2013/12/1,苗栗縣,南庄鄉,3990,10742,5894,4848
2013/12/1,苗栗縣,頭屋鄉,3628,11408,6003,5405
2013/12/1,苗栗縣,三義鄉,5441,17411,9113,8298
2013/12/1,苗栗縣,西湖鄉,2708,7649,4249,3400
2013/12/1,苗栗縣,造橋鄉,4117,13517,7112,6405
2013/12/1,苗栗縣,三灣鄉,2435,7126,3889,3237
2013/12/1,苗栗縣,獅潭鄉,1729,4678,2614,2064
2013/12/1,苗栗縣,泰安鄉,1978,5969,3197,2772
2013/12/1,彰化縣,彰化市,74482,236172,117165,119007
2013/12/1,彰化縣,鹿港鎮,23356,85964,43863,42101
2013/12/1,彰化縣,和美鎮,25501,90541,46345,44196
2013/12/1,彰化縣,北斗鎮,10284,33151,16760,16391
2013/12/1,彰化縣,員林市,38043,124938,62613,62325
2013/12/1,彰化縣,溪湖鎮,15809,55802,28453,27349
2013/12/1,彰化縣,田中鎮,12864,43106,22350,20756
2013/12/1,彰化縣,二林鎮,14756,52864,27283,25581
2013/12/1,彰化縣,線西鄉,4253,17123,8852,8271
2013/12/1,彰化縣,伸港鄉,9388,36114,18521,17593
2013/12/1,彰化縣,福興鄉,12426,48015,25069,22946
2013/12/1,彰化縣,秀水鄉,10218,39385,20345,19040
2013/12/1,彰化縣,花壇鄉,13510,45987,23682,22305
2013/12/1,彰化縣,芬園鄉,6860,24258,12784,11474
2013/12/1,彰化縣,大村鄉,10637,36452,18926,17526
2013/12/1,彰化縣,埔鹽鄉,8992,33456,17562,15894
2013/12/1,彰化縣,埔心鄉,10266,35034,18095,16939
2013/12/1,彰化縣,永靖鄉,10727,38530,20044,18486
2013/12/1,彰化縣,社頭鄉,12618,43868,22541,21327
2013/12/1,彰化縣,二水鄉,5360,15999,8400,7599
2013/12/1,彰化縣,田尾鄉,7809,27984,14536,13448
2013/12/1,彰化縣,埤頭鄉,8835,31221,16261,14960
2013/12/1,彰化縣,芳苑鄉,10093,35104,18613,16491
2013/12/1,彰化縣,大城鄉,5357,18043,9765,8278
2013/12/1,彰化縣,竹塘鄉,4635,16040,8452,7588
2013/12/1,彰化縣,溪州鄉,8861,30862,16220,14642
2013/12/1,南投縣,南投市,34129,102790,51599,51191
2013/12/1,南投縣,埔里鎮,28805,83701,42054,41647
2013/12/1,南投縣,草屯鎮,32240,99297,50152,49145
2013/12/1,南投縣,竹山鎮,19907,57101,29354,27747
2013/12/1,南投縣,集集鎮,4354,11413,5965,5448
2013/12/1,南投縣,名間鄉,12508,40382,21193,19189
2013/12/1,南投縣,鹿谷鄉,7326,18667,9914,8753
2013/12/1,南投縣,中寮鄉,5651,15719,8540,7179
2013/12/1,南投縣,魚池鄉,5767,16696,8764,7932
2013/12/1,南投縣,國姓鄉,7273,19919,10805,9114
2013/12/1,南投縣,水里鄉,7279,19071,10005,9066
2013/12/1,南投縣,信義鄉,5260,16727,8995,7732
2013/12/1,南投縣,仁愛鄉,4953,15739,8134,7605
2013/12/1,雲林縣,斗六市,36608,108011,54035,53976
2013/12/1,雲林縣,斗南鎮,15623,46271,23530,22741
2013/12/1,雲林縣,虎尾鎮,23783,70486,35792,34694
2013/12/1,雲林縣,西螺鎮,14359,47482,24155,23327
2013/12/1,雲林縣,土庫鎮,9101,29797,15594,14203
2013/12/1,雲林縣,北港鎮,15887,41986,21837,20149
2013/12/1,雲林縣,古坑鄉,10862,32865,17332,15533
2013/12/1,雲林縣,大埤鄉,6766,20290,10902,9388
2013/12/1,雲林縣,莿桐鄉,9243,29825,15659,14166
2013/12/1,雲林縣,林內鄉,5860,19117,9971,9146
2013/12/1,雲林縣,二崙鄉,8910,28712,15320,13392
2013/12/1,雲林縣,崙背鄉,8516,26241,13852,12389
2013/12/1,雲林縣,麥寮鄉,13600,42526,21623,20903
2013/12/1,雲林縣,東勢鄉,5795,15810,8657,7153
2013/12/1,雲林縣,褒忠鄉,4411,13706,7345,6361
2013/12/1,雲林縣,臺西鄉,8819,24897,13384,11513
2013/12/1,雲林縣,元長鄉,9462,27640,15081,12559
2013/12/1,雲林縣,四湖鄉,9038,25501,13831,11670
2013/12/1,雲林縣,口湖鄉,9668,29344,15598,13746
2013/12/1,雲林縣,水林鄉,10321,27285,14959,12326
2013/12/1,嘉義縣,太保市,11983,37023,19114,17909
2013/12/1,嘉義縣,朴子市,15263,43599,22067,21532
2013/12/1,嘉義縣,布袋鎮,10170,28701,14725,13976
2013/12/1,嘉義縣,大林鎮,11401,32593,16714,15879
2013/12/1,嘉義縣,民雄鄉,23773,72096,36911,35185
2013/12/1,嘉義縣,溪口鄉,5423,15546,8269,7277
2013/12/1,嘉義縣,新港鄉,10551,33507,17716,15791
2013/12/1,嘉義縣,六腳鄉,9056,24947,13227,11720
2013/12/1,嘉義縣,東石鄉,9455,26305,13975,12330
2013/12/1,嘉義縣,義竹鄉,7564,19856,10321,9535
2013/12/1,嘉義縣,鹿草鄉,5832,16652,8936,7716
2013/12/1,嘉義縣,水上鄉,17769,51289,26477,24812
2013/12/1,嘉義縣,中埔鄉,15916,46694,24346,22348
2013/12/1,嘉義縣,竹崎鄉,11545,37372,19936,17436
2013/12/1,嘉義縣,梅山鄉,6780,20576,10911,9665
2013/12/1,嘉義縣,番路鄉,4296,12174,6618,5556
2013/12/1,嘉義縣,大埔鄉,1940,4567,2375,2192
2013/12/1,嘉義縣,阿里山鄉,1935,5732,3048,2684
2013/12/1,屏東縣,屏東市,73206,205945,102337,103608
2013/12/1,屏東縣,潮州鎮,18876,55207,27691,27516
2013/12/1,屏東縣,東港鎮,16145,48585,24559,24026
2013/12/1,屏東縣,恆春鎮,11132,30823,15763,15060
2013/12/1,屏東縣,萬丹鄉,14622,52536,27222,25314
2013/12/1,屏東縣,長治鄉,9948,30488,15924,14564
2013/12/1,屏東縣,麟洛鄉,3684,11303,5834,5469
2013/12/1,屏東縣,九如鄉,6743,22408,11609,10799
2013/12/1,屏東縣,里港鄉,8050,26506,13493,13013
2013/12/1,屏東縣,鹽埔鄉,7843,26660,13857,12803
2013/12/1,屏東縣,高樹鄉,9417,25682,13713,11969
2013/12/1,屏東縣,萬巒鄉,6450,21164,11132,10032
2013/12/1,屏東縣,內埔鄉,18317,56550,29315,27235
2013/12/1,屏東縣,竹田鄉,5623,17806,9458,8348
2013/12/1,屏東縣,新埤鄉,3407,10243,5452,4791
2013/12/1,屏東縣,枋寮鄉,8576,25693,13461,12232
2013/12/1,屏東縣,新園鄉,11711,37117,19230,17887
2013/12/1,屏東縣,崁頂鄉,4378,16429,8341,8088
2013/12/1,屏東縣,林邊鄉,7067,19573,10083,9490
2013/12/1,屏東縣,南州鄉,3664,11130,5697,5433
2013/12/1,屏東縣,佳冬鄉,7073,20538,10666,9872
2013/12/1,屏東縣,琉球鄉,4146,12415,6871,5544
2013/12/1,屏東縣,車城鄉,3478,9106,4911,4195
2013/12/1,屏東縣,滿州鄉,3033,8124,4474,3650
2013/12/1,屏東縣,枋山鄉,2135,5775,3081,2694
2013/12/1,屏東縣,三地門鄉,2253,7566,3847,3719
2013/12/1,屏東縣,霧臺鄉,1049,3199,1655,1544
2013/12/1,屏東縣,瑪家鄉,1949,6598,3403,3195
2013/12/1,屏東縣,泰武鄉,1259,5131,2696,2435
2013/12/1,屏東縣,來義鄉,2220,7610,3888,3722
2013/12/1,屏東縣,春日鄉,1333,4823,2482,2341
2013/12/1,屏東縣,獅子鄉,1517,4776,2476,2300
2013/12/1,屏東縣,牡丹鄉,1883,4777,2465,2312
2013/12/1,臺東縣,臺東市,38749,107316,54088,53228
2013/12/1,臺東縣,成功鎮,5447,15051,7949,7102
2013/12/1,臺東縣,關山鎮,3253,9268,4859,4409
2013/12/1,臺東縣,卑南鄉,6629,17763,9468,8295
2013/12/1,臺東縣,大武鄉,2514,6531,3410,3121
2013/12/1,臺東縣,太麻里鄉,4611,11595,6155,5440
2013/12/1,臺東縣,東河鄉,3734,8992,4991,4001
2013/12/1,臺東縣,長濱鄉,2921,7733,4408,3325
2013/12/1,臺東縣,鹿野鄉,3123,8229,4428,3801
2013/12/1,臺東縣,池上鄉,3278,8679,4572,4107
2013/12/1,臺東縣,綠島鄉,1093,3580,1898,1682
2013/12/1,臺東縣,延平鄉,1068,3552,1917,1635
2013/12/1,臺東縣,海端鄉,1090,4363,2374,1989
2013/12/1,臺東縣,達仁鄉,1487,3762,2046,1716
2013/12/1,臺東縣,金峰鄉,1098,3502,1819,1683
2013/12/1,臺東縣,蘭嶼鄉,1691,4905,2501,2404
2013/12/1,花蓮縣,花蓮市,41192,107281,52226,55055
2013/12/1,花蓮縣,鳳林鎮,4409,11397,6022,5375
2013/12/1,花蓮縣,玉里鎮,8939,25695,13823,11872
2013/12/1,花蓮縣,新城鄉,7470,20148,10423,9725
2013/12/1,花蓮縣,吉安鄉,30637,82157,41746,40411
2013/12/1,花蓮縣,壽豐鄉,6899,18109,9781,8328
2013/12/1,花蓮縣,光復鄉,5026,13459,7153,6306
2013/12/1,花蓮縣,豐濱鄉,1745,4632,2580,2052
2013/12/1,花蓮縣,瑞穗鄉,4660,12170,6548,5622
2013/12/1,花蓮縣,富里鄉,4004,10966,5972,4994
2013/12/1,花蓮縣,秀林鄉,4716,15267,7910,7357
2013/12/1,花蓮縣,萬榮鄉,2080,6495,3457,3038
2013/12/1,花蓮縣,卓溪鄉,1663,6121,3375,2746
2013/12/1,澎湖縣,馬公市,22420,59502,30261,29241
2013/12/1,澎湖縣,湖西鄉,5252,14221,7484,6737
2013/12/1,澎湖縣,白沙鄉,3271,9591,5031,4560
2013/12/1,澎湖縣,西嶼鄉,2911,8403,4320,4083
2013/12/1,澎湖縣,望安鄉,1993,5021,2700,2321
2013/12/1,澎湖縣,七美鄉,1304,3662,1915,1747
2013/12/1,基隆市,中正區,22371,53571,27428,26143
2013/12/1,基隆市,七堵區,20705,54041,27362,26679
2013/12/1,基隆市,暖暖區,14947,37860,19171,18689
2013/12/1,基隆市,仁愛區,19550,47034,23161,23873
2013/12/1,基隆市,中山區,19308,49254,25102,24152
2013/12/1,基隆市,安樂區,32107,81906,40820,41086
2013/12/1,基隆市,信義區,20690,51248,25605,25643
2013/12/1,新竹市,東區,73513,204578,100774,103804
2013/12/1,新竹市,北區,53502,148041,72803,75238
2013/12/1,新竹市,香山區,25148,75864,38606,37258
2013/12/1,嘉義市,東區,44955,123821,60226,63595
2013/12/1,嘉義市,西區,52688,147051,72420,74631
2013/12/1,金門縣,金城鎮,12225,39062,19638,19424
2013/12/1,金門縣,金湖鎮,8113,26074,13209,12865
2013/12/1,金門縣,金沙鎮,5919,18567,9235,9332
2013/12/1,金門縣,金寧鄉,7245,25118,12752,12366
2013/12/1,金門縣,烈嶼鄉,2922,11236,5525,5711
2013/12/1,金門縣,烏坵鄉,134,656,328,328
2013/12/1,連江縣,南竿鄉,1397,7288,4129,3159
2013/12/1,連江縣,北竿鄉,465,2268,1259,1009
2013/12/1,連江縣,莒光鄉,270,1438,845,593
2013/12/1,連江縣,東引鄉,291,1171,690,481
2014/1/1,總計,新北市,1478482,3955777,1950128,2005649
2014/1/1,總計,臺北市,1027004,2688140,1290558,1397582
2014/1/1,總計,臺中市,898132,2702920,1340199,1362721
2014/1/1,總計,臺南市,663429,1883251,944512,938739
2014/1/1,總計,高雄市,1056653,2779790,1385726,1394064
2014/1/1,總計,臺灣省,3127501,9234181,4706445,4527736
2014/1/1,總計,宜蘭縣,160968,458378,232900,225478
2014/1/1,總計,桃園市,717215,2044857,1026942,1017915
2014/1/1,總計,新竹縣,175080,530882,272083,258799
2014/1/1,總計,苗栗縣,181042,565661,292016,273645
2014/1/1,總計,彰化縣,376012,1295658,663264,632394
2014/1/1,總計,南投縣,175472,517037,265388,251649
2014/1/1,總計,雲林縣,236665,707389,368315,339074
2014/1/1,總計,嘉義縣,180688,528825,275494,253331
2014/1/1,總計,屏東縣,282201,851774,436808,414966
2014/1/1,總計,臺東縣,81763,224738,116809,107929
2014/1/1,總計,花蓮縣,123471,333823,170947,162876
2014/1/1,總計,澎湖縣,37225,100585,51843,48742
2014/1/1,總計,基隆市,149701,374799,188614,186185
2014/1/1,總計,新竹市,152333,428834,212359,216475
2014/1/1,總計,嘉義市,97665,270941,132663,138278
2014/1/1,總計,福建省,39034,133456,67870,65586
2014/1/1,總計,金門縣,36605,121261,60930,60331
2014/1/1,總計,連江縣,2429,12195,6940,5255
2014/1/1,新北市,板橋區,203607,556933,273343,283590
2014/1/1,新北市,三重區,145798,389762,193076,196686
2014/1/1,新北市,中和區,160971,415742,203673,212069
2014/1/1,新北市,永和區,90616,229042,109247,119795
2014/1/1,新北市,新莊區,144708,409864,201438,208426
2014/1/1,新北市,新店區,121127,299042,145123,153919
2014/1/1,新北市,樹林區,64366,183553,91922,91631
2014/1/1,新北市,鶯歌區,28909,88684,44522,44162
2014/1/1,新北市,三峽區,39480,110072,55657,54415
2014/1/1,新北市,淡水區,65669,155547,75064,80483
2014/1/1,新北市,汐止區,83204,194115,95425,98690
2014/1/1,新北市,瑞芳區,16021,41450,20973,20477
2014/1/1,新北市,土城區,84968,239172,118732,120440
2014/1/1,新北市,蘆洲區,68171,199447,98339,101108
2014/1/1,新北市,五股區,28761,81763,41292,40471
2014/1/1,新北市,泰山區,27308,78014,38910,39104
2014/1/1,新北市,林口區,36219,94440,46382,48058
2014/1/1,新北市,深坑區,9258,23583,11856,11727
2014/1/1,新北市,石碇區,3361,7847,4321,3526
2014/1/1,新北市,坪林區,2473,6463,3621,2842
2014/1/1,新北市,三芝區,9190,23459,12088,11371
2014/1/1,新北市,石門區,4259,12772,6649,6123
2014/1/1,新北市,八里區,13334,36299,18267,18032
2014/1/1,新北市,平溪區,2377,4996,2770,2226
2014/1/1,新北市,雙溪區,3853,9401,5064,4337
2014/1/1,新北市,貢寮區,4451,13293,6809,6484
2014/1/1,新北市,金山區,6930,22383,11124,11259
2014/1/1,新北市,萬里區,7319,22599,11439,11160
2014/1/1,新北市,烏來區,1774,6040,3002,3038
2014/1/1,臺北市,松山區,79797,210411,99512,110899
2014/1/1,臺北市,信義區,88435,228621,109727,118894
2014/1/1,臺北市,大安區,119437,313461,146907,166554
2014/1/1,臺北市,中山區,97352,228926,107081,121845
2014/1/1,臺北市,中正區,64607,163235,78235,85000
2014/1/1,臺北市,大同區,50580,129949,63632,66317
2014/1/1,臺北市,萬華區,77223,193458,95795,97663
2014/1/1,臺北市,文山區,101965,271555,130961,140594
2014/1/1,臺北市,南港區,45109,119955,58697,61258
2014/1/1,臺北市,內湖區,103858,283085,135803,147282
2014/1/1,臺北市,士林區,104779,289898,140457,149441
2014/1/1,臺北市,北投區,93862,255586,123751,131835
2014/1/1,臺中市,中區,7931,19945,9899,10046
2014/1/1,臺中市,東區,26875,74579,37295,37284
2014/1/1,臺中市,南區,45010,118386,57268,61118
2014/1/1,臺中市,西區,44537,116395,55517,60878
2014/1/1,臺中市,北區,57792,147820,71267,76553
2014/1/1,臺中市,西屯區,78714,215698,104028,111670
2014/1/1,臺中市,南屯區,57165,160133,77037,83096
2014/1/1,臺中市,北屯區,89873,256353,123720,132633
2014/1/1,臺中市,豐原區,51556,166075,82285,83790
2014/1/1,臺中市,東勢區,17218,51936,26860,25076
2014/1/1,臺中市,大甲區,22336,77889,39438,38451
2014/1/1,臺中市,清水區,25868,86063,44293,41770
2014/1/1,臺中市,沙鹿區,26388,86431,43868,42563
2014/1/1,臺中市,梧棲區,16550,56035,28284,27751
2014/1/1,臺中市,后里區,15269,54090,27616,26474
2014/1/1,臺中市,神岡區,18471,64903,33289,31614
2014/1/1,臺中市,潭子區,34245,104477,51905,52572
2014/1/1,臺中市,大雅區,27488,92028,46152,45876
2014/1/1,臺中市,新社區,7456,25311,13167,12144
2014/1/1,臺中市,石岡區,4899,15634,8145,7489
2014/1/1,臺中市,外埔區,9221,31839,16378,15461
2014/1/1,臺中市,大安區,5326,19700,10367,9333
2014/1/1,臺中市,烏日區,21977,70656,35747,34909
2014/1/1,臺中市,大肚區,16475,56026,28697,27329
2014/1/1,臺中市,龍井區,21718,75697,38427,37270
2014/1/1,臺中市,霧峰區,19343,64357,32883,31474
2014/1/1,臺中市,太平區,58387,179031,89454,89577
2014/1/1,臺中市,大里區,65650,204847,101221,103626
2014/1/1,臺中市,和平區,4394,10586,5692,4894
2014/1/1,臺南市,新營區,28278,78560,38978,39582
2014/1/1,臺南市,鹽水區,10039,26394,13764,12630
2014/1/1,臺南市,白河區,10972,30134,15777,14357
2014/1/1,臺南市,柳營區,7806,21899,11420,10479
2014/1/1,臺南市,後壁區,8923,24865,12950,11915
2014/1/1,臺南市,東山區,8287,22163,11763,10400
2014/1/1,臺南市,麻豆區,15421,45199,22980,22219
2014/1/1,臺南市,下營區,9114,25298,13039,12259
2014/1/1,臺南市,六甲區,7747,23131,11978,11153
2014/1/1,臺南市,官田區,7747,21800,11148,10652
2014/1/1,臺南市,大內區,4020,10385,5536,4849
2014/1/1,臺南市,佳里區,20029,59403,29479,29924
2014/1/1,臺南市,學甲區,9653,27137,13888,13249
2014/1/1,臺南市,西港區,7952,24899,12633,12266
2014/1/1,臺南市,七股區,8121,23840,12446,11394
2014/1/1,臺南市,將軍區,7377,20795,10591,10204
2014/1/1,臺南市,北門區,4391,11846,5978,5868
2014/1/1,臺南市,新化區,14078,43850,22438,21412
2014/1/1,臺南市,善化區,15770,45247,22824,22423
2014/1/1,臺南市,新市區,11404,35394,17799,17595
2014/1/1,臺南市,安定區,9666,30233,15585,14648
2014/1/1,臺南市,山上區,2708,7563,3964,3599
2014/1/1,臺南市,玉井區,5136,14807,7722,7085
2014/1/1,臺南市,楠西區,3547,10171,5402,4769
2014/1/1,臺南市,南化區,2857,8887,4837,4050
2014/1/1,臺南市,左鎮區,1994,5213,2918,2295
2014/1/1,臺南市,仁德區,26292,72418,36914,35504
2014/1/1,臺南市,歸仁區,21720,67107,34112,32995
2014/1/1,臺南市,關廟區,10851,35107,18171,16936
2014/1/1,臺南市,龍崎區,1584,4309,2336,1973
2014/1/1,臺南市,永康區,80226,227002,112333,114669
2014/1/1,臺南市,東區,71911,191542,92237,99305
2014/1/1,臺南市,南區,44326,125586,62593,62993
2014/1/1,臺南市,北區,49383,132339,64859,67480
2014/1/1,臺南市,安南區,59000,185585,93978,91607
2014/1/1,臺南市,安平區,24271,64579,30836,33743
2014/1/1,臺南市,中西區,30828,78564,38306,40258
2014/1/1,高雄市,鹽埕區,10979,25846,12882,12964
2014/1/1,高雄市,鼓山區,54920,135170,65744,69426
2014/1/1,高雄市,左營區,76413,195436,95181,100255
2014/1/1,高雄市,楠梓區,65171,177684,87884,89800
2014/1/1,高雄市,三民區,134069,348408,169598,178810
2014/1/1,高雄市,新興區,22723,53134,25652,27482
2014/1/1,高雄市,前金區,12558,27987,13520,14467
2014/1/1,高雄市,苓雅區,72215,177543,85990,91553
2014/1/1,高雄市,前鎮區,77594,194681,96258,98423
2014/1/1,高雄市,旗津區,10958,29000,15005,13995
2014/1/1,高雄市,小港區,65576,156187,77953,78234
2014/1/1,高雄市,鳳山區,134069,352768,174134,178634
2014/1/1,高雄市,林園區,25253,70452,35929,34523
2014/1/1,高雄市,大寮區,40322,110487,56992,53495
2014/1/1,高雄市,大樹區,13222,43356,22307,21049
2014/1/1,高雄市,大社區,12435,34121,17466,16655
2014/1/1,高雄市,仁武區,29485,79487,40705,38782
2014/1/1,高雄市,鳥松區,17358,43812,22266,21546
2014/1/1,高雄市,岡山區,34251,97834,48761,49073
2014/1/1,高雄市,橋頭區,13079,37047,18905,18142
2014/1/1,高雄市,燕巢區,10253,30524,16218,14306
2014/1/1,高雄市,田寮區,3443,7724,4301,3423
2014/1/1,高雄市,阿蓮區,9362,29803,15033,14770
2014/1/1,高雄市,路竹區,16467,52990,27064,25926
2014/1/1,高雄市,湖內區,10155,29220,14988,14232
2014/1/1,高雄市,茄萣區,10375,30863,16011,14852
2014/1/1,高雄市,永安區,5827,14132,7114,7018
2014/1/1,高雄市,彌陀區,6696,19918,10327,9591
2014/1/1,高雄市,梓官區,12359,36398,18819,17579
2014/1/1,高雄市,旗山區,13870,38528,19969,18559
2014/1/1,高雄市,美濃區,14459,41640,21725,19915
2014/1/1,高雄市,六龜區,5696,13921,7526,6395
2014/1/1,高雄市,甲仙區,2375,6438,3429,3009
2014/1/1,高雄市,杉林區,4818,12560,6852,5708
2014/1/1,高雄市,內門區,5076,15318,8342,6976
2014/1/1,高雄市,茂林區,577,1834,925,909
2014/1/1,高雄市,桃源區,1331,4400,2323,2077
2014/1/1,高雄市,那瑪夏區,864,3139,1628,1511
2014/1/1,宜蘭縣,宜蘭市,34843,95928,46969,48959
2014/1/1,宜蘭縣,羅東鎮,25615,72331,34530,37801
2014/1/1,宜蘭縣,蘇澳鎮,13863,41328,21096,20232
2014/1/1,宜蘭縣,頭城鎮,10002,30025,15534,14491
2014/1/1,宜蘭縣,礁溪鄉,13105,35982,18827,17155
2014/1/1,宜蘭縣,壯圍鄉,8402,24504,12986,11518
2014/1/1,宜蘭縣,員山鄉,11208,32152,17149,15003
2014/1/1,宜蘭縣,冬山鄉,18431,53734,27571,26163
2014/1/1,宜蘭縣,五結鄉,13777,39261,20341,18920
2014/1/1,宜蘭縣,三星鄉,7985,21207,11493,9714
2014/1/1,宜蘭縣,大同鄉,1866,6014,3268,2746
2014/1/1,宜蘭縣,南澳鄉,1871,5912,3136,2776
2014/1/1,桃園市,桃園區,153236,415431,203107,212324
2014/1/1,桃園市,中壢區,136188,379127,188539,190588
2014/1/1,桃園市,平鎮區,70924,211210,105881,105329
2014/1/1,桃園市,八德區,61989,179725,90901,88824
2014/1/1,桃園市,楊梅區,52572,155851,79145,76706
2014/1/1,桃園市,大溪區,30423,91910,47302,44608
2014/1/1,桃園市,蘆竹區,52830,150070,74972,75098
2014/1/1,桃園市,大園區,28091,83590,43086,40504
2014/1/1,桃園市,龜山區,53118,140481,70724,69757
2014/1/1,桃園市,龍潭區,38529,115786,58624,57162
2014/1/1,桃園市,新屋區,15283,47988,25683,22305
2014/1/1,桃園市,觀音區,20319,63050,33089,29961
2014/1/1,桃園市,復興區,3713,10638,5889,4749
2014/1/1,新竹縣,竹北市,55387,159318,79509,79809
2014/1/1,新竹縣,關西鎮,9501,30870,16460,14410
2014/1/1,新竹縣,新埔鎮,10597,34667,18429,16238
2014/1/1,新竹縣,竹東鎮,31962,96265,48442,47823
2014/1/1,新竹縣,湖口鄉,24766,76782,39020,37762
2014/1/1,新竹縣,橫山鄉,4504,13907,7528,6379
2014/1/1,新竹縣,新豐鄉,17145,55389,28424,26965
2014/1/1,新竹縣,芎林鄉,6398,20244,10699,9545
2014/1/1,新竹縣,寶山鄉,5046,14113,7643,6470
2014/1/1,新竹縣,北埔鄉,3152,9825,5302,4523
2014/1/1,新竹縣,峨眉鄉,2073,5747,3201,2546
2014/1/1,新竹縣,尖石鄉,2816,9200,4919,4281
2014/1/1,新竹縣,五峰鄉,1733,4555,2507,2048
2014/1/1,苗栗縣,苗栗市,30340,91138,45602,45536
2014/1/1,苗栗縣,苑裡鎮,14268,48500,25154,23346
2014/1/1,苗栗縣,通霄鎮,11506,37142,19629,17513
2014/1/1,苗栗縣,竹南鎮,26466,82515,41818,40697
2014/1/1,苗栗縣,頭份市,32297,101596,51372,50224
2014/1/1,苗栗縣,後龍鎮,11848,38387,20201,18186
2014/1/1,苗栗縣,卓蘭鎮,6184,18462,9678,8784
2014/1/1,苗栗縣,大湖鄉,5434,15677,8318,7359
2014/1/1,苗栗縣,公館鄉,10551,34808,18118,16690
2014/1/1,苗栗縣,銅鑼鄉,6119,19007,10100,8907
2014/1/1,苗栗縣,南庄鄉,3988,10727,5883,4844
2014/1/1,苗栗縣,頭屋鄉,3627,11403,6008,5395
2014/1/1,苗栗縣,三義鄉,5440,17394,9112,8282
2014/1/1,苗栗縣,西湖鄉,2711,7647,4243,3404
2014/1/1,苗栗縣,造橋鄉,4123,13505,7102,6403
2014/1/1,苗栗縣,三灣鄉,2431,7121,3882,3239
2014/1/1,苗栗縣,獅潭鄉,1731,4668,2605,2063
2014/1/1,苗栗縣,泰安鄉,1978,5964,3191,2773
2014/1/1,彰化縣,彰化市,74504,236065,117077,118988
2014/1/1,彰化縣,鹿港鎮,23362,85918,43842,42076
2014/1/1,彰化縣,和美鎮,25525,90549,46344,44205
2014/1/1,彰化縣,北斗鎮,10289,33161,16763,16398
2014/1/1,彰化縣,員林市,38030,125010,62636,62374
2014/1/1,彰化縣,溪湖鎮,15806,55769,28430,27339
2014/1/1,彰化縣,田中鎮,12858,43107,22332,20775
2014/1/1,彰化縣,二林鎮,14756,52837,27277,25560
2014/1/1,彰化縣,線西鄉,4251,17133,8860,8273
2014/1/1,彰化縣,伸港鄉,9385,36090,18505,17585
2014/1/1,彰化縣,福興鄉,12435,48043,25085,22958
2014/1/1,彰化縣,秀水鄉,10229,39395,20346,19049
2014/1/1,彰化縣,花壇鄉,13518,45965,23678,22287
2014/1/1,彰化縣,芬園鄉,6856,24247,12770,11477
2014/1/1,彰化縣,大村鄉,10660,36461,18933,17528
2014/1/1,彰化縣,埔鹽鄉,8984,33440,17555,15885
2014/1/1,彰化縣,埔心鄉,10275,35034,18090,16944
2014/1/1,彰化縣,永靖鄉,10728,38500,20039,18461
2014/1/1,彰化縣,社頭鄉,12622,43866,22559,21307
2014/1/1,彰化縣,二水鄉,5355,15970,8386,7584
2014/1/1,彰化縣,田尾鄉,7806,27964,14521,13443
2014/1/1,彰化縣,埤頭鄉,8832,31186,16244,14942
2014/1/1,彰化縣,芳苑鄉,10087,35057,18581,16476
2014/1/1,彰化縣,大城鄉,5358,18018,9749,8269
2014/1/1,彰化縣,竹塘鄉,4633,16030,8452,7578
2014/1/1,彰化縣,溪州鄉,8868,30843,16210,14633
2014/1/1,南投縣,南投市,34115,102758,51605,51153
2014/1/1,南投縣,埔里鎮,28824,83693,42055,41638
2014/1/1,南投縣,草屯鎮,32269,99351,50164,49187
2014/1/1,南投縣,竹山鎮,19902,57045,29334,27711
2014/1/1,南投縣,集集鎮,4348,11399,5950,5449
2014/1/1,南投縣,名間鄉,12507,40339,21180,19159
2014/1/1,南投縣,鹿谷鄉,7343,18667,9918,8749
2014/1/1,南投縣,中寮鄉,5648,15704,8532,7172
2014/1/1,南投縣,魚池鄉,5764,16691,8754,7937
2014/1/1,南投縣,國姓鄉,7271,19879,10777,9102
2014/1/1,南投縣,水里鄉,7276,19045,9996,9049
2014/1/1,南投縣,信義鄉,5258,16725,8983,7742
2014/1/1,南投縣,仁愛鄉,4947,15741,8140,7601
2014/1/1,雲林縣,斗六市,36606,107973,54028,53945
2014/1/1,雲林縣,斗南鎮,15623,46244,23532,22712
2014/1/1,雲林縣,虎尾鎮,23813,70469,35799,34670
2014/1/1,雲林縣,西螺鎮,14364,47465,24155,23310
2014/1/1,雲林縣,土庫鎮,9107,29802,15590,14212
2014/1/1,雲林縣,北港鎮,15887,41964,21823,20141
2014/1/1,雲林縣,古坑鄉,10861,32847,17318,15529
2014/1/1,雲林縣,大埤鄉,6763,20228,10871,9357
2014/1/1,雲林縣,莿桐鄉,9252,29779,15642,14137
2014/1/1,雲林縣,林內鄉,5864,19105,9965,9140
2014/1/1,雲林縣,二崙鄉,8915,28687,15313,13374
2014/1/1,雲林縣,崙背鄉,8511,26207,13837,12370
2014/1/1,雲林縣,麥寮鄉,13617,42577,21636,20941
2014/1/1,雲林縣,東勢鄉,5791,15793,8653,7140
2014/1/1,雲林縣,褒忠鄉,4411,13695,7338,6357
2014/1/1,雲林縣,臺西鄉,8813,24925,13392,11533
2014/1/1,雲林縣,元長鄉,9459,27599,15068,12531
2014/1/1,雲林縣,四湖鄉,9029,25485,13835,11650
2014/1/1,雲林縣,口湖鄉,9664,29300,15583,13717
2014/1/1,雲林縣,水林鄉,10315,27245,14937,12308
2014/1/1,嘉義縣,太保市,11997,36996,19098,17898
2014/1/1,嘉義縣,朴子市,15275,43594,22081,21513
2014/1/1,嘉義縣,布袋鎮,10174,28689,14709,13980
2014/1/1,嘉義縣,大林鎮,11388,32527,16688,15839
2014/1/1,嘉義縣,民雄鄉,23786,72087,36918,35169
2014/1/1,嘉義縣,溪口鄉,5424,15533,8262,7271
2014/1/1,嘉義縣,新港鄉,10553,33497,17723,15774
2014/1/1,嘉義縣,六腳鄉,9053,24903,13201,11702
2014/1/1,嘉義縣,東石鄉,9453,26288,13965,12323
2014/1/1,嘉義縣,義竹鄉,7568,19821,10306,9515
2014/1/1,嘉義縣,鹿草鄉,5825,16629,8923,7706
2014/1/1,嘉義縣,水上鄉,17782,51248,26446,24802
2014/1/1,嘉義縣,中埔鄉,15903,46639,24323,22316
2014/1/1,嘉義縣,竹崎鄉,11553,37337,19913,17424
2014/1/1,嘉義縣,梅山鄉,6779,20559,10905,9654
2014/1/1,嘉義縣,番路鄉,4300,12159,6604,5555
2014/1/1,嘉義縣,大埔鄉,1942,4587,2379,2208
2014/1/1,嘉義縣,阿里山鄉,1933,5732,3050,2682
2014/1/1,屏東縣,屏東市,73175,205756,102223,103533
2014/1/1,屏東縣,潮州鎮,18902,55184,27682,27502
2014/1/1,屏東縣,東港鎮,16147,48582,24556,24026
2014/1/1,屏東縣,恆春鎮,11137,30827,15774,15053
2014/1/1,屏東縣,萬丹鄉,14636,52522,27220,25302
2014/1/1,屏東縣,長治鄉,9960,30502,15925,14577
2014/1/1,屏東縣,麟洛鄉,3686,11295,5838,5457
2014/1/1,屏東縣,九如鄉,6743,22381,11594,10787
2014/1/1,屏東縣,里港鄉,8050,26533,13509,13024
2014/1/1,屏東縣,鹽埔鄉,7836,26663,13857,12806
2014/1/1,屏東縣,高樹鄉,9422,25642,13689,11953
2014/1/1,屏東縣,萬巒鄉,6446,21131,11114,10017
2014/1/1,屏東縣,內埔鄉,18297,56481,29278,27203
2014/1/1,屏東縣,竹田鄉,5628,17804,9458,8346
2014/1/1,屏東縣,新埤鄉,3408,10234,5446,4788
2014/1/1,屏東縣,枋寮鄉,8582,25673,13452,12221
2014/1/1,屏東縣,新園鄉,11714,37084,19210,17874
2014/1/1,屏東縣,崁頂鄉,4379,16400,8330,8070
2014/1/1,屏東縣,林邊鄉,7065,19529,10062,9467
2014/1/1,屏東縣,南州鄉,3665,11111,5687,5424
2014/1/1,屏東縣,佳冬鄉,7067,20509,10654,9855
2014/1/1,屏東縣,琉球鄉,4161,12448,6887,5561
2014/1/1,屏東縣,車城鄉,3477,9097,4901,4196
2014/1/1,屏東縣,滿州鄉,3027,8108,4463,3645
2014/1/1,屏東縣,枋山鄉,2132,5772,3076,2696
2014/1/1,屏東縣,三地門鄉,2255,7572,3854,3718
2014/1/1,屏東縣,霧臺鄉,1050,3221,1663,1558
2014/1/1,屏東縣,瑪家鄉,1949,6598,3405,3193
2014/1/1,屏東縣,泰武鄉,1263,5144,2699,2445
2014/1/1,屏東縣,來義鄉,2219,7597,3883,3714
2014/1/1,屏東縣,春日鄉,1331,4823,2483,2340
2014/1/1,屏東縣,獅子鄉,1512,4775,2475,2300
2014/1/1,屏東縣,牡丹鄉,1880,4776,2461,2315
2014/1/1,臺東縣,臺東市,38753,107328,54072,53256
2014/1/1,臺東縣,成功鎮,5443,15048,7947,7101
2014/1/1,臺東縣,關山鎮,3244,9247,4851,4396
2014/1/1,臺東縣,卑南鄉,6620,17743,9457,8286
2014/1/1,臺東縣,大武鄉,2511,6515,3398,3117
2014/1/1,臺東縣,太麻里鄉,4611,11593,6147,5446
2014/1/1,臺東縣,東河鄉,3734,8973,4979,3994
2014/1/1,臺東縣,長濱鄉,2915,7719,4404,3315
2014/1/1,臺東縣,鹿野鄉,3119,8221,4418,3803
2014/1/1,臺東縣,池上鄉,3277,8680,4572,4108
2014/1/1,臺東縣,綠島鄉,1099,3591,1911,1680
2014/1/1,臺東縣,延平鄉,1068,3554,1919,1635
2014/1/1,臺東縣,海端鄉,1089,4359,2369,1990
2014/1/1,臺東縣,達仁鄉,1485,3747,2041,1706
2014/1/1,臺東縣,金峰鄉,1099,3506,1818,1688
2014/1/1,臺東縣,蘭嶼鄉,1696,4914,2506,2408
2014/1/1,花蓮縣,花蓮市,41183,107256,52228,55028
2014/1/1,花蓮縣,鳳林鎮,4415,11402,6018,5384
2014/1/1,花蓮縣,玉里鎮,8922,25636,13776,11860
2014/1/1,花蓮縣,新城鄉,7465,20126,10414,9712
2014/1/1,花蓮縣,吉安鄉,30688,82199,41758,40441
2014/1/1,花蓮縣,壽豐鄉,6899,18114,9778,8336
2014/1/1,花蓮縣,光復鄉,5029,13449,7146,6303
2014/1/1,花蓮縣,豐濱鄉,1744,4630,2583,2047
2014/1/1,花蓮縣,瑞穗鄉,4663,12179,6547,5632
2014/1/1,花蓮縣,富里鄉,3999,10947,5963,4984
2014/1/1,花蓮縣,秀林鄉,4723,15272,7913,7359
2014/1/1,花蓮縣,萬榮鄉,2078,6485,3448,3037
2014/1/1,花蓮縣,卓溪鄉,1663,6128,3375,2753
2014/1/1,澎湖縣,馬公市,22461,59583,30325,29258
2014/1/1,澎湖縣,湖西鄉,5268,14239,7505,6734
2014/1/1,澎湖縣,白沙鄉,3283,9624,5044,4580
2014/1/1,澎湖縣,西嶼鄉,2916,8428,4333,4095
2014/1/1,澎湖縣,望安鄉,1995,5031,2708,2323
2014/1/1,澎湖縣,七美鄉,1302,3680,1928,1752
2014/1/1,基隆市,中正區,22368,53519,27396,26123
2014/1/1,基隆市,七堵區,20699,54001,27339,26662
2014/1/1,基隆市,暖暖區,14983,37909,19205,18704
2014/1/1,基隆市,仁愛區,19550,47021,23154,23867
2014/1/1,基隆市,中山區,19296,49222,25099,24123
2014/1/1,基隆市,安樂區,32118,81897,40812,41085
2014/1/1,基隆市,信義區,20687,51230,25609,25621
2014/1/1,新竹市,東區,73629,204822,100894,103928
2014/1/1,新竹市,北區,53529,148055,72816,75239
2014/1/1,新竹市,香山區,25175,75957,38649,37308
2014/1/1,嘉義市,東區,44959,123796,60216,63580
2014/1/1,嘉義市,西區,52706,147145,72447,74698
2014/1/1,金門縣,金城鎮,12221,39193,19690,19503
2014/1/1,金門縣,金湖鎮,8123,26171,13240,12931
2014/1/1,金門縣,金沙鎮,5919,18634,9273,9361
2014/1/1,金門縣,金寧鄉,7275,25312,12849,12463
2014/1/1,金門縣,烈嶼鄉,2933,11292,5549,5743
2014/1/1,金門縣,烏坵鄉,134,659,329,330
2014/1/1,連江縣,南竿鄉,1399,7317,4146,3171
2014/1/1,連江縣,北竿鄉,466,2270,1258,1012
2014/1/1,連江縣,莒光鄉,273,1436,845,591
2014/1/1,連江縣,東引鄉,291,1172,691,481
2014/2/1,總計,新北市,1479124,3955842,1949785,2006057
2014/2/1,總計,臺北市,1027238,2689327,1291019,1398308
2014/2/1,總計,臺中市,898996,2704070,1340655,1363415
2014/2/1,總計,臺南市,663605,1883033,944325,938708
2014/2/1,總計,高雄市,1056921,2779653,1385335,1394318
2014/2/1,總計,臺灣省,3128801,9233227,4705383,4527844
2014/2/1,總計,宜蘭縣,160994,458312,232839,225473
2014/2/1,總計,桃園市,717831,2045309,1027061,1018248
2014/2/1,總計,新竹縣,175282,531303,272244,259059
2014/2/1,總計,苗栗縣,181132,565666,291976,273690
2014/2/1,總計,彰化縣,376085,1295375,663081,632294
2014/2/1,總計,南投縣,175463,516731,265215,251516
2014/2/1,總計,雲林縣,236716,707188,368142,339046
2014/2/1,總計,嘉義縣,180698,528148,275126,253022
2014/2/1,總計,屏東縣,282224,851432,436623,414809
2014/2/1,總計,臺東縣,81800,224753,116743,108010
2014/2/1,總計,花蓮縣,123524,333653,170801,162852
2014/2/1,總計,澎湖縣,37243,100609,51858,48751
2014/2/1,總計,基隆市,149723,374658,188496,186162
2014/2/1,總計,新竹市,152408,429018,212429,216589
2014/2/1,總計,嘉義市,97678,271072,132749,138323
2014/2/1,總計,福建省,39104,133977,68123,65854
2014/2/1,總計,金門縣,36701,121749,61161,60588
2014/2/1,總計,連江縣,2403,12228,6962,5266
2014/2/1,新北市,板橋區,203654,557007,273306,283701
2014/2/1,新北市,三重區,145845,389608,192932,196676
2014/2/1,新北市,中和區,161001,415609,203544,212065
2014/2/1,新北市,永和區,90637,229032,109226,119806
2014/2/1,新北市,新莊區,144811,409956,201445,208511
2014/2/1,新北市,新店區,121123,298854,144988,153866
2014/2/1,新北市,樹林區,64443,183566,91972,91594
2014/2/1,新北市,鶯歌區,28916,88726,44545,44181
2014/2/1,新北市,三峽區,39495,110120,55688,54432
2014/2/1,新北市,淡水區,65829,155770,75172,80598
2014/2/1,新北市,汐止區,83205,194074,95401,98673
2014/2/1,新北市,瑞芳區,16024,41439,20957,20482
2014/2/1,新北市,土城區,84937,239015,118616,120399
2014/2/1,新北市,蘆洲區,68197,199414,98306,101108
2014/2/1,新北市,五股區,28771,81759,41294,40465
2014/2/1,新北市,泰山區,27326,78062,38929,39133
2014/2/1,新北市,林口區,36316,94689,46491,48198
2014/2/1,新北市,深坑區,9253,23581,11851,11730
2014/2/1,新北市,石碇區,3361,7854,4319,3535
2014/2/1,新北市,坪林區,2473,6463,3618,2845
2014/2/1,新北市,三芝區,9197,23475,12104,11371
2014/2/1,新北市,石門區,4261,12764,6640,6124
2014/2/1,新北市,八里區,13344,36326,18267,18059
2014/2/1,新北市,平溪區,2376,4987,2762,2225
2014/2/1,新北市,雙溪區,3846,9402,5059,4343
2014/2/1,新北市,貢寮區,4458,13286,6803,6483
2014/2/1,新北市,金山區,6938,22392,11120,11272
2014/2/1,新北市,萬里區,7312,22574,11428,11146
2014/2/1,新北市,烏來區,1775,6038,3002,3036
2014/2/1,臺北市,松山區,79801,210539,99566,110973
2014/2/1,臺北市,信義區,88426,228642,109743,118899
2014/2/1,臺北市,大安區,119450,313613,146979,166634
2014/2/1,臺北市,中山區,97297,229026,107077,121949
2014/2/1,臺北市,中正區,64665,163391,78302,85089
2014/2/1,臺北市,大同區,50584,130026,63676,66350
2014/2/1,臺北市,萬華區,77245,193430,95767,97663
2014/2/1,臺北市,文山區,101970,271711,131029,140682
2014/2/1,臺北市,南港區,45105,119981,58695,61286
2014/2/1,臺北市,內湖區,103951,283295,135894,147401
2014/2/1,臺北市,士林區,104833,289966,140472,149494
2014/2/1,臺北市,北投區,93911,255707,123819,131888
2014/2/1,臺中市,中區,7949,19943,9893,10050
2014/2/1,臺中市,東區,26874,74564,37286,37278
2014/2/1,臺中市,南區,45023,118445,57273,61172
2014/2/1,臺中市,西區,44548,116344,55488,60856
2014/2/1,臺中市,北區,57834,147828,71260,76568
2014/2/1,臺中市,西屯區,78882,216033,104136,111897
2014/2/1,臺中市,南屯區,57307,160366,77131,83235
2014/2/1,臺中市,北屯區,90028,256711,123943,132768
2014/2/1,臺中市,豐原區,51577,166092,82312,83780
2014/2/1,臺中市,東勢區,17218,51930,26869,25061
2014/2/1,臺中市,大甲區,22339,77876,39451,38425
2014/2/1,臺中市,清水區,25891,86068,44292,41776
2014/2/1,臺中市,沙鹿區,26438,86528,43936,42592
2014/2/1,臺中市,梧棲區,16558,56039,28274,27765
2014/2/1,臺中市,后里區,15274,54080,27606,26474
2014/2/1,臺中市,神岡區,18481,64904,33284,31620
2014/2/1,臺中市,潭子區,34235,104433,51864,52569
2014/2/1,臺中市,大雅區,27530,92106,46170,45936
2014/2/1,臺中市,新社區,7445,25297,13158,12139
2014/2/1,臺中市,石岡區,4900,15614,8129,7485
2014/2/1,臺中市,外埔區,9222,31826,16362,15464
2014/2/1,臺中市,大安區,5316,19666,10338,9328
2014/2/1,臺中市,烏日區,22018,70727,35779,34948
2014/2/1,臺中市,大肚區,16495,56053,28709,27344
2014/2/1,臺中市,龍井區,21736,75655,38411,37244
2014/2/1,臺中市,霧峰區,19346,64319,32864,31455
2014/2/1,臺中市,太平區,58447,179142,89513,89629
2014/2/1,臺中市,大里區,65694,204893,101229,103664
2014/2/1,臺中市,和平區,4391,10588,5695,4893
2014/2/1,臺南市,新營區,28268,78563,38993,39570
2014/2/1,臺南市,鹽水區,10022,26367,13748,12619
2014/2/1,臺南市,白河區,10965,30085,15747,14338
2014/2/1,臺南市,柳營區,7797,21873,11401,10472
2014/2/1,臺南市,後壁區,8907,24787,12905,11882
2014/2/1,臺南市,東山區,8282,22096,11736,10360
2014/2/1,臺南市,麻豆區,15422,45211,22983,22228
2014/2/1,臺南市,下營區,9118,25245,13011,12234
2014/2/1,臺南市,六甲區,7736,23117,11987,11130
2014/2/1,臺南市,官田區,7744,21791,11140,10651
2014/2/1,臺南市,大內區,4010,10375,5528,4847
2014/2/1,臺南市,佳里區,20036,59403,29474,29929
2014/2/1,臺南市,學甲區,9658,27146,13895,13251
2014/2/1,臺南市,西港區,7950,24879,12625,12254
2014/2/1,臺南市,七股區,8118,23820,12430,11390
2014/2/1,臺南市,將軍區,7365,20745,10572,10173
2014/2/1,臺南市,北門區,4388,11826,5968,5858
2014/2/1,臺南市,新化區,14082,43822,22432,21390
2014/2/1,臺南市,善化區,15787,45287,22856,22431
2014/2/1,臺南市,新市區,11411,35426,17807,17619
2014/2/1,臺南市,安定區,9673,30235,15583,14652
2014/2/1,臺南市,山上區,2710,7550,3958,3592
2014/2/1,臺南市,玉井區,5138,14765,7693,7072
2014/2/1,臺南市,楠西區,3545,10161,5398,4763
2014/2/1,臺南市,南化區,2856,8883,4831,4052
2014/2/1,臺南市,左鎮區,1993,5206,2914,2292
2014/2/1,臺南市,仁德區,26298,72474,36931,35543
2014/2/1,臺南市,歸仁區,21736,67177,34155,33022
2014/2/1,臺南市,關廟區,10851,35070,18145,16925
2014/2/1,臺南市,龍崎區,1581,4305,2338,1967
2014/2/1,臺南市,永康區,80286,227120,112359,114761
2014/2/1,臺南市,東區,71966,191541,92223,99318
2014/2/1,臺南市,南區,44323,125512,62530,62982
2014/2/1,臺南市,北區,49399,132291,64853,67438
2014/2/1,臺南市,安南區,59064,185680,93998,91682
2014/2/1,臺南市,安平區,24247,64558,30854,33704
2014/2/1,臺南市,中西區,30873,78641,38324,40317
2014/2/1,高雄市,鹽埕區,10963,25836,12871,12965
2014/2/1,高雄市,鼓山區,54947,135158,65724,69434
2014/2/1,高雄市,左營區,76452,195459,95162,100297
2014/2/1,高雄市,楠梓區,65271,177818,87947,89871
2014/2/1,高雄市,三民區,134090,348332,169494,178838
2014/2/1,高雄市,新興區,22729,53087,25617,27470
2014/2/1,高雄市,前金區,12561,27983,13518,14465
2014/2/1,高雄市,苓雅區,72137,177442,85929,91513
2014/2/1,高雄市,前鎮區,77595,194602,96219,98383
2014/2/1,高雄市,旗津區,10955,28985,14996,13989
2014/2/1,高雄市,小港區,65567,156188,77938,78250
2014/2/1,高雄市,鳳山區,134152,352959,174174,178785
2014/2/1,高雄市,林園區,25258,70486,35920,34566
2014/2/1,高雄市,大寮區,40346,110466,56983,53483
2014/2/1,高雄市,大樹區,13208,43336,22297,21039
2014/2/1,高雄市,大社區,12460,34147,17470,16677
2014/2/1,高雄市,仁武區,29545,79615,40765,38850
2014/2/1,高雄市,鳥松區,17357,43764,22237,21527
2014/2/1,高雄市,岡山區,34246,97837,48740,49097
2014/2/1,高雄市,橋頭區,13074,37021,18884,18137
2014/2/1,高雄市,燕巢區,10251,30522,16218,14304
2014/2/1,高雄市,田寮區,3438,7714,4294,3420
2014/2/1,高雄市,阿蓮區,9362,29747,14995,14752
2014/2/1,高雄市,路竹區,16474,52991,27066,25925
2014/2/1,高雄市,湖內區,10172,29273,15004,14269
2014/2/1,高雄市,茄萣區,10379,30828,16002,14826
2014/2/1,高雄市,永安區,5826,14121,7105,7016
2014/2/1,高雄市,彌陀區,6689,19911,10322,9589
2014/2/1,高雄市,梓官區,12366,36395,18806,17589
2014/2/1,高雄市,旗山區,13870,38511,19959,18552
2014/2/1,高雄市,美濃區,14455,41591,21694,19897
2014/2/1,高雄市,六龜區,5685,13882,7504,6378
2014/2/1,高雄市,甲仙區,2375,6417,3424,2993
2014/2/1,高雄市,杉林區,4818,12546,6845,5701
2014/2/1,高雄市,內門區,5074,15288,8330,6958
2014/2/1,高雄市,茂林區,578,1850,929,921
2014/2/1,高雄市,桃源區,1332,4392,2318,2074
2014/2/1,高雄市,那瑪夏區,864,3153,1635,1518
2014/2/1,宜蘭縣,宜蘭市,34863,95865,46954,48911
2014/2/1,宜蘭縣,羅東鎮,25602,72302,34505,37797
2014/2/1,宜蘭縣,蘇澳鎮,13865,41315,21096,20219
2014/2/1,宜蘭縣,頭城鎮,10008,30013,15520,14493
2014/2/1,宜蘭縣,礁溪鄉,13105,35979,18827,17152
2014/2/1,宜蘭縣,壯圍鄉,8410,24526,12987,11539
2014/2/1,宜蘭縣,員山鄉,11198,32135,17134,15001
2014/2/1,宜蘭縣,冬山鄉,18424,53672,27525,26147
2014/2/1,宜蘭縣,五結鄉,13780,39249,20328,18921
2014/2/1,宜蘭縣,三星鄉,8000,21258,11528,9730
2014/2/1,宜蘭縣,大同鄉,1865,6036,3279,2757
2014/2/1,宜蘭縣,南澳鄉,1874,5962,3156,2806
2014/2/1,桃園市,桃園區,153366,415567,203152,212415
2014/2/1,桃園市,中壢區,136311,379220,188499,190721
2014/2/1,桃園市,平鎮區,70964,211235,105895,105340
2014/2/1,桃園市,八德區,62031,179682,90891,88791
2014/2/1,桃園市,楊梅區,52621,155928,79166,76762
2014/2/1,桃園市,大溪區,30458,91932,47301,44631
2014/2/1,桃園市,蘆竹區,52900,150150,75015,75135
2014/2/1,桃園市,大園區,28115,83585,43097,40488
2014/2/1,桃園市,龜山區,53145,140528,70758,69770
2014/2/1,桃園市,龍潭區,38546,115746,58587,57159
2014/2/1,桃園市,新屋區,15308,47997,25695,22302
2014/2/1,桃園市,觀音區,20347,63077,33103,29974
2014/2/1,桃園市,復興區,3719,10662,5902,4760
2014/2/1,新竹縣,竹北市,55526,159642,79676,79966
2014/2/1,新竹縣,關西鎮,9491,30834,16427,14407
2014/2/1,新竹縣,新埔鎮,10591,34618,18403,16215
2014/2/1,新竹縣,竹東鎮,31991,96236,48431,47805
2014/2/1,新竹縣,湖口鄉,24789,76861,39042,37819
2014/2/1,新竹縣,橫山鄉,4517,13914,7528,6386
2014/2/1,新竹縣,新豐鄉,17156,55421,28430,26991
2014/2/1,新竹縣,芎林鄉,6385,20223,10689,9534
2014/2/1,新竹縣,寶山鄉,5056,14159,7666,6493
2014/2/1,新竹縣,北埔鄉,3150,9820,5294,4526
2014/2/1,新竹縣,峨眉鄉,2071,5751,3194,2557
2014/2/1,新竹縣,尖石鄉,2820,9217,4929,4288
2014/2/1,新竹縣,五峰鄉,1739,4607,2535,2072
2014/2/1,苗栗縣,苗栗市,30333,91153,45624,45529
2014/2/1,苗栗縣,苑裡鎮,14274,48480,25127,23353
2014/2/1,苗栗縣,通霄鎮,11511,37133,19613,17520
2014/2/1,苗栗縣,竹南鎮,26510,82615,41860,40755
2014/2/1,苗栗縣,頭份市,32357,101663,51397,50266
2014/2/1,苗栗縣,後龍鎮,11859,38401,20220,18181
2014/2/1,苗栗縣,卓蘭鎮,6180,18439,9666,8773
2014/2/1,苗栗縣,大湖鄉,5431,15657,8297,7360
2014/2/1,苗栗縣,公館鄉,10546,34796,18101,16695
2014/2/1,苗栗縣,銅鑼鄉,6117,18977,10087,8890
2014/2/1,苗栗縣,南庄鄉,3978,10701,5873,4828
2014/2/1,苗栗縣,頭屋鄉,3630,11399,6002,5397
2014/2/1,苗栗縣,三義鄉,5435,17359,9098,8261
2014/2/1,苗栗縣,西湖鄉,2712,7636,4236,3400
2014/2/1,苗栗縣,造橋鄉,4124,13497,7097,6400
2014/2/1,苗栗縣,三灣鄉,2431,7118,3879,3239
2014/2/1,苗栗縣,獅潭鄉,1728,4667,2597,2070
2014/2/1,苗栗縣,泰安鄉,1976,5975,3202,2773
2014/2/1,彰化縣,彰化市,74493,236010,117042,118968
2014/2/1,彰化縣,鹿港鎮,23378,85916,43865,42051
2014/2/1,彰化縣,和美鎮,25545,90517,46332,44185
2014/2/1,彰化縣,北斗鎮,10290,33176,16771,16405
2014/2/1,彰化縣,員林市,38026,125060,62668,62392
2014/2/1,彰化縣,溪湖鎮,15818,55777,28440,27337
2014/2/1,彰化縣,田中鎮,12858,43105,22322,20783
2014/2/1,彰化縣,二林鎮,14762,52841,27265,25576
2014/2/1,彰化縣,線西鄉,4252,17132,8860,8272
2014/2/1,彰化縣,伸港鄉,9397,36136,18515,17621
2014/2/1,彰化縣,福興鄉,12435,47991,25055,22936
2014/2/1,彰化縣,秀水鄉,10227,39402,20353,19049
2014/2/1,彰化縣,花壇鄉,13519,45967,23672,22295
2014/2/1,彰化縣,芬園鄉,6853,24252,12768,11484
2014/2/1,彰化縣,大村鄉,10663,36405,18899,17506
2014/2/1,彰化縣,埔鹽鄉,8981,33413,17551,15862
2014/2/1,彰化縣,埔心鄉,10275,35027,18069,16958
2014/2/1,彰化縣,永靖鄉,10739,38454,20019,18435
2014/2/1,彰化縣,社頭鄉,12629,43837,22552,21285
2014/2/1,彰化縣,二水鄉,5354,15949,8380,7569
2014/2/1,彰化縣,田尾鄉,7804,27935,14501,13434
2014/2/1,彰化縣,埤頭鄉,8848,31180,16238,14942
2014/2/1,彰化縣,芳苑鄉,10091,35042,18565,16477
2014/2/1,彰化縣,大城鄉,5356,17996,9737,8259
2014/2/1,彰化縣,竹塘鄉,4627,16027,8445,7582
2014/2/1,彰化縣,溪州鄉,8865,30828,16197,14631
2014/2/1,南投縣,南投市,34114,102793,51611,51182
2014/2/1,南投縣,埔里鎮,28811,83610,42009,41601
2014/2/1,南投縣,草屯鎮,32280,99329,50152,49177
2014/2/1,南投縣,竹山鎮,19902,57025,29322,27703
2014/2/1,南投縣,集集鎮,4358,11397,5946,5451
2014/2/1,南投縣,名間鄉,12505,40269,21143,19126
2014/2/1,南投縣,鹿谷鄉,7353,18653,9912,8741
2014/2/1,南投縣,中寮鄉,5649,15690,8522,7168
2014/2/1,南投縣,魚池鄉,5760,16672,8744,7928
2014/2/1,南投縣,國姓鄉,7269,19859,10770,9089
2014/2/1,南投縣,水里鄉,7271,19003,9982,9021
2014/2/1,南投縣,信義鄉,5248,16698,8963,7735
2014/2/1,南投縣,仁愛鄉,4943,15733,8139,7594
2014/2/1,雲林縣,斗六市,36630,107996,54019,53977
2014/2/1,雲林縣,斗南鎮,15616,46210,23498,22712
2014/2/1,雲林縣,虎尾鎮,23834,70497,35803,34694
2014/2/1,雲林縣,西螺鎮,14372,47419,24136,23283
2014/2/1,雲林縣,土庫鎮,9119,29795,15581,14214
2014/2/1,雲林縣,北港鎮,15886,41944,21805,20139
2014/2/1,雲林縣,古坑鄉,10866,32809,17299,15510
2014/2/1,雲林縣,大埤鄉,6763,20185,10844,9341
2014/2/1,雲林縣,莿桐鄉,9266,29784,15634,14150
2014/2/1,雲林縣,林內鄉,5860,19082,9959,9123
2014/2/1,雲林縣,二崙鄉,8906,28641,15294,13347
2014/2/1,雲林縣,崙背鄉,8514,26181,13829,12352
2014/2/1,雲林縣,麥寮鄉,13628,42643,21661,20982
2014/2/1,雲林縣,東勢鄉,5794,15802,8655,7147
2014/2/1,雲林縣,褒忠鄉,4408,13673,7322,6351
2014/2/1,雲林縣,臺西鄉,8820,25009,13439,11570
2014/2/1,雲林縣,元長鄉,9449,27562,15042,12520
2014/2/1,雲林縣,四湖鄉,9020,25488,13838,11650
2014/2/1,雲林縣,口湖鄉,9657,29278,15560,13718
2014/2/1,雲林縣,水林鄉,10308,27190,14924,12266
2014/2/1,嘉義縣,太保市,12009,36949,19065,17884
2014/2/1,嘉義縣,朴子市,15273,43554,22067,21487
2014/2/1,嘉義縣,布袋鎮,10165,28618,14669,13949
2014/2/1,嘉義縣,大林鎮,11379,32467,16659,15808
2014/2/1,嘉義縣,民雄鄉,23801,72092,36921,35171
2014/2/1,嘉義縣,溪口鄉,5428,15507,8247,7260
2014/2/1,嘉義縣,新港鄉,10554,33466,17714,15752
2014/2/1,嘉義縣,六腳鄉,9040,24866,13175,11691
2014/2/1,嘉義縣,東石鄉,9452,26267,13955,12312
2014/2/1,嘉義縣,義竹鄉,7568,19807,10308,9499
2014/2/1,嘉義縣,鹿草鄉,5816,16592,8902,7690
2014/2/1,嘉義縣,水上鄉,17822,51182,26409,24773
2014/2/1,嘉義縣,中埔鄉,15888,46521,24253,22268
2014/2/1,嘉義縣,竹崎鄉,11550,37275,19869,17406
2014/2/1,嘉義縣,梅山鄉,6777,20521,10888,9633
2014/2/1,嘉義縣,番路鄉,4298,12138,6588,5550
2014/2/1,嘉義縣,大埔鄉,1946,4590,2381,2209
2014/2/1,嘉義縣,阿里山鄉,1932,5736,3056,2680
2014/2/1,屏東縣,屏東市,73171,205644,102189,103455
2014/2/1,屏東縣,潮州鎮,18902,55143,27662,27481
2014/2/1,屏東縣,東港鎮,16150,48588,24574,24014
2014/2/1,屏東縣,恆春鎮,11146,30837,15773,15064
2014/2/1,屏東縣,萬丹鄉,14625,52471,27186,25285
2014/2/1,屏東縣,長治鄉,9954,30466,15911,14555
2014/2/1,屏東縣,麟洛鄉,3689,11298,5837,5461
2014/2/1,屏東縣,九如鄉,6746,22361,11573,10788
2014/2/1,屏東縣,里港鄉,8060,26558,13528,13030
2014/2/1,屏東縣,鹽埔鄉,7833,26636,13842,12794
2014/2/1,屏東縣,高樹鄉,9428,25631,13688,11943
2014/2/1,屏東縣,萬巒鄉,6444,21111,11101,10010
2014/2/1,屏東縣,內埔鄉,18290,56466,29262,27204
2014/2/1,屏東縣,竹田鄉,5626,17787,9444,8343
2014/2/1,屏東縣,新埤鄉,3414,10216,5434,4782
2014/2/1,屏東縣,枋寮鄉,8589,25688,13455,12233
2014/2/1,屏東縣,新園鄉,11706,37025,19181,17844
2014/2/1,屏東縣,崁頂鄉,4382,16394,8331,8063
2014/2/1,屏東縣,林邊鄉,7062,19510,10049,9461
2014/2/1,屏東縣,南州鄉,3670,11111,5683,5428
2014/2/1,屏東縣,佳冬鄉,7062,20462,10638,9824
2014/2/1,屏東縣,琉球鄉,4178,12476,6902,5574
2014/2/1,屏東縣,車城鄉,3472,9086,4894,4192
2014/2/1,屏東縣,滿州鄉,3028,8105,4461,3644
2014/2/1,屏東縣,枋山鄉,2135,5771,3069,2702
2014/2/1,屏東縣,三地門鄉,2264,7614,3871,3743
2014/2/1,屏東縣,霧臺鄉,1050,3247,1674,1573
2014/2/1,屏東縣,瑪家鄉,1951,6608,3409,3199
2014/2/1,屏東縣,泰武鄉,1266,5134,2695,2439
2014/2/1,屏東縣,來義鄉,2218,7604,3889,3715
2014/2/1,屏東縣,春日鄉,1331,4826,2483,2343
2014/2/1,屏東縣,獅子鄉,1507,4777,2471,2306
2014/2/1,屏東縣,牡丹鄉,1875,4781,2464,2317
2014/2/1,臺東縣,臺東市,38754,107302,54041,53261
2014/2/1,臺東縣,成功鎮,5444,15029,7930,7099
2014/2/1,臺東縣,關山鎮,3252,9248,4852,4396
2014/2/1,臺東縣,卑南鄉,6622,17767,9460,8307
2014/2/1,臺東縣,大武鄉,2508,6516,3393,3123
2014/2/1,臺東縣,太麻里鄉,4612,11586,6141,5445
2014/2/1,臺東縣,東河鄉,3743,8978,4976,4002
2014/2/1,臺東縣,長濱鄉,2914,7721,4399,3322
2014/2/1,臺東縣,鹿野鄉,3120,8229,4411,3818
2014/2/1,臺東縣,池上鄉,3281,8679,4567,4112
2014/2/1,臺東縣,綠島鄉,1097,3603,1913,1690
2014/2/1,臺東縣,延平鄉,1069,3546,1912,1634
2014/2/1,臺東縣,海端鄉,1093,4370,2376,1994
2014/2/1,臺東縣,達仁鄉,1484,3737,2035,1702
2014/2/1,臺東縣,金峰鄉,1102,3526,1829,1697
2014/2/1,臺東縣,蘭嶼鄉,1705,4916,2508,2408
2014/2/1,花蓮縣,花蓮市,41168,107128,52122,55006
2014/2/1,花蓮縣,鳳林鎮,4420,11385,6012,5373
2014/2/1,花蓮縣,玉里鎮,8915,25589,13739,11850
2014/2/1,花蓮縣,新城鄉,7465,20078,10394,9684
2014/2/1,花蓮縣,吉安鄉,30709,82203,41775,40428
2014/2/1,花蓮縣,壽豐鄉,6917,18136,9774,8362
2014/2/1,花蓮縣,光復鄉,5028,13446,7142,6304
2014/2/1,花蓮縣,豐濱鄉,1743,4665,2596,2069
2014/2/1,花蓮縣,瑞穗鄉,4669,12172,6547,5625
2014/2/1,花蓮縣,富里鄉,4014,10956,5965,4991
2014/2/1,花蓮縣,秀林鄉,4732,15267,7907,7360
2014/2/1,花蓮縣,萬榮鄉,2078,6503,3458,3045
2014/2/1,花蓮縣,卓溪鄉,1666,6125,3370,2755
2014/2/1,澎湖縣,馬公市,22469,59615,30335,29280
2014/2/1,澎湖縣,湖西鄉,5264,14223,7506,6717
2014/2/1,澎湖縣,白沙鄉,3286,9629,5040,4589
2014/2/1,澎湖縣,西嶼鄉,2926,8420,4333,4087
2014/2/1,澎湖縣,望安鄉,1994,5042,2715,2327
2014/2/1,澎湖縣,七美鄉,1304,3680,1929,1751
2014/2/1,基隆市,中正區,22361,53451,27352,26099
2014/2/1,基隆市,七堵區,20716,53976,27322,26654
2014/2/1,基隆市,暖暖區,14989,37927,19212,18715
2014/2/1,基隆市,仁愛區,19557,47011,23149,23862
2014/2/1,基隆市,中山區,19272,49150,25043,24107
2014/2/1,基隆市,安樂區,32137,81933,40825,41108
2014/2/1,基隆市,信義區,20691,51210,25593,25617
2014/2/1,新竹市,東區,73654,204972,100952,104020
2014/2/1,新竹市,北區,53558,148090,72824,75266
2014/2/1,新竹市,香山區,25196,75956,38653,37303
2014/2/1,嘉義市,東區,44946,123876,60268,63608
2014/2/1,嘉義市,西區,52732,147196,72481,74715
2014/2/1,金門縣,金城鎮,12236,39302,19737,19565
2014/2/1,金門縣,金湖鎮,8128,26247,13279,12968
2014/2/1,金門縣,金沙鎮,5928,18684,9287,9397
2014/2/1,金門縣,金寧鄉,7335,25474,12924,12550
2014/2/1,金門縣,烈嶼鄉,2940,11381,5604,5777
2014/2/1,金門縣,烏坵鄉,134,661,330,331
2014/2/1,連江縣,南竿鄉,1375,7344,4160,3184
2014/2/1,連江縣,北竿鄉,467,2275,1263,1012
2014/2/1,連江縣,莒光鄉,271,1431,842,589
2014/2/1,連江縣,東引鄉,290,1178,697,481
2014/3/1,總計,新北市,1480359,3955390,1949172,2006218
2014/3/1,總計,臺北市,1027984,2690232,1291306,1398926
2014/3/1,總計,臺中市,900230,2705064,1341024,1364040
2014/3/1,總計,臺南市,663977,1883077,944234,938843
2014/3/1,總計,高雄市,1057446,2778669,1384641,1394028
2014/3/1,總計,臺灣省,3131353,9232555,4704581,4527974
2014/3/1,總計,宜蘭縣,161091,458427,232834,225593
2014/3/1,總計,桃園市,718936,2045811,1027246,1018565
2014/3/1,總計,新竹縣,175569,531723,272429,259294
2014/3/1,總計,苗栗縣,181264,565693,291930,273763
2014/3/1,總計,彰化縣,376328,1294911,662781,632130
2014/3/1,總計,南投縣,175527,516315,264985,251330
2014/3/1,總計,雲林縣,236791,706958,368006,338952
2014/3/1,總計,嘉義縣,180730,527721,274921,252800
2014/3/1,總計,屏東縣,282306,851127,436452,414675
2014/3/1,總計,臺東縣,81794,224675,116663,108012
2014/3/1,總計,花蓮縣,123606,333639,170731,162908
2014/3/1,總計,澎湖縣,37351,100812,51982,48830
2014/3/1,總計,基隆市,149780,374428,188395,186033
2014/3/1,總計,新竹市,152568,429212,212523,216689
2014/3/1,總計,嘉義市,97712,271103,132703,138400
2014/3/1,總計,福建省,39211,134607,68438,66169
2014/3/1,總計,金門縣,36803,122296,61423,60873
2014/3/1,總計,連江縣,2408,12311,7015,5296
2014/3/1,新北市,板橋區,203735,556772,273130,283642
2014/3/1,新北市,三重區,145953,389544,192880,196664
2014/3/1,新北市,中和區,161109,415217,203276,211941
2014/3/1,新北市,永和區,90666,228961,109186,119775
2014/3/1,新北市,新莊區,144959,410026,201432,208594
2014/3/1,新北市,新店區,121272,298715,144892,153823
2014/3/1,新北市,樹林區,64458,183494,91943,91551
2014/3/1,新北市,鶯歌區,28936,88724,44531,44193
2014/3/1,新北市,三峽區,39549,110212,55688,54524
2014/3/1,新北市,淡水區,66060,156109,75325,80784
2014/3/1,新北市,汐止區,83263,194044,95394,98650
2014/3/1,新北市,瑞芳區,16023,41380,20916,20464
2014/3/1,新北市,土城區,84974,239052,118596,120456
2014/3/1,新北市,蘆洲區,68216,199324,98258,101066
2014/3/1,新北市,五股區,28800,81788,41315,40473
2014/3/1,新北市,泰山區,27328,78054,38910,39144
2014/3/1,新北市,林口區,36440,94916,46576,48340
2014/3/1,新北市,深坑區,9244,23560,11833,11727
2014/3/1,新北市,石碇區,3365,7853,4322,3531
2014/3/1,新北市,坪林區,2476,6458,3614,2844
2014/3/1,新北市,三芝區,9203,23483,12101,11382
2014/3/1,新北市,石門區,4261,12724,6623,6101
2014/3/1,新北市,八里區,13366,36355,18273,18082
2014/3/1,新北市,平溪區,2371,4991,2766,2225
2014/3/1,新北市,雙溪區,3851,9419,5070,4349
2014/3/1,新北市,貢寮區,4453,13275,6800,6475
2014/3/1,新北市,金山區,6935,22363,11109,11254
2014/3/1,新北市,萬里區,7318,22531,11405,11126
2014/3/1,新北市,烏來區,1775,6046,3008,3038
2014/3/1,臺北市,松山區,79838,210578,99554,111024
2014/3/1,臺北市,信義區,88485,228662,109731,118931
2014/3/1,臺北市,大安區,119491,313687,147037,166650
2014/3/1,臺北市,中山區,97290,228947,107016,121931
2014/3/1,臺北市,中正區,64692,163457,78319,85138
2014/3/1,臺北市,大同區,50657,130149,63747,66402
2014/3/1,臺北市,萬華區,77291,193416,95747,97669
2014/3/1,臺北市,文山區,102059,271876,131106,140770
2014/3/1,臺北市,南港區,45152,120076,58727,61349
2014/3/1,臺北市,內湖區,104110,283510,135991,147519
2014/3/1,臺北市,士林區,104888,289932,140424,149508
2014/3/1,臺北市,北投區,94031,255942,123907,132035
2014/3/1,臺中市,中區,7933,19901,9877,10024
2014/3/1,臺中市,東區,26892,74624,37305,37319
2014/3/1,臺中市,南區,45099,118554,57289,61265
2014/3/1,臺中市,西區,44575,116317,55458,60859
2014/3/1,臺中市,北區,57867,147783,71214,76569
2014/3/1,臺中市,西屯區,79065,216205,104224,111981
2014/3/1,臺中市,南屯區,57468,160577,77247,83330
2014/3/1,臺中市,北屯區,90202,256920,124086,132834
2014/3/1,臺中市,豐原區,51644,166182,82351,83831
2014/3/1,臺中市,東勢區,17207,51865,26832,25033
2014/3/1,臺中市,大甲區,22345,77883,39466,38417
2014/3/1,臺中市,清水區,25893,86042,44286,41756
2014/3/1,臺中市,沙鹿區,26500,86654,44002,42652
2014/3/1,臺中市,梧棲區,16582,56088,28281,27807
2014/3/1,臺中市,后里區,15272,54034,27561,26473
2014/3/1,臺中市,神岡區,18505,64893,33282,31611
2014/3/1,臺中市,潭子區,34277,104401,51846,52555
2014/3/1,臺中市,大雅區,27562,92116,46173,45943
2014/3/1,臺中市,新社區,7462,25308,13176,12132
2014/3/1,臺中市,石岡區,4905,15580,8109,7471
2014/3/1,臺中市,外埔區,9224,31803,16345,15458
2014/3/1,臺中市,大安區,5317,19662,10341,9321
2014/3/1,臺中市,烏日區,22076,70784,35800,34984
2014/3/1,臺中市,大肚區,16525,56097,28718,27379
2014/3/1,臺中市,龍井區,21741,75613,38386,37227
2014/3/1,臺中市,霧峰區,19363,64330,32871,31459
2014/3/1,臺中市,太平區,58558,179252,89504,89748
2014/3/1,臺中市,大里區,65782,204977,101298,103679
2014/3/1,臺中市,和平區,4389,10619,5696,4923
2014/3/1,臺南市,新營區,28269,78586,39004,39582
2014/3/1,臺南市,鹽水區,10020,26387,13758,12629
2014/3/1,臺南市,白河區,10971,30069,15744,14325
2014/3/1,臺南市,柳營區,7800,21857,11391,10466
2014/3/1,臺南市,後壁區,8909,24753,12887,11866
2014/3/1,臺南市,東山區,8287,22085,11717,10368
2014/3/1,臺南市,麻豆區,15414,45182,22973,22209
2014/3/1,臺南市,下營區,9119,25238,13008,12230
2014/3/1,臺南市,六甲區,7738,23106,11983,11123
2014/3/1,臺南市,官田區,7751,21766,11139,10627
2014/3/1,臺南市,大內區,4004,10359,5522,4837
2014/3/1,臺南市,佳里區,20049,59444,29477,29967
2014/3/1,臺南市,學甲區,9665,27134,13888,13246
2014/3/1,臺南市,西港區,7956,24854,12611,12243
2014/3/1,臺南市,七股區,8112,23775,12412,11363
2014/3/1,臺南市,將軍區,7363,20713,10560,10153
2014/3/1,臺南市,北門區,4393,11808,5958,5850
2014/3/1,臺南市,新化區,14084,43825,22435,21390
2014/3/1,臺南市,善化區,15824,45367,22913,22454
2014/3/1,臺南市,新市區,11428,35418,17799,17619
2014/3/1,臺南市,安定區,9674,30227,15570,14657
2014/3/1,臺南市,山上區,2706,7555,3961,3594
2014/3/1,臺南市,玉井區,5136,14739,7679,7060
2014/3/1,臺南市,楠西區,3547,10147,5393,4754
2014/3/1,臺南市,南化區,2861,8877,4824,4053
2014/3/1,臺南市,左鎮區,1988,5197,2906,2291
2014/3/1,臺南市,仁德區,26319,72559,36962,35597
2014/3/1,臺南市,歸仁區,21751,67199,34157,33042
2014/3/1,臺南市,關廟區,10862,35068,18139,16929
2014/3/1,臺南市,龍崎區,1579,4302,2333,1969
2014/3/1,臺南市,永康區,80350,227228,112379,114849
2014/3/1,臺南市,東區,72015,191498,92244,99254
2014/3/1,臺南市,南區,44336,125430,62459,62971
2014/3/1,臺南市,北區,49377,132208,64801,67407
2014/3/1,臺南市,安南區,59167,185913,94096,91817
2014/3/1,臺南市,安平區,24272,64564,30840,33724
2014/3/1,臺南市,中西區,30881,78640,38312,40328
2014/3/1,高雄市,鹽埕區,10950,25776,12845,12931
2014/3/1,高雄市,鼓山區,54962,135111,65681,69430
2014/3/1,高雄市,左營區,76480,195404,95093,100311
2014/3/1,高雄市,楠梓區,65359,177903,87949,89954
2014/3/1,高雄市,三民區,134129,348117,169409,178708
2014/3/1,高雄市,新興區,22742,53013,25561,27452
2014/3/1,高雄市,前金區,12547,27962,13496,14466
2014/3/1,高雄市,苓雅區,72103,177206,85821,91385
2014/3/1,高雄市,前鎮區,77594,194452,96116,98336
2014/3/1,高雄市,旗津區,10947,28958,14992,13966
2014/3/1,高雄市,小港區,65591,156124,77918,78206
2014/3/1,高雄市,鳳山區,134344,353076,174170,178906
2014/3/1,高雄市,林園區,25268,70490,35911,34579
2014/3/1,高雄市,大寮區,40384,110501,57002,53499
2014/3/1,高雄市,大樹區,13219,43276,22266,21010
2014/3/1,高雄市,大社區,12483,34186,17461,16725
2014/3/1,高雄市,仁武區,29616,79737,40837,38900
2014/3/1,高雄市,鳥松區,17359,43701,22215,21486
2014/3/1,高雄市,岡山區,34253,97758,48675,49083
2014/3/1,高雄市,橋頭區,13074,37036,18908,18128
2014/3/1,高雄市,燕巢區,10273,30533,16207,14326
2014/3/1,高雄市,田寮區,3439,7705,4289,3416
2014/3/1,高雄市,阿蓮區,9361,29702,14981,14721
2014/3/1,高雄市,路竹區,16474,52974,27056,25918
2014/3/1,高雄市,湖內區,10193,29289,15006,14283
2014/3/1,高雄市,茄萣區,10376,30800,15981,14819
2014/3/1,高雄市,永安區,5821,14097,7102,6995
2014/3/1,高雄市,彌陀區,6693,19921,10319,9602
2014/3/1,高雄市,梓官區,12365,36362,18799,17563
2014/3/1,高雄市,旗山區,13865,38450,19938,18512
2014/3/1,高雄市,美濃區,14451,41570,21687,19883
2014/3/1,高雄市,六龜區,5685,13863,7492,6371
2014/3/1,高雄市,甲仙區,2373,6413,3416,2997
2014/3/1,高雄市,杉林區,4818,12521,6839,5682
2014/3/1,高雄市,內門區,5069,15273,8315,6958
2014/3/1,高雄市,茂林區,579,1853,928,925
2014/3/1,高雄市,桃源區,1342,4385,2314,2071
2014/3/1,高雄市,那瑪夏區,865,3171,1646,1525
2014/3/1,宜蘭縣,宜蘭市,34838,95798,46870,48928
2014/3/1,宜蘭縣,羅東鎮,25619,72339,34504,37835
2014/3/1,宜蘭縣,蘇澳鎮,13881,41285,21100,20185
2014/3/1,宜蘭縣,頭城鎮,10009,29996,15507,14489
2014/3/1,宜蘭縣,礁溪鄉,13117,36017,18849,17168
2014/3/1,宜蘭縣,壯圍鄉,8403,24522,12988,11534
2014/3/1,宜蘭縣,員山鄉,11202,32197,17162,15035
2014/3/1,宜蘭縣,冬山鄉,18440,53668,27516,26152
2014/3/1,宜蘭縣,五結鄉,13816,39290,20357,18933
2014/3/1,宜蘭縣,三星鄉,8011,21271,11529,9742
2014/3/1,宜蘭縣,大同鄉,1870,6051,3288,2763
2014/3/1,宜蘭縣,南澳鄉,1885,5993,3164,2829
2014/3/1,桃園市,桃園區,153520,415490,203107,212383
2014/3/1,桃園市,中壢區,136526,379457,188578,190879
2014/3/1,桃園市,平鎮區,71066,211224,105860,105364
2014/3/1,桃園市,八德區,62181,179778,90945,88833
2014/3/1,桃園市,楊梅區,52689,155978,79170,76808
2014/3/1,桃園市,大溪區,30487,91939,47313,44626
2014/3/1,桃園市,蘆竹區,52978,150135,75020,75115
2014/3/1,桃園市,大園區,28217,83627,43111,40516
2014/3/1,桃園市,龜山區,53233,140543,70770,69773
2014/3/1,桃園市,龍潭區,38608,115913,58676,57237
2014/3/1,桃園市,新屋區,15329,48005,25690,22315
2014/3/1,桃園市,觀音區,20380,63058,33096,29962
2014/3/1,桃園市,復興區,3722,10664,5910,4754
2014/3/1,新竹縣,竹北市,55740,160114,79882,80232
2014/3/1,新竹縣,關西鎮,9515,30814,16427,14387
2014/3/1,新竹縣,新埔鎮,10580,34565,18389,16176
2014/3/1,新竹縣,竹東鎮,32008,96164,48398,47766
2014/3/1,新竹縣,湖口鄉,24834,76894,39073,37821
2014/3/1,新竹縣,橫山鄉,4512,13904,7516,6388
2014/3/1,新竹縣,新豐鄉,17173,55416,28426,26990
2014/3/1,新竹縣,芎林鄉,6379,20208,10676,9532
2014/3/1,新竹縣,寶山鄉,5052,14211,7690,6521
2014/3/1,新竹縣,北埔鄉,3147,9793,5276,4517
2014/3/1,新竹縣,峨眉鄉,2072,5750,3185,2565
2014/3/1,新竹縣,尖石鄉,2815,9250,4951,4299
2014/3/1,新竹縣,五峰鄉,1742,4640,2540,2100
2014/3/1,苗栗縣,苗栗市,30332,91111,45602,45509
2014/3/1,苗栗縣,苑裡鎮,14288,48476,25109,23367
2014/3/1,苗栗縣,通霄鎮,11511,37111,19601,17510
2014/3/1,苗栗縣,竹南鎮,26566,82690,41877,40813
2014/3/1,苗栗縣,頭份市,32422,101745,51429,50316
2014/3/1,苗栗縣,後龍鎮,11864,38426,20207,18219
2014/3/1,苗栗縣,卓蘭鎮,6173,18404,9650,8754
2014/3/1,苗栗縣,大湖鄉,5431,15638,8292,7346
2014/3/1,苗栗縣,公館鄉,10551,34761,18081,16680
2014/3/1,苗栗縣,銅鑼鄉,6113,18975,10088,8887
2014/3/1,苗栗縣,南庄鄉,3981,10698,5870,4828
2014/3/1,苗栗縣,頭屋鄉,3630,11394,5999,5395
2014/3/1,苗栗縣,三義鄉,5438,17323,9081,8242
2014/3/1,苗栗縣,西湖鄉,2707,7632,4237,3395
2014/3/1,苗栗縣,造橋鄉,4131,13511,7110,6401
2014/3/1,苗栗縣,三灣鄉,2427,7118,3877,3241
2014/3/1,苗栗縣,獅潭鄉,1728,4676,2606,2070
2014/3/1,苗栗縣,泰安鄉,1971,6004,3214,2790
2014/3/1,彰化縣,彰化市,74510,235901,116972,118929
2014/3/1,彰化縣,鹿港鎮,23414,85938,43864,42074
2014/3/1,彰化縣,和美鎮,25594,90540,46341,44199
2014/3/1,彰化縣,北斗鎮,10301,33202,16788,16414
2014/3/1,彰化縣,員林市,38064,125118,62661,62457
2014/3/1,彰化縣,溪湖鎮,15837,55749,28424,27325
2014/3/1,彰化縣,田中鎮,12857,43050,22292,20758
2014/3/1,彰化縣,二林鎮,14773,52793,27235,25558
2014/3/1,彰化縣,線西鄉,4253,17124,8852,8272
2014/3/1,彰化縣,伸港鄉,9399,36126,18518,17608
2014/3/1,彰化縣,福興鄉,12444,47962,25048,22914
2014/3/1,彰化縣,秀水鄉,10236,39379,20346,19033
2014/3/1,彰化縣,花壇鄉,13531,45932,23661,22271
2014/3/1,彰化縣,芬園鄉,6856,24226,12751,11475
2014/3/1,彰化縣,大村鄉,10672,36360,18872,17488
2014/3/1,彰化縣,埔鹽鄉,8970,33391,17548,15843
2014/3/1,彰化縣,埔心鄉,10291,34993,18048,16945
2014/3/1,彰化縣,永靖鄉,10748,38431,20007,18424
2014/3/1,彰化縣,社頭鄉,12637,43804,22541,21263
2014/3/1,彰化縣,二水鄉,5356,15940,8368,7572
2014/3/1,彰化縣,田尾鄉,7816,27937,14497,13440
2014/3/1,彰化縣,埤頭鄉,8844,31170,16232,14938
2014/3/1,彰化縣,芳苑鄉,10089,35021,18543,16478
2014/3/1,彰化縣,大城鄉,5352,17997,9737,8260
2014/3/1,彰化縣,竹塘鄉,4627,16009,8439,7570
2014/3/1,彰化縣,溪州鄉,8857,30818,16196,14622
2014/3/1,南投縣,南投市,34132,102698,51558,51140
2014/3/1,南投縣,埔里鎮,28799,83503,41955,41548
2014/3/1,南投縣,草屯鎮,32308,99264,50126,49138
2014/3/1,南投縣,竹山鎮,19910,57015,29286,27729
2014/3/1,南投縣,集集鎮,4355,11433,5973,5460
2014/3/1,南投縣,名間鄉,12506,40191,21097,19094
2014/3/1,南投縣,鹿谷鄉,7367,18631,9905,8726
2014/3/1,南投縣,中寮鄉,5649,15652,8514,7138
2014/3/1,南投縣,魚池鄉,5757,16660,8739,7921
2014/3/1,南投縣,國姓鄉,7275,19845,10759,9086
2014/3/1,南投縣,水里鄉,7268,18950,9949,9001
2014/3/1,南投縣,信義鄉,5251,16700,8962,7738
2014/3/1,南投縣,仁愛鄉,4950,15773,8162,7611
2014/3/1,雲林縣,斗六市,36680,108060,54062,53998
2014/3/1,雲林縣,斗南鎮,15620,46181,23463,22718
2014/3/1,雲林縣,虎尾鎮,23842,70446,35787,34659
2014/3/1,雲林縣,西螺鎮,14362,47374,24128,23246
2014/3/1,雲林縣,土庫鎮,9132,29783,15571,14212
2014/3/1,雲林縣,北港鎮,15895,41914,21797,20117
2014/3/1,雲林縣,古坑鄉,10861,32742,17257,15485
2014/3/1,雲林縣,大埤鄉,6764,20160,10834,9326
2014/3/1,雲林縣,莿桐鄉,9269,29763,15621,14142
2014/3/1,雲林縣,林內鄉,5864,19053,9950,9103
2014/3/1,雲林縣,二崙鄉,8901,28622,15284,13338
2014/3/1,雲林縣,崙背鄉,8512,26172,13820,12352
2014/3/1,雲林縣,麥寮鄉,13649,42700,21685,21015
2014/3/1,雲林縣,東勢鄉,5803,15799,8656,7143
2014/3/1,雲林縣,褒忠鄉,4404,13651,7311,6340
2014/3/1,雲林縣,臺西鄉,8819,25067,13463,11604
2014/3/1,雲林縣,元長鄉,9446,27541,15015,12526
2014/3/1,雲林縣,四湖鄉,9008,25507,13842,11665
2014/3/1,雲林縣,口湖鄉,9651,29228,15533,13695
2014/3/1,雲林縣,水林鄉,10309,27195,14927,12268
2014/3/1,嘉義縣,太保市,12018,36938,19052,17886
2014/3/1,嘉義縣,朴子市,15267,43532,22055,21477
2014/3/1,嘉義縣,布袋鎮,10163,28550,14642,13908
2014/3/1,嘉義縣,大林鎮,11377,32434,16640,15794
2014/3/1,嘉義縣,民雄鄉,23810,72051,36900,35151
2014/3/1,嘉義縣,溪口鄉,5434,15528,8262,7266
2014/3/1,嘉義縣,新港鄉,10558,33447,17726,15721
2014/3/1,嘉義縣,六腳鄉,9038,24852,13160,11692
2014/3/1,嘉義縣,東石鄉,9455,26285,13963,12322
2014/3/1,嘉義縣,義竹鄉,7559,19752,10275,9477
2014/3/1,嘉義縣,鹿草鄉,5815,16572,8887,7685
2014/3/1,嘉義縣,水上鄉,17829,51118,26376,24742
2014/3/1,嘉義縣,中埔鄉,15882,46420,24200,22220
2014/3/1,嘉義縣,竹崎鄉,11569,37270,19876,17394
2014/3/1,嘉義縣,梅山鄉,6775,20509,10882,9627
2014/3/1,嘉義縣,番路鄉,4294,12129,6579,5550
2014/3/1,嘉義縣,大埔鄉,1948,4600,2393,2207
2014/3/1,嘉義縣,阿里山鄉,1939,5734,3053,2681
2014/3/1,屏東縣,屏東市,73185,205531,102152,103379
2014/3/1,屏東縣,潮州鎮,18882,55046,27626,27420
2014/3/1,屏東縣,東港鎮,16168,48538,24548,23990
2014/3/1,屏東縣,恆春鎮,11147,30864,15790,15074
2014/3/1,屏東縣,萬丹鄉,14634,52445,27168,25277
2014/3/1,屏東縣,長治鄉,9951,30432,15887,14545
2014/3/1,屏東縣,麟洛鄉,3701,11293,5838,5455
2014/3/1,屏東縣,九如鄉,6757,22369,11579,10790
2014/3/1,屏東縣,里港鄉,8057,26574,13528,13046
2014/3/1,屏東縣,鹽埔鄉,7832,26635,13845,12790
2014/3/1,屏東縣,高樹鄉,9424,25626,13689,11937
2014/3/1,屏東縣,萬巒鄉,6437,21074,11082,9992
2014/3/1,屏東縣,內埔鄉,18306,56424,29245,27179
2014/3/1,屏東縣,竹田鄉,5615,17767,9425,8342
2014/3/1,屏東縣,新埤鄉,3418,10220,5442,4778
2014/3/1,屏東縣,枋寮鄉,8588,25672,13446,12226
2014/3/1,屏東縣,新園鄉,11720,36983,19154,17829
2014/3/1,屏東縣,崁頂鄉,4381,16376,8323,8053
2014/3/1,屏東縣,林邊鄉,7050,19461,10021,9440
2014/3/1,屏東縣,南州鄉,3673,11115,5689,5426
2014/3/1,屏東縣,佳冬鄉,7057,20465,10637,9828
2014/3/1,屏東縣,琉球鄉,4203,12529,6932,5597
2014/3/1,屏東縣,車城鄉,3478,9086,4892,4194
2014/3/1,屏東縣,滿州鄉,3033,8120,4463,3657
2014/3/1,屏東縣,枋山鄉,2134,5799,3082,2717
2014/3/1,屏東縣,三地門鄉,2268,7641,3875,3766
2014/3/1,屏東縣,霧臺鄉,1052,3271,1686,1585
2014/3/1,屏東縣,瑪家鄉,1956,6632,3414,3218
2014/3/1,屏東縣,泰武鄉,1268,5166,2704,2462
2014/3/1,屏東縣,來義鄉,2217,7591,3885,3706
2014/3/1,屏東縣,春日鄉,1330,4824,2482,2342
2014/3/1,屏東縣,獅子鄉,1506,4782,2466,2316
2014/3/1,屏東縣,牡丹鄉,1878,4776,2457,2319
2014/3/1,臺東縣,臺東市,38774,107235,53986,53249
2014/3/1,臺東縣,成功鎮,5447,15038,7938,7100
2014/3/1,臺東縣,關山鎮,3244,9220,4832,4388
2014/3/1,臺東縣,卑南鄉,6611,17690,9428,8262
2014/3/1,臺東縣,大武鄉,2505,6515,3390,3125
2014/3/1,臺東縣,太麻里鄉,4616,11567,6130,5437
2014/3/1,臺東縣,東河鄉,3739,8982,4978,4004
2014/3/1,臺東縣,長濱鄉,2914,7734,4403,3331
2014/3/1,臺東縣,鹿野鄉,3121,8223,4401,3822
2014/3/1,臺東縣,池上鄉,3269,8667,4557,4110
2014/3/1,臺東縣,綠島鄉,1099,3674,1944,1730
2014/3/1,臺東縣,延平鄉,1072,3556,1921,1635
2014/3/1,臺東縣,海端鄉,1092,4378,2379,1999
2014/3/1,臺東縣,達仁鄉,1479,3726,2031,1695
2014/3/1,臺東縣,金峰鄉,1105,3555,1846,1709
2014/3/1,臺東縣,蘭嶼鄉,1707,4915,2499,2416
2014/3/1,花蓮縣,花蓮市,41205,107090,52093,54997
2014/3/1,花蓮縣,鳳林鎮,4420,11367,5999,5368
2014/3/1,花蓮縣,玉里鎮,8910,25576,13715,11861
2014/3/1,花蓮縣,新城鄉,7476,20106,10411,9695
2014/3/1,花蓮縣,吉安鄉,30738,82231,41801,40430
2014/3/1,花蓮縣,壽豐鄉,6919,18104,9738,8366
2014/3/1,花蓮縣,光復鄉,5027,13401,7113,6288
2014/3/1,花蓮縣,豐濱鄉,1742,4694,2602,2092
2014/3/1,花蓮縣,瑞穗鄉,4663,12168,6541,5627
2014/3/1,花蓮縣,富里鄉,4022,10962,5963,4999
2014/3/1,花蓮縣,秀林鄉,4742,15309,7929,7380
2014/3/1,花蓮縣,萬榮鄉,2078,6502,3455,3047
2014/3/1,花蓮縣,卓溪鄉,1664,6129,3371,2758
2014/3/1,澎湖縣,馬公市,22545,59732,30398,29334
2014/3/1,澎湖縣,湖西鄉,5276,14233,7523,6710
2014/3/1,澎湖縣,白沙鄉,3288,9640,5053,4587
2014/3/1,澎湖縣,西嶼鄉,2934,8449,4349,4100
2014/3/1,澎湖縣,望安鄉,1995,5050,2714,2336
2014/3/1,澎湖縣,七美鄉,1313,3708,1945,1763
2014/3/1,基隆市,中正區,22340,53383,27290,26093
2014/3/1,基隆市,七堵區,20722,53976,27313,26663
2014/3/1,基隆市,暖暖區,15009,37927,19202,18725
2014/3/1,基隆市,仁愛區,19556,46987,23150,23837
2014/3/1,基隆市,中山區,19295,49069,25007,24062
2014/3/1,基隆市,安樂區,32161,81902,40830,41072
2014/3/1,基隆市,信義區,20697,51184,25603,25581
2014/3/1,新竹市,東區,73729,205127,101036,104091
2014/3/1,新竹市,北區,53626,148188,72853,75335
2014/3/1,新竹市,香山區,25213,75897,38634,37263
2014/3/1,嘉義市,東區,44969,123927,60228,63699
2014/3/1,嘉義市,西區,52743,147176,72475,74701
2014/3/1,金門縣,金城鎮,12253,39490,19827,19663
2014/3/1,金門縣,金湖鎮,8160,26341,13325,13016
2014/3/1,金門縣,金沙鎮,5934,18754,9317,9437
2014/3/1,金門縣,金寧鄉,7374,25618,12984,12634
2014/3/1,金門縣,烈嶼鄉,2948,11432,5640,5792
2014/3/1,金門縣,烏坵鄉,134,661,330,331
2014/3/1,連江縣,南竿鄉,1376,7399,4194,3205
2014/3/1,連江縣,北竿鄉,469,2290,1264,1026
2014/3/1,連江縣,莒光鄉,272,1435,848,587
2014/3/1,連江縣,東引鄉,291,1187,709,478
2014/4/1,總計,新北市,1481945,3954905,1948566,2006339
2014/4/1,總計,臺北市,1028991,2691331,1291738,1399593
2014/4/1,總計,臺中市,901517,2706209,1341394,1364815
2014/4/1,總計,臺南市,664400,1883102,944169,938933
2014/4/1,總計,高雄市,1057883,2778132,1384253,1393879
2014/4/1,總計,臺灣省,3134358,9233971,4704717,4529254
2014/4/1,總計,宜蘭縣,161263,458550,232858,225692
2014/4/1,總計,桃園市,720259,2046547,1027533,1019014
2014/4/1,總計,新竹縣,175896,532474,272814,259660
2014/4/1,總計,苗栗縣,181460,565965,291982,273983
2014/4/1,總計,彰化縣,376533,1294433,662452,631981
2014/4/1,總計,南投縣,175572,516207,264919,251288
2014/4/1,總計,雲林縣,236923,707151,368070,339081
2014/4/1,總計,嘉義縣,180800,527470,274766,252704
2014/4/1,總計,屏東縣,282363,850931,436309,414622
2014/4/1,總計,臺東縣,81808,224803,116693,108110
2014/4/1,總計,花蓮縣,123680,333694,170711,162983
2014/4/1,總計,澎湖縣,37419,100994,52057,48937
2014/4/1,總計,基隆市,149853,374269,188306,185963
2014/4/1,總計,新竹市,152774,429420,212627,216793
2014/4/1,總計,嘉義市,97755,271063,132620,138443
2014/4/1,總計,福建省,39346,135298,68794,66504
2014/4/1,總計,金門縣,36932,122956,61757,61199
2014/4/1,總計,連江縣,2414,12342,7037,5305
2014/4/1,新北市,板橋區,203812,556588,272962,283626
2014/4/1,新北市,三重區,146118,389309,192735,196574
2014/4/1,新北市,中和區,161222,414947,203149,211798
2014/4/1,新北市,永和區,90714,228938,109204,119734
2014/4/1,新北市,新莊區,145178,410076,201409,208667
2014/4/1,新北市,新店區,121433,298641,144791,153850
2014/4/1,新北市,樹林區,64503,183556,91966,91590
2014/4/1,新北市,鶯歌區,28959,88717,44515,44202
2014/4/1,新北市,三峽區,39623,110309,55740,54569
2014/4/1,新北市,淡水區,66268,156368,75415,80953
2014/4/1,新北市,汐止區,83317,194025,95368,98657
2014/4/1,新北市,瑞芳區,16016,41390,20910,20480
2014/4/1,新北市,土城區,85058,238985,118527,120458
2014/4/1,新北市,蘆洲區,68312,199213,98183,101030
2014/4/1,新北市,五股區,28831,81793,41313,40480
2014/4/1,新北市,泰山區,27352,78115,38955,39160
2014/4/1,新北市,林口區,36566,95053,46604,48449
2014/4/1,新北市,深坑區,9259,23514,11805,11709
2014/4/1,新北市,石碇區,3367,7869,4340,3529
2014/4/1,新北市,坪林區,2474,6440,3608,2832
2014/4/1,新北市,三芝區,9201,23456,12081,11375
2014/4/1,新北市,石門區,4261,12686,6605,6081
2014/4/1,新北市,八里區,13388,36357,18270,18087
2014/4/1,新北市,平溪區,2373,4999,2769,2230
2014/4/1,新北市,雙溪區,3849,9422,5065,4357
2014/4/1,新北市,貢寮區,4452,13257,6793,6464
2014/4/1,新北市,金山區,6952,22339,11096,11243
2014/4/1,新北市,萬里區,7315,22506,11391,11115
2014/4/1,新北市,烏來區,1772,6037,2997,3040
2014/4/1,臺北市,松山區,79885,210554,99531,111023
2014/4/1,臺北市,信義區,88498,228733,109749,118984
2014/4/1,臺北市,大安區,119563,313690,147063,166627
2014/4/1,臺北市,中山區,97393,229075,107052,122023
2014/4/1,臺北市,中正區,64737,163578,78371,85207
2014/4/1,臺北市,大同區,50737,130236,63771,66465
2014/4/1,臺北市,萬華區,77380,193427,95738,97689
2014/4/1,臺北市,文山區,102234,272167,131262,140905
2014/4/1,臺北市,南港區,45182,120053,58724,61329
2014/4/1,臺北市,內湖區,104262,283774,136115,147659
2014/4/1,臺北市,士林區,104975,290033,140453,149580
2014/4/1,臺北市,北投區,94145,256011,123909,132102
2014/4/1,臺中市,中區,7935,19823,9849,9974
2014/4/1,臺中市,東區,26915,74622,37323,37299
2014/4/1,臺中市,南區,45197,118741,57391,61350
2014/4/1,臺中市,西區,44623,116336,55438,60898
2014/4/1,臺中市,北區,57890,147711,71151,76560
2014/4/1,臺中市,西屯區,79172,216350,104324,112026
2014/4/1,臺中市,南屯區,57562,160629,77260,83369
2014/4/1,臺中市,北屯區,90476,257384,124254,133130
2014/4/1,臺中市,豐原區,51708,166210,82349,83861
2014/4/1,臺中市,東勢區,17198,51801,26802,24999
2014/4/1,臺中市,大甲區,22365,77874,39444,38430
2014/4/1,臺中市,清水區,25906,86044,44296,41748
2014/4/1,臺中市,沙鹿區,26588,86814,44091,42723
2014/4/1,臺中市,梧棲區,16607,56145,28294,27851
2014/4/1,臺中市,后里區,15294,54038,27558,26480
2014/4/1,臺中市,神岡區,18525,64872,33273,31599
2014/4/1,臺中市,潭子區,34296,104414,51860,52554
2014/4/1,臺中市,大雅區,27585,92116,46176,45940
2014/4/1,臺中市,新社區,7459,25268,13161,12107
2014/4/1,臺中市,石岡區,4904,15552,8094,7458
2014/4/1,臺中市,外埔區,9222,31811,16338,15473
2014/4/1,臺中市,大安區,5320,19644,10347,9297
2014/4/1,臺中市,烏日區,22157,70898,35846,35052
2014/4/1,臺中市,大肚區,16541,56144,28740,27404
2014/4/1,臺中市,龍井區,21755,75590,38348,37242
2014/4/1,臺中市,霧峰區,19375,64308,32860,31448
2014/4/1,臺中市,太平區,58714,179418,89536,89882
2014/4/1,臺中市,大里區,65835,204981,101259,103722
2014/4/1,臺中市,和平區,4393,10671,5732,4939
2014/4/1,臺南市,新營區,28299,78528,38965,39563
2014/4/1,臺南市,鹽水區,10021,26384,13743,12641
2014/4/1,臺南市,白河區,10991,30013,15728,14285
2014/4/1,臺南市,柳營區,7800,21829,11374,10455
2014/4/1,臺南市,後壁區,8896,24723,12877,11846
2014/4/1,臺南市,東山區,8291,22056,11707,10349
2014/4/1,臺南市,麻豆區,15420,45211,22986,22225
2014/4/1,臺南市,下營區,9126,25212,12988,12224
2014/4/1,臺南市,六甲區,7736,23078,11957,11121
2014/4/1,臺南市,官田區,7757,21775,11134,10641
2014/4/1,臺南市,大內區,3993,10333,5505,4828
2014/4/1,臺南市,佳里區,20079,59471,29500,29971
2014/4/1,臺南市,學甲區,9650,27101,13872,13229
2014/4/1,臺南市,西港區,7972,24864,12618,12246
2014/4/1,臺南市,七股區,8107,23672,12351,11321
2014/4/1,臺南市,將軍區,7356,20688,10549,10139
2014/4/1,臺南市,北門區,4386,11800,5948,5852
2014/4/1,臺南市,新化區,14086,43880,22451,21429
2014/4/1,臺南市,善化區,15848,45425,22941,22484
2014/4/1,臺南市,新市區,11430,35378,17783,17595
2014/4/1,臺南市,安定區,9679,30237,15570,14667
2014/4/1,臺南市,山上區,2706,7543,3956,3587
2014/4/1,臺南市,玉井區,5141,14730,7672,7058
2014/4/1,臺南市,楠西區,3551,10161,5399,4762
2014/4/1,臺南市,南化區,2863,8882,4827,4055
2014/4/1,臺南市,左鎮區,1990,5198,2909,2289
2014/4/1,臺南市,仁德區,26353,72669,37009,35660
2014/4/1,臺南市,歸仁區,21768,67259,34161,33098
2014/4/1,臺南市,關廟區,10869,35054,18132,16922
2014/4/1,臺南市,龍崎區,1580,4299,2331,1968
2014/4/1,臺南市,永康區,80426,227296,112411,114885
2014/4/1,臺南市,東區,71981,191366,92180,99186
2014/4/1,臺南市,南區,44399,125512,62498,63014
2014/4/1,臺南市,北區,49429,132285,64848,67437
2014/4/1,臺南市,安南區,59244,186090,94212,91878
2014/4/1,臺南市,安平區,24300,64532,30809,33723
2014/4/1,臺南市,中西區,30877,78568,38268,40300
2014/4/1,高雄市,鹽埕區,10937,25734,12830,12904
2014/4/1,高雄市,鼓山區,54993,135111,65662,69449
2014/4/1,高雄市,左營區,76447,195309,95009,100300
2014/4/1,高雄市,楠梓區,65420,177886,87989,89897
2014/4/1,高雄市,三民區,134173,348027,169370,178657
2014/4/1,高雄市,新興區,22764,53000,25542,27458
2014/4/1,高雄市,前金區,12550,27965,13495,14470
2014/4/1,高雄市,苓雅區,72094,177042,85733,91309
2014/4/1,高雄市,前鎮區,77623,194330,96028,98302
2014/4/1,高雄市,旗津區,10946,28966,15006,13960
2014/4/1,高雄市,小港區,65546,156009,77865,78144
2014/4/1,高雄市,鳳山區,134496,353205,174202,179003
2014/4/1,高雄市,林園區,25279,70502,35911,34591
2014/4/1,高雄市,大寮區,40403,110454,56973,53481
2014/4/1,高雄市,大樹區,13232,43221,22230,20991
2014/4/1,高雄市,大社區,12511,34195,17462,16733
2014/4/1,高雄市,仁武區,29652,79880,40905,38975
2014/4/1,高雄市,鳥松區,17365,43716,22219,21497
2014/4/1,高雄市,岡山區,34256,97732,48662,49070
2014/4/1,高雄市,橋頭區,13095,37063,18925,18138
2014/4/1,高雄市,燕巢區,10282,30505,16182,14323
2014/4/1,高雄市,田寮區,3441,7701,4289,3412
2014/4/1,高雄市,阿蓮區,9364,29676,14977,14699
2014/4/1,高雄市,路竹區,16501,52982,27061,25921
2014/4/1,高雄市,湖內區,10203,29291,15005,14286
2014/4/1,高雄市,茄萣區,10374,30778,15958,14820
2014/4/1,高雄市,永安區,5817,14083,7090,6993
2014/4/1,高雄市,彌陀區,6692,19893,10309,9584
2014/4/1,高雄市,梓官區,12367,36387,18811,17576
2014/4/1,高雄市,旗山區,13868,38421,19916,18505
2014/4/1,高雄市,美濃區,14451,41554,21689,19865
2014/4/1,高雄市,六龜區,5680,13877,7493,6384
2014/4/1,高雄市,甲仙區,2379,6406,3413,2993
2014/4/1,高雄市,杉林區,4820,12512,6826,5686
2014/4/1,高雄市,內門區,5070,15273,8309,6964
2014/4/1,高雄市,茂林區,584,1874,936,938
2014/4/1,高雄市,桃源區,1342,4395,2323,2072
2014/4/1,高雄市,那瑪夏區,866,3177,1648,1529
2014/4/1,宜蘭縣,宜蘭市,34878,95841,46879,48962
2014/4/1,宜蘭縣,羅東鎮,25655,72377,34557,37820
2014/4/1,宜蘭縣,蘇澳鎮,13897,41306,21096,20210
2014/4/1,宜蘭縣,頭城鎮,10017,29965,15483,14482
2014/4/1,宜蘭縣,礁溪鄉,13154,36040,18852,17188
2014/4/1,宜蘭縣,壯圍鄉,8406,24518,12990,11528
2014/4/1,宜蘭縣,員山鄉,11230,32253,17158,15095
2014/4/1,宜蘭縣,冬山鄉,18437,53657,27519,26138
2014/4/1,宜蘭縣,五結鄉,13814,39195,20309,18886
2014/4/1,宜蘭縣,三星鄉,8012,21298,11532,9766
2014/4/1,宜蘭縣,大同鄉,1873,6081,3303,2778
2014/4/1,宜蘭縣,南澳鄉,1890,6019,3180,2839
2014/4/1,桃園市,桃園區,153722,415640,203186,212454
2014/4/1,桃園市,中壢區,136732,379579,188611,190968
2014/4/1,桃園市,平鎮區,71182,211283,105853,105430
2014/4/1,桃園市,八德區,62374,179943,91042,88901
2014/4/1,桃園市,楊梅區,52782,156063,79188,76875
2014/4/1,桃園市,大溪區,30500,91928,47302,44626
2014/4/1,桃園市,蘆竹區,53040,150078,75013,75065
2014/4/1,桃園市,大園區,28374,83787,43190,40597
2014/4/1,桃園市,龜山區,53319,140569,70768,69801
2014/4/1,桃園市,龍潭區,38659,115889,58668,57221
2014/4/1,桃園市,新屋區,15349,47958,25676,22282
2014/4/1,桃園市,觀音區,20503,63134,33114,30020
2014/4/1,桃園市,復興區,3723,10696,5922,4774
2014/4/1,新竹縣,竹北市,55945,160565,80112,80453
2014/4/1,新竹縣,關西鎮,9521,30845,16435,14410
2014/4/1,新竹縣,新埔鎮,10597,34622,18401,16221
2014/4/1,新竹縣,竹東鎮,32034,96085,48356,47729
2014/4/1,新竹縣,湖口鄉,24871,76963,39113,37850
2014/4/1,新竹縣,橫山鄉,4516,13927,7535,6392
2014/4/1,新竹縣,新豐鄉,17188,55469,28467,27002
2014/4/1,新竹縣,芎林鄉,6385,20235,10704,9531
2014/4/1,新竹縣,寶山鄉,5059,14230,7700,6530
2014/4/1,新竹縣,北埔鄉,3148,9774,5266,4508
2014/4/1,新竹縣,峨眉鄉,2074,5755,3188,2567
2014/4/1,新竹縣,尖石鄉,2817,9309,4974,4335
2014/4/1,新竹縣,五峰鄉,1741,4695,2563,2132
2014/4/1,苗栗縣,苗栗市,30346,91119,45602,45517
2014/4/1,苗栗縣,苑裡鎮,14294,48485,25109,23376
2014/4/1,苗栗縣,通霄鎮,11536,37090,19582,17508
2014/4/1,苗栗縣,竹南鎮,26627,82800,41917,40883
2014/4/1,苗栗縣,頭份市,32477,101761,51432,50329
2014/4/1,苗栗縣,後龍鎮,11875,38499,20239,18260
2014/4/1,苗栗縣,卓蘭鎮,6176,18393,9642,8751
2014/4/1,苗栗縣,大湖鄉,5437,15639,8281,7358
2014/4/1,苗栗縣,公館鄉,10544,34740,18063,16677
2014/4/1,苗栗縣,銅鑼鄉,6120,18976,10079,8897
2014/4/1,苗栗縣,南庄鄉,3974,10685,5866,4819
2014/4/1,苗栗縣,頭屋鄉,3633,11407,6001,5406
2014/4/1,苗栗縣,三義鄉,5445,17306,9073,8233
2014/4/1,苗栗縣,西湖鄉,2705,7621,4225,3396
2014/4/1,苗栗縣,造橋鄉,4126,13524,7114,6410
2014/4/1,苗栗縣,三灣鄉,2439,7144,3885,3259
2014/4/1,苗栗縣,獅潭鄉,1730,4711,2624,2087
2014/4/1,苗栗縣,泰安鄉,1976,6065,3248,2817
2014/4/1,彰化縣,彰化市,74522,235765,116914,118851
2014/4/1,彰化縣,鹿港鎮,23433,85980,43879,42101
2014/4/1,彰化縣,和美鎮,25628,90584,46358,44226
2014/4/1,彰化縣,北斗鎮,10314,33220,16789,16431
2014/4/1,彰化縣,員林市,38079,125132,62645,62487
2014/4/1,彰化縣,溪湖鎮,15828,55735,28406,27329
2014/4/1,彰化縣,田中鎮,12868,43026,22270,20756
2014/4/1,彰化縣,二林鎮,14787,52760,27215,25545
2014/4/1,彰化縣,線西鄉,4270,17131,8860,8271
2014/4/1,彰化縣,伸港鄉,9393,36108,18507,17601
2014/4/1,彰化縣,福興鄉,12446,47924,25032,22892
2014/4/1,彰化縣,秀水鄉,10257,39367,20344,19023
2014/4/1,彰化縣,花壇鄉,13563,45951,23668,22283
2014/4/1,彰化縣,芬園鄉,6851,24206,12743,11463
2014/4/1,彰化縣,大村鄉,10673,36371,18874,17497
2014/4/1,彰化縣,埔鹽鄉,8962,33354,17516,15838
2014/4/1,彰化縣,埔心鄉,10290,34951,18026,16925
2014/4/1,彰化縣,永靖鄉,10759,38403,20000,18403
2014/4/1,彰化縣,社頭鄉,12645,43763,22533,21230
2014/4/1,彰化縣,二水鄉,5358,15911,8348,7563
2014/4/1,彰化縣,田尾鄉,7814,27892,14470,13422
2014/4/1,彰化縣,埤頭鄉,8846,31160,16213,14947
2014/4/1,彰化縣,芳苑鄉,10097,34958,18505,16453
2014/4/1,彰化縣,大城鄉,5350,17958,9721,8237
2014/4/1,彰化縣,竹塘鄉,4638,16005,8432,7573
2014/4/1,彰化縣,溪州鄉,8862,30818,16184,14634
2014/4/1,南投縣,南投市,34117,102664,51527,51137
2014/4/1,南投縣,埔里鎮,28796,83436,41934,41502
2014/4/1,南投縣,草屯鎮,32333,99262,50138,49124
2014/4/1,南投縣,竹山鎮,19919,57013,29286,27727
2014/4/1,南投縣,集集鎮,4367,11468,6001,5467
2014/4/1,南投縣,名間鄉,12513,40185,21098,19087
2014/4/1,南投縣,鹿谷鄉,7383,18620,9893,8727
2014/4/1,南投縣,中寮鄉,5647,15622,8492,7130
2014/4/1,南投縣,魚池鄉,5759,16631,8723,7908
2014/4/1,南投縣,國姓鄉,7285,19858,10754,9104
2014/4/1,南投縣,水里鄉,7262,18899,9913,8986
2014/4/1,南投縣,信義鄉,5246,16724,8983,7741
2014/4/1,南投縣,仁愛鄉,4945,15825,8177,7648
2014/4/1,雲林縣,斗六市,36693,108028,54036,53992
2014/4/1,雲林縣,斗南鎮,15646,46173,23449,22724
2014/4/1,雲林縣,虎尾鎮,23861,70430,35776,34654
2014/4/1,雲林縣,西螺鎮,14368,47353,24109,23244
2014/4/1,雲林縣,土庫鎮,9137,29767,15553,14214
2014/4/1,雲林縣,北港鎮,15919,41891,21770,20121
2014/4/1,雲林縣,古坑鄉,10871,32744,17268,15476
2014/4/1,雲林縣,大埤鄉,6747,20115,10812,9303
2014/4/1,雲林縣,莿桐鄉,9268,29752,15610,14142
2014/4/1,雲林縣,林內鄉,5871,19119,9986,9133
2014/4/1,雲林縣,二崙鄉,8902,28598,15287,13311
2014/4/1,雲林縣,崙背鄉,8521,26171,13813,12358
2014/4/1,雲林縣,麥寮鄉,13669,42871,21788,21083
2014/4/1,雲林縣,東勢鄉,5803,15828,8667,7161
2014/4/1,雲林縣,褒忠鄉,4403,13666,7331,6335
2014/4/1,雲林縣,臺西鄉,8827,25111,13486,11625
2014/4/1,雲林縣,元長鄉,9455,27556,15015,12541
2014/4/1,雲林縣,四湖鄉,9014,25589,13873,11716
2014/4/1,雲林縣,口湖鄉,9642,29207,15522,13685
2014/4/1,雲林縣,水林鄉,10306,27182,14919,12263
2014/4/1,嘉義縣,太保市,12023,36959,19067,17892
2014/4/1,嘉義縣,朴子市,15283,43512,22027,21485
2014/4/1,嘉義縣,布袋鎮,10145,28511,14617,13894
2014/4/1,嘉義縣,大林鎮,11370,32412,16627,15785
2014/4/1,嘉義縣,民雄鄉,23827,71999,36879,35120
2014/4/1,嘉義縣,溪口鄉,5441,15574,8276,7298
2014/4/1,嘉義縣,新港鄉,10567,33441,17712,15729
2014/4/1,嘉義縣,六腳鄉,9038,24847,13163,11684
2014/4/1,嘉義縣,東石鄉,9458,26306,13986,12320
2014/4/1,嘉義縣,義竹鄉,7551,19737,10270,9467
2014/4/1,嘉義縣,鹿草鄉,5825,16574,8888,7686
2014/4/1,嘉義縣,水上鄉,17840,51048,26350,24698
2014/4/1,嘉義縣,中埔鄉,15888,46350,24147,22203
2014/4/1,嘉義縣,竹崎鄉,11583,37209,19847,17362
2014/4/1,嘉義縣,梅山鄉,6770,20504,10881,9623
2014/4/1,嘉義縣,番路鄉,4295,12124,6569,5555
2014/4/1,嘉義縣,大埔鄉,1952,4619,2402,2217
2014/4/1,嘉義縣,阿里山鄉,1944,5744,3058,2686
2014/4/1,屏東縣,屏東市,73198,205187,101996,103191
2014/4/1,屏東縣,潮州鎮,18887,54940,27574,27366
2014/4/1,屏東縣,東港鎮,16171,48483,24525,23958
2014/4/1,屏東縣,恆春鎮,11164,30845,15792,15053
2014/4/1,屏東縣,萬丹鄉,14629,52379,27130,25249
2014/4/1,屏東縣,長治鄉,9942,30432,15896,14536
2014/4/1,屏東縣,麟洛鄉,3713,11337,5855,5482
2014/4/1,屏東縣,九如鄉,6750,22355,11565,10790
2014/4/1,屏東縣,里港鄉,8066,26678,13563,13115
2014/4/1,屏東縣,鹽埔鄉,7828,26621,13824,12797
2014/4/1,屏東縣,高樹鄉,9423,25652,13682,11970
2014/4/1,屏東縣,萬巒鄉,6437,21050,11066,9984
2014/4/1,屏東縣,內埔鄉,18319,56440,29264,27176
2014/4/1,屏東縣,竹田鄉,5623,17786,9446,8340
2014/4/1,屏東縣,新埤鄉,3419,10235,5440,4795
2014/4/1,屏東縣,枋寮鄉,8587,25653,13427,12226
2014/4/1,屏東縣,新園鄉,11726,36945,19134,17811
2014/4/1,屏東縣,崁頂鄉,4387,16375,8324,8051
2014/4/1,屏東縣,林邊鄉,7041,19448,10011,9437
2014/4/1,屏東縣,南州鄉,3676,11116,5688,5428
2014/4/1,屏東縣,佳冬鄉,7041,20424,10621,9803
2014/4/1,屏東縣,琉球鄉,4201,12595,6959,5636
2014/4/1,屏東縣,車城鄉,3479,9126,4914,4212
2014/4/1,屏東縣,滿州鄉,3037,8122,4455,3667
2014/4/1,屏東縣,枋山鄉,2129,5806,3082,2724
2014/4/1,屏東縣,三地門鄉,2269,7674,3887,3787
2014/4/1,屏東縣,霧臺鄉,1051,3329,1710,1619
2014/4/1,屏東縣,瑪家鄉,1960,6650,3426,3224
2014/4/1,屏東縣,泰武鄉,1265,5181,2711,2470
2014/4/1,屏東縣,來義鄉,2221,7596,3889,3707
2014/4/1,屏東縣,春日鄉,1333,4826,2483,2343
2014/4/1,屏東縣,獅子鄉,1510,4830,2493,2337
2014/4/1,屏東縣,牡丹鄉,1881,4815,2477,2338
2014/4/1,臺東縣,臺東市,38781,107135,53932,53203
2014/4/1,臺東縣,成功鎮,5440,15037,7926,7111
2014/4/1,臺東縣,關山鎮,3239,9204,4822,4382
2014/4/1,臺東縣,卑南鄉,6619,17690,9427,8263
2014/4/1,臺東縣,大武鄉,2507,6518,3386,3132
2014/4/1,臺東縣,太麻里鄉,4617,11559,6133,5426
2014/4/1,臺東縣,東河鄉,3744,9008,4988,4020
2014/4/1,臺東縣,長濱鄉,2917,7778,4420,3358
2014/4/1,臺東縣,鹿野鄉,3121,8230,4411,3819
2014/4/1,臺東縣,池上鄉,3274,8661,4551,4110
2014/4/1,臺東縣,綠島鄉,1094,3763,1988,1775
2014/4/1,臺東縣,延平鄉,1075,3574,1928,1646
2014/4/1,臺東縣,海端鄉,1089,4387,2379,2008
2014/4/1,臺東縣,達仁鄉,1478,3734,2034,1700
2014/4/1,臺東縣,金峰鄉,1106,3590,1860,1730
2014/4/1,臺東縣,蘭嶼鄉,1707,4935,2508,2427
2014/4/1,花蓮縣,花蓮市,41190,107005,52025,54980
2014/4/1,花蓮縣,鳳林鎮,4424,11339,5981,5358
2014/4/1,花蓮縣,玉里鎮,8915,25606,13723,11883
2014/4/1,花蓮縣,新城鄉,7474,20095,10402,9693
2014/4/1,花蓮縣,吉安鄉,30768,82208,41783,40425
2014/4/1,花蓮縣,壽豐鄉,6950,18145,9762,8383
2014/4/1,花蓮縣,光復鄉,5030,13441,7130,6311
2014/4/1,花蓮縣,豐濱鄉,1742,4710,2611,2099
2014/4/1,花蓮縣,瑞穗鄉,4670,12177,6538,5639
2014/4/1,花蓮縣,富里鄉,4020,10952,5967,4985
2014/4/1,花蓮縣,秀林鄉,4749,15329,7935,7394
2014/4/1,花蓮縣,萬榮鄉,2080,6512,3457,3055
2014/4/1,花蓮縣,卓溪鄉,1668,6175,3397,2778
2014/4/1,澎湖縣,馬公市,22580,59825,30433,29392
2014/4/1,澎湖縣,湖西鄉,5276,14229,7514,6715
2014/4/1,澎湖縣,白沙鄉,3300,9660,5065,4595
2014/4/1,澎湖縣,西嶼鄉,2945,8463,4354,4109
2014/4/1,澎湖縣,望安鄉,2000,5080,2733,2347
2014/4/1,澎湖縣,七美鄉,1318,3737,1958,1779
2014/4/1,基隆市,中正區,22353,53336,27264,26072
2014/4/1,基隆市,七堵區,20757,53998,27336,26662
2014/4/1,基隆市,暖暖區,15018,37987,19215,18772
2014/4/1,基隆市,仁愛區,19570,46993,23149,23844
2014/4/1,基隆市,中山區,19287,49005,24964,24041
2014/4/1,基隆市,安樂區,32172,81848,40814,41034
2014/4/1,基隆市,信義區,20696,51102,25564,25538
2014/4/1,新竹市,東區,73843,205288,101126,104162
2014/4/1,新竹市,北區,53682,148262,72849,75413
2014/4/1,新竹市,香山區,25249,75870,38652,37218
2014/4/1,嘉義市,東區,44990,123877,60196,63681
2014/4/1,嘉義市,西區,52765,147186,72424,74762
2014/4/1,金門縣,金城鎮,12277,39712,19946,19766
2014/4/1,金門縣,金湖鎮,8184,26491,13399,13092
2014/4/1,金門縣,金沙鎮,5960,18866,9371,9495
2014/4/1,金門縣,金寧鄉,7425,25759,13053,12706
2014/4/1,金門縣,烈嶼鄉,2952,11462,5653,5809
2014/4/1,金門縣,烏坵鄉,134,666,335,331
2014/4/1,連江縣,南竿鄉,1378,7420,4208,3212
2014/4/1,連江縣,北竿鄉,472,2296,1269,1027
2014/4/1,連江縣,莒光鄉,272,1427,842,585
2014/4/1,連江縣,東引鄉,292,1199,718,481
2014/5/1,總計,新北市,1484920,3955995,1948623,2007372
2014/5/1,總計,臺北市,1030335,2692138,1291858,1400280
2014/5/1,總計,臺中市,902984,2707123,1341676,1365447
2014/5/1,總計,臺南市,664951,1882865,943948,938917
2014/5/1,總計,高雄市,1058800,2777415,1383711,1393704
2014/5/1,總計,臺灣省,3139219,9235470,4705189,4530281
2014/5/1,總計,宜蘭縣,161509,458568,232816,225752
2014/5/1,總計,桃園市,722364,2047834,1028137,1019697
2014/5/1,總計,新竹縣,176420,533361,273250,260111
2014/5/1,總計,苗栗縣,181740,566262,292091,274171
2014/5/1,總計,彰化縣,376876,1293997,662196,631801
2014/5/1,總計,南投縣,175693,515996,264788,251208
2014/5/1,總計,雲林縣,237115,707199,368088,339111
2014/5/1,總計,嘉義縣,180931,527196,274673,252523
2014/5/1,總計,屏東縣,282513,850693,436155,414538
2014/5/1,總計,臺東縣,81832,224905,116747,108158
2014/5/1,總計,花蓮縣,123752,333668,170674,162994
2014/5/1,總計,澎湖縣,37489,101156,52116,49040
2014/5/1,總計,基隆市,149982,373998,188180,185818
2014/5/1,總計,新竹市,153200,429654,212745,216909
2014/5/1,總計,嘉義市,97803,270983,132533,138450
2014/5/1,總計,福建省,39477,135877,69087,66790
2014/5/1,總計,金門縣,37060,123512,62025,61487
2014/5/1,總計,連江縣,2417,12365,7062,5303
2014/5/1,新北市,板橋區,204060,556447,272833,283614
2014/5/1,新北市,三重區,146372,389240,192684,196556
2014/5/1,新北市,中和區,161465,414879,203081,211798
2014/5/1,新北市,永和區,90782,228715,109058,119657
2014/5/1,新北市,新莊區,145501,410133,201357,208776
2014/5/1,新北市,新店區,121705,298737,144826,153911
2014/5/1,新北市,樹林區,64610,183659,91957,91702
2014/5/1,新北市,鶯歌區,29046,88769,44516,44253
2014/5/1,新北市,三峽區,39747,110437,55784,54653
2014/5/1,新北市,淡水區,66620,156807,75642,81165
2014/5/1,新北市,汐止區,83485,194218,95451,98767
2014/5/1,新北市,瑞芳區,16043,41398,20916,20482
2014/5/1,新北市,土城區,85180,239013,118542,120471
2014/5/1,新北市,蘆洲區,68441,199234,98140,101094
2014/5/1,新北市,五股區,28922,81857,41354,40503
2014/5/1,新北市,泰山區,27385,78121,38947,39174
2014/5/1,新北市,林口區,36766,95391,46753,48638
2014/5/1,新北市,深坑區,9281,23545,11817,11728
2014/5/1,新北市,石碇區,3373,7875,4334,3541
2014/5/1,新北市,坪林區,2469,6424,3597,2827
2014/5/1,新北市,三芝區,9218,23460,12082,11378
2014/5/1,新北市,石門區,4264,12671,6596,6075
2014/5/1,新北市,八里區,13449,36442,18310,18132
2014/5/1,新北市,平溪區,2372,4986,2753,2233
2014/5/1,新北市,雙溪區,3851,9419,5058,4361
2014/5/1,新北市,貢寮區,4447,13243,6784,6459
2014/5/1,新北市,金山區,6978,22360,11090,11270
2014/5/1,新北市,萬里區,7316,22469,11352,11117
2014/5/1,新北市,烏來區,1772,6046,3009,3037
2014/5/1,臺北市,松山區,79933,210574,99551,111023
2014/5/1,臺北市,信義區,88572,228716,109708,119008
2014/5/1,臺北市,大安區,119734,313733,147083,166650
2014/5/1,臺北市,中山區,97524,229167,107084,122083
2014/5/1,臺北市,中正區,64819,163623,78380,85243
2014/5/1,臺北市,大同區,50810,130317,63809,66508
2014/5/1,臺北市,萬華區,77451,193395,95709,97686
2014/5/1,臺北市,文山區,102406,272336,131291,141045
2014/5/1,臺北市,南港區,45247,120201,58761,61440
2014/5/1,臺北市,內湖區,104440,283856,136104,147752
2014/5/1,臺北市,士林區,105103,290064,140428,149636
2014/5/1,臺北市,北投區,94296,256156,123950,132206
2014/5/1,臺中市,中區,7942,19765,9820,9945
2014/5/1,臺中市,東區,26956,74639,37311,37328
2014/5/1,臺中市,南區,45286,118879,57481,61398
2014/5/1,臺中市,西區,44628,116191,55319,60872
2014/5/1,臺中市,北區,57953,147606,71088,76518
2014/5/1,臺中市,西屯區,79367,216633,104446,112187
2014/5/1,臺中市,南屯區,57714,160757,77293,83464
2014/5/1,臺中市,北屯區,90680,257688,124420,133268
2014/5/1,臺中市,豐原區,51789,166191,82322,83869
2014/5/1,臺中市,東勢區,17222,51790,26777,25013
2014/5/1,臺中市,大甲區,22373,77802,39401,38401
2014/5/1,臺中市,清水區,25907,86037,44292,41745
2014/5/1,臺中市,沙鹿區,26682,86926,44148,42778
2014/5/1,臺中市,梧棲區,16630,56155,28296,27859
2014/5/1,臺中市,后里區,15323,54011,27540,26471
2014/5/1,臺中市,神岡區,18533,64876,33278,31598
2014/5/1,臺中市,潭子區,34335,104470,51867,52603
2014/5/1,臺中市,大雅區,27602,92099,46154,45945
2014/5/1,臺中市,新社區,7455,25246,13140,12106
2014/5/1,臺中市,石岡區,4897,15523,8086,7437
2014/5/1,臺中市,外埔區,9233,31764,16331,15433
2014/5/1,臺中市,大安區,5318,19664,10358,9306
2014/5/1,臺中市,烏日區,22213,70925,35845,35080
2014/5/1,臺中市,大肚區,16547,56161,28752,27409
2014/5/1,臺中市,龍井區,21771,75592,38343,37249
2014/5/1,臺中市,霧峰區,19386,64296,32859,31437
2014/5/1,臺中市,太平區,58938,179644,89648,89996
2014/5/1,臺中市,大里區,65904,205060,101300,103760
2014/5/1,臺中市,和平區,4400,10733,5761,4972
2014/5/1,臺南市,新營區,28333,78483,38938,39545
2014/5/1,臺南市,鹽水區,10028,26416,13767,12649
2014/5/1,臺南市,白河區,10984,29987,15706,14281
2014/5/1,臺南市,柳營區,7814,21856,11394,10462
2014/5/1,臺南市,後壁區,8899,24713,12869,11844
2014/5/1,臺南市,東山區,8289,22037,11698,10339
2014/5/1,臺南市,麻豆區,15427,45151,22949,22202
2014/5/1,臺南市,下營區,9120,25219,12996,12223
2014/5/1,臺南市,六甲區,7748,23065,11948,11117
2014/5/1,臺南市,官田區,7755,21775,11135,10640
2014/5/1,臺南市,大內區,3987,10327,5502,4825
2014/5/1,臺南市,佳里區,20108,59476,29509,29967
2014/5/1,臺南市,學甲區,9653,27075,13851,13224
2014/5/1,臺南市,西港區,7981,24858,12606,12252
2014/5/1,臺南市,七股區,8106,23649,12342,11307
2014/5/1,臺南市,將軍區,7352,20674,10537,10137
2014/5/1,臺南市,北門區,4382,11772,5933,5839
2014/5/1,臺南市,新化區,14092,43851,22421,21430
2014/5/1,臺南市,善化區,15890,45457,22957,22500
2014/5/1,臺南市,新市區,11444,35386,17800,17586
2014/5/1,臺南市,安定區,9688,30254,15565,14689
2014/5/1,臺南市,山上區,2701,7530,3951,3579
2014/5/1,臺南市,玉井區,5137,14684,7656,7028
2014/5/1,臺南市,楠西區,3550,10159,5396,4763
2014/5/1,臺南市,南化區,2863,8890,4827,4063
2014/5/1,臺南市,左鎮區,1989,5203,2910,2293
2014/5/1,臺南市,仁德區,26366,72640,37016,35624
2014/5/1,臺南市,歸仁區,21790,67273,34173,33100
2014/5/1,臺南市,關廟區,10876,35008,18120,16888
2014/5/1,臺南市,龍崎區,1584,4308,2334,1974
2014/5/1,臺南市,永康區,80505,227386,112431,114955
2014/5/1,臺南市,東區,71986,191207,92091,99116
2014/5/1,臺南市,南區,44465,125560,62521,63039
2014/5/1,臺南市,北區,49492,132286,64816,67470
2014/5/1,臺南市,安南區,59386,186294,94277,92017
2014/5/1,臺南市,安平區,24326,64516,30788,33728
2014/5/1,臺南市,中西區,30855,78440,38218,40222
2014/5/1,高雄市,鹽埕區,10920,25670,12801,12869
2014/5/1,高雄市,鼓山區,55040,135161,65656,69505
2014/5/1,高雄市,左營區,76585,195340,94975,100365
2014/5/1,高雄市,楠梓區,65521,177902,87994,89908
2014/5/1,高雄市,三民區,134279,347791,169212,178579
2014/5/1,高雄市,新興區,22752,52908,25489,27419
2014/5/1,高雄市,前金區,12541,27929,13475,14454
2014/5/1,高雄市,苓雅區,72099,176849,85620,91229
2014/5/1,高雄市,前鎮區,77708,194295,95978,98317
2014/5/1,高雄市,旗津區,10952,28993,15030,13963
2014/5/1,高雄市,小港區,65556,155953,77838,78115
2014/5/1,高雄市,鳳山區,134712,353157,174202,178955
2014/5/1,高雄市,林園區,25288,70481,35888,34593
2014/5/1,高雄市,大寮區,40478,110530,56999,53531
2014/5/1,高雄市,大樹區,13229,43205,22230,20975
2014/5/1,高雄市,大社區,12513,34181,17459,16722
2014/5/1,高雄市,仁武區,29741,80017,40958,39059
2014/5/1,高雄市,鳥松區,17377,43665,22200,21465
2014/5/1,高雄市,岡山區,34272,97700,48649,49051
2014/5/1,高雄市,橋頭區,13096,37070,18920,18150
2014/5/1,高雄市,燕巢區,10289,30497,16177,14320
2014/5/1,高雄市,田寮區,3438,7693,4284,3409
2014/5/1,高雄市,阿蓮區,9355,29654,14964,14690
2014/5/1,高雄市,路竹區,16514,52980,27060,25920
2014/5/1,高雄市,湖內區,10244,29322,15015,14307
2014/5/1,高雄市,茄萣區,10365,30736,15930,14806
2014/5/1,高雄市,永安區,5816,14086,7083,7003
2014/5/1,高雄市,彌陀區,6692,19909,10318,9591
2014/5/1,高雄市,梓官區,12381,36346,18790,17556
2014/5/1,高雄市,旗山區,13874,38396,19915,18481
2014/5/1,高雄市,美濃區,14455,41499,21673,19826
2014/5/1,高雄市,六龜區,5669,13837,7468,6369
2014/5/1,高雄市,甲仙區,2374,6411,3413,2998
2014/5/1,高雄市,杉林區,4815,12531,6831,5700
2014/5/1,高雄市,內門區,5068,15264,8303,6961
2014/5/1,高雄市,茂林區,584,1874,934,940
2014/5/1,高雄市,桃源區,1342,4388,2321,2067
2014/5/1,高雄市,那瑪夏區,866,3195,1659,1536
2014/5/1,宜蘭縣,宜蘭市,34921,95772,46861,48911
2014/5/1,宜蘭縣,羅東鎮,25685,72352,34529,37823
2014/5/1,宜蘭縣,蘇澳鎮,13920,41299,21093,20206
2014/5/1,宜蘭縣,頭城鎮,10029,29960,15484,14476
2014/5/1,宜蘭縣,礁溪鄉,13173,36006,18828,17178
2014/5/1,宜蘭縣,壯圍鄉,8397,24508,12976,11532
2014/5/1,宜蘭縣,員山鄉,11256,32273,17145,15128
2014/5/1,宜蘭縣,冬山鄉,18475,53705,27551,26154
2014/5/1,宜蘭縣,五結鄉,13855,39227,20311,18916
2014/5/1,宜蘭縣,三星鄉,8031,21319,11528,9791
2014/5/1,宜蘭縣,大同鄉,1874,6096,3313,2783
2014/5/1,宜蘭縣,南澳鄉,1893,6051,3197,2854
2014/5/1,桃園市,桃園區,154120,415786,203206,212580
2014/5/1,桃園市,中壢區,137098,379885,188772,191113
2014/5/1,桃園市,平鎮區,71341,211358,105858,105500
2014/5/1,桃園市,八德區,62577,180091,91102,88989
2014/5/1,桃園市,楊梅區,52952,156184,79263,76921
2014/5/1,桃園市,大溪區,30554,91857,47283,44574
2014/5/1,桃園市,蘆竹區,53178,150189,75087,75102
2014/5/1,桃園市,大園區,28586,83895,43226,40669
2014/5/1,桃園市,龜山區,53410,140665,70844,69821
2014/5/1,桃園市,龍潭區,38807,115970,58707,57263
2014/5/1,桃園市,新屋區,15377,47986,25689,22297
2014/5/1,桃園市,觀音區,20643,63176,33136,30040
2014/5/1,桃園市,復興區,3721,10792,5964,4828
2014/5/1,新竹縣,竹北市,56311,161268,80463,80805
2014/5/1,新竹縣,關西鎮,9524,30837,16422,14415
2014/5/1,新竹縣,新埔鎮,10616,34617,18401,16216
2014/5/1,新竹縣,竹東鎮,32030,96013,48318,47695
2014/5/1,新竹縣,湖口鄉,24922,76967,39117,37850
2014/5/1,新竹縣,橫山鄉,4525,13935,7539,6396
2014/5/1,新竹縣,新豐鄉,17227,55526,28515,27011
2014/5/1,新竹縣,芎林鄉,6413,20278,10727,9551
2014/5/1,新竹縣,寶山鄉,5063,14278,7717,6561
2014/5/1,新竹縣,北埔鄉,3149,9800,5277,4523
2014/5/1,新竹縣,峨眉鄉,2077,5765,3192,2573
2014/5/1,新竹縣,尖石鄉,2813,9341,4979,4362
2014/5/1,新竹縣,五峰鄉,1750,4736,2583,2153
2014/5/1,苗栗縣,苗栗市,30367,91108,45604,45504
2014/5/1,苗栗縣,苑裡鎮,14311,48504,25124,23380
2014/5/1,苗栗縣,通霄鎮,11541,37074,19564,17510
2014/5/1,苗栗縣,竹南鎮,26762,82933,41977,40956
2014/5/1,苗栗縣,頭份市,32552,101847,51462,50385
2014/5/1,苗栗縣,後龍鎮,11881,38547,20276,18271
2014/5/1,苗栗縣,卓蘭鎮,6179,18396,9643,8753
2014/5/1,苗栗縣,大湖鄉,5424,15633,8268,7365
2014/5/1,苗栗縣,公館鄉,10553,34740,18049,16691
2014/5/1,苗栗縣,銅鑼鄉,6114,18984,10085,8899
2014/5/1,苗栗縣,南庄鄉,3983,10699,5871,4828
2014/5/1,苗栗縣,頭屋鄉,3633,11405,5998,5407
2014/5/1,苗栗縣,三義鄉,5455,17305,9067,8238
2014/5/1,苗栗縣,西湖鄉,2701,7617,4222,3395
2014/5/1,苗栗縣,造橋鄉,4126,13503,7099,6404
2014/5/1,苗栗縣,三灣鄉,2446,7145,3887,3258
2014/5/1,苗栗縣,獅潭鄉,1734,4731,2635,2096
2014/5/1,苗栗縣,泰安鄉,1978,6091,3260,2831
2014/5/1,彰化縣,彰化市,74578,235683,116859,118824
2014/5/1,彰化縣,鹿港鎮,23461,86021,43879,42142
2014/5/1,彰化縣,和美鎮,25686,90569,46356,44213
2014/5/1,彰化縣,北斗鎮,10322,33172,16759,16413
2014/5/1,彰化縣,員林市,38120,125041,62600,62441
2014/5/1,彰化縣,溪湖鎮,15853,55746,28414,27332
2014/5/1,彰化縣,田中鎮,12872,42965,22240,20725
2014/5/1,彰化縣,二林鎮,14786,52680,27173,25507
2014/5/1,彰化縣,線西鄉,4278,17150,8868,8282
2014/5/1,彰化縣,伸港鄉,9412,36119,18497,17622
2014/5/1,彰化縣,福興鄉,12444,47889,25009,22880
2014/5/1,彰化縣,秀水鄉,10278,39343,20331,19012
2014/5/1,彰化縣,花壇鄉,13575,45942,23660,22282
2014/5/1,彰化縣,芬園鄉,6863,24197,12734,11463
2014/5/1,彰化縣,大村鄉,10682,36401,18888,17513
2014/5/1,彰化縣,埔鹽鄉,8960,33345,17505,15840
2014/5/1,彰化縣,埔心鄉,10313,34969,18033,16936
2014/5/1,彰化縣,永靖鄉,10756,38398,19987,18411
2014/5/1,彰化縣,社頭鄉,12652,43754,22531,21223
2014/5/1,彰化縣,二水鄉,5360,15900,8347,7553
2014/5/1,彰化縣,田尾鄉,7823,27860,14463,13397
2014/5/1,彰化縣,埤頭鄉,8851,31133,16199,14934
2014/5/1,彰化縣,芳苑鄉,10103,34932,18501,16431
2014/5/1,彰化縣,大城鄉,5345,17938,9729,8209
2014/5/1,彰化縣,竹塘鄉,4633,16009,8437,7572
2014/5/1,彰化縣,溪州鄉,8870,30841,16197,14644
2014/5/1,南投縣,南投市,34154,102616,51489,51127
2014/5/1,南投縣,埔里鎮,28814,83414,41915,41499
2014/5/1,南投縣,草屯鎮,32397,99298,50149,49149
2014/5/1,南投縣,竹山鎮,19923,56992,29279,27713
2014/5/1,南投縣,集集鎮,4364,11467,5992,5475
2014/5/1,南投縣,名間鄉,12512,40094,21063,19031
2014/5/1,南投縣,鹿谷鄉,7392,18593,9882,8711
2014/5/1,南投縣,中寮鄉,5642,15604,8488,7116
2014/5/1,南投縣,魚池鄉,5756,16615,8714,7901
2014/5/1,南投縣,國姓鄉,7302,19862,10749,9113
2014/5/1,南投縣,水里鄉,7248,18854,9890,8964
2014/5/1,南投縣,信義鄉,5245,16736,8989,7747
2014/5/1,南投縣,仁愛鄉,4944,15851,8189,7662
2014/5/1,雲林縣,斗六市,36734,108010,54019,53991
2014/5/1,雲林縣,斗南鎮,15649,46111,23420,22691
2014/5/1,雲林縣,虎尾鎮,23888,70397,35747,34650
2014/5/1,雲林縣,西螺鎮,14373,47293,24063,23230
2014/5/1,雲林縣,土庫鎮,9163,29771,15558,14213
2014/5/1,雲林縣,北港鎮,15942,41848,21749,20099
2014/5/1,雲林縣,古坑鄉,10878,32747,17281,15466
2014/5/1,雲林縣,大埤鄉,6752,20064,10787,9277
2014/5/1,雲林縣,莿桐鄉,9269,29728,15611,14117
2014/5/1,雲林縣,林內鄉,5875,19147,10004,9143
2014/5/1,雲林縣,二崙鄉,8908,28547,15265,13282
2014/5/1,雲林縣,崙背鄉,8533,26140,13796,12344
2014/5/1,雲林縣,麥寮鄉,13698,43082,21899,21183
2014/5/1,雲林縣,東勢鄉,5809,15912,8708,7204
2014/5/1,雲林縣,褒忠鄉,4405,13671,7337,6334
2014/5/1,雲林縣,臺西鄉,8828,25139,13507,11632
2014/5/1,雲林縣,元長鄉,9454,27544,15009,12535
2014/5/1,雲林縣,四湖鄉,9015,25646,13894,11752
2014/5/1,雲林縣,口湖鄉,9646,29257,15532,13725
2014/5/1,雲林縣,水林鄉,10296,27145,14902,12243
2014/5/1,嘉義縣,太保市,12047,36942,19062,17880
2014/5/1,嘉義縣,朴子市,15286,43427,21998,21429
2014/5/1,嘉義縣,布袋鎮,10149,28586,14659,13927
2014/5/1,嘉義縣,大林鎮,11363,32359,16586,15773
2014/5/1,嘉義縣,民雄鄉,23891,72023,36901,35122
2014/5/1,嘉義縣,溪口鄉,5447,15569,8283,7286
2014/5/1,嘉義縣,新港鄉,10563,33410,17698,15712
2014/5/1,嘉義縣,六腳鄉,9039,24822,13147,11675
2014/5/1,嘉義縣,東石鄉,9467,26340,14015,12325
2014/5/1,嘉義縣,義竹鄉,7551,19711,10252,9459
2014/5/1,嘉義縣,鹿草鄉,5836,16567,8890,7677
2014/5/1,嘉義縣,水上鄉,17845,50989,26324,24665
2014/5/1,嘉義縣,中埔鄉,15892,46250,24085,22165
2014/5/1,嘉義縣,竹崎鄉,11583,37158,19819,17339
2014/5/1,嘉義縣,梅山鄉,6770,20480,10881,9599
2014/5/1,嘉義縣,番路鄉,4302,12169,6593,5576
2014/5/1,嘉義縣,大埔鄉,1951,4638,2416,2222
2014/5/1,嘉義縣,阿里山鄉,1949,5756,3064,2692
2014/5/1,屏東縣,屏東市,73233,204941,101876,103065
2014/5/1,屏東縣,潮州鎮,18904,54869,27534,27335
2014/5/1,屏東縣,東港鎮,16175,48467,24519,23948
2014/5/1,屏東縣,恆春鎮,11158,30847,15792,15055
2014/5/1,屏東縣,萬丹鄉,14648,52350,27112,25238
2014/5/1,屏東縣,長治鄉,9941,30411,15889,14522
2014/5/1,屏東縣,麟洛鄉,3711,11322,5858,5464
2014/5/1,屏東縣,九如鄉,6744,22310,11545,10765
2014/5/1,屏東縣,里港鄉,8056,26729,13579,13150
2014/5/1,屏東縣,鹽埔鄉,7826,26624,13833,12791
2014/5/1,屏東縣,高樹鄉,9433,25669,13692,11977
2014/5/1,屏東縣,萬巒鄉,6446,21022,11052,9970
2014/5/1,屏東縣,內埔鄉,18321,56364,29216,27148
2014/5/1,屏東縣,竹田鄉,5635,17793,9447,8346
2014/5/1,屏東縣,新埤鄉,3430,10248,5450,4798
2014/5/1,屏東縣,枋寮鄉,8586,25631,13421,12210
2014/5/1,屏東縣,新園鄉,11723,36870,19094,17776
2014/5/1,屏東縣,崁頂鄉,4397,16377,8328,8049
2014/5/1,屏東縣,林邊鄉,7033,19413,10001,9412
2014/5/1,屏東縣,南州鄉,3671,11101,5688,5413
2014/5/1,屏東縣,佳冬鄉,7040,20377,10596,9781
2014/5/1,屏東縣,琉球鄉,4245,12666,6992,5674
2014/5/1,屏東縣,車城鄉,3488,9173,4932,4241
2014/5/1,屏東縣,滿州鄉,3036,8149,4465,3684
2014/5/1,屏東縣,枋山鄉,2131,5812,3079,2733
2014/5/1,屏東縣,三地門鄉,2272,7740,3910,3830
2014/5/1,屏東縣,霧臺鄉,1052,3396,1735,1661
2014/5/1,屏東縣,瑪家鄉,1963,6673,3428,3245
2014/5/1,屏東縣,泰武鄉,1273,5232,2741,2491
2014/5/1,屏東縣,來義鄉,2220,7600,3886,3714
2014/5/1,屏東縣,春日鄉,1336,4839,2489,2350
2014/5/1,屏東縣,獅子鄉,1512,4843,2491,2352
2014/5/1,屏東縣,牡丹鄉,1874,4835,2485,2350
2014/5/1,臺東縣,臺東市,38785,107027,53873,53154
2014/5/1,臺東縣,成功鎮,5452,15048,7935,7113
2014/5/1,臺東縣,關山鎮,3238,9198,4821,4377
2014/5/1,臺東縣,卑南鄉,6632,17742,9459,8283
2014/5/1,臺東縣,大武鄉,2510,6574,3420,3154
2014/5/1,臺東縣,太麻里鄉,4619,11575,6134,5441
2014/5/1,臺東縣,東河鄉,3747,9038,4996,4042
2014/5/1,臺東縣,長濱鄉,2917,7779,4416,3363
2014/5/1,臺東縣,鹿野鄉,3117,8232,4417,3815
2014/5/1,臺東縣,池上鄉,3272,8660,4555,4105
2014/5/1,臺東縣,綠島鄉,1090,3790,1998,1792
2014/5/1,臺東縣,延平鄉,1073,3580,1934,1646
2014/5/1,臺東縣,海端鄉,1089,4381,2373,2008
2014/5/1,臺東縣,達仁鄉,1475,3735,2035,1700
2014/5/1,臺東縣,金峰鄉,1110,3623,1872,1751
2014/5/1,臺東縣,蘭嶼鄉,1706,4923,2509,2414
2014/5/1,花蓮縣,花蓮市,41216,106796,51956,54840
2014/5/1,花蓮縣,鳳林鎮,4427,11333,5977,5356
2014/5/1,花蓮縣,玉里鎮,8922,25620,13739,11881
2014/5/1,花蓮縣,新城鄉,7471,20185,10433,9752
2014/5/1,花蓮縣,吉安鄉,30783,82200,41756,40444
2014/5/1,花蓮縣,壽豐鄉,6965,18175,9759,8416
2014/5/1,花蓮縣,光復鄉,5026,13443,7141,6302
2014/5/1,花蓮縣,豐濱鄉,1757,4732,2611,2121
2014/5/1,花蓮縣,瑞穗鄉,4661,12196,6544,5652
2014/5/1,花蓮縣,富里鄉,4018,10968,5973,4995
2014/5/1,花蓮縣,秀林鄉,4761,15353,7943,7410
2014/5/1,花蓮縣,萬榮鄉,2075,6487,3450,3037
2014/5/1,花蓮縣,卓溪鄉,1670,6180,3392,2788
2014/5/1,澎湖縣,馬公市,22624,59870,30442,29428
2014/5/1,澎湖縣,湖西鄉,5293,14246,7517,6729
2014/5/1,澎湖縣,白沙鄉,3309,9730,5101,4629
2014/5/1,澎湖縣,西嶼鄉,2946,8467,4351,4116
2014/5/1,澎湖縣,望安鄉,2000,5085,2736,2349
2014/5/1,澎湖縣,七美鄉,1317,3758,1969,1789
2014/5/1,基隆市,中正區,22376,53323,27256,26067
2014/5/1,基隆市,七堵區,20791,53961,27326,26635
2014/5/1,基隆市,暖暖區,15069,38014,19224,18790
2014/5/1,基隆市,仁愛區,19537,46826,23084,23742
2014/5/1,基隆市,中山區,19267,48922,24937,23985
2014/5/1,基隆市,安樂區,32187,81841,40800,41041
2014/5/1,基隆市,信義區,20755,51111,25553,25558
2014/5/1,新竹市,東區,74089,205556,101267,104289
2014/5/1,新竹市,北區,53786,148210,72822,75388
2014/5/1,新竹市,香山區,25325,75888,38656,37232
2014/5/1,嘉義市,東區,44989,123791,60137,63654
2014/5/1,嘉義市,西區,52814,147192,72396,74796
2014/5/1,金門縣,金城鎮,12314,39930,20049,19881
2014/5/1,金門縣,金湖鎮,8203,26577,13436,13141
2014/5/1,金門縣,金沙鎮,5984,18924,9399,9525
2014/5/1,金門縣,金寧鄉,7464,25889,13118,12771
2014/5/1,金門縣,烈嶼鄉,2961,11527,5689,5838
2014/5/1,金門縣,烏坵鄉,134,665,334,331
2014/5/1,連江縣,南竿鄉,1381,7435,4234,3201
2014/5/1,連江縣,北竿鄉,471,2301,1271,1030
2014/5/1,連江縣,莒光鄉,271,1422,836,586
2014/5/1,連江縣,東引鄉,294,1207,721,486
2014/6/1,總計,新北市,1486716,3956728,1948833,2007895
2014/6/1,總計,臺北市,1031465,2693672,1292391,1401281
2014/6/1,總計,臺中市,904183,2708338,1342099,1366239
2014/6/1,總計,臺南市,665443,1883042,943920,939122
2014/6/1,總計,高雄市,1059475,2777296,1383480,1393816
2014/6/1,總計,臺灣省,3142718,9236587,4705385,4531202
2014/6/1,總計,宜蘭縣,161730,458771,232897,225874
2014/6/1,總計,桃園市,723763,2049009,1028597,1020412
2014/6/1,總計,新竹縣,176832,533851,273516,260335
2014/6/1,總計,苗栗縣,181983,566446,292156,274290
2014/6/1,總計,彰化縣,377149,1293530,661946,631584
2014/6/1,總計,南投縣,175808,515784,264687,251097
2014/6/1,總計,雲林縣,237254,707282,368099,339183
2014/6/1,總計,嘉義縣,180933,526936,274525,252411
2014/6/1,總計,屏東縣,282596,850527,436005,414522
2014/6/1,總計,臺東縣,81951,225041,116827,108214
2014/6/1,總計,花蓮縣,123835,333630,170658,162972
2014/6/1,總計,澎湖縣,37401,101112,52084,49028
2014/6/1,總計,基隆市,150053,373786,188027,185759
2014/6/1,總計,新竹市,153558,430041,212908,217133
2014/6/1,總計,嘉義市,97872,270841,132453,138388
2014/6/1,總計,福建省,39623,136373,69370,67003
2014/6/1,總計,金門縣,37167,123947,62267,61680
2014/6/1,總計,連江縣,2456,12426,7103,5323
2014/6/1,新北市,板橋區,204162,556241,272740,283501
2014/6/1,新北市,三重區,146554,389235,192655,196580
2014/6/1,新北市,中和區,161569,414807,202992,211815
2014/6/1,新北市,永和區,90750,228430,108918,119512
2014/6/1,新北市,新莊區,145772,410399,201469,208930
2014/6/1,新北市,新店區,121855,298731,144801,153930
2014/6/1,新北市,樹林區,64724,183781,92020,91761
2014/6/1,新北市,鶯歌區,29067,88777,44499,44278
2014/6/1,新北市,三峽區,39839,110620,55881,54739
2014/6/1,新北市,淡水區,66849,157051,75743,81308
2014/6/1,新北市,汐止區,83604,194290,95492,98798
2014/6/1,新北市,瑞芳區,16034,41408,20931,20477
2014/6/1,新北市,土城區,85210,238934,118490,120444
2014/6/1,新北市,蘆洲區,68521,199257,98138,101119
2014/6/1,新北市,五股區,28986,81889,41374,40515
2014/6/1,新北市,泰山區,27426,78155,38946,39209
2014/6/1,新北市,林口區,36889,95650,46891,48759
2014/6/1,新北市,深坑區,9283,23551,11814,11737
2014/6/1,新北市,石碇區,3383,7891,4344,3547
2014/6/1,新北市,坪林區,2469,6412,3590,2822
2014/6/1,新北市,三芝區,9234,23490,12090,11400
2014/6/1,新北市,石門區,4261,12648,6588,6060
2014/6/1,新北市,八里區,13517,36519,18344,18175
2014/6/1,新北市,平溪區,2368,4981,2751,2230
2014/6/1,新北市,雙溪區,3850,9425,5064,4361
2014/6/1,新北市,貢寮區,4451,13228,6779,6449
2014/6/1,新北市,金山區,6989,22355,11096,11259
2014/6/1,新北市,萬里區,7327,22495,11373,11122
2014/6/1,新北市,烏來區,1773,6078,3020,3058
2014/6/1,臺北市,松山區,80008,210660,99580,111080
2014/6/1,臺北市,信義區,88636,228763,109715,119048
2014/6/1,臺北市,大安區,119841,313795,147115,166680
2014/6/1,臺北市,中山區,97610,229351,107167,122184
2014/6/1,臺北市,中正區,64923,163744,78411,85333
2014/6/1,臺北市,大同區,50879,130447,63830,66617
2014/6/1,臺北市,萬華區,77568,193461,95744,97717
2014/6/1,臺北市,文山區,102515,272459,131336,141123
2014/6/1,臺北市,南港區,45323,120238,58745,61493
2014/6/1,臺北市,內湖區,104599,284186,136223,147963
2014/6/1,臺北市,士林區,105119,290186,140473,149713
2014/6/1,臺北市,北投區,94444,256382,124052,132330
2014/6/1,臺中市,中區,7928,19701,9782,9919
2014/6/1,臺中市,東區,26950,74652,37335,37317
2014/6/1,臺中市,南區,45353,119042,57551,61491
2014/6/1,臺中市,西區,44641,116072,55261,60811
2014/6/1,臺中市,北區,58029,147646,71109,76537
2014/6/1,臺中市,西屯區,79484,216794,104507,112287
2014/6/1,臺中市,南屯區,57796,160958,77330,83628
2014/6/1,臺中市,北屯區,90846,257835,124472,133363
2014/6/1,臺中市,豐原區,51856,166269,82364,83905
2014/6/1,臺中市,東勢區,17228,51716,26746,24970
2014/6/1,臺中市,大甲區,22389,77744,39372,38372
2014/6/1,臺中市,清水區,25897,85982,44250,41732
2014/6/1,臺中市,沙鹿區,26720,86992,44185,42807
2014/6/1,臺中市,梧棲區,16658,56260,28356,27904
2014/6/1,臺中市,后里區,15344,54012,27531,26481
2014/6/1,臺中市,神岡區,18555,64880,33259,31621
2014/6/1,臺中市,潭子區,34381,104596,51925,52671
2014/6/1,臺中市,大雅區,27639,92105,46141,45964
2014/6/1,臺中市,新社區,7465,25238,13131,12107
2014/6/1,臺中市,石岡區,4908,15509,8080,7429
2014/6/1,臺中市,外埔區,9237,31756,16323,15433
2014/6/1,臺中市,大安區,5321,19636,10344,9292
2014/6/1,臺中市,烏日區,22261,70953,35840,35113
2014/6/1,臺中市,大肚區,16568,56210,28786,27424
2014/6/1,臺中市,龍井區,21815,75655,38386,37269
2014/6/1,臺中市,霧峰區,19427,64354,32896,31458
2014/6/1,臺中市,太平區,59073,179866,89743,90123
2014/6/1,臺中市,大里區,66008,205141,101313,103828
2014/6/1,臺中市,和平區,4406,10764,5781,4983
2014/6/1,臺南市,新營區,28351,78384,38866,39518
2014/6/1,臺南市,鹽水區,10044,26424,13779,12645
2014/6/1,臺南市,白河區,10982,29956,15689,14267
2014/6/1,臺南市,柳營區,7819,21879,11404,10475
2014/6/1,臺南市,後壁區,8894,24681,12853,11828
2014/6/1,臺南市,東山區,8287,22021,11695,10326
2014/6/1,臺南市,麻豆區,15422,45139,22938,22201
2014/6/1,臺南市,下營區,9122,25210,12998,12212
2014/6/1,臺南市,六甲區,7741,23041,11932,11109
2014/6/1,臺南市,官田區,7762,21764,11125,10639
2014/6/1,臺南市,大內區,3983,10318,5491,4827
2014/6/1,臺南市,佳里區,20128,59445,29499,29946
2014/6/1,臺南市,學甲區,9647,27052,13842,13210
2014/6/1,臺南市,西港區,7989,24850,12604,12246
2014/6/1,臺南市,七股區,8106,23641,12322,11319
2014/6/1,臺南市,將軍區,7348,20644,10518,10126
2014/6/1,臺南市,北門區,4382,11764,5930,5834
2014/6/1,臺南市,新化區,14106,43844,22420,21424
2014/6/1,臺南市,善化區,15921,45510,23002,22508
2014/6/1,臺南市,新市區,11451,35412,17807,17605
2014/6/1,臺南市,安定區,9697,30255,15552,14703
2014/6/1,臺南市,山上區,2701,7536,3947,3589
2014/6/1,臺南市,玉井區,5134,14669,7641,7028
2014/6/1,臺南市,楠西區,3549,10144,5390,4754
2014/6/1,臺南市,南化區,2863,8892,4833,4059
2014/6/1,臺南市,左鎮區,1988,5208,2908,2300
2014/6/1,臺南市,仁德區,26400,72714,37056,35658
2014/6/1,臺南市,歸仁區,21822,67300,34195,33105
2014/6/1,臺南市,關廟區,10876,34968,18090,16878
2014/6/1,臺南市,龍崎區,1584,4304,2332,1972
2014/6/1,臺南市,永康區,80618,227598,112511,115087
2014/6/1,臺南市,東區,71994,191047,91994,99053
2014/6/1,臺南市,南區,44520,125616,62528,63088
2014/6/1,臺南市,北區,49535,132337,64836,67501
2014/6/1,臺南市,安南區,59498,186533,94395,92138
2014/6/1,臺南市,安平區,24331,64549,30804,33745
2014/6/1,臺南市,中西區,30848,78393,38194,40199
2014/6/1,高雄市,鹽埕區,10906,25590,12772,12818
2014/6/1,高雄市,鼓山區,55110,135207,65672,69535
2014/6/1,高雄市,左營區,76647,195397,94939,100458
2014/6/1,高雄市,楠梓區,65606,177984,88022,89962
2014/6/1,高雄市,三民區,134358,347845,169242,178603
2014/6/1,高雄市,新興區,22742,52787,25440,27347
2014/6/1,高雄市,前金區,12534,27908,13437,14471
2014/6/1,高雄市,苓雅區,72084,176654,85545,91109
2014/6/1,高雄市,前鎮區,77733,194197,95937,98260
2014/6/1,高雄市,旗津區,10927,28973,15023,13950
2014/6/1,高雄市,小港區,65581,155948,77823,78125
2014/6/1,高雄市,鳳山區,134799,353142,174187,178955
2014/6/1,高雄市,林園區,25315,70504,35894,34610
2014/6/1,高雄市,大寮區,40527,110600,57024,53576
2014/6/1,高雄市,大樹區,13226,43203,22230,20973
2014/6/1,高雄市,大社區,12534,34199,17455,16744
2014/6/1,高雄市,仁武區,29850,80170,41023,39147
2014/6/1,高雄市,鳥松區,17397,43667,22193,21474
2014/6/1,高雄市,岡山區,34298,97734,48652,49082
2014/6/1,高雄市,橋頭區,13102,37087,18931,18156
2014/6/1,高雄市,燕巢區,10315,30487,16175,14312
2014/6/1,高雄市,田寮區,3434,7692,4279,3413
2014/6/1,高雄市,阿蓮區,9352,29617,14945,14672
2014/6/1,高雄市,路竹區,16521,52961,27056,25905
2014/6/1,高雄市,湖內區,10265,29321,15017,14304
2014/6/1,高雄市,茄萣區,10364,30732,15919,14813
2014/6/1,高雄市,永安區,5814,14108,7089,7019
2014/6/1,高雄市,彌陀區,6701,19925,10315,9610
2014/6/1,高雄市,梓官區,12397,36367,18795,17572
2014/6/1,高雄市,旗山區,13869,38341,19885,18456
2014/6/1,高雄市,美濃區,14470,41481,21672,19809
2014/6/1,高雄市,六龜區,5659,13802,7443,6359
2014/6/1,高雄市,甲仙區,2372,6405,3414,2991
2014/6/1,高雄市,杉林區,4824,12595,6857,5738
2014/6/1,高雄市,內門區,5067,15254,8291,6963
2014/6/1,高雄市,茂林區,584,1876,931,945
2014/6/1,高雄市,桃源區,1326,4340,2291,2049
2014/6/1,高雄市,那瑪夏區,865,3196,1665,1531
2014/6/1,宜蘭縣,宜蘭市,34993,95746,46850,48896
2014/6/1,宜蘭縣,羅東鎮,25692,72322,34530,37792
2014/6/1,宜蘭縣,蘇澳鎮,13940,41316,21093,20223
2014/6/1,宜蘭縣,頭城鎮,10036,29936,15454,14482
2014/6/1,宜蘭縣,礁溪鄉,13205,36037,18834,17203
2014/6/1,宜蘭縣,壯圍鄉,8392,24512,12966,11546
2014/6/1,宜蘭縣,員山鄉,11266,32299,17155,15144
2014/6/1,宜蘭縣,冬山鄉,18494,53715,27563,26152
2014/6/1,宜蘭縣,五結鄉,13883,39284,20349,18935
2014/6/1,宜蘭縣,三星鄉,8061,21380,11555,9825
2014/6/1,宜蘭縣,大同鄉,1876,6129,3337,2792
2014/6/1,宜蘭縣,南澳鄉,1892,6095,3211,2884
2014/6/1,桃園市,桃園區,154356,415915,203261,212654
2014/6/1,桃園市,中壢區,137355,380136,188832,191304
2014/6/1,桃園市,平鎮區,71448,211523,105903,105620
2014/6/1,桃園市,八德區,62690,180231,91174,89057
2014/6/1,桃園市,楊梅區,53059,156332,79333,76999
2014/6/1,桃園市,大溪區,30590,91875,47311,44564
2014/6/1,桃園市,蘆竹區,53314,150377,75178,75199
2014/6/1,桃園市,大園區,28753,83899,43185,40714
2014/6/1,桃園市,龜山區,53490,140672,70858,69814
2014/6/1,桃園市,龍潭區,38873,116002,58701,57301
2014/6/1,桃園市,新屋區,15397,47981,25708,22273
2014/6/1,桃園市,觀音區,20718,63226,33164,30062
2014/6/1,桃園市,復興區,3720,10840,5989,4851
2014/6/1,新竹縣,竹北市,56571,161704,80705,80999
2014/6/1,新竹縣,關西鎮,9522,30824,16431,14393
2014/6/1,新竹縣,新埔鎮,10624,34621,18397,16224
2014/6/1,新竹縣,竹東鎮,32062,96004,48291,47713
2014/6/1,新竹縣,湖口鄉,24970,76940,39108,37832
2014/6/1,新竹縣,橫山鄉,4527,13903,7528,6375
2014/6/1,新竹縣,新豐鄉,17280,55600,28560,27040
2014/6/1,新竹縣,芎林鄉,6423,20301,10734,9567
2014/6/1,新竹縣,寶山鄉,5073,14299,7731,6568
2014/6/1,新竹縣,北埔鄉,3147,9811,5279,4532
2014/6/1,新竹縣,峨眉鄉,2071,5766,3188,2578
2014/6/1,新竹縣,尖石鄉,2813,9344,4980,4364
2014/6/1,新竹縣,五峰鄉,1749,4734,2584,2150
2014/6/1,苗栗縣,苗栗市,30403,91044,45564,45480
2014/6/1,苗栗縣,苑裡鎮,14311,48550,25152,23398
2014/6/1,苗栗縣,通霄鎮,11538,37063,19565,17498
2014/6/1,苗栗縣,竹南鎮,26856,83135,42072,41063
2014/6/1,苗栗縣,頭份市,32628,101879,51486,50393
2014/6/1,苗栗縣,後龍鎮,11889,38547,20276,18271
2014/6/1,苗栗縣,卓蘭鎮,6169,18377,9629,8748
2014/6/1,苗栗縣,大湖鄉,5430,15614,8261,7353
2014/6/1,苗栗縣,公館鄉,10560,34717,18030,16687
2014/6/1,苗栗縣,銅鑼鄉,6126,18998,10088,8910
2014/6/1,苗栗縣,南庄鄉,3980,10685,5866,4819
2014/6/1,苗栗縣,頭屋鄉,3639,11394,5986,5408
2014/6/1,苗栗縣,三義鄉,5467,17319,9068,8251
2014/6/1,苗栗縣,西湖鄉,2700,7613,4223,3390
2014/6/1,苗栗縣,造橋鄉,4128,13492,7086,6406
2014/6/1,苗栗縣,三灣鄉,2444,7156,3895,3261
2014/6/1,苗栗縣,獅潭鄉,1737,4755,2647,2108
2014/6/1,苗栗縣,泰安鄉,1978,6108,3262,2846
2014/6/1,彰化縣,彰化市,74603,235496,116793,118703
2014/6/1,彰化縣,鹿港鎮,23501,86030,43878,42152
2014/6/1,彰化縣,和美鎮,25731,90599,46352,44247
2014/6/1,彰化縣,北斗鎮,10321,33146,16741,16405
2014/6/1,彰化縣,員林市,38163,124976,62570,62406
2014/6/1,彰化縣,溪湖鎮,15873,55766,28419,27347
2014/6/1,彰化縣,田中鎮,12869,42925,22216,20709
2014/6/1,彰化縣,二林鎮,14789,52650,27154,25496
2014/6/1,彰化縣,線西鄉,4279,17143,8868,8275
2014/6/1,彰化縣,伸港鄉,9418,36120,18499,17621
2014/6/1,彰化縣,福興鄉,12451,47859,24977,22882
2014/6/1,彰化縣,秀水鄉,10281,39330,20329,19001
2014/6/1,彰化縣,花壇鄉,13593,45946,23655,22291
2014/6/1,彰化縣,芬園鄉,6868,24212,12740,11472
2014/6/1,彰化縣,大村鄉,10691,36403,18888,17515
2014/6/1,彰化縣,埔鹽鄉,8964,33320,17497,15823
2014/6/1,彰化縣,埔心鄉,10323,34977,18037,16940
2014/6/1,彰化縣,永靖鄉,10771,38378,19979,18399
2014/6/1,彰化縣,社頭鄉,12653,43743,22518,21225
2014/6/1,彰化縣,二水鄉,5362,15878,8339,7539
2014/6/1,彰化縣,田尾鄉,7824,27845,14462,13383
2014/6/1,彰化縣,埤頭鄉,8865,31110,16202,14908
2014/6/1,彰化縣,芳苑鄉,10106,34902,18493,16409
2014/6/1,彰化縣,大城鄉,5345,17927,9721,8206
2014/6/1,彰化縣,竹塘鄉,4629,15984,8417,7567
2014/6/1,彰化縣,溪州鄉,8876,30865,16202,14663
2014/6/1,南投縣,南投市,34185,102580,51461,51119
2014/6/1,南投縣,埔里鎮,28833,83441,41921,41520
2014/6/1,南投縣,草屯鎮,32416,99213,50115,49098
2014/6/1,南投縣,竹山鎮,19931,56983,29277,27706
2014/6/1,南投縣,集集鎮,4371,11486,6004,5482
2014/6/1,南投縣,名間鄉,12511,40063,21050,19013
2014/6/1,南投縣,鹿谷鄉,7409,18557,9866,8691
2014/6/1,南投縣,中寮鄉,5648,15617,8497,7120
2014/6/1,南投縣,魚池鄉,5755,16569,8685,7884
2014/6/1,南投縣,國姓鄉,7304,19859,10755,9104
2014/6/1,南投縣,水里鄉,7255,18840,9878,8962
2014/6/1,南投縣,信義鄉,5243,16765,9015,7750
2014/6/1,南投縣,仁愛鄉,4947,15811,8163,7648
2014/6/1,雲林縣,斗六市,36794,107991,54005,53986
2014/6/1,雲林縣,斗南鎮,15654,46078,23406,22672
2014/6/1,雲林縣,虎尾鎮,23908,70364,35742,34622
2014/6/1,雲林縣,西螺鎮,14379,47273,24041,23232
2014/6/1,雲林縣,土庫鎮,9172,29822,15586,14236
2014/6/1,雲林縣,北港鎮,15944,41833,21733,20100
2014/6/1,雲林縣,古坑鄉,10893,32740,17280,15460
2014/6/1,雲林縣,大埤鄉,6753,20050,10778,9272
2014/6/1,雲林縣,莿桐鄉,9279,29737,15610,14127
2014/6/1,雲林縣,林內鄉,5881,19175,10017,9158
2014/6/1,雲林縣,二崙鄉,8911,28552,15271,13281
2014/6/1,雲林縣,崙背鄉,8518,26087,13759,12328
2014/6/1,雲林縣,麥寮鄉,13713,43200,21976,21224
2014/6/1,雲林縣,東勢鄉,5817,15963,8723,7240
2014/6/1,雲林縣,褒忠鄉,4411,13684,7345,6339
2014/6/1,雲林縣,臺西鄉,8826,25122,13508,11614
2014/6/1,雲林縣,元長鄉,9444,27522,14994,12528
2014/6/1,雲林縣,四湖鄉,9008,25695,13911,11784
2014/6/1,雲林縣,口湖鄉,9661,29260,15522,13738
2014/6/1,雲林縣,水林鄉,10288,27134,14892,12242
2014/6/1,嘉義縣,太保市,12047,36945,19079,17866
2014/6/1,嘉義縣,朴子市,15307,43434,21995,21439
2014/6/1,嘉義縣,布袋鎮,10140,28569,14651,13918
2014/6/1,嘉義縣,大林鎮,11369,32348,16574,15774
2014/6/1,嘉義縣,民雄鄉,23897,71992,36897,35095
2014/6/1,嘉義縣,溪口鄉,5448,15554,8279,7275
2014/6/1,嘉義縣,新港鄉,10563,33388,17676,15712
2014/6/1,嘉義縣,六腳鄉,9036,24798,13143,11655
2014/6/1,嘉義縣,東石鄉,9468,26333,14004,12329
2014/6/1,嘉義縣,義竹鄉,7552,19692,10245,9447
2014/6/1,嘉義縣,鹿草鄉,5831,16522,8867,7655
2014/6/1,嘉義縣,水上鄉,17817,50953,26300,24653
2014/6/1,嘉義縣,中埔鄉,15898,46228,24069,22159
2014/6/1,嘉義縣,竹崎鄉,11582,37167,19825,17342
2014/6/1,嘉義縣,梅山鄉,6767,20441,10849,9592
2014/6/1,嘉義縣,番路鄉,4307,12166,6592,5574
2014/6/1,嘉義縣,大埔鄉,1952,4644,2417,2227
2014/6/1,嘉義縣,阿里山鄉,1952,5762,3063,2699
2014/6/1,屏東縣,屏東市,73224,204740,101745,102995
2014/6/1,屏東縣,潮州鎮,18916,54844,27522,27322
2014/6/1,屏東縣,東港鎮,16175,48453,24516,23937
2014/6/1,屏東縣,恆春鎮,11164,30849,15781,15068
2014/6/1,屏東縣,萬丹鄉,14653,52288,27083,25205
2014/6/1,屏東縣,長治鄉,9944,30414,15895,14519
2014/6/1,屏東縣,麟洛鄉,3707,11317,5859,5458
2014/6/1,屏東縣,九如鄉,6749,22301,11529,10772
2014/6/1,屏東縣,里港鄉,8071,26695,13575,13120
2014/6/1,屏東縣,鹽埔鄉,7836,26680,13850,12830
2014/6/1,屏東縣,高樹鄉,9437,25681,13680,12001
2014/6/1,屏東縣,萬巒鄉,6442,20995,11031,9964
2014/6/1,屏東縣,內埔鄉,18333,56327,29198,27129
2014/6/1,屏東縣,竹田鄉,5639,17765,9432,8333
2014/6/1,屏東縣,新埤鄉,3430,10268,5452,4816
2014/6/1,屏東縣,枋寮鄉,8582,25641,13431,12210
2014/6/1,屏東縣,新園鄉,11729,36823,19079,17744
2014/6/1,屏東縣,崁頂鄉,4400,16354,8312,8042
2014/6/1,屏東縣,林邊鄉,7031,19405,10001,9404
2014/6/1,屏東縣,南州鄉,3676,11099,5680,5419
2014/6/1,屏東縣,佳冬鄉,7048,20367,10595,9772
2014/6/1,屏東縣,琉球鄉,4251,12661,6992,5669
2014/6/1,屏東縣,車城鄉,3493,9188,4935,4253
2014/6/1,屏東縣,滿州鄉,3032,8175,4475,3700
2014/6/1,屏東縣,枋山鄉,2131,5800,3066,2734
2014/6/1,屏東縣,三地門鄉,2275,7772,3931,3841
2014/6/1,屏東縣,霧臺鄉,1050,3436,1747,1689
2014/6/1,屏東縣,瑪家鄉,1963,6702,3452,3250
2014/6/1,屏東縣,泰武鄉,1278,5286,2764,2522
2014/6/1,屏東縣,來義鄉,2221,7621,3892,3729
2014/6/1,屏東縣,春日鄉,1337,4858,2492,2366
2014/6/1,屏東縣,獅子鄉,1508,4874,2512,2362
2014/6/1,屏東縣,牡丹鄉,1871,4848,2501,2347
2014/6/1,臺東縣,臺東市,38839,106998,53849,53149
2014/6/1,臺東縣,成功鎮,5468,15040,7945,7095
2014/6/1,臺東縣,關山鎮,3250,9194,4824,4370
2014/6/1,臺東縣,卑南鄉,6642,17774,9480,8294
2014/6/1,臺東縣,大武鄉,2520,6616,3438,3178
2014/6/1,臺東縣,太麻里鄉,4617,11574,6149,5425
2014/6/1,臺東縣,東河鄉,3748,9024,4982,4042
2014/6/1,臺東縣,長濱鄉,2917,7769,4412,3357
2014/6/1,臺東縣,鹿野鄉,3121,8253,4430,3823
2014/6/1,臺東縣,池上鄉,3271,8665,4555,4110
2014/6/1,臺東縣,綠島鄉,1104,3810,2014,1796
2014/6/1,臺東縣,延平鄉,1072,3598,1943,1655
2014/6/1,臺東縣,海端鄉,1088,4383,2367,2016
2014/6/1,臺東縣,達仁鄉,1473,3765,2046,1719
2014/6/1,臺東縣,金峰鄉,1111,3648,1883,1765
2014/6/1,臺東縣,蘭嶼鄉,1710,4930,2510,2420
2014/6/1,花蓮縣,花蓮市,41223,106657,51871,54786
2014/6/1,花蓮縣,鳳林鎮,4426,11325,5969,5356
2014/6/1,花蓮縣,玉里鎮,8922,25583,13714,11869
2014/6/1,花蓮縣,新城鄉,7479,20193,10445,9748
2014/6/1,花蓮縣,吉安鄉,30841,82215,41782,40433
2014/6/1,花蓮縣,壽豐鄉,6967,18215,9775,8440
2014/6/1,花蓮縣,光復鄉,5046,13466,7169,6297
2014/6/1,花蓮縣,豐濱鄉,1755,4778,2633,2145
2014/6/1,花蓮縣,瑞穗鄉,4656,12186,6540,5646
2014/6/1,花蓮縣,富里鄉,4008,10950,5963,4987
2014/6/1,花蓮縣,秀林鄉,4766,15358,7942,7416
2014/6/1,花蓮縣,萬榮鄉,2073,6499,3452,3047
2014/6/1,花蓮縣,卓溪鄉,1673,6205,3403,2802
2014/6/1,澎湖縣,馬公市,22516,59768,30385,29383
2014/6/1,澎湖縣,湖西鄉,5308,14256,7528,6728
2014/6/1,澎湖縣,白沙鄉,3314,9737,5103,4634
2014/6/1,澎湖縣,西嶼鄉,2945,8478,4356,4122
2014/6/1,澎湖縣,望安鄉,1998,5096,2735,2361
2014/6/1,澎湖縣,七美鄉,1320,3777,1977,1800
2014/6/1,基隆市,中正區,22363,53277,27249,26028
2014/6/1,基隆市,七堵區,20807,53940,27324,26616
2014/6/1,基隆市,暖暖區,15083,38038,19226,18812
2014/6/1,基隆市,仁愛區,19544,46779,23053,23726
2014/6/1,基隆市,中山區,19267,48840,24883,23957
2014/6/1,基隆市,安樂區,32192,81780,40752,41028
2014/6/1,基隆市,信義區,20797,51132,25540,25592
2014/6/1,新竹市,東區,74279,205848,101409,104439
2014/6/1,新竹市,北區,53886,148259,72804,75455
2014/6/1,新竹市,香山區,25393,75934,38695,37239
2014/6/1,嘉義市,東區,45016,123641,60067,63574
2014/6/1,嘉義市,西區,52856,147200,72386,74814
2014/6/1,金門縣,金城鎮,12336,40076,20128,19948
2014/6/1,金門縣,金湖鎮,8231,26722,13514,13208
2014/6/1,金門縣,金沙鎮,5988,19028,9451,9577
2014/6/1,金門縣,金寧鄉,7506,25877,13121,12756
2014/6/1,金門縣,烈嶼鄉,2972,11581,5720,5861
2014/6/1,金門縣,烏坵鄉,134,663,333,330
2014/6/1,連江縣,南竿鄉,1412,7475,4266,3209
2014/6/1,連江縣,北竿鄉,474,2322,1282,1040
2014/6/1,連江縣,莒光鄉,273,1414,826,588
2014/6/1,連江縣,東引鄉,297,1215,729,486
2014/7/1,總計,新北市,1488509,3957965,1949110,2008855
2014/7/1,總計,臺北市,1032751,2695027,1292989,1402038
2014/7/1,總計,臺中市,905613,2709764,1342757,1367007
2014/7/1,總計,臺南市,665829,1882946,943722,939224
2014/7/1,總計,高雄市,1060315,2777240,1383208,1394032
2014/7/1,總計,臺灣省,3146351,9238244,4705573,4532671
2014/7/1,總計,宜蘭縣,161966,458786,232833,225953
2014/7/1,總計,桃園市,725512,2050600,1029302,1021298
2014/7/1,總計,新竹縣,177244,534493,273816,260677
2014/7/1,總計,苗栗縣,182187,566704,292200,274504
2014/7/1,總計,彰化縣,377421,1293129,661734,631395
2014/7/1,總計,南投縣,175872,515564,264562,251002
2014/7/1,總計,雲林縣,237326,707199,367999,339200
2014/7/1,總計,嘉義縣,180999,526735,274374,252361
2014/7/1,總計,屏東縣,282694,850166,435783,414383
2014/7/1,總計,臺東縣,81968,225170,116851,108319
2014/7/1,總計,花蓮縣,123873,333707,170628,163079
2014/7/1,總計,澎湖縣,37365,101176,52077,49099
2014/7/1,總計,基隆市,150135,373702,187941,185761
2014/7/1,總計,新竹市,153849,430295,213046,217249
2014/7/1,總計,嘉義市,97940,270818,132427,138391
2014/7/1,總計,福建省,39724,137077,69691,67386
2014/7/1,總計,金門縣,37266,124616,62562,62054
2014/7/1,總計,連江縣,2458,12461,7129,5332
2014/7/1,新北市,板橋區,204280,556078,272690,283388
2014/7/1,新北市,三重區,146664,389212,192596,196616
2014/7/1,新北市,中和區,161712,414889,203007,211882
2014/7/1,新北市,永和區,90757,228204,108745,119459
2014/7/1,新北市,新莊區,145999,410436,201469,208967
2014/7/1,新北市,新店區,122032,298938,144897,154041
2014/7/1,新北市,樹林區,64775,183724,91959,91765
2014/7/1,新北市,鶯歌區,29110,88847,44503,44344
2014/7/1,新北市,三峽區,39957,110757,55926,54831
2014/7/1,新北市,淡水區,67094,157390,75885,81505
2014/7/1,新北市,汐止區,83692,194467,95583,98884
2014/7/1,新北市,瑞芳區,16036,41418,20927,20491
2014/7/1,新北市,土城區,85295,238918,118453,120465
2014/7/1,新北市,蘆洲區,68578,199289,98138,101151
2014/7/1,新北市,五股區,29066,81936,41380,40556
2014/7/1,新北市,泰山區,27461,78142,38922,39220
2014/7/1,新北市,林口區,37030,95958,47029,48929
2014/7/1,新北市,深坑區,9286,23548,11810,11738
2014/7/1,新北市,石碇區,3384,7905,4352,3553
2014/7/1,新北市,坪林區,2465,6418,3591,2827
2014/7/1,新北市,三芝區,9240,23472,12087,11385
2014/7/1,新北市,石門區,4261,12662,6585,6077
2014/7/1,新北市,八里區,13573,36676,18427,18249
2014/7/1,新北市,平溪區,2368,4994,2754,2240
2014/7/1,新北市,雙溪區,3847,9433,5075,4358
2014/7/1,新北市,貢寮區,4444,13202,6765,6437
2014/7/1,新北市,金山區,6991,22378,11105,11273
2014/7/1,新北市,萬里區,7337,22552,11401,11151
2014/7/1,新北市,烏來區,1775,6122,3049,3073
2014/7/1,臺北市,松山區,79987,210559,99526,111033
2014/7/1,臺北市,信義區,88782,229049,109904,119145
2014/7/1,臺北市,大安區,119927,313728,147074,166654
2014/7/1,臺北市,中山區,97735,229546,107278,122268
2014/7/1,臺北市,中正區,64964,163689,78326,85363
2014/7/1,臺北市,大同區,50981,130516,63854,66662
2014/7/1,臺北市,萬華區,77742,193729,95863,97866
2014/7/1,臺北市,文山區,102624,272653,131439,141214
2014/7/1,臺北市,南港區,45429,120366,58809,61557
2014/7/1,臺北市,內湖區,104770,284479,136346,148133
2014/7/1,臺北市,士林區,105201,290115,140457,149658
2014/7/1,臺北市,北投區,94609,256598,124113,132485
2014/7/1,臺中市,中區,7916,19642,9774,9868
2014/7/1,臺中市,東區,26955,74658,37339,37319
2014/7/1,臺中市,南區,45450,119224,57591,61633
2014/7/1,臺中市,西區,44645,115955,55226,60729
2014/7/1,臺中市,北區,58021,147411,70998,76413
2014/7/1,臺中市,西屯區,79657,217066,104603,112463
2014/7/1,臺中市,南屯區,57914,161104,77410,83694
2014/7/1,臺中市,北屯區,91076,258106,124596,133510
2014/7/1,臺中市,豐原區,51907,166228,82359,83869
2014/7/1,臺中市,東勢區,17236,51690,26735,24955
2014/7/1,臺中市,大甲區,22397,77648,39323,38325
2014/7/1,臺中市,清水區,25929,85944,44230,41714
2014/7/1,臺中市,沙鹿區,26779,87158,44269,42889
2014/7/1,臺中市,梧棲區,16677,56311,28365,27946
2014/7/1,臺中市,后里區,15351,54030,27555,26475
2014/7/1,臺中市,神岡區,18586,64918,33287,31631
2014/7/1,臺中市,潭子區,34441,104675,51961,52714
2014/7/1,臺中市,大雅區,27722,92191,46179,46012
2014/7/1,臺中市,新社區,7472,25244,13131,12113
2014/7/1,臺中市,石岡區,4908,15499,8072,7427
2014/7/1,臺中市,外埔區,9240,31764,16333,15431
2014/7/1,臺中市,大安區,5334,19656,10357,9299
2014/7/1,臺中市,烏日區,22313,71020,35866,35154
2014/7/1,臺中市,大肚區,16589,56191,28781,27410
2014/7/1,臺中市,龍井區,21855,75711,38428,37283
2014/7/1,臺中市,霧峰區,19455,64413,32924,31489
2014/7/1,臺中市,太平區,59209,180147,89817,90330
2014/7/1,臺中市,大里區,66157,205344,101440,103904
2014/7/1,臺中市,和平區,4422,10816,5808,5008
2014/7/1,臺南市,新營區,28360,78343,38823,39520
2014/7/1,臺南市,鹽水區,10043,26398,13766,12632
2014/7/1,臺南市,白河區,10977,29896,15667,14229
2014/7/1,臺南市,柳營區,7827,21881,11413,10468
2014/7/1,臺南市,後壁區,8901,24664,12841,11823
2014/7/1,臺南市,東山區,8288,21997,11673,10324
2014/7/1,臺南市,麻豆區,15413,45115,22919,22196
2014/7/1,臺南市,下營區,9126,25193,12995,12198
2014/7/1,臺南市,六甲區,7739,22993,11904,11089
2014/7/1,臺南市,官田區,7760,21748,11119,10629
2014/7/1,臺南市,大內區,3979,10283,5470,4813
2014/7/1,臺南市,佳里區,20161,59479,29525,29954
2014/7/1,臺南市,學甲區,9661,27015,13824,13191
2014/7/1,臺南市,西港區,7994,24857,12603,12254
2014/7/1,臺南市,七股區,8111,23629,12300,11329
2014/7/1,臺南市,將軍區,7353,20644,10510,10134
2014/7/1,臺南市,北門區,4381,11749,5918,5831
2014/7/1,臺南市,新化區,14119,43836,22398,21438
2014/7/1,臺南市,善化區,15976,45628,23059,22569
2014/7/1,臺南市,新市區,11458,35431,17821,17610
2014/7/1,臺南市,安定區,9719,30283,15561,14722
2014/7/1,臺南市,山上區,2698,7537,3941,3596
2014/7/1,臺南市,玉井區,5125,14642,7627,7015
2014/7/1,臺南市,楠西區,3547,10135,5383,4752
2014/7/1,臺南市,南化區,2863,8889,4827,4062
2014/7/1,臺南市,左鎮區,1989,5201,2907,2294
2014/7/1,臺南市,仁德區,26404,72739,37068,35671
2014/7/1,臺南市,歸仁區,21859,67334,34209,33125
2014/7/1,臺南市,關廟區,10875,34943,18077,16866
2014/7/1,臺南市,龍崎區,1582,4299,2331,1968
2014/7/1,臺南市,永康區,80686,227703,112556,115147
2014/7/1,臺南市,東區,71945,190855,91875,98980
2014/7/1,臺南市,南區,44543,125605,62497,63108
2014/7/1,臺南市,北區,49570,132438,64879,67559
2014/7/1,臺南市,安南區,59616,186739,94497,92242
2014/7/1,臺南市,安平區,24369,64611,30828,33783
2014/7/1,臺南市,中西區,30812,78214,38111,40103
2014/7/1,高雄市,鹽埕區,10910,25571,12770,12801
2014/7/1,高雄市,鼓山區,55161,135288,65724,69564
2014/7/1,高雄市,左營區,76715,195351,94867,100484
2014/7/1,高雄市,楠梓區,65677,178129,88049,90080
2014/7/1,高雄市,三民區,134441,347606,169047,178559
2014/7/1,高雄市,新興區,22731,52745,25428,27317
2014/7/1,高雄市,前金區,12516,27884,13424,14460
2014/7/1,高雄市,苓雅區,72076,176368,85381,90987
2014/7/1,高雄市,前鎮區,77806,194144,95941,98203
2014/7/1,高雄市,旗津區,10926,28978,15023,13955
2014/7/1,高雄市,小港區,65644,155879,77783,78096
2014/7/1,高雄市,鳳山區,134886,353294,174217,179077
2014/7/1,高雄市,林園區,25335,70508,35891,34617
2014/7/1,高雄市,大寮區,40615,110779,57109,53670
2014/7/1,高雄市,大樹區,13236,43198,22211,20987
2014/7/1,高雄市,大社區,12568,34251,17468,16783
2014/7/1,高雄市,仁武區,29944,80330,41113,39217
2014/7/1,高雄市,鳥松區,17417,43611,22165,21446
2014/7/1,高雄市,岡山區,34328,97741,48649,49092
2014/7/1,高雄市,橋頭區,13117,37081,18923,18158
2014/7/1,高雄市,燕巢區,10333,30484,16180,14304
2014/7/1,高雄市,田寮區,3430,7697,4285,3412
2014/7/1,高雄市,阿蓮區,9362,29606,14935,14671
2014/7/1,高雄市,路竹區,16552,53004,27079,25925
2014/7/1,高雄市,湖內區,10269,29337,15031,14306
2014/7/1,高雄市,茄萣區,10370,30721,15904,14817
2014/7/1,高雄市,永安區,5816,14127,7103,7024
2014/7/1,高雄市,彌陀區,6705,19925,10304,9621
2014/7/1,高雄市,梓官區,12403,36357,18785,17572
2014/7/1,高雄市,旗山區,13877,38304,19867,18437
2014/7/1,高雄市,美濃區,14461,41445,21666,19779
2014/7/1,高雄市,六龜區,5666,13783,7437,6346
2014/7/1,高雄市,甲仙區,2371,6427,3416,3011
2014/7/1,高雄市,杉林區,4827,12605,6863,5742
2014/7/1,高雄市,內門區,5063,15256,8281,6975
2014/7/1,高雄市,茂林區,584,1894,939,955
2014/7/1,高雄市,桃源區,1314,4317,2276,2041
2014/7/1,高雄市,那瑪夏區,863,3215,1674,1541
2014/7/1,宜蘭縣,宜蘭市,35035,95768,46852,48916
2014/7/1,宜蘭縣,羅東鎮,25694,72277,34507,37770
2014/7/1,宜蘭縣,蘇澳鎮,13949,41256,21058,20198
2014/7/1,宜蘭縣,頭城鎮,10044,29957,15458,14499
2014/7/1,宜蘭縣,礁溪鄉,13255,36037,18837,17200
2014/7/1,宜蘭縣,壯圍鄉,8404,24487,12955,11532
2014/7/1,宜蘭縣,員山鄉,11295,32302,17146,15156
2014/7/1,宜蘭縣,冬山鄉,18513,53675,27537,26138
2014/7/1,宜蘭縣,五結鄉,13921,39322,20359,18963
2014/7/1,宜蘭縣,三星鄉,8082,21419,11563,9856
2014/7/1,宜蘭縣,大同鄉,1879,6132,3334,2798
2014/7/1,宜蘭縣,南澳鄉,1895,6154,3227,2927
2014/7/1,桃園市,桃園區,154703,416123,203366,212757
2014/7/1,桃園市,中壢區,137585,380403,188899,191504
2014/7/1,桃園市,平鎮區,71560,211595,105965,105630
2014/7/1,桃園市,八德區,62886,180427,91263,89164
2014/7/1,桃園市,楊梅區,53197,156464,79419,77045
2014/7/1,桃園市,大溪區,30631,91878,47277,44601
2014/7/1,桃園市,蘆竹區,53517,150574,75265,75309
2014/7/1,桃園市,大園區,28907,83970,43256,40714
2014/7/1,桃園市,龜山區,53652,140818,70900,69918
2014/7/1,桃園市,龍潭區,38921,116067,58723,57344
2014/7/1,桃園市,新屋區,15450,48063,25749,22314
2014/7/1,桃園市,觀音區,20786,63342,33213,30129
2014/7/1,桃園市,復興區,3717,10876,6007,4869
2014/7/1,新竹縣,竹北市,56826,162248,80986,81262
2014/7/1,新竹縣,關西鎮,9520,30814,16406,14408
2014/7/1,新竹縣,新埔鎮,10629,34596,18387,16209
2014/7/1,新竹縣,竹東鎮,32112,95959,48256,47703
2014/7/1,新竹縣,湖口鄉,25035,76969,39151,37818
2014/7/1,新竹縣,橫山鄉,4526,13898,7529,6369
2014/7/1,新竹縣,新豐鄉,17301,55605,28553,27052
2014/7/1,新竹縣,芎林鄉,6434,20310,10734,9576
2014/7/1,新竹縣,寶山鄉,5079,14339,7740,6599
2014/7/1,新竹縣,北埔鄉,3144,9813,5282,4531
2014/7/1,新竹縣,峨眉鄉,2074,5794,3203,2591
2014/7/1,新竹縣,尖石鄉,2811,9395,5000,4395
2014/7/1,新竹縣,五峰鄉,1753,4753,2589,2164
2014/7/1,苗栗縣,苗栗市,30417,90990,45533,45457
2014/7/1,苗栗縣,苑裡鎮,14338,48601,25161,23440
2014/7/1,苗栗縣,通霄鎮,11535,37057,19551,17506
2014/7/1,苗栗縣,竹南鎮,26911,83185,42072,41113
2014/7/1,苗栗縣,頭份市,32717,101982,51545,50437
2014/7/1,苗栗縣,後龍鎮,11896,38579,20288,18291
2014/7/1,苗栗縣,卓蘭鎮,6166,18374,9618,8756
2014/7/1,苗栗縣,大湖鄉,5436,15595,8261,7334
2014/7/1,苗栗縣,公館鄉,10569,34761,18039,16722
2014/7/1,苗栗縣,銅鑼鄉,6124,18972,10071,8901
2014/7/1,苗栗縣,南庄鄉,3978,10673,5858,4815
2014/7/1,苗栗縣,頭屋鄉,3638,11386,5971,5415
2014/7/1,苗栗縣,三義鄉,5475,17328,9077,8251
2014/7/1,苗栗縣,西湖鄉,2700,7606,4222,3384
2014/7/1,苗栗縣,造橋鄉,4135,13494,7082,6412
2014/7/1,苗栗縣,三灣鄉,2436,7182,3908,3274
2014/7/1,苗栗縣,獅潭鄉,1738,4758,2652,2106
2014/7/1,苗栗縣,泰安鄉,1978,6181,3291,2890
2014/7/1,彰化縣,彰化市,74648,235389,116749,118640
2014/7/1,彰化縣,鹿港鎮,23521,86002,43883,42119
2014/7/1,彰化縣,和美鎮,25781,90641,46360,44281
2014/7/1,彰化縣,北斗鎮,10339,33165,16743,16422
2014/7/1,彰化縣,員林市,38212,124921,62554,62367
2014/7/1,彰化縣,溪湖鎮,15904,55762,28420,27342
2014/7/1,彰化縣,田中鎮,12862,42895,22185,20710
2014/7/1,彰化縣,二林鎮,14782,52561,27105,25456
2014/7/1,彰化縣,線西鄉,4286,17152,8879,8273
2014/7/1,彰化縣,伸港鄉,9429,36139,18509,17630
2014/7/1,彰化縣,福興鄉,12464,47863,24970,22893
2014/7/1,彰化縣,秀水鄉,10299,39309,20320,18989
2014/7/1,彰化縣,花壇鄉,13606,45935,23643,22292
2014/7/1,彰化縣,芬園鄉,6874,24223,12743,11480
2014/7/1,彰化縣,大村鄉,10698,36423,18904,17519
2014/7/1,彰化縣,埔鹽鄉,8962,33277,17474,15803
2014/7/1,彰化縣,埔心鄉,10328,34950,18031,16919
2014/7/1,彰化縣,永靖鄉,10772,38375,19971,18404
2014/7/1,彰化縣,社頭鄉,12652,43719,22501,21218
2014/7/1,彰化縣,二水鄉,5355,15868,8339,7529
2014/7/1,彰化縣,田尾鄉,7831,27849,14464,13385
2014/7/1,彰化縣,埤頭鄉,8863,31110,16191,14919
2014/7/1,彰化縣,芳苑鄉,10101,34877,18485,16392
2014/7/1,彰化縣,大城鄉,5347,17930,9721,8209
2014/7/1,彰化縣,竹塘鄉,4632,15975,8421,7554
2014/7/1,彰化縣,溪州鄉,8873,30819,16169,14650
2014/7/1,南投縣,南投市,34213,102533,51430,51103
2014/7/1,南投縣,埔里鎮,28827,83368,41885,41483
2014/7/1,南投縣,草屯鎮,32439,99186,50105,49081
2014/7/1,南投縣,竹山鎮,19937,56929,29239,27690
2014/7/1,南投縣,集集鎮,4376,11478,6013,5465
2014/7/1,南投縣,名間鄉,12511,40051,21045,19006
2014/7/1,南投縣,鹿谷鄉,7420,18557,9858,8699
2014/7/1,南投縣,中寮鄉,5644,15605,8483,7122
2014/7/1,南投縣,魚池鄉,5753,16561,8681,7880
2014/7/1,南投縣,國姓鄉,7311,19871,10756,9115
2014/7/1,南投縣,水里鄉,7249,18811,9867,8944
2014/7/1,南投縣,信義鄉,5247,16802,9035,7767
2014/7/1,南投縣,仁愛鄉,4945,15812,8165,7647
2014/7/1,雲林縣,斗六市,36817,107940,53972,53968
2014/7/1,雲林縣,斗南鎮,15658,46065,23409,22656
2014/7/1,雲林縣,虎尾鎮,23903,70294,35686,34608
2014/7/1,雲林縣,西螺鎮,14376,47221,24001,23220
2014/7/1,雲林縣,土庫鎮,9180,29825,15574,14251
2014/7/1,雲林縣,北港鎮,15958,41760,21697,20063
2014/7/1,雲林縣,古坑鄉,10889,32718,17274,15444
2014/7/1,雲林縣,大埤鄉,6754,20048,10765,9283
2014/7/1,雲林縣,莿桐鄉,9275,29742,15594,14148
2014/7/1,雲林縣,林內鄉,5890,19174,10027,9147
2014/7/1,雲林縣,二崙鄉,8900,28498,15239,13259
2014/7/1,雲林縣,崙背鄉,8518,26067,13758,12309
2014/7/1,雲林縣,麥寮鄉,13737,43314,22028,21286
2014/7/1,雲林縣,東勢鄉,5837,16032,8769,7263
2014/7/1,雲林縣,褒忠鄉,4404,13695,7355,6340
2014/7/1,雲林縣,臺西鄉,8831,25116,13503,11613
2014/7/1,雲林縣,元長鄉,9446,27507,14988,12519
2014/7/1,雲林縣,四湖鄉,9011,25739,13936,11803
2014/7/1,雲林縣,口湖鄉,9662,29264,15510,13754
2014/7/1,雲林縣,水林鄉,10280,27180,14914,12266
2014/7/1,嘉義縣,太保市,12065,37000,19101,17899
2014/7/1,嘉義縣,朴子市,15308,43368,21971,21397
2014/7/1,嘉義縣,布袋鎮,10133,28561,14641,13920
2014/7/1,嘉義縣,大林鎮,11368,32306,16560,15746
2014/7/1,嘉義縣,民雄鄉,23919,72007,36896,35111
2014/7/1,嘉義縣,溪口鄉,5448,15555,8291,7264
2014/7/1,嘉義縣,新港鄉,10569,33332,17636,15696
2014/7/1,嘉義縣,六腳鄉,9034,24767,13124,11643
2014/7/1,嘉義縣,東石鄉,9465,26357,14013,12344
2014/7/1,嘉義縣,義竹鄉,7552,19689,10241,9448
2014/7/1,嘉義縣,鹿草鄉,5825,16494,8839,7655
2014/7/1,嘉義縣,水上鄉,17831,50957,26290,24667
2014/7/1,嘉義縣,中埔鄉,15911,46229,24075,22154
2014/7/1,嘉義縣,竹崎鄉,11585,37135,19799,17336
2014/7/1,嘉義縣,梅山鄉,6770,20405,10833,9572
2014/7/1,嘉義縣,番路鄉,4308,12157,6582,5575
2014/7/1,嘉義縣,大埔鄉,1956,4647,2415,2232
2014/7/1,嘉義縣,阿里山鄉,1952,5769,3067,2702
2014/7/1,屏東縣,屏東市,73219,204378,101589,102789
2014/7/1,屏東縣,潮州鎮,18920,54766,27477,27289
2014/7/1,屏東縣,東港鎮,16195,48420,24498,23922
2014/7/1,屏東縣,恆春鎮,11179,30827,15765,15062
2014/7/1,屏東縣,萬丹鄉,14660,52246,27051,25195
2014/7/1,屏東縣,長治鄉,9941,30398,15882,14516
2014/7/1,屏東縣,麟洛鄉,3711,11341,5865,5476
2014/7/1,屏東縣,九如鄉,6760,22297,11525,10772
2014/7/1,屏東縣,里港鄉,8079,26718,13582,13136
2014/7/1,屏東縣,鹽埔鄉,7843,26687,13852,12835
2014/7/1,屏東縣,高樹鄉,9430,25687,13686,12001
2014/7/1,屏東縣,萬巒鄉,6444,20985,11018,9967
2014/7/1,屏東縣,內埔鄉,18341,56301,29204,27097
2014/7/1,屏東縣,竹田鄉,5643,17763,9427,8336
2014/7/1,屏東縣,新埤鄉,3450,10331,5476,4855
2014/7/1,屏東縣,枋寮鄉,8580,25622,13425,12197
2014/7/1,屏東縣,新園鄉,11733,36827,19077,17750
2014/7/1,屏東縣,崁頂鄉,4404,16359,8321,8038
2014/7/1,屏東縣,林邊鄉,7024,19378,9983,9395
2014/7/1,屏東縣,南州鄉,3681,11104,5686,5418
2014/7/1,屏東縣,佳冬鄉,7050,20332,10573,9759
2014/7/1,屏東縣,琉球鄉,4248,12692,7003,5689
2014/7/1,屏東縣,車城鄉,3495,9189,4936,4253
2014/7/1,屏東縣,滿州鄉,3036,8193,4488,3705
2014/7/1,屏東縣,枋山鄉,2128,5784,3059,2725
2014/7/1,屏東縣,三地門鄉,2275,7791,3945,3846
2014/7/1,屏東縣,霧臺鄉,1050,3469,1763,1706
2014/7/1,屏東縣,瑪家鄉,1963,6713,3451,3262
2014/7/1,屏東縣,泰武鄉,1279,5301,2767,2534
2014/7/1,屏東縣,來義鄉,2218,7627,3887,3740
2014/7/1,屏東縣,春日鄉,1342,4874,2497,2377
2014/7/1,屏東縣,獅子鄉,1504,4906,2526,2380
2014/7/1,屏東縣,牡丹鄉,1869,4860,2499,2361
2014/7/1,臺東縣,臺東市,38871,107029,53865,53164
2014/7/1,臺東縣,成功鎮,5464,15051,7949,7102
2014/7/1,臺東縣,關山鎮,3255,9199,4817,4382
2014/7/1,臺東縣,卑南鄉,6638,17768,9477,8291
2014/7/1,臺東縣,大武鄉,2526,6649,3456,3193
2014/7/1,臺東縣,太麻里鄉,4616,11553,6136,5417
2014/7/1,臺東縣,東河鄉,3742,9034,4984,4050
2014/7/1,臺東縣,長濱鄉,2922,7778,4417,3361
2014/7/1,臺東縣,鹿野鄉,3118,8259,4431,3828
2014/7/1,臺東縣,池上鄉,3270,8662,4552,4110
2014/7/1,臺東縣,綠島鄉,1094,3806,2001,1805
2014/7/1,臺東縣,延平鄉,1075,3626,1955,1671
2014/7/1,臺東縣,海端鄉,1091,4388,2367,2021
2014/7/1,臺東縣,達仁鄉,1470,3775,2051,1724
2014/7/1,臺東縣,金峰鄉,1110,3650,1877,1773
2014/7/1,臺東縣,蘭嶼鄉,1706,4943,2516,2427
2014/7/1,花蓮縣,花蓮市,41201,106574,51815,54759
2014/7/1,花蓮縣,鳳林鎮,4429,11317,5959,5358
2014/7/1,花蓮縣,玉里鎮,8918,25545,13695,11850
2014/7/1,花蓮縣,新城鄉,7496,20237,10459,9778
2014/7/1,花蓮縣,吉安鄉,30857,82233,41776,40457
2014/7/1,花蓮縣,壽豐鄉,6978,18240,9776,8464
2014/7/1,花蓮縣,光復鄉,5050,13475,7172,6303
2014/7/1,花蓮縣,豐濱鄉,1754,4796,2647,2149
2014/7/1,花蓮縣,瑞穗鄉,4660,12219,6551,5668
2014/7/1,花蓮縣,富里鄉,4005,10948,5958,4990
2014/7/1,花蓮縣,秀林鄉,4770,15399,7956,7443
2014/7/1,花蓮縣,萬榮鄉,2080,6501,3450,3051
2014/7/1,花蓮縣,卓溪鄉,1675,6223,3414,2809
2014/7/1,澎湖縣,馬公市,22490,59732,30343,29389
2014/7/1,澎湖縣,湖西鄉,5304,14294,7536,6758
2014/7/1,澎湖縣,白沙鄉,3316,9751,5113,4638
2014/7/1,澎湖縣,西嶼鄉,2940,8486,4356,4130
2014/7/1,澎湖縣,望安鄉,1990,5120,2746,2374
2014/7/1,澎湖縣,七美鄉,1325,3793,1983,1810
2014/7/1,基隆市,中正區,22364,53185,27231,25954
2014/7/1,基隆市,七堵區,20822,53926,27292,26634
2014/7/1,基隆市,暖暖區,15109,38102,19252,18850
2014/7/1,基隆市,仁愛區,19527,46701,23016,23685
2014/7/1,基隆市,中山區,19291,48831,24870,23961
2014/7/1,基隆市,安樂區,32198,81754,40725,41029
2014/7/1,基隆市,信義區,20824,51203,25555,25648
2014/7/1,新竹市,東區,74415,205954,101489,104465
2014/7/1,新竹市,北區,53994,148310,72805,75505
2014/7/1,新竹市,香山區,25440,76031,38752,37279
2014/7/1,嘉義市,東區,45048,123540,59995,63545
2014/7/1,嘉義市,西區,52892,147278,72432,74846
2014/7/1,金門縣,金城鎮,12364,40241,20199,20042
2014/7/1,金門縣,金湖鎮,8252,26875,13580,13295
2014/7/1,金門縣,金沙鎮,6000,19141,9504,9637
2014/7/1,金門縣,金寧鄉,7534,26022,13181,12841
2014/7/1,金門縣,烈嶼鄉,2982,11671,5763,5908
2014/7/1,金門縣,烏坵鄉,134,666,335,331
2014/7/1,連江縣,南竿鄉,1416,7504,4292,3212
2014/7/1,連江縣,北竿鄉,473,2320,1281,1039
2014/7/1,連江縣,莒光鄉,272,1418,827,591
2014/7/1,連江縣,東引鄉,297,1219,729,490
2014/8/1,總計,新北市,1491623,3959855,1949664,2010191
2014/8/1,總計,臺北市,1034296,2695007,1292896,1402111
2014/8/1,總計,臺中市,907689,2711252,1343404,1367848
2014/8/1,總計,臺南市,666822,1883451,944002,939449
2014/8/1,總計,高雄市,1061818,2777318,1382884,1394434
2014/8/1,總計,臺灣省,3152182,9239833,4705932,4533901
2014/8/1,總計,宜蘭縣,162304,458877,232883,225994
2014/8/1,總計,桃園市,727987,2052529,1030189,1022340
2014/8/1,總計,新竹縣,177805,535307,274213,261094
2014/8/1,總計,苗栗縣,182474,566818,292207,274611
2014/8/1,總計,彰化縣,377944,1292599,661389,631210
2014/8/1,總計,南投縣,176021,515345,264414,250931
2014/8/1,總計,雲林縣,237544,706941,367813,339128
2014/8/1,總計,嘉義縣,181121,526469,274179,252290
2014/8/1,總計,屏東縣,282844,849794,435540,414254
2014/8/1,總計,臺東縣,82048,225061,116784,108277
2014/8/1,總計,花蓮縣,124009,333733,170614,163119
2014/8/1,總計,澎湖縣,37371,101110,52042,49068
2014/8/1,總計,基隆市,150404,373721,187968,185753
2014/8/1,總計,新竹市,154223,430644,213247,217397
2014/8/1,總計,嘉義市,98083,270885,132450,138435
2014/8/1,總計,福建省,39805,137527,69864,67663
2014/8/1,總計,金門縣,37346,125089,62757,62332
2014/8/1,總計,連江縣,2459,12438,7107,5331
2014/8/1,新北市,板橋區,204571,555891,272519,283372
2014/8/1,新北市,三重區,146954,389230,192529,196701
2014/8/1,新北市,中和區,161972,415008,203016,211992
2014/8/1,新北市,永和區,90815,227961,108593,119368
2014/8/1,新北市,新莊區,146380,410745,201582,209163
2014/8/1,新北市,新店區,122346,299144,144959,154185
2014/8/1,新北市,樹林區,64883,183687,91951,91736
2014/8/1,新北市,鶯歌區,29155,88873,44498,44375
2014/8/1,新北市,三峽區,40067,110960,56002,54958
2014/8/1,新北市,淡水區,67392,157706,76032,81674
2014/8/1,新北市,汐止區,83893,194715,95675,99040
2014/8/1,新北市,瑞芳區,16054,41395,20904,20491
2014/8/1,新北市,土城區,85433,239091,118546,120545
2014/8/1,新北市,蘆洲區,68716,199418,98243,101175
2014/8/1,新北市,五股區,29149,82011,41435,40576
2014/8/1,新北市,泰山區,27546,78202,38964,39238
2014/8/1,新北市,林口區,37218,96262,47166,49096
2014/8/1,新北市,深坑區,9308,23585,11825,11760
2014/8/1,新北市,石碇區,3382,7893,4341,3552
2014/8/1,新北市,坪林區,2468,6417,3588,2829
2014/8/1,新北市,三芝區,9242,23492,12101,11391
2014/8/1,新北市,石門區,4258,12676,6587,6089
2014/8/1,新北市,八里區,13643,36807,18469,18338
2014/8/1,新北市,平溪區,2367,4996,2753,2243
2014/8/1,新北市,雙溪區,3843,9429,5068,4361
2014/8/1,新北市,貢寮區,4441,13164,6744,6420
2014/8/1,新北市,金山區,7005,22382,11105,11277
2014/8/1,新北市,萬里區,7345,22606,11426,11180
2014/8/1,新北市,烏來區,1777,6109,3043,3066
2014/8/1,臺北市,松山區,80049,210360,99414,110946
2014/8/1,臺北市,信義區,88933,229025,109878,119147
2014/8/1,臺北市,大安區,120015,313402,146884,166518
2014/8/1,臺北市,中山區,97914,229638,107312,122326
2014/8/1,臺北市,中正區,65002,163477,78237,85240
2014/8/1,臺北市,大同區,51008,130577,63879,66698
2014/8/1,臺北市,萬華區,77907,193955,95962,97993
2014/8/1,臺北市,文山區,102856,272840,131502,141338
2014/8/1,臺北市,南港區,45544,120544,58908,61636
2014/8/1,臺北市,內湖區,104964,284544,136376,148168
2014/8/1,臺北市,士林區,105379,290120,140449,149671
2014/8/1,臺北市,北投區,94725,256525,124095,132430
2014/8/1,臺中市,中區,7881,19472,9703,9769
2014/8/1,臺中市,東區,27012,74713,37368,37345
2014/8/1,臺中市,南區,45596,119461,57696,61765
2014/8/1,臺中市,西區,44682,115852,55188,60664
2014/8/1,臺中市,北區,58134,147381,70918,76463
2014/8/1,臺中市,西屯區,79937,217355,104739,112616
2014/8/1,臺中市,南屯區,58061,161300,77545,83755
2014/8/1,臺中市,北屯區,91366,258370,124731,133639
2014/8/1,臺中市,豐原區,52021,166234,82342,83892
2014/8/1,臺中市,東勢區,17250,51621,26688,24933
2014/8/1,臺中市,大甲區,22451,77649,39311,38338
2014/8/1,臺中市,清水區,25977,85969,44249,41720
2014/8/1,臺中市,沙鹿區,26861,87249,44320,42929
2014/8/1,臺中市,梧棲區,16714,56358,28387,27971
2014/8/1,臺中市,后里區,15360,54049,27559,26490
2014/8/1,臺中市,神岡區,18614,64868,33259,31609
2014/8/1,臺中市,潭子區,34520,104762,52015,52747
2014/8/1,臺中市,大雅區,27807,92314,46236,46078
2014/8/1,臺中市,新社區,7468,25224,13121,12103
2014/8/1,臺中市,石岡區,4907,15476,8061,7415
2014/8/1,臺中市,外埔區,9270,31748,16328,15420
2014/8/1,臺中市,大安區,5335,19645,10351,9294
2014/8/1,臺中市,烏日區,22358,71084,35888,35196
2014/8/1,臺中市,大肚區,16603,56223,28797,27426
2014/8/1,臺中市,龍井區,21905,75768,38457,37311
2014/8/1,臺中市,霧峰區,19467,64419,32918,31501
2014/8/1,臺中市,太平區,59376,180396,89925,90471
2014/8/1,臺中市,大里區,66339,205481,101499,103982
2014/8/1,臺中市,和平區,4417,10811,5805,5006
2014/8/1,臺南市,新營區,28404,78318,38831,39487
2014/8/1,臺南市,鹽水區,10046,26365,13759,12606
2014/8/1,臺南市,白河區,10997,29875,15659,14216
2014/8/1,臺南市,柳營區,7834,21881,11405,10476
2014/8/1,臺南市,後壁區,8901,24660,12839,11821
2014/8/1,臺南市,東山區,8286,21974,11663,10311
2014/8/1,臺南市,麻豆區,15430,45095,22909,22186
2014/8/1,臺南市,下營區,9130,25189,12989,12200
2014/8/1,臺南市,六甲區,7735,22954,11894,11060
2014/8/1,臺南市,官田區,7773,21754,11126,10628
2014/8/1,臺南市,大內區,3974,10258,5465,4793
2014/8/1,臺南市,佳里區,20188,59512,29534,29978
2014/8/1,臺南市,學甲區,9666,26967,13808,13159
2014/8/1,臺南市,西港區,8024,24895,12622,12273
2014/8/1,臺南市,七股區,8116,23622,12292,11330
2014/8/1,臺南市,將軍區,7344,20609,10483,10126
2014/8/1,臺南市,北門區,4381,11746,5918,5828
2014/8/1,臺南市,新化區,14135,43824,22394,21430
2014/8/1,臺南市,善化區,16079,45769,23128,22641
2014/8/1,臺南市,新市區,11480,35477,17829,17648
2014/8/1,臺南市,安定區,9735,30283,15555,14728
2014/8/1,臺南市,山上區,2699,7531,3937,3594
2014/8/1,臺南市,玉井區,5135,14646,7636,7010
2014/8/1,臺南市,楠西區,3551,10123,5377,4746
2014/8/1,臺南市,南化區,2867,8901,4835,4066
2014/8/1,臺南市,左鎮區,1997,5197,2903,2294
2014/8/1,臺南市,仁德區,26457,72864,37120,35744
2014/8/1,臺南市,歸仁區,21885,67369,34223,33146
2014/8/1,臺南市,關廟區,10885,34916,18064,16852
2014/8/1,臺南市,龍崎區,1579,4296,2331,1965
2014/8/1,臺南市,永康區,80865,228060,112757,115303
2014/8/1,臺南市,東區,71975,190641,91785,98856
2014/8/1,臺南市,南區,44603,125648,62523,63125
2014/8/1,臺南市,北區,49664,132469,64869,67600
2014/8/1,臺南市,安南區,59743,186906,94587,92319
2014/8/1,臺南市,安平區,24431,64710,30867,33843
2014/8/1,臺南市,中西區,30828,78147,38086,40061
2014/8/1,高雄市,鹽埕區,10910,25548,12740,12808
2014/8/1,高雄市,鼓山區,55294,135382,65766,69616
2014/8/1,高雄市,左營區,76855,195467,94870,100597
2014/8/1,高雄市,楠梓區,65826,178164,88036,90128
2014/8/1,高雄市,三民區,134667,347571,168996,178575
2014/8/1,高雄市,新興區,22748,52654,25367,27287
2014/8/1,高雄市,前金區,12531,27855,13407,14448
2014/8/1,高雄市,苓雅區,72160,176244,85267,90977
2014/8/1,高雄市,前鎮區,77866,194042,95869,98173
2014/8/1,高雄市,旗津區,10936,28973,15014,13959
2014/8/1,高雄市,小港區,65749,155948,77819,78129
2014/8/1,高雄市,鳳山區,135048,353341,174211,179130
2014/8/1,高雄市,林園區,25360,70480,35869,34611
2014/8/1,高雄市,大寮區,40726,110950,57191,53759
2014/8/1,高雄市,大樹區,13251,43223,22212,21011
2014/8/1,高雄市,大社區,12592,34299,17503,16796
2014/8/1,高雄市,仁武區,30030,80442,41164,39278
2014/8/1,高雄市,鳥松區,17428,43602,22152,21450
2014/8/1,高雄市,岡山區,34355,97693,48618,49075
2014/8/1,高雄市,橋頭區,13164,37150,18949,18201
2014/8/1,高雄市,燕巢區,10331,30451,16149,14302
2014/8/1,高雄市,田寮區,3428,7699,4282,3417
2014/8/1,高雄市,阿蓮區,9361,29597,14935,14662
2014/8/1,高雄市,路竹區,16569,52971,27064,25907
2014/8/1,高雄市,湖內區,10293,29356,15025,14331
2014/8/1,高雄市,茄萣區,10374,30722,15904,14818
2014/8/1,高雄市,永安區,5822,14141,7112,7029
2014/8/1,高雄市,彌陀區,6709,19907,10297,9610
2014/8/1,高雄市,梓官區,12417,36395,18802,17593
2014/8/1,高雄市,旗山區,13872,38246,19836,18410
2014/8/1,高雄市,美濃區,14456,41372,21619,19753
2014/8/1,高雄市,六龜區,5659,13751,7419,6332
2014/8/1,高雄市,甲仙區,2371,6426,3413,3013
2014/8/1,高雄市,杉林區,4841,12617,6865,5752
2014/8/1,高雄市,內門區,5064,15236,8264,6972
2014/8/1,高雄市,茂林區,584,1899,942,957
2014/8/1,高雄市,桃源區,1309,4289,2260,2029
2014/8/1,高雄市,那瑪夏區,862,3215,1676,1539
2014/8/1,宜蘭縣,宜蘭市,35113,95773,46876,48897
2014/8/1,宜蘭縣,羅東鎮,25729,72253,34503,37750
2014/8/1,宜蘭縣,蘇澳鎮,13966,41230,21037,20193
2014/8/1,宜蘭縣,頭城鎮,10074,29938,15461,14477
2014/8/1,宜蘭縣,礁溪鄉,13290,36040,18816,17224
2014/8/1,宜蘭縣,壯圍鄉,8408,24485,12957,11528
2014/8/1,宜蘭縣,員山鄉,11328,32378,17177,15201
2014/8/1,宜蘭縣,冬山鄉,18560,53698,27565,26133
2014/8/1,宜蘭縣,五結鄉,13961,39356,20358,18998
2014/8/1,宜蘭縣,三星鄉,8094,21431,11573,9858
2014/8/1,宜蘭縣,大同鄉,1883,6134,3330,2804
2014/8/1,宜蘭縣,南澳鄉,1898,6161,3230,2931
2014/8/1,桃園市,桃園區,155333,416398,203506,212892
2014/8/1,桃園市,中壢區,137936,380773,189075,191698
2014/8/1,桃園市,平鎮區,71759,211806,106070,105736
2014/8/1,桃園市,八德區,63179,180680,91354,89326
2014/8/1,桃園市,楊梅區,53351,156605,79475,77130
2014/8/1,桃園市,大溪區,30668,91837,47281,44556
2014/8/1,桃園市,蘆竹區,53696,150720,75335,75385
2014/8/1,桃園市,大園區,29060,84047,43281,40766
2014/8/1,桃園市,龜山區,53924,141187,71070,70117
2014/8/1,桃園市,龍潭區,39034,116108,58706,57402
2014/8/1,桃園市,新屋區,15477,48060,25755,22305
2014/8/1,桃園市,觀音區,20856,63432,33270,30162
2014/8/1,桃園市,復興區,3714,10876,6011,4865
2014/8/1,新竹縣,竹北市,57196,162940,81328,81612
2014/8/1,新竹縣,關西鎮,9532,30815,16414,14401
2014/8/1,新竹縣,新埔鎮,10639,34560,18362,16198
2014/8/1,新竹縣,竹東鎮,32172,95982,48274,47708
2014/8/1,新竹縣,湖口鄉,25087,77044,39177,37867
2014/8/1,新竹縣,橫山鄉,4526,13886,7523,6363
2014/8/1,新竹縣,新豐鄉,17340,55638,28558,27080
2014/8/1,新竹縣,芎林鄉,6437,20314,10746,9568
2014/8/1,新竹縣,寶山鄉,5088,14361,7744,6617
2014/8/1,新竹縣,北埔鄉,3142,9811,5284,4527
2014/8/1,新竹縣,峨眉鄉,2074,5790,3203,2587
2014/8/1,新竹縣,尖石鄉,2819,9417,5013,4404
2014/8/1,新竹縣,五峰鄉,1753,4749,2587,2162
2014/8/1,苗栗縣,苗栗市,30467,91021,45541,45480
2014/8/1,苗栗縣,苑裡鎮,14345,48594,25156,23438
2014/8/1,苗栗縣,通霄鎮,11546,37013,19521,17492
2014/8/1,苗栗縣,竹南鎮,27020,83294,42122,41172
2014/8/1,苗栗縣,頭份市,32809,102115,51602,50513
2014/8/1,苗栗縣,後龍鎮,11909,38557,20271,18286
2014/8/1,苗栗縣,卓蘭鎮,6159,18371,9616,8755
2014/8/1,苗栗縣,大湖鄉,5439,15575,8259,7316
2014/8/1,苗栗縣,公館鄉,10588,34786,18046,16740
2014/8/1,苗栗縣,銅鑼鄉,6119,18968,10068,8900
2014/8/1,苗栗縣,南庄鄉,3977,10670,5855,4815
2014/8/1,苗栗縣,頭屋鄉,3638,11358,5958,5400
2014/8/1,苗栗縣,三義鄉,5475,17314,9064,8250
2014/8/1,苗栗縣,西湖鄉,2701,7604,4223,3381
2014/8/1,苗栗縣,造橋鄉,4136,13478,7069,6409
2014/8/1,苗栗縣,三灣鄉,2436,7177,3905,3272
2014/8/1,苗栗縣,獅潭鄉,1739,4757,2646,2111
2014/8/1,苗栗縣,泰安鄉,1971,6166,3285,2881
2014/8/1,彰化縣,彰化市,74770,235255,116686,118569
2014/8/1,彰化縣,鹿港鎮,23572,86032,43890,42142
2014/8/1,彰化縣,和美鎮,25836,90673,46353,44320
2014/8/1,彰化縣,北斗鎮,10353,33146,16730,16416
2014/8/1,彰化縣,員林市,38287,124838,62487,62351
2014/8/1,彰化縣,溪湖鎮,15919,55725,28391,27334
2014/8/1,彰化縣,田中鎮,12888,42852,22161,20691
2014/8/1,彰化縣,二林鎮,14785,52511,27086,25425
2014/8/1,彰化縣,線西鄉,4290,17135,8876,8259
2014/8/1,彰化縣,伸港鄉,9441,36155,18520,17635
2014/8/1,彰化縣,福興鄉,12471,47816,24938,22878
2014/8/1,彰化縣,秀水鄉,10315,39285,20308,18977
2014/8/1,彰化縣,花壇鄉,13618,45913,23623,22290
2014/8/1,彰化縣,芬園鄉,6879,24196,12734,11462
2014/8/1,彰化縣,大村鄉,10714,36419,18902,17517
2014/8/1,彰化縣,埔鹽鄉,8973,33262,17464,15798
2014/8/1,彰化縣,埔心鄉,10338,34933,18023,16910
2014/8/1,彰化縣,永靖鄉,10791,38365,19948,18417
2014/8/1,彰化縣,社頭鄉,12664,43715,22497,21218
2014/8/1,彰化縣,二水鄉,5355,15880,8341,7539
2014/8/1,彰化縣,田尾鄉,7841,27862,14481,13381
2014/8/1,彰化縣,埤頭鄉,8877,31080,16180,14900
2014/8/1,彰化縣,芳苑鄉,10105,34866,18473,16393
2014/8/1,彰化縣,大城鄉,5347,17903,9712,8191
2014/8/1,彰化縣,竹塘鄉,4635,15962,8413,7549
2014/8/1,彰化縣,溪州鄉,8880,30820,16172,14648
2014/8/1,南投縣,南投市,34263,102495,51419,51076
2014/8/1,南投縣,埔里鎮,28882,83363,41874,41489
2014/8/1,南投縣,草屯鎮,32484,99226,50107,49119
2014/8/1,南投縣,竹山鎮,19925,56870,29206,27664
2014/8/1,南投縣,集集鎮,4382,11456,6002,5454
2014/8/1,南投縣,名間鄉,12524,40017,21037,18980
2014/8/1,南投縣,鹿谷鄉,7432,18533,9836,8697
2014/8/1,南投縣,中寮鄉,5647,15608,8483,7125
2014/8/1,南投縣,魚池鄉,5746,16536,8664,7872
2014/8/1,南投縣,國姓鄉,7307,19832,10733,9099
2014/8/1,南投縣,水里鄉,7251,18790,9860,8930
2014/8/1,南投縣,信義鄉,5244,16817,9038,7779
2014/8/1,南投縣,仁愛鄉,4934,15802,8155,7647
2014/8/1,雲林縣,斗六市,36903,107989,53986,54003
2014/8/1,雲林縣,斗南鎮,15688,46048,23406,22642
2014/8/1,雲林縣,虎尾鎮,23945,70300,35683,34617
2014/8/1,雲林縣,西螺鎮,14391,47225,24005,23220
2014/8/1,雲林縣,土庫鎮,9188,29797,15561,14236
2014/8/1,雲林縣,北港鎮,15971,41713,21671,20042
2014/8/1,雲林縣,古坑鄉,10884,32696,17262,15434
2014/8/1,雲林縣,大埤鄉,6753,20048,10760,9288
2014/8/1,雲林縣,莿桐鄉,9287,29721,15580,14141
2014/8/1,雲林縣,林內鄉,5887,19156,10020,9136
2014/8/1,雲林縣,二崙鄉,8897,28443,15206,13237
2014/8/1,雲林縣,崙背鄉,8518,26031,13737,12294
2014/8/1,雲林縣,麥寮鄉,13765,43374,22052,21322
2014/8/1,雲林縣,東勢鄉,5839,16013,8760,7253
2014/8/1,雲林縣,褒忠鄉,4410,13702,7360,6342
2014/8/1,雲林縣,臺西鄉,8824,25089,13483,11606
2014/8/1,雲林縣,元長鄉,9445,27477,14971,12506
2014/8/1,雲林縣,四湖鄉,9017,25711,13917,11794
2014/8/1,雲林縣,口湖鄉,9658,29240,15493,13747
2014/8/1,雲林縣,水林鄉,10274,27168,14900,12268
2014/8/1,嘉義縣,太保市,12092,37065,19119,17946
2014/8/1,嘉義縣,朴子市,15332,43322,21944,21378
2014/8/1,嘉義縣,布袋鎮,10129,28541,14629,13912
2014/8/1,嘉義縣,大林鎮,11376,32259,16530,15729
2014/8/1,嘉義縣,民雄鄉,23964,71978,36868,35110
2014/8/1,嘉義縣,溪口鄉,5448,15542,8288,7254
2014/8/1,嘉義縣,新港鄉,10581,33343,17627,15716
2014/8/1,嘉義縣,六腳鄉,9039,24752,13119,11633
2014/8/1,嘉義縣,東石鄉,9465,26345,14005,12340
2014/8/1,嘉義縣,義竹鄉,7549,19669,10229,9440
2014/8/1,嘉義縣,鹿草鄉,5826,16479,8825,7654
2014/8/1,嘉義縣,水上鄉,17834,50914,26275,24639
2014/8/1,嘉義縣,中埔鄉,15915,46208,24053,22155
2014/8/1,嘉義縣,竹崎鄉,11585,37114,19789,17325
2014/8/1,嘉義縣,梅山鄉,6771,20374,10825,9549
2014/8/1,嘉義縣,番路鄉,4313,12156,6575,5581
2014/8/1,嘉義縣,大埔鄉,1953,4649,2420,2229
2014/8/1,嘉義縣,阿里山鄉,1949,5759,3059,2700
2014/8/1,屏東縣,屏東市,73286,204259,101519,102740
2014/8/1,屏東縣,潮州鎮,18926,54808,27492,27316
2014/8/1,屏東縣,東港鎮,16222,48415,24481,23934
2014/8/1,屏東縣,恆春鎮,11170,30819,15762,15057
2014/8/1,屏東縣,萬丹鄉,14672,52209,27023,25186
2014/8/1,屏東縣,長治鄉,9953,30453,15915,14538
2014/8/1,屏東縣,麟洛鄉,3714,11333,5862,5471
2014/8/1,屏東縣,九如鄉,6758,22258,11503,10755
2014/8/1,屏東縣,里港鄉,8091,26722,13583,13139
2014/8/1,屏東縣,鹽埔鄉,7841,26676,13852,12824
2014/8/1,屏東縣,高樹鄉,9434,25653,13664,11989
2014/8/1,屏東縣,萬巒鄉,6446,20963,11008,9955
2014/8/1,屏東縣,內埔鄉,18360,56298,29191,27107
2014/8/1,屏東縣,竹田鄉,5645,17759,9432,8327
2014/8/1,屏東縣,新埤鄉,3448,10321,5473,4848
2014/8/1,屏東縣,枋寮鄉,8577,25575,13388,12187
2014/8/1,屏東縣,新園鄉,11735,36810,19070,17740
2014/8/1,屏東縣,崁頂鄉,4411,16340,8317,8023
2014/8/1,屏東縣,林邊鄉,7017,19343,9963,9380
2014/8/1,屏東縣,南州鄉,3679,11090,5671,5419
2014/8/1,屏東縣,佳冬鄉,7045,20333,10581,9752
2014/8/1,屏東縣,琉球鄉,4248,12684,6997,5687
2014/8/1,屏東縣,車城鄉,3502,9174,4929,4245
2014/8/1,屏東縣,滿州鄉,3037,8184,4478,3706
2014/8/1,屏東縣,枋山鄉,2127,5770,3057,2713
2014/8/1,屏東縣,三地門鄉,2275,7804,3952,3852
2014/8/1,屏東縣,霧臺鄉,1050,3468,1764,1704
2014/8/1,屏東縣,瑪家鄉,1961,6712,3447,3265
2014/8/1,屏東縣,泰武鄉,1280,5304,2773,2531
2014/8/1,屏東縣,來義鄉,2221,7634,3886,3748
2014/8/1,屏東縣,春日鄉,1341,4859,2490,2369
2014/8/1,屏東縣,獅子鄉,1503,4896,2518,2378
2014/8/1,屏東縣,牡丹鄉,1869,4868,2499,2369
2014/8/1,臺東縣,臺東市,38944,107037,53853,53184
2014/8/1,臺東縣,成功鎮,5461,15043,7958,7085
2014/8/1,臺東縣,關山鎮,3253,9181,4806,4375
2014/8/1,臺東縣,卑南鄉,6641,17739,9463,8276
2014/8/1,臺東縣,大武鄉,2530,6647,3458,3189
2014/8/1,臺東縣,太麻里鄉,4601,11513,6112,5401
2014/8/1,臺東縣,東河鄉,3748,9051,4994,4057
2014/8/1,臺東縣,長濱鄉,2933,7777,4414,3363
2014/8/1,臺東縣,鹿野鄉,3112,8243,4424,3819
2014/8/1,臺東縣,池上鄉,3271,8633,4535,4098
2014/8/1,臺東縣,綠島鄉,1094,3813,2005,1808
2014/8/1,臺東縣,延平鄉,1074,3625,1959,1666
2014/8/1,臺東縣,海端鄉,1093,4385,2361,2024
2014/8/1,臺東縣,達仁鄉,1463,3760,2041,1719
2014/8/1,臺東縣,金峰鄉,1109,3663,1885,1778
2014/8/1,臺東縣,蘭嶼鄉,1721,4951,2516,2435
2014/8/1,花蓮縣,花蓮市,41206,106494,51773,54721
2014/8/1,花蓮縣,鳳林鎮,4430,11301,5949,5352
2014/8/1,花蓮縣,玉里鎮,8932,25526,13681,11845
2014/8/1,花蓮縣,新城鄉,7517,20232,10458,9774
2014/8/1,花蓮縣,吉安鄉,30927,82349,41837,40512
2014/8/1,花蓮縣,壽豐鄉,6991,18251,9771,8480
2014/8/1,花蓮縣,光復鄉,5052,13459,7158,6301
2014/8/1,花蓮縣,豐濱鄉,1753,4782,2639,2143
2014/8/1,花蓮縣,瑞穗鄉,4666,12224,6554,5670
2014/8/1,花蓮縣,富里鄉,4001,10946,5956,4990
2014/8/1,花蓮縣,秀林鄉,4773,15401,7963,7438
2014/8/1,花蓮縣,萬榮鄉,2081,6512,3449,3063
2014/8/1,花蓮縣,卓溪鄉,1680,6256,3426,2830
2014/8/1,澎湖縣,馬公市,22493,59685,30315,29370
2014/8/1,澎湖縣,湖西鄉,5305,14287,7536,6751
2014/8/1,澎湖縣,白沙鄉,3326,9762,5116,4646
2014/8/1,澎湖縣,西嶼鄉,2937,8483,4355,4128
2014/8/1,澎湖縣,望安鄉,1990,5121,2746,2375
2014/8/1,澎湖縣,七美鄉,1320,3772,1974,1798
2014/8/1,基隆市,中正區,22418,53199,27234,25965
2014/8/1,基隆市,七堵區,20871,53966,27319,26647
2014/8/1,基隆市,暖暖區,15170,38183,19282,18901
2014/8/1,基隆市,仁愛區,19525,46577,22962,23615
2014/8/1,基隆市,中山區,19320,48806,24865,23941
2014/8/1,基隆市,安樂區,32238,81762,40721,41041
2014/8/1,基隆市,信義區,20862,51228,25585,25643
2014/8/1,新竹市,東區,74579,206050,101549,104501
2014/8/1,新竹市,北區,54125,148457,72895,75562
2014/8/1,新竹市,香山區,25519,76137,38803,37334
2014/8/1,嘉義市,東區,45140,123631,59992,63639
2014/8/1,嘉義市,西區,52943,147254,72458,74796
2014/8/1,金門縣,金城鎮,12378,40349,20251,20098
2014/8/1,金門縣,金湖鎮,8272,26975,13623,13352
2014/8/1,金門縣,金沙鎮,6014,19263,9552,9711
2014/8/1,金門縣,金寧鄉,7561,26115,13206,12909
2014/8/1,金門縣,烈嶼鄉,2987,11718,5789,5929
2014/8/1,金門縣,烏坵鄉,134,669,336,333
2014/8/1,連江縣,南竿鄉,1416,7479,4275,3204
2014/8/1,連江縣,北竿鄉,474,2317,1275,1042
2014/8/1,連江縣,莒光鄉,272,1416,824,592
2014/8/1,連江縣,東引鄉,297,1226,733,493
2014/9/1,總計,新北市,1495243,3961374,1950031,2011343
2014/9/1,總計,臺北市,1036877,2695649,1293032,1402617
2014/9/1,總計,臺中市,910079,2712948,1344077,1368871
2014/9/1,總計,臺南市,667772,1883493,943896,939597
2014/9/1,總計,高雄市,1063794,2777461,1382862,1394599
2014/9/1,總計,臺灣省,3159261,9240718,4705987,4534731
2014/9/1,總計,宜蘭縣,162601,458784,232801,225983
2014/9/1,總計,桃園市,730869,2054260,1030878,1023382
2014/9/1,總計,新竹縣,178564,536111,274614,261497
2014/9/1,總計,苗栗縣,182873,566918,292239,274679
2014/9/1,總計,彰化縣,378352,1292126,661074,631052
2014/9/1,總計,南投縣,176188,515081,264298,250783
2014/9/1,總計,雲林縣,237726,706688,367643,339045
2014/9/1,總計,嘉義縣,181256,526028,273958,252070
2014/9/1,總計,屏東縣,283097,849326,435288,414038
2014/9/1,總計,臺東縣,82090,224931,116730,108201
2014/9/1,總計,花蓮縣,124106,333531,170468,163063
2014/9/1,總計,澎湖縣,37806,101482,52239,49243
2014/9/1,總計,基隆市,150663,373597,187900,185697
2014/9/1,總計,新竹市,154857,431029,213443,217586
2014/9/1,總計,嘉義市,98213,270826,132414,138412
2014/9/1,總計,福建省,39899,138637,70432,68205
2014/9/1,總計,金門縣,37428,126156,63297,62859
2014/9/1,總計,連江縣,2471,12481,7135,5346
2014/9/1,新北市,板橋區,204892,555735,272402,283333
2014/9/1,新北市,三重區,147206,389180,192493,196687
2014/9/1,新北市,中和區,162354,415073,202968,212105
2014/9/1,新北市,永和區,90886,227629,108448,119181
2014/9/1,新北市,新莊區,146759,410905,201670,209235
2014/9/1,新北市,新店區,122700,299327,145004,154323
2014/9/1,新北市,樹林區,65026,183767,91977,91790
2014/9/1,新北市,鶯歌區,29170,88886,44498,44388
2014/9/1,新北市,三峽區,40230,111163,56096,55067
2014/9/1,新北市,淡水區,67869,158223,76259,81964
2014/9/1,新北市,汐止區,84175,194879,95717,99162
2014/9/1,新北市,瑞芳區,16075,41372,20889,20483
2014/9/1,新北市,土城區,85550,239056,118497,120559
2014/9/1,新北市,蘆洲區,68863,199460,98217,101243
2014/9/1,新北市,五股區,29230,82147,41491,40656
2014/9/1,新北市,泰山區,27620,78231,38964,39267
2014/9/1,新北市,林口區,37501,96658,47349,49309
2014/9/1,新北市,深坑區,9316,23590,11835,11755
2014/9/1,新北市,石碇區,3377,7885,4336,3549
2014/9/1,新北市,坪林區,2470,6405,3579,2826
2014/9/1,新北市,三芝區,9243,23444,12072,11372
2014/9/1,新北市,石門區,4256,12679,6598,6081
2014/9/1,新北市,八里區,13706,36997,18548,18449
2014/9/1,新北市,平溪區,2360,4986,2747,2239
2014/9/1,新北市,雙溪區,3838,9423,5067,4356
2014/9/1,新北市,貢寮區,4438,13142,6736,6406
2014/9/1,新北市,金山區,7007,22361,11092,11269
2014/9/1,新北市,萬里區,7348,22645,11433,11212
2014/9/1,新北市,烏來區,1778,6126,3049,3077
2014/9/1,臺北市,松山區,80125,210150,99316,110834
2014/9/1,臺北市,信義區,89104,229071,109887,119184
2014/9/1,臺北市,大安區,120173,313062,146702,166360
2014/9/1,臺北市,中山區,98243,229812,107393,122419
2014/9/1,臺北市,中正區,65098,163220,78136,85084
2014/9/1,臺北市,大同區,51151,130687,63904,66783
2014/9/1,臺北市,萬華區,78109,194229,96064,98165
2014/9/1,臺北市,文山區,103193,273096,131593,141503
2014/9/1,臺北市,南港區,45769,120744,59016,61728
2014/9/1,臺北市,內湖區,105259,284767,136436,148331
2014/9/1,臺北市,士林區,105562,290048,140396,149652
2014/9/1,臺北市,北投區,95091,256763,124189,132574
2014/9/1,臺中市,中區,7870,19407,9656,9751
2014/9/1,臺中市,東區,27085,74745,37371,37374
2014/9/1,臺中市,南區,45752,119658,57809,61849
2014/9/1,臺中市,西區,44726,115684,55096,60588
2014/9/1,臺中市,北區,58202,147321,70896,76425
2014/9/1,臺中市,西屯區,80302,217673,104871,112802
2014/9/1,臺中市,南屯區,58229,161472,77615,83857
2014/9/1,臺中市,北屯區,91669,258701,124837,133864
2014/9/1,臺中市,豐原區,52159,166354,82440,83914
2014/9/1,臺中市,東勢區,17249,51585,26652,24933
2014/9/1,臺中市,大甲區,22496,77582,39272,38310
2014/9/1,臺中市,清水區,26006,85908,44226,41682
2014/9/1,臺中市,沙鹿區,26972,87352,44345,43007
2014/9/1,臺中市,梧棲區,16777,56449,28433,28016
2014/9/1,臺中市,后里區,15386,54035,27546,26489
2014/9/1,臺中市,神岡區,18668,64870,33251,31619
2014/9/1,臺中市,潭子區,34588,104834,52052,52782
2014/9/1,臺中市,大雅區,27869,92369,46263,46106
2014/9/1,臺中市,新社區,7469,25247,13138,12109
2014/9/1,臺中市,石岡區,4904,15443,8040,7403
2014/9/1,臺中市,外埔區,9287,31758,16320,15438
2014/9/1,臺中市,大安區,5343,19640,10353,9287
2014/9/1,臺中市,烏日區,22461,71197,35947,35250
2014/9/1,臺中市,大肚區,16620,56246,28804,27442
2014/9/1,臺中市,龍井區,21981,75841,38493,37348
2014/9/1,臺中市,霧峰區,19510,64443,32934,31509
2014/9/1,臺中市,太平區,59616,180712,90078,90634
2014/9/1,臺中市,大里區,66464,205612,101538,104074
2014/9/1,臺中市,和平區,4419,10810,5801,5009
2014/9/1,臺南市,新營區,28434,78267,38798,39469
2014/9/1,臺南市,鹽水區,10056,26348,13754,12594
2014/9/1,臺南市,白河區,11002,29858,15641,14217
2014/9/1,臺南市,柳營區,7834,21861,11398,10463
2014/9/1,臺南市,後壁區,8894,24633,12824,11809
2014/9/1,臺南市,東山區,8295,21963,11659,10304
2014/9/1,臺南市,麻豆區,15454,45072,22887,22185
2014/9/1,臺南市,下營區,9130,25167,12979,12188
2014/9/1,臺南市,六甲區,7731,22895,11857,11038
2014/9/1,臺南市,官田區,7781,21754,11131,10623
2014/9/1,臺南市,大內區,3970,10263,5477,4786
2014/9/1,臺南市,佳里區,20239,59522,29546,29976
2014/9/1,臺南市,學甲區,9658,26951,13801,13150
2014/9/1,臺南市,西港區,8026,24913,12628,12285
2014/9/1,臺南市,七股區,8124,23632,12292,11340
2014/9/1,臺南市,將軍區,7347,20597,10474,10123
2014/9/1,臺南市,北門區,4377,11721,5900,5821
2014/9/1,臺南市,新化區,14182,43806,22387,21419
2014/9/1,臺南市,善化區,16209,45893,23210,22683
2014/9/1,臺南市,新市區,11502,35463,17819,17644
2014/9/1,臺南市,安定區,9735,30281,15567,14714
2014/9/1,臺南市,山上區,2698,7515,3930,3585
2014/9/1,臺南市,玉井區,5145,14636,7622,7014
2014/9/1,臺南市,楠西區,3553,10123,5369,4754
2014/9/1,臺南市,南化區,2870,8908,4838,4070
2014/9/1,臺南市,左鎮區,2001,5199,2902,2297
2014/9/1,臺南市,仁德區,26516,72956,37147,35809
2014/9/1,臺南市,歸仁區,21913,67399,34245,33154
2014/9/1,臺南市,關廟區,10887,34898,18048,16850
2014/9/1,臺南市,龍崎區,1577,4297,2328,1969
2014/9/1,臺南市,永康區,81013,228264,112858,115406
2014/9/1,臺南市,東區,71969,190360,91633,98727
2014/9/1,臺南市,南區,44694,125650,62526,63124
2014/9/1,臺南市,北區,49728,132459,64845,67614
2014/9/1,臺南市,安南區,59892,187160,94674,92486
2014/9/1,臺南市,安平區,24489,64745,30869,33876
2014/9/1,臺南市,中西區,30847,78064,38033,40031
2014/9/1,高雄市,鹽埕區,10904,25479,12704,12775
2014/9/1,高雄市,鼓山區,55478,135524,65837,69687
2014/9/1,高雄市,左營區,77050,195536,94850,100686
2014/9/1,高雄市,楠梓區,66028,178320,88122,90198
2014/9/1,高雄市,三民區,134866,347451,168892,178559
2014/9/1,高雄市,新興區,22791,52624,25338,27286
2014/9/1,高雄市,前金區,12571,27869,13421,14448
2014/9/1,高雄市,苓雅區,72226,176033,85171,90862
2014/9/1,高雄市,前鎮區,78019,194080,95913,98167
2014/9/1,高雄市,旗津區,10942,28960,15014,13946
2014/9/1,高雄市,小港區,65846,155893,77752,78141
2014/9/1,高雄市,鳳山區,135303,353476,174275,179201
2014/9/1,高雄市,林園區,25380,70455,35853,34602
2014/9/1,高雄市,大寮區,40830,111054,57225,53829
2014/9/1,高雄市,大樹區,13269,43224,22219,21005
2014/9/1,高雄市,大社區,12613,34333,17516,16817
2014/9/1,高雄市,仁武區,30160,80610,41237,39373
2014/9/1,高雄市,鳥松區,17469,43647,22189,21458
2014/9/1,高雄市,岡山區,34403,97662,48606,49056
2014/9/1,高雄市,橋頭區,13187,37135,18940,18195
2014/9/1,高雄市,燕巢區,10342,30443,16145,14298
2014/9/1,高雄市,田寮區,3422,7701,4279,3422
2014/9/1,高雄市,阿蓮區,9366,29560,14922,14638
2014/9/1,高雄市,路竹區,16628,52989,27083,25906
2014/9/1,高雄市,湖內區,10318,29378,15041,14337
2014/9/1,高雄市,茄萣區,10380,30681,15888,14793
2014/9/1,高雄市,永安區,5822,14149,7110,7039
2014/9/1,高雄市,彌陀區,6722,19917,10305,9612
2014/9/1,高雄市,梓官區,12418,36368,18787,17581
2014/9/1,高雄市,旗山區,13877,38183,19802,18381
2014/9/1,高雄市,美濃區,14469,41333,21614,19719
2014/9/1,高雄市,六龜區,5663,13734,7417,6317
2014/9/1,高雄市,甲仙區,2372,6426,3413,3013
2014/9/1,高雄市,杉林區,4841,12614,6864,5750
2014/9/1,高雄市,內門區,5060,15215,8244,6971
2014/9/1,高雄市,茂林區,584,1906,947,959
2014/9/1,高雄市,桃源區,1314,4289,2256,2033
2014/9/1,高雄市,那瑪夏區,861,3210,1671,1539
2014/9/1,宜蘭縣,宜蘭市,35190,95799,46864,48935
2014/9/1,宜蘭縣,羅東鎮,25786,72469,34605,37864
2014/9/1,宜蘭縣,蘇澳鎮,13980,41143,20976,20167
2014/9/1,宜蘭縣,頭城鎮,10084,29925,15459,14466
2014/9/1,宜蘭縣,礁溪鄉,13311,36018,18809,17209
2014/9/1,宜蘭縣,壯圍鄉,8418,24476,12937,11539
2014/9/1,宜蘭縣,員山鄉,11347,32367,17177,15190
2014/9/1,宜蘭縣,冬山鄉,18562,53562,27518,26044
2014/9/1,宜蘭縣,五結鄉,14018,39332,20351,18981
2014/9/1,宜蘭縣,三星鄉,8120,21396,11553,9843
2014/9/1,宜蘭縣,大同鄉,1886,6135,3326,2809
2014/9/1,宜蘭縣,南澳鄉,1899,6162,3226,2936
2014/9/1,桃園市,桃園區,155988,416403,203472,212931
2014/9/1,桃園市,中壢區,138356,380829,189084,191745
2014/9/1,桃園市,平鎮區,72041,212073,106164,105909
2014/9/1,桃園市,八德區,63485,180999,91485,89514
2014/9/1,桃園市,楊梅區,53514,156818,79581,77237
2014/9/1,桃園市,大溪區,30746,91846,47287,44559
2014/9/1,桃園市,蘆竹區,53903,150969,75481,75488
2014/9/1,桃園市,大園區,29269,84191,43322,40869
2014/9/1,桃園市,龜山區,54276,141565,71236,70329
2014/9/1,桃園市,龍潭區,39165,116150,58716,57434
2014/9/1,桃園市,新屋區,15501,48036,25743,22293
2014/9/1,桃園市,觀音區,20910,63491,33303,30188
2014/9/1,桃園市,復興區,3715,10890,6004,4886
2014/9/1,新竹縣,竹北市,57731,163701,81693,82008
2014/9/1,新竹縣,關西鎮,9529,30790,16408,14382
2014/9/1,新竹縣,新埔鎮,10642,34522,18350,16172
2014/9/1,新竹縣,竹東鎮,32230,95989,48272,47717
2014/9/1,新竹縣,湖口鄉,25174,77098,39213,37885
2014/9/1,新竹縣,橫山鄉,4526,13859,7510,6349
2014/9/1,新竹縣,新豐鄉,17391,55678,28576,27102
2014/9/1,新竹縣,芎林鄉,6443,20302,10738,9564
2014/9/1,新竹縣,寶山鄉,5108,14377,7754,6623
2014/9/1,新竹縣,北埔鄉,3144,9801,5283,4518
2014/9/1,新竹縣,峨眉鄉,2075,5792,3208,2584
2014/9/1,新竹縣,尖石鄉,2822,9459,5027,4432
2014/9/1,新竹縣,五峰鄉,1749,4743,2582,2161
2014/9/1,苗栗縣,苗栗市,30535,90936,45486,45450
2014/9/1,苗栗縣,苑裡鎮,14359,48605,25171,23434
2014/9/1,苗栗縣,通霄鎮,11563,37011,19514,17497
2014/9/1,苗栗縣,竹南鎮,27123,83353,42147,41206
2014/9/1,苗栗縣,頭份市,32979,102335,51696,50639
2014/9/1,苗栗縣,後龍鎮,11916,38524,20261,18263
2014/9/1,苗栗縣,卓蘭鎮,6154,18367,9625,8742
2014/9/1,苗栗縣,大湖鄉,5435,15558,8248,7310
2014/9/1,苗栗縣,公館鄉,10604,34784,18049,16735
2014/9/1,苗栗縣,銅鑼鄉,6128,18951,10052,8899
2014/9/1,苗栗縣,南庄鄉,3982,10691,5862,4829
2014/9/1,苗栗縣,頭屋鄉,3647,11369,5969,5400
2014/9/1,苗栗縣,三義鄉,5475,17270,9044,8226
2014/9/1,苗栗縣,西湖鄉,2693,7601,4220,3381
2014/9/1,苗栗縣,造橋鄉,4135,13471,7063,6408
2014/9/1,苗栗縣,三灣鄉,2433,7162,3901,3261
2014/9/1,苗栗縣,獅潭鄉,1739,4749,2642,2107
2014/9/1,苗栗縣,泰安鄉,1973,6181,3289,2892
2014/9/1,彰化縣,彰化市,74876,235134,116631,118503
2014/9/1,彰化縣,鹿港鎮,23626,86037,43880,42157
2014/9/1,彰化縣,和美鎮,25889,90667,46349,44318
2014/9/1,彰化縣,北斗鎮,10375,33175,16747,16428
2014/9/1,彰化縣,員林市,38319,124746,62422,62324
2014/9/1,彰化縣,溪湖鎮,15940,55732,28382,27350
2014/9/1,彰化縣,田中鎮,12887,42812,22127,20685
2014/9/1,彰化縣,二林鎮,14796,52466,27056,25410
2014/9/1,彰化縣,線西鄉,4296,17130,8877,8253
2014/9/1,彰化縣,伸港鄉,9447,36158,18521,17637
2014/9/1,彰化縣,福興鄉,12481,47802,24925,22877
2014/9/1,彰化縣,秀水鄉,10340,39328,20332,18996
2014/9/1,彰化縣,花壇鄉,13644,45906,23625,22281
2014/9/1,彰化縣,芬園鄉,6886,24188,12725,11463
2014/9/1,彰化縣,大村鄉,10719,36440,18909,17531
2014/9/1,彰化縣,埔鹽鄉,8980,33238,17458,15780
2014/9/1,彰化縣,埔心鄉,10340,34928,18013,16915
2014/9/1,彰化縣,永靖鄉,10786,38296,19921,18375
2014/9/1,彰化縣,社頭鄉,12679,43678,22469,21209
2014/9/1,彰化縣,二水鄉,5350,15857,8324,7533
2014/9/1,彰化縣,田尾鄉,7843,27840,14471,13369
2014/9/1,彰化縣,埤頭鄉,8879,31053,16157,14896
2014/9/1,彰化縣,芳苑鄉,10109,34851,18463,16388
2014/9/1,彰化縣,大城鄉,5345,17894,9713,8181
2014/9/1,彰化縣,竹塘鄉,4633,15949,8398,7551
2014/9/1,彰化縣,溪州鄉,8887,30821,16179,14642
2014/9/1,南投縣,南投市,34306,102382,51367,51015
2014/9/1,南投縣,埔里鎮,28902,83232,41823,41409
2014/9/1,南投縣,草屯鎮,32527,99273,50133,49140
2014/9/1,南投縣,竹山鎮,19943,56796,29178,27618
2014/9/1,南投縣,集集鎮,4381,11437,5992,5445
2014/9/1,南投縣,名間鄉,12539,40016,21031,18985
2014/9/1,南投縣,鹿谷鄉,7465,18534,9834,8700
2014/9/1,南投縣,中寮鄉,5651,15607,8485,7122
2014/9/1,南投縣,魚池鄉,5748,16555,8676,7879
2014/9/1,南投縣,國姓鄉,7305,19798,10712,9086
2014/9/1,南投縣,水里鄉,7247,18774,9847,8927
2014/9/1,南投縣,信義鄉,5238,16829,9034,7795
2014/9/1,南投縣,仁愛鄉,4936,15848,8186,7662
2014/9/1,雲林縣,斗六市,36989,108019,54000,54019
2014/9/1,雲林縣,斗南鎮,15707,46029,23398,22631
2014/9/1,雲林縣,虎尾鎮,23947,70288,35658,34630
2014/9/1,雲林縣,西螺鎮,14401,47214,23995,23219
2014/9/1,雲林縣,土庫鎮,9194,29759,15545,14214
2014/9/1,雲林縣,北港鎮,15999,41706,21666,20040
2014/9/1,雲林縣,古坑鄉,10928,32732,17269,15463
2014/9/1,雲林縣,大埤鄉,6760,20027,10747,9280
2014/9/1,雲林縣,莿桐鄉,9283,29686,15560,14126
2014/9/1,雲林縣,林內鄉,5899,19112,10003,9109
2014/9/1,雲林縣,二崙鄉,8904,28398,15186,13212
2014/9/1,雲林縣,崙背鄉,8517,26008,13731,12277
2014/9/1,雲林縣,麥寮鄉,13786,43522,22116,21406
2014/9/1,雲林縣,東勢鄉,5824,15988,8743,7245
2014/9/1,雲林縣,褒忠鄉,4411,13681,7347,6334
2014/9/1,雲林縣,臺西鄉,8813,25059,13469,11590
2014/9/1,雲林縣,元長鄉,9442,27437,14952,12485
2014/9/1,雲林縣,四湖鄉,9006,25675,13900,11775
2014/9/1,雲林縣,口湖鄉,9650,29202,15472,13730
2014/9/1,雲林縣,水林鄉,10266,27146,14886,12260
2014/9/1,嘉義縣,太保市,12114,37054,19111,17943
2014/9/1,嘉義縣,朴子市,15346,43256,21912,21344
2014/9/1,嘉義縣,布袋鎮,10124,28519,14617,13902
2014/9/1,嘉義縣,大林鎮,11394,32246,16520,15726
2014/9/1,嘉義縣,民雄鄉,24004,71968,36863,35105
2014/9/1,嘉義縣,溪口鄉,5446,15509,8280,7229
2014/9/1,嘉義縣,新港鄉,10583,33289,17611,15678
2014/9/1,嘉義縣,六腳鄉,9044,24714,13103,11611
2014/9/1,嘉義縣,東石鄉,9462,26346,13994,12352
2014/9/1,嘉義縣,義竹鄉,7547,19648,10220,9428
2014/9/1,嘉義縣,鹿草鄉,5826,16459,8803,7656
2014/9/1,嘉義縣,水上鄉,17854,50856,26244,24612
2014/9/1,嘉義縣,中埔鄉,15928,46207,24057,22150
2014/9/1,嘉義縣,竹崎鄉,11592,37053,19765,17288
2014/9/1,嘉義縣,梅山鄉,6768,20337,10807,9530
2014/9/1,嘉義縣,番路鄉,4317,12154,6567,5587
2014/9/1,嘉義縣,大埔鄉,1957,4656,2424,2232
2014/9/1,嘉義縣,阿里山鄉,1950,5757,3060,2697
2014/9/1,屏東縣,屏東市,73350,204084,101447,102637
2014/9/1,屏東縣,潮州鎮,18972,54812,27488,27324
2014/9/1,屏東縣,東港鎮,16236,48368,24448,23920
2014/9/1,屏東縣,恆春鎮,11179,30793,15754,15039
2014/9/1,屏東縣,萬丹鄉,14689,52151,26995,25156
2014/9/1,屏東縣,長治鄉,9966,30471,15914,14557
2014/9/1,屏東縣,麟洛鄉,3727,11338,5859,5479
2014/9/1,屏東縣,九如鄉,6768,22247,11493,10754
2014/9/1,屏東縣,里港鄉,8105,26730,13590,13140
2014/9/1,屏東縣,鹽埔鄉,7840,26670,13843,12827
2014/9/1,屏東縣,高樹鄉,9429,25653,13666,11987
2014/9/1,屏東縣,萬巒鄉,6448,20955,11002,9953
2014/9/1,屏東縣,內埔鄉,18408,56250,29166,27084
2014/9/1,屏東縣,竹田鄉,5640,17763,9429,8334
2014/9/1,屏東縣,新埤鄉,3452,10310,5469,4841
2014/9/1,屏東縣,枋寮鄉,8580,25554,13373,12181
2014/9/1,屏東縣,新園鄉,11731,36792,19067,17725
2014/9/1,屏東縣,崁頂鄉,4407,16329,8308,8021
2014/9/1,屏東縣,林邊鄉,7023,19312,9942,9370
2014/9/1,屏東縣,南州鄉,3674,11058,5651,5407
2014/9/1,屏東縣,佳冬鄉,7047,20320,10578,9742
2014/9/1,屏東縣,琉球鄉,4255,12670,6982,5688
2014/9/1,屏東縣,車城鄉,3501,9172,4928,4244
2014/9/1,屏東縣,滿州鄉,3033,8184,4478,3706
2014/9/1,屏東縣,枋山鄉,2131,5759,3056,2703
2014/9/1,屏東縣,三地門鄉,2278,7804,3949,3855
2014/9/1,屏東縣,霧臺鄉,1048,3468,1765,1703
2014/9/1,屏東縣,瑪家鄉,1956,6711,3446,3265
2014/9/1,屏東縣,泰武鄉,1282,5312,2776,2536
2014/9/1,屏東縣,來義鄉,2224,7636,3888,3748
2014/9/1,屏東縣,春日鄉,1344,4873,2503,2370
2014/9/1,屏東縣,獅子鄉,1505,4903,2526,2377
2014/9/1,屏東縣,牡丹鄉,1869,4874,2509,2365
2014/9/1,臺東縣,臺東市,38989,106992,53837,53155
2014/9/1,臺東縣,成功鎮,5459,15006,7944,7062
2014/9/1,臺東縣,關山鎮,3248,9188,4828,4360
2014/9/1,臺東縣,卑南鄉,6640,17737,9456,8281
2014/9/1,臺東縣,大武鄉,2527,6623,3445,3178
2014/9/1,臺東縣,太麻里鄉,4607,11514,6109,5405
2014/9/1,臺東縣,東河鄉,3746,9050,4988,4062
2014/9/1,臺東縣,長濱鄉,2936,7789,4418,3371
2014/9/1,臺東縣,鹿野鄉,3105,8229,4423,3806
2014/9/1,臺東縣,池上鄉,3268,8622,4531,4091
2014/9/1,臺東縣,綠島鄉,1098,3816,2008,1808
2014/9/1,臺東縣,延平鄉,1072,3614,1948,1666
2014/9/1,臺東縣,海端鄉,1094,4378,2350,2028
2014/9/1,臺東縣,達仁鄉,1464,3757,2041,1716
2014/9/1,臺東縣,金峰鄉,1111,3657,1885,1772
2014/9/1,臺東縣,蘭嶼鄉,1726,4959,2519,2440
2014/9/1,花蓮縣,花蓮市,41234,106355,51693,54662
2014/9/1,花蓮縣,鳳林鎮,4436,11297,5943,5354
2014/9/1,花蓮縣,玉里鎮,8931,25480,13642,11838
2014/9/1,花蓮縣,新城鄉,7526,20269,10473,9796
2014/9/1,花蓮縣,吉安鄉,30975,82390,41851,40539
2014/9/1,花蓮縣,壽豐鄉,6996,18245,9762,8483
2014/9/1,花蓮縣,光復鄉,5054,13440,7145,6295
2014/9/1,花蓮縣,豐濱鄉,1753,4751,2627,2124
2014/9/1,花蓮縣,瑞穗鄉,4654,12193,6545,5648
2014/9/1,花蓮縣,富里鄉,4002,10913,5939,4974
2014/9/1,花蓮縣,秀林鄉,4784,15449,7986,7463
2014/9/1,花蓮縣,萬榮鄉,2084,6511,3444,3067
2014/9/1,花蓮縣,卓溪鄉,1677,6238,3418,2820
2014/9/1,澎湖縣,馬公市,22925,60095,30540,29555
2014/9/1,澎湖縣,湖西鄉,5303,14260,7525,6735
2014/9/1,澎湖縣,白沙鄉,3331,9776,5121,4655
2014/9/1,澎湖縣,西嶼鄉,2935,8469,4341,4128
2014/9/1,澎湖縣,望安鄉,1987,5114,2742,2372
2014/9/1,澎湖縣,七美鄉,1325,3768,1970,1798
2014/9/1,基隆市,中正區,22475,53184,27248,25936
2014/9/1,基隆市,七堵區,20910,53979,27321,26658
2014/9/1,基隆市,暖暖區,15217,38221,19297,18924
2014/9/1,基隆市,仁愛區,19529,46474,22916,23558
2014/9/1,基隆市,中山區,19336,48779,24845,23934
2014/9/1,基隆市,安樂區,32281,81686,40673,41013
2014/9/1,基隆市,信義區,20915,51274,25600,25674
2014/9/1,新竹市,東區,74938,206268,101655,104613
2014/9/1,新竹市,北區,54273,148566,72943,75623
2014/9/1,新竹市,香山區,25646,76195,38845,37350
2014/9/1,嘉義市,東區,45162,123506,59943,63563
2014/9/1,嘉義市,西區,53051,147320,72471,74849
2014/9/1,金門縣,金城鎮,12397,40500,20346,20154
2014/9/1,金門縣,金湖鎮,8288,27078,13670,13408
2014/9/1,金門縣,金沙鎮,6020,19290,9553,9737
2014/9/1,金門縣,金寧鄉,7594,26868,13584,13284
2014/9/1,金門縣,烈嶼鄉,2995,11751,5808,5943
2014/9/1,金門縣,烏坵鄉,134,669,336,333
2014/9/1,連江縣,南竿鄉,1423,7509,4299,3210
2014/9/1,連江縣,北竿鄉,477,2320,1276,1044
2014/9/1,連江縣,莒光鄉,272,1418,823,595
2014/9/1,連江縣,東引鄉,299,1234,737,497
2014/10/1,總計,新北市,1495562,3962920,1950515,2012405
2014/10/1,總計,臺北市,1037047,2697644,1293884,1403760
2014/10/1,總計,臺中市,910523,2714642,1344785,1369857
2014/10/1,總計,臺南市,667750,1883562,943887,939675
2014/10/1,總計,高雄市,1063871,2777773,1382805,1394968
2014/10/1,總計,臺灣省,3159846,9241501,4706143,4535358
2014/10/1,總計,宜蘭縣,162625,458799,232787,226012
2014/10/1,總計,桃園市,731296,2055259,1031368,1023891
2014/10/1,總計,新竹縣,178724,536539,274772,261767
2014/10/1,總計,苗栗縣,182883,567044,292260,274784
2014/10/1,總計,彰化縣,378355,1292098,661046,631052
2014/10/1,總計,南投縣,176154,514894,264155,250739
2014/10/1,總計,雲林縣,237758,706634,367634,339000
2014/10/1,總計,嘉義縣,181238,525775,273806,251969
2014/10/1,總計,屏東縣,283135,849113,435159,413954
2014/10/1,總計,臺東縣,82082,224807,116663,108144
2014/10/1,總計,花蓮縣,124086,333413,170393,163020
2014/10/1,總計,澎湖縣,37840,101548,52286,49262
2014/10/1,總計,基隆市,150598,373463,187816,185647
2014/10/1,總計,新竹市,154880,431336,213594,217742
2014/10/1,總計,嘉義市,98192,270779,132404,138375
2014/10/1,總計,福建省,39928,139074,70635,68439
2014/10/1,總計,金門縣,37465,126562,63489,63073
2014/10/1,總計,連江縣,2463,12512,7146,5366
2014/10/1,新北市,板橋區,204890,555794,272351,283443
2014/10/1,新北市,三重區,147247,389280,192497,196783
2014/10/1,新北市,中和區,162343,415138,202988,212150
2014/10/1,新北市,永和區,90789,227432,108344,119088
2014/10/1,新北市,新莊區,146813,411217,201800,209417
2014/10/1,新北市,新店區,122795,299464,145045,154419
2014/10/1,新北市,樹林區,65022,183865,92020,91845
2014/10/1,新北市,鶯歌區,29170,88962,44512,44450
2014/10/1,新北市,三峽區,40255,111317,56185,55132
2014/10/1,新北市,淡水區,67969,158433,76384,82049
2014/10/1,新北市,汐止區,84192,194940,95725,99215
2014/10/1,新北市,瑞芳區,16060,41345,20877,20468
2014/10/1,新北市,土城區,85533,239099,118524,120575
2014/10/1,新北市,蘆洲區,68847,199502,98173,101329
2014/10/1,新北市,五股區,29243,82144,41484,40660
2014/10/1,新北市,泰山區,27623,78236,38980,39256
2014/10/1,新北市,林口區,37585,96920,47483,49437
2014/10/1,新北市,深坑區,9315,23613,11855,11758
2014/10/1,新北市,石碇區,3377,7886,4338,3548
2014/10/1,新北市,坪林區,2471,6412,3580,2832
2014/10/1,新北市,三芝區,9248,23463,12078,11385
2014/10/1,新北市,石門區,4269,12691,6603,6088
2014/10/1,新北市,八里區,13722,37055,18572,18483
2014/10/1,新北市,平溪區,2360,4987,2750,2237
2014/10/1,新北市,雙溪區,3836,9421,5066,4355
2014/10/1,新北市,貢寮區,4444,13148,6740,6408
2014/10/1,新北市,金山區,7003,22354,11076,11278
2014/10/1,新北市,萬里區,7357,22669,11434,11235
2014/10/1,新北市,烏來區,1784,6133,3051,3082
2014/10/1,臺北市,松山區,80102,210267,99368,110899
2014/10/1,臺北市,信義區,89156,229283,110028,119255
2014/10/1,臺北市,大安區,120205,313287,146806,166481
2014/10/1,臺北市,中山區,98288,230102,107502,122600
2014/10/1,臺北市,中正區,65087,163282,78139,85143
2014/10/1,臺北市,大同區,51160,130812,63986,66826
2014/10/1,臺北市,萬華區,78134,194353,96104,98249
2014/10/1,臺北市,文山區,103167,273195,131611,141584
2014/10/1,臺北市,南港區,45792,120921,59090,61831
2014/10/1,臺北市,內湖區,105304,285085,136590,148495
2014/10/1,臺北市,士林區,105547,290041,140363,149678
2014/10/1,臺北市,北投區,95105,257016,124297,132719
2014/10/1,臺中市,中區,7861,19376,9633,9743
2014/10/1,臺中市,東區,27098,74799,37401,37398
2014/10/1,臺中市,南區,45782,119732,57817,61915
2014/10/1,臺中市,西區,44711,115623,55059,60564
2014/10/1,臺中市,北區,58216,147324,70910,76414
2014/10/1,臺中市,西屯區,80353,217820,104939,112881
2014/10/1,臺中市,南屯區,58269,161635,77684,83951
2014/10/1,臺中市,北屯區,91727,258948,124941,134007
2014/10/1,臺中市,豐原區,52175,166409,82438,83971
2014/10/1,臺中市,東勢區,17239,51561,26643,24918
2014/10/1,臺中市,大甲區,22509,77619,39274,38345
2014/10/1,臺中市,清水區,26005,85936,44241,41695
2014/10/1,臺中市,沙鹿區,27000,87449,44394,43055
2014/10/1,臺中市,梧棲區,16790,56484,28447,28037
2014/10/1,臺中市,后里區,15404,54066,27564,26502
2014/10/1,臺中市,神岡區,18666,64854,33264,31590
2014/10/1,臺中市,潭子區,34616,104884,52061,52823
2014/10/1,臺中市,大雅區,27875,92466,46310,46156
2014/10/1,臺中市,新社區,7471,25251,13137,12114
2014/10/1,臺中市,石岡區,4906,15432,8032,7400
2014/10/1,臺中市,外埔區,9288,31787,16338,15449
2014/10/1,臺中市,大安區,5346,19661,10368,9293
2014/10/1,臺中市,烏日區,22531,71340,36022,35318
2014/10/1,臺中市,大肚區,16646,56309,28843,27466
2014/10/1,臺中市,龍井區,21977,75945,38536,37409
2014/10/1,臺中市,霧峰區,19522,64432,32928,31504
2014/10/1,臺中市,太平區,59658,180848,90135,90713
2014/10/1,臺中市,大里區,66472,205835,101627,104208
2014/10/1,臺中市,和平區,4410,10817,5799,5018
2014/10/1,臺南市,新營區,28429,78196,38780,39416
2014/10/1,臺南市,鹽水區,10051,26343,13750,12593
2014/10/1,臺南市,白河區,10996,29826,15614,14212
2014/10/1,臺南市,柳營區,7837,21857,11389,10468
2014/10/1,臺南市,後壁區,8887,24634,12830,11804
2014/10/1,臺南市,東山區,8290,21950,11658,10292
2014/10/1,臺南市,麻豆區,15446,45054,22884,22170
2014/10/1,臺南市,下營區,9121,25134,12955,12179
2014/10/1,臺南市,六甲區,7727,22872,11840,11032
2014/10/1,臺南市,官田區,7786,21746,11126,10620
2014/10/1,臺南市,大內區,3968,10267,5474,4793
2014/10/1,臺南市,佳里區,20254,59534,29557,29977
2014/10/1,臺南市,學甲區,9645,26948,13800,13148
2014/10/1,臺南市,西港區,8038,24899,12627,12272
2014/10/1,臺南市,七股區,8124,23602,12274,11328
2014/10/1,臺南市,將軍區,7346,20601,10476,10125
2014/10/1,臺南市,北門區,4377,11721,5905,5816
2014/10/1,臺南市,新化區,14178,43790,22389,21401
2014/10/1,臺南市,善化區,16223,45942,23239,22703
2014/10/1,臺南市,新市區,11498,35470,17826,17644
2014/10/1,臺南市,安定區,9742,30291,15565,14726
2014/10/1,臺南市,山上區,2696,7512,3928,3584
2014/10/1,臺南市,玉井區,5141,14623,7617,7006
2014/10/1,臺南市,楠西區,3550,10112,5360,4752
2014/10/1,臺南市,南化區,2870,8972,4863,4109
2014/10/1,臺南市,左鎮區,2001,5204,2902,2302
2014/10/1,臺南市,仁德區,26530,73006,37174,35832
2014/10/1,臺南市,歸仁區,21928,67451,34260,33191
2014/10/1,臺南市,關廟區,10895,34872,18037,16835
2014/10/1,臺南市,龍崎區,1576,4299,2332,1967
2014/10/1,臺南市,永康區,81000,228379,112892,115487
2014/10/1,臺南市,東區,71930,190316,91607,98709
2014/10/1,臺南市,南區,44694,125622,62478,63144
2014/10/1,臺南市,北區,49741,132472,64828,67644
2014/10/1,臺南市,安南區,59936,187313,94768,92545
2014/10/1,臺南市,安平區,24495,64793,30884,33909
2014/10/1,臺南市,中西區,30804,77939,37999,39940
2014/10/1,高雄市,鹽埕區,10892,25454,12699,12755
2014/10/1,高雄市,鼓山區,55452,135563,65825,69738
2014/10/1,高雄市,左營區,77058,195529,94859,100670
2014/10/1,高雄市,楠梓區,66034,178356,88114,90242
2014/10/1,高雄市,三民區,134860,347464,168873,178591
2014/10/1,高雄市,新興區,22784,52614,25322,27292
2014/10/1,高雄市,前金區,12557,27825,13398,14427
2014/10/1,高雄市,苓雅區,72205,175977,85116,90861
2014/10/1,高雄市,前鎮區,78022,193989,95867,98122
2014/10/1,高雄市,旗津區,10946,28967,15029,13938
2014/10/1,高雄市,小港區,65893,156037,77812,78225
2014/10/1,高雄市,鳳山區,135298,353586,174284,179302
2014/10/1,高雄市,林園區,25375,70426,35850,34576
2014/10/1,高雄市,大寮區,40841,111073,57214,53859
2014/10/1,高雄市,大樹區,13276,43206,22215,20991
2014/10/1,高雄市,大社區,12629,34372,17535,16837
2014/10/1,高雄市,仁武區,30202,80715,41274,39441
2014/10/1,高雄市,鳥松區,17482,43671,22197,21474
2014/10/1,高雄市,岡山區,34414,97710,48616,49094
2014/10/1,高雄市,橋頭區,13185,37158,18951,18207
2014/10/1,高雄市,燕巢區,10340,30421,16129,14292
2014/10/1,高雄市,田寮區,3416,7697,4270,3427
2014/10/1,高雄市,阿蓮區,9378,29549,14923,14626
2014/10/1,高雄市,路竹區,16643,53000,27087,25913
2014/10/1,高雄市,湖內區,10320,29387,15052,14335
2014/10/1,高雄市,茄萣區,10377,30682,15889,14793
2014/10/1,高雄市,永安區,5821,14161,7117,7044
2014/10/1,高雄市,彌陀區,6714,19911,10291,9620
2014/10/1,高雄市,梓官區,12419,36374,18796,17578
2014/10/1,高雄市,旗山區,13875,38166,19793,18373
2014/10/1,高雄市,美濃區,14476,41358,21620,19738
2014/10/1,高雄市,六龜區,5659,13733,7417,6316
2014/10/1,高雄市,甲仙區,2372,6423,3410,3013
2014/10/1,高雄市,杉林區,4842,12600,6854,5746
2014/10/1,高雄市,內門區,5059,15215,8237,6978
2014/10/1,高雄市,茂林區,583,1909,947,962
2014/10/1,高雄市,桃源區,1312,4290,2258,2032
2014/10/1,高雄市,那瑪夏區,860,3205,1665,1540
2014/10/1,宜蘭縣,宜蘭市,35194,95775,46848,48927
2014/10/1,宜蘭縣,羅東鎮,25793,72486,34601,37885
2014/10/1,宜蘭縣,蘇澳鎮,13965,41095,20953,20142
2014/10/1,宜蘭縣,頭城鎮,10069,29913,15458,14455
2014/10/1,宜蘭縣,礁溪鄉,13301,36014,18798,17216
2014/10/1,宜蘭縣,壯圍鄉,8421,24475,12933,11542
2014/10/1,宜蘭縣,員山鄉,11351,32395,17203,15192
2014/10/1,宜蘭縣,冬山鄉,18554,53547,27511,26036
2014/10/1,宜蘭縣,五結鄉,14049,39356,20367,18989
2014/10/1,宜蘭縣,三星鄉,8138,21431,11555,9876
2014/10/1,宜蘭縣,大同鄉,1889,6147,3332,2815
2014/10/1,宜蘭縣,南澳鄉,1901,6165,3228,2937
2014/10/1,桃園市,桃園區,156085,416655,203615,213040
2014/10/1,桃園市,中壢區,138321,380885,189083,191802
2014/10/1,桃園市,平鎮區,72061,212144,106260,105884
2014/10/1,桃園市,八德區,63485,181078,91530,89548
2014/10/1,桃園市,楊梅區,53567,156960,79647,77313
2014/10/1,桃園市,大溪區,30767,91874,47304,44570
2014/10/1,桃園市,蘆竹區,53979,151108,75548,75560
2014/10/1,桃園市,大園區,29421,84277,43369,40908
2014/10/1,桃園市,龜山區,54285,141676,71287,70389
2014/10/1,桃園市,龍潭區,39180,116137,58688,57449
2014/10/1,桃園市,新屋區,15497,48044,25741,22303
2014/10/1,桃園市,觀音區,20928,63516,33292,30224
2014/10/1,桃園市,復興區,3720,10905,6004,4901
2014/10/1,新竹縣,竹北市,57828,164071,81833,82238
2014/10/1,新竹縣,關西鎮,9542,30792,16401,14391
2014/10/1,新竹縣,新埔鎮,10638,34494,18336,16158
2014/10/1,新竹縣,竹東鎮,32230,95981,48266,47715
2014/10/1,新竹縣,湖口鄉,25181,77119,39212,37907
2014/10/1,新竹縣,橫山鄉,4530,13858,7510,6348
2014/10/1,新竹縣,新豐鄉,17408,55726,28607,27119
2014/10/1,新竹縣,芎林鄉,6451,20300,10749,9551
2014/10/1,新竹縣,寶山鄉,5116,14381,7758,6623
2014/10/1,新竹縣,北埔鄉,3146,9817,5287,4530
2014/10/1,新竹縣,峨眉鄉,2076,5778,3199,2579
2014/10/1,新竹縣,尖石鄉,2829,9481,5036,4445
2014/10/1,新竹縣,五峰鄉,1749,4741,2578,2163
2014/10/1,苗栗縣,苗栗市,30543,90937,45478,45459
2014/10/1,苗栗縣,苑裡鎮,14367,48593,25156,23437
2014/10/1,苗栗縣,通霄鎮,11559,36987,19505,17482
2014/10/1,苗栗縣,竹南鎮,27116,83399,42164,41235
2014/10/1,苗栗縣,頭份市,33008,102456,51753,50703
2014/10/1,苗栗縣,後龍鎮,11907,38499,20245,18254
2014/10/1,苗栗縣,卓蘭鎮,6150,18388,9632,8756
2014/10/1,苗栗縣,大湖鄉,5432,15544,8241,7303
2014/10/1,苗栗縣,公館鄉,10608,34821,18050,16771
2014/10/1,苗栗縣,銅鑼鄉,6131,18948,10055,8893
2014/10/1,苗栗縣,南庄鄉,3978,10685,5866,4819
2014/10/1,苗栗縣,頭屋鄉,3636,11370,5974,5396
2014/10/1,苗栗縣,三義鄉,5476,17270,9036,8234
2014/10/1,苗栗縣,西湖鄉,2692,7598,4214,3384
2014/10/1,苗栗縣,造橋鄉,4136,13467,7066,6401
2014/10/1,苗栗縣,三灣鄉,2429,7150,3892,3258
2014/10/1,苗栗縣,獅潭鄉,1739,4744,2637,2107
2014/10/1,苗栗縣,泰安鄉,1976,6188,3296,2892
2014/10/1,彰化縣,彰化市,74856,235102,116605,118497
2014/10/1,彰化縣,鹿港鎮,23656,86077,43915,42162
2014/10/1,彰化縣,和美鎮,25893,90675,46372,44303
2014/10/1,彰化縣,北斗鎮,10376,33192,16757,16435
2014/10/1,彰化縣,員林市,38308,124775,62435,62340
2014/10/1,彰化縣,溪湖鎮,15932,55738,28377,27361
2014/10/1,彰化縣,田中鎮,12896,42790,22121,20669
2014/10/1,彰化縣,二林鎮,14794,52417,27053,25364
2014/10/1,彰化縣,線西鄉,4295,17137,8876,8261
2014/10/1,彰化縣,伸港鄉,9448,36148,18512,17636
2014/10/1,彰化縣,福興鄉,12491,47807,24918,22889
2014/10/1,彰化縣,秀水鄉,10343,39355,20345,19010
2014/10/1,彰化縣,花壇鄉,13646,45909,23632,22277
2014/10/1,彰化縣,芬園鄉,6887,24188,12734,11454
2014/10/1,彰化縣,大村鄉,10712,36450,18885,17565
2014/10/1,彰化縣,埔鹽鄉,8983,33227,17453,15774
2014/10/1,彰化縣,埔心鄉,10335,34949,18031,16918
2014/10/1,彰化縣,永靖鄉,10788,38268,19902,18366
2014/10/1,彰化縣,社頭鄉,12686,43687,22485,21202
2014/10/1,彰化縣,二水鄉,5340,15848,8317,7531
2014/10/1,彰化縣,田尾鄉,7839,27853,14469,13384
2014/10/1,彰化縣,埤頭鄉,8876,31052,16157,14895
2014/10/1,彰化縣,芳苑鄉,10116,34854,18459,16395
2014/10/1,彰化縣,大城鄉,5341,17876,9699,8177
2014/10/1,彰化縣,竹塘鄉,4627,15923,8380,7543
2014/10/1,彰化縣,溪州鄉,8891,30801,16157,14644
2014/10/1,南投縣,南投市,34295,102311,51334,50977
2014/10/1,南投縣,埔里鎮,28900,83176,41770,41406
2014/10/1,南投縣,草屯鎮,32505,99257,50112,49145
2014/10/1,南投縣,竹山鎮,19950,56778,29166,27612
2014/10/1,南投縣,集集鎮,4377,11431,5986,5445
2014/10/1,南投縣,名間鄉,12525,40033,21025,19008
2014/10/1,南投縣,鹿谷鄉,7501,18542,9837,8705
2014/10/1,南投縣,中寮鄉,5655,15601,8480,7121
2014/10/1,南投縣,魚池鄉,5736,16536,8674,7862
2014/10/1,南投縣,國姓鄉,7294,19774,10703,9071
2014/10/1,南投縣,水里鄉,7242,18756,9837,8919
2014/10/1,南投縣,信義鄉,5238,16839,9043,7796
2014/10/1,南投縣,仁愛鄉,4936,15860,8188,7672
2014/10/1,雲林縣,斗六市,36998,108061,54022,54039
2014/10/1,雲林縣,斗南鎮,15716,46028,23398,22630
2014/10/1,雲林縣,虎尾鎮,23955,70293,35659,34634
2014/10/1,雲林縣,西螺鎮,14407,47205,23991,23214
2014/10/1,雲林縣,土庫鎮,9206,29766,15545,14221
2014/10/1,雲林縣,北港鎮,15992,41661,21647,20014
2014/10/1,雲林縣,古坑鄉,10929,32734,17271,15463
2014/10/1,雲林縣,大埤鄉,6758,20033,10758,9275
2014/10/1,雲林縣,莿桐鄉,9281,29687,15565,14122
2014/10/1,雲林縣,林內鄉,5897,19058,9975,9083
2014/10/1,雲林縣,二崙鄉,8919,28385,15186,13199
2014/10/1,雲林縣,崙背鄉,8519,25989,13722,12267
2014/10/1,雲林縣,麥寮鄉,13792,43708,22201,21507
2014/10/1,雲林縣,東勢鄉,5816,15974,8741,7233
2014/10/1,雲林縣,褒忠鄉,4409,13659,7329,6330
2014/10/1,雲林縣,臺西鄉,8805,25046,13464,11582
2014/10/1,雲林縣,元長鄉,9444,27421,14951,12470
2014/10/1,雲林縣,四湖鄉,9009,25630,13884,11746
2014/10/1,雲林縣,口湖鄉,9641,29167,15457,13710
2014/10/1,雲林縣,水林鄉,10265,27129,14868,12261
2014/10/1,嘉義縣,太保市,12122,37037,19094,17943
2014/10/1,嘉義縣,朴子市,15350,43233,21904,21329
2014/10/1,嘉義縣,布袋鎮,10122,28496,14609,13887
2014/10/1,嘉義縣,大林鎮,11389,32237,16523,15714
2014/10/1,嘉義縣,民雄鄉,24011,71927,36836,35091
2014/10/1,嘉義縣,溪口鄉,5442,15484,8262,7222
2014/10/1,嘉義縣,新港鄉,10582,33278,17605,15673
2014/10/1,嘉義縣,六腳鄉,9041,24695,13091,11604
2014/10/1,嘉義縣,東石鄉,9457,26337,13985,12352
2014/10/1,嘉義縣,義竹鄉,7542,19644,10214,9430
2014/10/1,嘉義縣,鹿草鄉,5823,16453,8794,7659
2014/10/1,嘉義縣,水上鄉,17848,50815,26219,24596
2014/10/1,嘉義縣,中埔鄉,15936,46198,24060,22138
2014/10/1,嘉義縣,竹崎鄉,11589,37022,19747,17275
2014/10/1,嘉義縣,梅山鄉,6769,20352,10810,9542
2014/10/1,嘉義縣,番路鄉,4310,12139,6569,5570
2014/10/1,嘉義縣,大埔鄉,1953,4658,2425,2233
2014/10/1,嘉義縣,阿里山鄉,1952,5770,3059,2711
2014/10/1,屏東縣,屏東市,73374,204012,101393,102619
2014/10/1,屏東縣,潮州鎮,18972,54781,27479,27302
2014/10/1,屏東縣,東港鎮,16244,48357,24461,23896
2014/10/1,屏東縣,恆春鎮,11187,30795,15748,15047
2014/10/1,屏東縣,萬丹鄉,14706,52158,26986,25172
2014/10/1,屏東縣,長治鄉,9952,30467,15914,14553
2014/10/1,屏東縣,麟洛鄉,3723,11331,5856,5475
2014/10/1,屏東縣,九如鄉,6768,22219,11485,10734
2014/10/1,屏東縣,里港鄉,8104,26760,13591,13169
2014/10/1,屏東縣,鹽埔鄉,7843,26674,13842,12832
2014/10/1,屏東縣,高樹鄉,9422,25623,13648,11975
2014/10/1,屏東縣,萬巒鄉,6450,20956,11005,9951
2014/10/1,屏東縣,內埔鄉,18409,56252,29174,27078
2014/10/1,屏東縣,竹田鄉,5632,17741,9415,8326
2014/10/1,屏東縣,新埤鄉,3445,10290,5456,4834
2014/10/1,屏東縣,枋寮鄉,8571,25546,13368,12178
2014/10/1,屏東縣,新園鄉,11735,36758,19051,17707
2014/10/1,屏東縣,崁頂鄉,4413,16332,8312,8020
2014/10/1,屏東縣,林邊鄉,7025,19292,9932,9360
2014/10/1,屏東縣,南州鄉,3669,11054,5650,5404
2014/10/1,屏東縣,佳冬鄉,7045,20304,10565,9739
2014/10/1,屏東縣,琉球鄉,4262,12689,6993,5696
2014/10/1,屏東縣,車城鄉,3501,9176,4931,4245
2014/10/1,屏東縣,滿州鄉,3036,8188,4479,3709
2014/10/1,屏東縣,枋山鄉,2137,5762,3061,2701
2014/10/1,屏東縣,三地門鄉,2285,7820,3954,3866
2014/10/1,屏東縣,霧臺鄉,1047,3464,1765,1699
2014/10/1,屏東縣,瑪家鄉,1959,6720,3445,3275
2014/10/1,屏東縣,泰武鄉,1284,5306,2774,2532
2014/10/1,屏東縣,來義鄉,2222,7641,3889,3752
2014/10/1,屏東縣,春日鄉,1345,4871,2503,2368
2014/10/1,屏東縣,獅子鄉,1505,4899,2525,2374
2014/10/1,屏東縣,牡丹鄉,1863,4875,2509,2366
2014/10/1,臺東縣,臺東市,38977,106951,53804,53147
2014/10/1,臺東縣,成功鎮,5460,14993,7933,7060
2014/10/1,臺東縣,關山鎮,3243,9167,4823,4344
2014/10/1,臺東縣,卑南鄉,6642,17728,9459,8269
2014/10/1,臺東縣,大武鄉,2525,6615,3437,3178
2014/10/1,臺東縣,太麻里鄉,4606,11503,6102,5401
2014/10/1,臺東縣,東河鄉,3754,9048,4990,4058
2014/10/1,臺東縣,長濱鄉,2942,7781,4414,3367
2014/10/1,臺東縣,鹿野鄉,3099,8208,4417,3791
2014/10/1,臺東縣,池上鄉,3260,8613,4518,4095
2014/10/1,臺東縣,綠島鄉,1101,3824,2013,1811
2014/10/1,臺東縣,延平鄉,1070,3617,1951,1666
2014/10/1,臺東縣,海端鄉,1094,4379,2349,2030
2014/10/1,臺東縣,達仁鄉,1465,3746,2037,1709
2014/10/1,臺東縣,金峰鄉,1111,3666,1894,1772
2014/10/1,臺東縣,蘭嶼鄉,1733,4968,2522,2446
2014/10/1,花蓮縣,花蓮市,41208,106282,51652,54630
2014/10/1,花蓮縣,鳳林鎮,4428,11281,5923,5358
2014/10/1,花蓮縣,玉里鎮,8925,25451,13630,11821
2014/10/1,花蓮縣,新城鄉,7529,20261,10465,9796
2014/10/1,花蓮縣,吉安鄉,30998,82440,41860,40580
2014/10/1,花蓮縣,壽豐鄉,6997,18252,9767,8485
2014/10/1,花蓮縣,光復鄉,5052,13413,7143,6270
2014/10/1,花蓮縣,豐濱鄉,1750,4752,2627,2125
2014/10/1,花蓮縣,瑞穗鄉,4661,12167,6533,5634
2014/10/1,花蓮縣,富里鄉,3998,10894,5935,4959
2014/10/1,花蓮縣,秀林鄉,4777,15479,8003,7476
2014/10/1,花蓮縣,萬榮鄉,2086,6512,3445,3067
2014/10/1,花蓮縣,卓溪鄉,1677,6229,3410,2819
2014/10/1,澎湖縣,馬公市,22961,60157,30587,29570
2014/10/1,澎湖縣,湖西鄉,5299,14264,7528,6736
2014/10/1,澎湖縣,白沙鄉,3335,9772,5117,4655
2014/10/1,澎湖縣,西嶼鄉,2932,8457,4335,4122
2014/10/1,澎湖縣,望安鄉,1987,5125,2749,2376
2014/10/1,澎湖縣,七美鄉,1326,3773,1970,1803
2014/10/1,基隆市,中正區,22488,53193,27261,25932
2014/10/1,基隆市,七堵區,20919,53966,27309,26657
2014/10/1,基隆市,暖暖區,15212,38222,19300,18922
2014/10/1,基隆市,仁愛區,19501,46412,22890,23522
2014/10/1,基隆市,中山區,19315,48743,24819,23924
2014/10/1,基隆市,安樂區,32267,81651,40654,40997
2014/10/1,基隆市,信義區,20896,51276,25583,25693
2014/10/1,新竹市,東區,74950,206487,101770,104717
2014/10/1,新竹市,北區,54265,148586,72950,75636
2014/10/1,新竹市,香山區,25665,76263,38874,37389
2014/10/1,嘉義市,東區,45142,123430,59909,63521
2014/10/1,嘉義市,西區,53050,147349,72495,74854
2014/10/1,金門縣,金城鎮,12418,40645,20405,20240
2014/10/1,金門縣,金湖鎮,8289,27156,13713,13443
2014/10/1,金門縣,金沙鎮,6025,19340,9576,9764
2014/10/1,金門縣,金寧鄉,7601,26932,13616,13316
2014/10/1,金門縣,烈嶼鄉,2998,11819,5843,5976
2014/10/1,金門縣,烏坵鄉,134,670,336,334
2014/10/1,連江縣,南竿鄉,1421,7521,4299,3222
2014/10/1,連江縣,北竿鄉,475,2323,1275,1048
2014/10/1,連江縣,莒光鄉,268,1418,822,596
2014/10/1,連江縣,東引鄉,299,1250,750,500
2014/11/1,總計,新北市,1495585,3963970,1950837,2013133
2014/11/1,總計,臺北市,1037206,2700091,1294867,1405224
2014/11/1,總計,臺中市,910860,2716497,1345534,1370963
2014/11/1,總計,臺南市,667662,1883844,943962,939882
2014/11/1,總計,高雄市,1063946,2778155,1382820,1395335
2014/11/1,總計,臺灣省,3160266,9242566,4706281,4536285
2014/11/1,總計,宜蘭縣,162682,458880,232812,226068
2014/11/1,總計,桃園市,731638,2056273,1031770,1024503
2014/11/1,總計,新竹縣,178750,536954,274922,262032
2014/11/1,總計,苗栗縣,182899,567202,292308,274894
2014/11/1,總計,彰化縣,378437,1292226,661134,631092
2014/11/1,總計,南投縣,176144,514836,264169,250667
2014/11/1,總計,雲林縣,237637,706174,367337,338837
2014/11/1,總計,嘉義縣,181216,525579,273682,251897
2014/11/1,總計,屏東縣,283135,848804,434958,413846
2014/11/1,總計,臺東縣,82039,224719,116570,108149
2014/11/1,總計,花蓮縣,124153,333484,170419,163065
2014/11/1,總計,澎湖縣,37857,101636,52327,49309
2014/11/1,總計,基隆市,150552,373340,187757,185583
2014/11/1,總計,新竹市,154920,431601,213683,217918
2014/11/1,總計,嘉義市,98207,270858,132433,138425
2014/11/1,總計,福建省,39952,139492,70843,68649
2014/11/1,總計,金門縣,37491,126964,63681,63283
2014/11/1,總計,連江縣,2461,12528,7162,5366
2014/11/1,新北市,板橋區,204899,555938,272359,283579
2014/11/1,新北市,三重區,147285,389311,192477,196834
2014/11/1,新北市,中和區,162312,415199,203009,212190
2014/11/1,新北市,永和區,90731,227309,108271,119038
2014/11/1,新北市,新莊區,146830,411312,201810,209502
2014/11/1,新北市,新店區,122737,299460,145025,154435
2014/11/1,新北市,樹林區,65011,183924,92045,91879
2014/11/1,新北市,鶯歌區,29177,89021,44554,44467
2014/11/1,新北市,三峽區,40277,111416,56210,55206
2014/11/1,新北市,淡水區,67998,158471,76416,82055
2014/11/1,新北市,汐止區,84158,194918,95682,99236
2014/11/1,新北市,瑞芳區,16054,41316,20859,20457
2014/11/1,新北市,土城區,85514,239206,118581,120625
2014/11/1,新北市,蘆洲區,68864,199645,98256,101389
2014/11/1,新北市,五股區,29242,82148,41496,40652
2014/11/1,新北市,泰山區,27652,78303,39015,39288
2014/11/1,新北市,林口區,37634,97123,47602,49521
2014/11/1,新北市,深坑區,9324,23612,11857,11755
2014/11/1,新北市,石碇區,3372,7883,4331,3552
2014/11/1,新北市,坪林區,2471,6418,3586,2832
2014/11/1,新北市,三芝區,9259,23472,12079,11393
2014/11/1,新北市,石門區,4272,12708,6611,6097
2014/11/1,新北市,八里區,13729,37092,18577,18515
2014/11/1,新北市,平溪區,2359,4977,2740,2237
2014/11/1,新北市,雙溪區,3836,9426,5065,4361
2014/11/1,新北市,貢寮區,4440,13147,6737,6410
2014/11/1,新北市,金山區,7002,22376,11087,11289
2014/11/1,新北市,萬里區,7358,22684,11437,11247
2014/11/1,新北市,烏來區,1788,6155,3063,3092
2014/11/1,臺北市,松山區,80117,210482,99452,111030
2014/11/1,臺北市,信義區,89163,229452,110064,119388
2014/11/1,臺北市,大安區,120196,313487,146837,166650
2014/11/1,臺北市,中山區,98288,230272,107598,122674
2014/11/1,臺北市,中正區,65112,163477,78232,85245
2014/11/1,臺北市,大同區,51178,130961,64054,66907
2014/11/1,臺北市,萬華區,78132,194479,96135,98344
2014/11/1,臺北市,文山區,103224,273481,131747,141734
2014/11/1,臺北市,南港區,45813,121031,59134,61897
2014/11/1,臺北市,內湖區,105330,285406,136728,148678
2014/11/1,臺北市,士林區,105554,290296,140469,149827
2014/11/1,臺北市,北投區,95099,257267,124417,132850
2014/11/1,臺中市,中區,7865,19387,9633,9754
2014/11/1,臺中市,東區,27088,74849,37423,37426
2014/11/1,臺中市,南區,45808,119826,57843,61983
2014/11/1,臺中市,西區,44708,115661,55083,60578
2014/11/1,臺中市,北區,58249,147433,70960,76473
2014/11/1,臺中市,西屯區,80406,218009,104961,113048
2014/11/1,臺中市,南屯區,58274,161713,77708,84005
2014/11/1,臺中市,北屯區,91708,259105,125018,134087
2014/11/1,臺中市,豐原區,52169,166455,82461,83994
2014/11/1,臺中市,東勢區,17231,51515,26617,24898
2014/11/1,臺中市,大甲區,22509,77629,39273,38356
2014/11/1,臺中市,清水區,26011,85977,44252,41725
2014/11/1,臺中市,沙鹿區,27012,87538,44441,43097
2014/11/1,臺中市,梧棲區,16808,56527,28470,28057
2014/11/1,臺中市,后里區,15409,54090,27580,26510
2014/11/1,臺中市,神岡區,18672,64914,33270,31644
2014/11/1,臺中市,潭子區,34632,104946,52089,52857
2014/11/1,臺中市,大雅區,27892,92561,46355,46206
2014/11/1,臺中市,新社區,7479,25257,13152,12105
2014/11/1,臺中市,石岡區,4907,15434,8030,7404
2014/11/1,臺中市,外埔區,9291,31800,16350,15450
2014/11/1,臺中市,大安區,5346,19673,10371,9302
2014/11/1,臺中市,烏日區,22557,71395,36043,35352
2014/11/1,臺中市,大肚區,16654,56362,28875,27487
2014/11/1,臺中市,龍井區,21985,76016,38567,37449
2014/11/1,臺中市,霧峰區,19531,64440,32918,31522
2014/11/1,臺中市,太平區,59768,181140,90277,90863
2014/11/1,臺中市,大里區,66482,206018,101711,104307
2014/11/1,臺中市,和平區,4409,10827,5803,5024
2014/11/1,臺南市,新營區,28416,78206,38796,39410
2014/11/1,臺南市,鹽水區,10050,26325,13740,12585
2014/11/1,臺南市,白河區,10988,29789,15601,14188
2014/11/1,臺南市,柳營區,7837,21844,11382,10462
2014/11/1,臺南市,後壁區,8889,24636,12833,11803
2014/11/1,臺南市,東山區,8284,21942,11646,10296
2014/11/1,臺南市,麻豆區,15435,45052,22878,22174
2014/11/1,臺南市,下營區,9116,25107,12938,12169
2014/11/1,臺南市,六甲區,7730,22859,11835,11024
2014/11/1,臺南市,官田區,7784,21744,11123,10621
2014/11/1,臺南市,大內區,3970,10268,5477,4791
2014/11/1,臺南市,佳里區,20262,59532,29548,29984
2014/11/1,臺南市,學甲區,9638,26938,13788,13150
2014/11/1,臺南市,西港區,8045,24913,12629,12284
2014/11/1,臺南市,七股區,8120,23613,12287,11326
2014/11/1,臺南市,將軍區,7345,20600,10476,10124
2014/11/1,臺南市,北門區,4375,11709,5902,5807
2014/11/1,臺南市,新化區,14191,43795,22390,21405
2014/11/1,臺南市,善化區,16237,45998,23260,22738
2014/11/1,臺南市,新市區,11491,35455,17819,17636
2014/11/1,臺南市,安定區,9752,30289,15566,14723
2014/11/1,臺南市,山上區,2687,7497,3918,3579
2014/11/1,臺南市,玉井區,5130,14605,7610,6995
2014/11/1,臺南市,楠西區,3546,10119,5361,4758
2014/11/1,臺南市,南化區,2870,8983,4868,4115
2014/11/1,臺南市,左鎮區,1995,5190,2891,2299
2014/11/1,臺南市,仁德區,26527,73072,37213,35859
2014/11/1,臺南市,歸仁區,21922,67456,34254,33202
2014/11/1,臺南市,關廟區,10891,34874,18034,16840
2014/11/1,臺南市,龍崎區,1576,4296,2329,1967
2014/11/1,臺南市,永康區,80999,228500,112949,115551
2014/11/1,臺南市,東區,71860,190236,91572,98664
2014/11/1,臺南市,南區,44682,125641,62474,63167
2014/11/1,臺南市,北區,49732,132561,64869,67692
2014/11/1,臺南市,安南區,59971,187438,94816,92622
2014/11/1,臺南市,安平區,24517,64823,30893,33930
2014/11/1,臺南市,中西區,30802,77939,37997,39942
2014/11/1,高雄市,鹽埕區,10885,25450,12692,12758
2014/11/1,高雄市,鼓山區,55446,135592,65840,69752
2014/11/1,高雄市,左營區,77044,195554,94873,100681
2014/11/1,高雄市,楠梓區,66065,178448,88159,90289
2014/11/1,高雄市,三民區,134850,347477,168858,178619
2014/11/1,高雄市,新興區,22774,52613,25320,27293
2014/11/1,高雄市,前金區,12551,27817,13396,14421
2014/11/1,高雄市,苓雅區,72196,175963,85118,90845
2014/11/1,高雄市,前鎮區,78036,193933,95801,98132
2014/11/1,高雄市,旗津區,10944,28957,15018,13939
2014/11/1,高雄市,小港區,65905,156075,77839,78236
2014/11/1,高雄市,鳳山區,135301,353790,174340,179450
2014/11/1,高雄市,林園區,25391,70478,35870,34608
2014/11/1,高雄市,大寮區,40834,111059,57211,53848
2014/11/1,高雄市,大樹區,13278,43210,22215,20995
2014/11/1,高雄市,大社區,12648,34399,17554,16845
2014/11/1,高雄市,仁武區,30249,80773,41285,39488
2014/11/1,高雄市,鳥松區,17486,43711,22206,21505
2014/11/1,高雄市,岡山區,34414,97730,48637,49093
2014/11/1,高雄市,橋頭區,13185,37173,18951,18222
2014/11/1,高雄市,燕巢區,10337,30392,16106,14286
2014/11/1,高雄市,田寮區,3412,7694,4263,3431
2014/11/1,高雄市,阿蓮區,9384,29558,14923,14635
2014/11/1,高雄市,路竹區,16661,53020,27101,25919
2014/11/1,高雄市,湖內區,10319,29382,15046,14336
2014/11/1,高雄市,茄萣區,10379,30672,15878,14794
2014/11/1,高雄市,永安區,5816,14149,7108,7041
2014/11/1,高雄市,彌陀區,6716,19906,10289,9617
2014/11/1,高雄市,梓官區,12421,36378,18782,17596
2014/11/1,高雄市,旗山區,13864,38143,19776,18367
2014/11/1,高雄市,美濃區,14470,41325,21609,19716
2014/11/1,高雄市,六龜區,5659,13702,7402,6300
2014/11/1,高雄市,甲仙區,2370,6436,3409,3027
2014/11/1,高雄市,杉林區,4838,12579,6840,5739
2014/11/1,高雄市,內門區,5058,15204,8233,6971
2014/11/1,高雄市,茂林區,584,1913,949,964
2014/11/1,高雄市,桃源區,1315,4298,2261,2037
2014/11/1,高雄市,那瑪夏區,861,3202,1662,1540
2014/11/1,宜蘭縣,宜蘭市,35193,95801,46859,48942
2014/11/1,宜蘭縣,羅東鎮,25806,72517,34583,37934
2014/11/1,宜蘭縣,蘇澳鎮,13976,41104,20966,20138
2014/11/1,宜蘭縣,頭城鎮,10071,29919,15458,14461
2014/11/1,宜蘭縣,礁溪鄉,13308,36015,18797,17218
2014/11/1,宜蘭縣,壯圍鄉,8429,24484,12935,11549
2014/11/1,宜蘭縣,員山鄉,11346,32384,17192,15192
2014/11/1,宜蘭縣,冬山鄉,18560,53512,27514,25998
2014/11/1,宜蘭縣,五結鄉,14060,39373,20384,18989
2014/11/1,宜蘭縣,三星鄉,8147,21455,11563,9892
2014/11/1,宜蘭縣,大同鄉,1888,6155,3329,2826
2014/11/1,宜蘭縣,南澳鄉,1898,6161,3232,2929
2014/11/1,桃園市,桃園區,156110,416825,203678,213147
2014/11/1,桃園市,中壢區,138386,381104,189164,191940
2014/11/1,桃園市,平鎮區,72057,212195,106255,105940
2014/11/1,桃園市,八德區,63497,181172,91588,89584
2014/11/1,桃園市,楊梅區,53617,157072,79703,77369
2014/11/1,桃園市,大溪區,30763,91822,47267,44555
2014/11/1,桃園市,蘆竹區,54010,151255,75604,75651
2014/11/1,桃園市,大園區,29493,84337,43392,40945
2014/11/1,桃園市,龜山區,54332,141814,71353,70461
2014/11/1,桃園市,龍潭區,39183,116133,58697,57436
2014/11/1,桃園市,新屋區,15515,48057,25747,22310
2014/11/1,桃園市,觀音區,20953,63562,33312,30250
2014/11/1,桃園市,復興區,3722,10925,6010,4915
2014/11/1,新竹縣,竹北市,57896,164424,81997,82427
2014/11/1,新竹縣,關西鎮,9536,30799,16398,14401
2014/11/1,新竹縣,新埔鎮,10630,34472,18320,16152
2014/11/1,新竹縣,竹東鎮,32224,95987,48266,47721
2014/11/1,新竹縣,湖口鄉,25164,77147,39211,37936
2014/11/1,新竹縣,橫山鄉,4532,13859,7506,6353
2014/11/1,新竹縣,新豐鄉,17412,55748,28613,27135
2014/11/1,新竹縣,芎林鄉,6447,20296,10748,9548
2014/11/1,新竹縣,寶山鄉,5113,14388,7760,6628
2014/11/1,新竹縣,北埔鄉,3143,9816,5287,4529
2014/11/1,新竹縣,峨眉鄉,2075,5773,3193,2580
2014/11/1,新竹縣,尖石鄉,2828,9497,5044,4453
2014/11/1,新竹縣,五峰鄉,1750,4748,2579,2169
2014/11/1,苗栗縣,苗栗市,30530,90940,45462,45478
2014/11/1,苗栗縣,苑裡鎮,14379,48597,25161,23436
2014/11/1,苗栗縣,通霄鎮,11569,36984,19495,17489
2014/11/1,苗栗縣,竹南鎮,27136,83493,42189,41304
2014/11/1,苗栗縣,頭份市,33006,102496,51783,50713
2014/11/1,苗栗縣,後龍鎮,11894,38484,20235,18249
2014/11/1,苗栗縣,卓蘭鎮,6149,18386,9632,8754
2014/11/1,苗栗縣,大湖鄉,5432,15548,8241,7307
2014/11/1,苗栗縣,公館鄉,10613,34844,18073,16771
2014/11/1,苗栗縣,銅鑼鄉,6131,18942,10051,8891
2014/11/1,苗栗縣,南庄鄉,3980,10693,5863,4830
2014/11/1,苗栗縣,頭屋鄉,3636,11374,5979,5395
2014/11/1,苗栗縣,三義鄉,5475,17285,9049,8236
2014/11/1,苗栗縣,西湖鄉,2692,7597,4215,3382
2014/11/1,苗栗縣,造橋鄉,4137,13468,7061,6407
2014/11/1,苗栗縣,三灣鄉,2428,7151,3894,3257
2014/11/1,苗栗縣,獅潭鄉,1738,4738,2632,2106
2014/11/1,苗栗縣,泰安鄉,1974,6182,3293,2889
2014/11/1,彰化縣,彰化市,74867,235197,116652,118545
2014/11/1,彰化縣,鹿港鎮,23677,86109,43925,42184
2014/11/1,彰化縣,和美鎮,25897,90701,46396,44305
2014/11/1,彰化縣,北斗鎮,10387,33186,16759,16427
2014/11/1,彰化縣,員林市,38320,124777,62426,62351
2014/11/1,彰化縣,溪湖鎮,15936,55759,28386,27373
2014/11/1,彰化縣,田中鎮,12899,42792,22126,20666
2014/11/1,彰化縣,二林鎮,14797,52416,27064,25352
2014/11/1,彰化縣,線西鄉,4300,17157,8884,8273
2014/11/1,彰化縣,伸港鄉,9448,36163,18519,17644
2014/11/1,彰化縣,福興鄉,12491,47831,24931,22900
2014/11/1,彰化縣,秀水鄉,10345,39361,20356,19005
2014/11/1,彰化縣,花壇鄉,13652,45913,23633,22280
2014/11/1,彰化縣,芬園鄉,6889,24194,12734,11460
2014/11/1,彰化縣,大村鄉,10727,36485,18917,17568
2014/11/1,彰化縣,埔鹽鄉,8977,33222,17442,15780
2014/11/1,彰化縣,埔心鄉,10338,34943,18032,16911
2014/11/1,彰化縣,永靖鄉,10783,38230,19894,18336
2014/11/1,彰化縣,社頭鄉,12696,43686,22491,21195
2014/11/1,彰化縣,二水鄉,5336,15834,8304,7530
2014/11/1,彰化縣,田尾鄉,7842,27846,14457,13389
2014/11/1,彰化縣,埤頭鄉,8872,31037,16145,14892
2014/11/1,彰化縣,芳苑鄉,10117,34839,18453,16386
2014/11/1,彰化縣,大城鄉,5338,17849,9678,8171
2014/11/1,彰化縣,竹塘鄉,4619,15902,8374,7528
2014/11/1,彰化縣,溪州鄉,8887,30797,16156,14641
2014/11/1,南投縣,南投市,34262,102313,51336,50977
2014/11/1,南投縣,埔里鎮,28882,83134,41754,41380
2014/11/1,南投縣,草屯鎮,32521,99261,50127,49134
2014/11/1,南投縣,竹山鎮,19954,56760,29167,27593
2014/11/1,南投縣,集集鎮,4379,11440,5991,5449
2014/11/1,南投縣,名間鄉,12533,40037,21029,19008
2014/11/1,南投縣,鹿谷鄉,7511,18544,9841,8703
2014/11/1,南投縣,中寮鄉,5652,15594,8480,7114
2014/11/1,南投縣,魚池鄉,5741,16542,8679,7863
2014/11/1,南投縣,國姓鄉,7297,19763,10698,9065
2014/11/1,南投縣,水里鄉,7236,18742,9836,8906
2014/11/1,南投縣,信義鄉,5242,16849,9049,7800
2014/11/1,南投縣,仁愛鄉,4934,15857,8182,7675
2014/11/1,雲林縣,斗六市,36989,108082,54013,54069
2014/11/1,雲林縣,斗南鎮,15699,46006,23376,22630
2014/11/1,雲林縣,虎尾鎮,23938,70311,35676,34635
2014/11/1,雲林縣,西螺鎮,14410,47181,23981,23200
2014/11/1,雲林縣,土庫鎮,9203,29749,15531,14218
2014/11/1,雲林縣,北港鎮,15968,41616,21631,19985
2014/11/1,雲林縣,古坑鄉,10924,32691,17249,15442
2014/11/1,雲林縣,大埤鄉,6752,20011,10747,9264
2014/11/1,雲林縣,莿桐鄉,9271,29657,15560,14097
2014/11/1,雲林縣,林內鄉,5901,19009,9939,9070
2014/11/1,雲林縣,二崙鄉,8918,28358,15167,13191
2014/11/1,雲林縣,崙背鄉,8506,25952,13702,12250
2014/11/1,雲林縣,麥寮鄉,13797,43698,22162,21536
2014/11/1,雲林縣,東勢鄉,5810,15945,8723,7222
2014/11/1,雲林縣,褒忠鄉,4411,13654,7326,6328
2014/11/1,雲林縣,臺西鄉,8797,25035,13457,11578
2014/11/1,雲林縣,元長鄉,9437,27405,14944,12461
2014/11/1,雲林縣,四湖鄉,9013,25580,13858,11722
2014/11/1,雲林縣,口湖鄉,9638,29136,15442,13694
2014/11/1,雲林縣,水林鄉,10255,27098,14853,12245
2014/11/1,嘉義縣,太保市,12124,37028,19079,17949
2014/11/1,嘉義縣,朴子市,15371,43218,21894,21324
2014/11/1,嘉義縣,布袋鎮,10116,28476,14594,13882
2014/11/1,嘉義縣,大林鎮,11387,32205,16499,15706
2014/11/1,嘉義縣,民雄鄉,24004,71918,36838,35080
2014/11/1,嘉義縣,溪口鄉,5440,15480,8260,7220
2014/11/1,嘉義縣,新港鄉,10586,33268,17610,15658
2014/11/1,嘉義縣,六腳鄉,9032,24691,13078,11613
2014/11/1,嘉義縣,東石鄉,9450,26345,13983,12362
2014/11/1,嘉義縣,義竹鄉,7547,19645,10213,9432
2014/11/1,嘉義縣,鹿草鄉,5824,16433,8793,7640
2014/11/1,嘉義縣,水上鄉,17844,50789,26202,24587
2014/11/1,嘉義縣,中埔鄉,15932,46188,24052,22136
2014/11/1,嘉義縣,竹崎鄉,11583,36974,19730,17244
2014/11/1,嘉義縣,梅山鄉,6767,20349,10804,9545
2014/11/1,嘉義縣,番路鄉,4308,12140,6567,5573
2014/11/1,嘉義縣,大埔鄉,1950,4656,2426,2230
2014/11/1,嘉義縣,阿里山鄉,1951,5776,3060,2716
2014/11/1,屏東縣,屏東市,73393,203947,101343,102604
2014/11/1,屏東縣,潮州鎮,18962,54748,27469,27279
2014/11/1,屏東縣,東港鎮,16238,48323,24444,23879
2014/11/1,屏東縣,恆春鎮,11190,30804,15742,15062
2014/11/1,屏東縣,萬丹鄉,14704,52136,26975,25161
2014/11/1,屏東縣,長治鄉,9954,30441,15904,14537
2014/11/1,屏東縣,麟洛鄉,3725,11326,5855,5471
2014/11/1,屏東縣,九如鄉,6769,22204,11478,10726
2014/11/1,屏東縣,里港鄉,8099,26785,13605,13180
2014/11/1,屏東縣,鹽埔鄉,7844,26669,13840,12829
2014/11/1,屏東縣,高樹鄉,9424,25601,13639,11962
2014/11/1,屏東縣,萬巒鄉,6446,20929,10986,9943
2014/11/1,屏東縣,內埔鄉,18400,56226,29155,27071
2014/11/1,屏東縣,竹田鄉,5630,17732,9409,8323
2014/11/1,屏東縣,新埤鄉,3447,10283,5451,4832
2014/11/1,屏東縣,枋寮鄉,8575,25527,13361,12166
2014/11/1,屏東縣,新園鄉,11743,36768,19050,17718
2014/11/1,屏東縣,崁頂鄉,4414,16358,8325,8033
2014/11/1,屏東縣,林邊鄉,7017,19268,9916,9352
2014/11/1,屏東縣,南州鄉,3669,11049,5652,5397
2014/11/1,屏東縣,佳冬鄉,7042,20284,10549,9735
2014/11/1,屏東縣,琉球鄉,4267,12681,6981,5700
2014/11/1,屏東縣,車城鄉,3500,9172,4926,4246
2014/11/1,屏東縣,滿州鄉,3034,8180,4476,3704
2014/11/1,屏東縣,枋山鄉,2139,5766,3060,2706
2014/11/1,屏東縣,三地門鄉,2284,7822,3950,3872
2014/11/1,屏東縣,霧臺鄉,1047,3462,1764,1698
2014/11/1,屏東縣,瑪家鄉,1958,6723,3451,3272
2014/11/1,屏東縣,泰武鄉,1289,5309,2775,2534
2014/11/1,屏東縣,來義鄉,2222,7643,3894,3749
2014/11/1,屏東縣,春日鄉,1344,4862,2498,2364
2014/11/1,屏東縣,獅子鄉,1504,4899,2525,2374
2014/11/1,屏東縣,牡丹鄉,1862,4877,2510,2367
2014/11/1,臺東縣,臺東市,38956,106933,53774,53159
2014/11/1,臺東縣,成功鎮,5455,14962,7917,7045
2014/11/1,臺東縣,關山鎮,3242,9156,4814,4342
2014/11/1,臺東縣,卑南鄉,6639,17701,9429,8272
2014/11/1,臺東縣,大武鄉,2524,6608,3431,3177
2014/11/1,臺東縣,太麻里鄉,4604,11506,6108,5398
2014/11/1,臺東縣,東河鄉,3750,9031,4979,4052
2014/11/1,臺東縣,長濱鄉,2937,7776,4408,3368
2014/11/1,臺東縣,鹿野鄉,3100,8216,4415,3801
2014/11/1,臺東縣,池上鄉,3259,8608,4520,4088
2014/11/1,臺東縣,綠島鄉,1100,3823,2014,1809
2014/11/1,臺東縣,延平鄉,1068,3614,1952,1662
2014/11/1,臺東縣,海端鄉,1093,4383,2349,2034
2014/11/1,臺東縣,達仁鄉,1466,3750,2035,1715
2014/11/1,臺東縣,金峰鄉,1111,3676,1899,1777
2014/11/1,臺東縣,蘭嶼鄉,1735,4976,2526,2450
2014/11/1,花蓮縣,花蓮市,41247,106335,51674,54661
2014/11/1,花蓮縣,鳳林鎮,4427,11271,5925,5346
2014/11/1,花蓮縣,玉里鎮,8925,25442,13614,11828
2014/11/1,花蓮縣,新城鄉,7536,20274,10471,9803
2014/11/1,花蓮縣,吉安鄉,31021,82444,41865,40579
2014/11/1,花蓮縣,壽豐鄉,7003,18256,9768,8488
2014/11/1,花蓮縣,光復鄉,5052,13417,7146,6271
2014/11/1,花蓮縣,豐濱鄉,1746,4744,2622,2122
2014/11/1,花蓮縣,瑞穗鄉,4661,12172,6536,5636
2014/11/1,花蓮縣,富里鄉,3993,10871,5922,4949
2014/11/1,花蓮縣,秀林鄉,4777,15499,8015,7484
2014/11/1,花蓮縣,萬榮鄉,2086,6524,3447,3077
2014/11/1,花蓮縣,卓溪鄉,1679,6235,3414,2821
2014/11/1,澎湖縣,馬公市,22978,60216,30610,29606
2014/11/1,澎湖縣,湖西鄉,5304,14274,7543,6731
2014/11/1,澎湖縣,白沙鄉,3336,9789,5121,4668
2014/11/1,澎湖縣,西嶼鄉,2924,8452,4331,4121
2014/11/1,澎湖縣,望安鄉,1993,5135,2754,2381
2014/11/1,澎湖縣,七美鄉,1322,3770,1968,1802
2014/11/1,基隆市,中正區,22475,53135,27228,25907
2014/11/1,基隆市,七堵區,20917,53953,27303,26650
2014/11/1,基隆市,暖暖區,15210,38229,19301,18928
2014/11/1,基隆市,仁愛區,19497,46395,22879,23516
2014/11/1,基隆市,中山區,19314,48751,24825,23926
2014/11/1,基隆市,安樂區,32266,81634,40643,40991
2014/11/1,基隆市,信義區,20873,51243,25578,25665
2014/11/1,新竹市,東區,74973,206696,101843,104853
2014/11/1,新竹市,北區,54284,148640,72971,75669
2014/11/1,新竹市,香山區,25663,76265,38869,37396
2014/11/1,嘉義市,東區,45138,123422,59911,63511
2014/11/1,嘉義市,西區,53069,147436,72522,74914
2014/11/1,金門縣,金城鎮,12424,40756,20461,20295
2014/11/1,金門縣,金湖鎮,8297,27217,13740,13477
2014/11/1,金門縣,金沙鎮,6018,19359,9588,9771
2014/11/1,金門縣,金寧鄉,7615,27070,13685,13385
2014/11/1,金門縣,烈嶼鄉,3003,11889,5871,6018
2014/11/1,金門縣,烏坵鄉,134,673,336,337
2014/11/1,連江縣,南竿鄉,1422,7534,4312,3222
2014/11/1,連江縣,北竿鄉,474,2325,1277,1048
2014/11/1,連江縣,莒光鄉,266,1415,820,595
2014/11/1,連江縣,東引鄉,299,1254,753,501
2014/12/1,總計,新北市,1497018,3966818,1951739,2015079
2014/12/1,總計,臺北市,1037402,2702315,1295636,1406679
2014/12/1,總計,桃園市,733004,2058328,1032625,1025703
2014/12/1,總計,臺中市,912305,2719835,1347010,1372825
2014/12/1,總計,臺南市,668013,1884284,944069,940215
2014/12/1,總計,高雄市,1064667,2778992,1382998,1395994
2014/12/1,總計,臺灣省,2430232,7182952,3672707,3510245
2014/12/1,總計,宜蘭縣,162872,458777,232814,225963
2014/12/1,總計,新竹縣,179147,537630,275244,262386
2014/12/1,總計,苗栗縣,183124,567132,292237,274895
2014/12/1,總計,彰化縣,378621,1291474,660741,630733
2014/12/1,總計,南投縣,176140,514315,263899,250416
2014/12/1,總計,雲林縣,237726,705356,366895,338461
2014/12/1,總計,嘉義縣,181300,524783,273324,251459
2014/12/1,總計,屏東縣,283161,847917,434587,413330
2014/12/1,總計,臺東縣,82074,224470,116396,108074
2014/12/1,總計,花蓮縣,124243,333392,170324,163068
2014/12/1,總計,澎湖縣,37917,101758,52392,49366
2014/12/1,總計,基隆市,150492,373077,187605,185472
2014/12/1,總計,新竹市,155139,431988,213836,218152
2014/12/1,總計,嘉義市,98276,270883,132413,138470
2014/12/1,總計,福建省,40058,140229,71187,69042
2014/12/1,總計,金門縣,37584,127723,64034,63689
2014/12/1,總計,連江縣,2474,12506,7153,5353
2014/12/1,新北市,板橋區,204899,555914,272300,283614
2014/12/1,新北市,三重區,147402,389325,192412,196913
2014/12/1,新北市,中和區,162378,415226,202986,212240
2014/12/1,新北市,永和區,90687,227267,108243,119024
2014/12/1,新北市,新莊區,147092,411711,201987,209724
2014/12/1,新北市,新店區,122810,299730,145091,154639
2014/12/1,新北市,樹林區,65057,184167,92148,92019
2014/12/1,新北市,鶯歌區,29201,89075,44603,44472
2014/12/1,新北市,三峽區,40345,111588,56280,55308
2014/12/1,新北市,淡水區,68253,158953,76614,82339
2014/12/1,新北市,汐止區,84229,195140,95721,99419
2014/12/1,新北市,瑞芳區,16088,41315,20859,20456
2014/12/1,新北市,土城區,85549,239270,118591,120679
2014/12/1,新北市,蘆洲區,68922,199750,98311,101439
2014/12/1,新北市,五股區,29305,82255,41533,40722
2014/12/1,新北市,泰山區,27668,78370,39032,39338
2014/12/1,新北市,林口區,37840,97645,47815,49830
2014/12/1,新北市,深坑區,9330,23636,11861,11775
2014/12/1,新北市,石碇區,3368,7864,4329,3535
2014/12/1,新北市,坪林區,2478,6455,3603,2852
2014/12/1,新北市,三芝區,9279,23480,12085,11395
2014/12/1,新北市,石門區,4283,12733,6627,6106
2014/12/1,新北市,八里區,13764,37187,18613,18574
2014/12/1,新北市,平溪區,2351,4954,2726,2228
2014/12/1,新北市,雙溪區,3842,9450,5073,4377
2014/12/1,新北市,貢寮區,4434,13115,6718,6397
2014/12/1,新北市,金山區,7003,22400,11099,11301
2014/12/1,新北市,萬里區,7369,22678,11417,11261
2014/12/1,新北市,烏來區,1792,6165,3062,3103
2014/12/1,臺北市,松山區,80073,210473,99430,111043
2014/12/1,臺北市,信義區,89181,229657,110182,119475
2014/12/1,臺北市,大安區,120178,313693,146903,166790
2014/12/1,臺北市,中山區,98324,230496,107664,122832
2014/12/1,臺北市,中正區,65087,163388,78158,85230
2014/12/1,臺北市,大同區,51164,130973,64003,66970
2014/12/1,臺北市,萬華區,78157,194715,96205,98510
2014/12/1,臺北市,文山區,103299,273921,131932,141989
2014/12/1,臺北市,南港區,45863,121257,59213,62044
2014/12/1,臺北市,內湖區,105416,285767,136922,148845
2014/12/1,臺北市,士林區,105568,290455,140510,149945
2014/12/1,臺北市,北投區,95092,257520,124514,133006
2014/12/1,桃園市,桃園區,156369,417366,203922,213444
2014/12/1,桃園市,中壢區,138536,381449,189330,192119
2014/12/1,桃園市,大溪區,30801,91887,47305,44582
2014/12/1,桃園市,楊梅區,53679,157200,79758,77442
2014/12/1,桃園市,蘆竹區,54073,151354,75637,75717
2014/12/1,桃園市,大園區,29822,84531,43474,41057
2014/12/1,桃園市,龜山區,54466,141998,71432,70566
2014/12/1,桃園市,八德區,63598,181431,91694,89737
2014/12/1,桃園市,龍潭區,39242,116211,58712,57499
2014/12/1,桃園市,平鎮區,72169,212328,106310,106018
2014/12/1,桃園市,新屋區,15532,48058,25751,22307
2014/12/1,桃園市,觀音區,20997,63602,33307,30295
2014/12/1,桃園市,復興區,3720,10913,5993,4920
2014/12/1,臺中市,中區,7848,19323,9602,9721
2014/12/1,臺中市,東區,27086,74922,37454,37468
2014/12/1,臺中市,南區,45952,120128,57959,62169
2014/12/1,臺中市,西區,44725,115731,55101,60630
2014/12/1,臺中市,北區,58247,147471,70976,76495
2014/12/1,臺中市,西屯區,80619,218540,105264,113276
2014/12/1,臺中市,南屯區,58370,161906,77793,84113
2014/12/1,臺中市,北屯區,91950,259742,125321,134421
2014/12/1,臺中市,豐原區,52173,166458,82444,84014
2014/12/1,臺中市,東勢區,17241,51485,26611,24874
2014/12/1,臺中市,大甲區,22522,77607,39239,38368
2014/12/1,臺中市,清水區,26032,85957,44233,41724
2014/12/1,臺中市,沙鹿區,27099,87742,44559,43183
2014/12/1,臺中市,梧棲區,16839,56643,28530,28113
2014/12/1,臺中市,后里區,15439,54106,27581,26525
2014/12/1,臺中市,神岡區,18694,64956,33287,31669
2014/12/1,臺中市,潭子區,34709,105165,52196,52969
2014/12/1,臺中市,大雅區,27921,92628,46393,46235
2014/12/1,臺中市,新社區,7476,25242,13138,12104
2014/12/1,臺中市,石岡區,4899,15405,8010,7395
2014/12/1,臺中市,外埔區,9291,31800,16349,15451
2014/12/1,臺中市,大安區,5355,19654,10361,9293
2014/12/1,臺中市,烏日區,22635,71520,36100,35420
2014/12/1,臺中市,大肚區,16677,56364,28867,27497
2014/12/1,臺中市,龍井區,22033,76164,38606,37558
2014/12/1,臺中市,霧峰區,19562,64496,32925,31571
2014/12/1,臺中市,太平區,59914,181537,90485,91052
2014/12/1,臺中市,大里區,66583,206318,101818,104500
2014/12/1,臺中市,和平區,4414,10825,5808,5017
2014/12/1,臺南市,新營區,28426,78231,38800,39431
2014/12/1,臺南市,鹽水區,10065,26322,13740,12582
2014/12/1,臺南市,白河區,10978,29731,15569,14162
2014/12/1,臺南市,柳營區,7843,21828,11376,10452
2014/12/1,臺南市,後壁區,8887,24589,12805,11784
2014/12/1,臺南市,東山區,8282,21920,11627,10293
2014/12/1,臺南市,麻豆區,15450,45067,22912,22155
2014/12/1,臺南市,下營區,9111,25068,12919,12149
2014/12/1,臺南市,六甲區,7715,22832,11820,11012
2014/12/1,臺南市,官田區,7796,21706,11100,10606
2014/12/1,臺南市,大內區,3972,10248,5468,4780
2014/12/1,臺南市,佳里區,20276,59533,29554,29979
2014/12/1,臺南市,學甲區,9647,26949,13784,13165
2014/12/1,臺南市,西港區,8044,24896,12610,12286
2014/12/1,臺南市,七股區,8125,23608,12279,11329
2014/12/1,臺南市,將軍區,7339,20568,10455,10113
2014/12/1,臺南市,北門區,4369,11691,5894,5797
2014/12/1,臺南市,新化區,14203,43782,22385,21397
2014/12/1,臺南市,善化區,16290,46100,23307,22793
2014/12/1,臺南市,新市區,11516,35482,17816,17666
2014/12/1,臺南市,安定區,9763,30298,15552,14746
2014/12/1,臺南市,山上區,2688,7500,3922,3578
2014/12/1,臺南市,玉井區,5120,14561,7582,6979
2014/12/1,臺南市,楠西區,3538,10116,5356,4760
2014/12/1,臺南市,南化區,2863,9001,4878,4123
2014/12/1,臺南市,左鎮區,1998,5181,2890,2291
2014/12/1,臺南市,仁德區,26526,73099,37205,35894
2014/12/1,臺南市,歸仁區,21963,67504,34300,33204
2014/12/1,臺南市,關廟區,10889,34865,18024,16841
2014/12/1,臺南市,龍崎區,1573,4292,2326,1966
2014/12/1,臺南市,永康區,81040,228651,113016,115635
2014/12/1,臺南市,東區,71870,190233,91546,98687
2014/12/1,臺南市,南區,44706,125691,62488,63203
2014/12/1,臺南市,北區,49711,132558,64876,67682
2014/12/1,臺南市,安南區,60102,187775,95005,92770
2014/12/1,臺南市,安平區,24546,64898,30906,33992
2014/12/1,臺南市,中西區,30783,77910,37977,39933
2014/12/1,高雄市,鹽埕區,10894,25400,12663,12737
2014/12/1,高雄市,鼓山區,55501,135667,65877,69790
2014/12/1,高雄市,左營區,77053,195643,94873,100770
2014/12/1,高雄市,楠梓區,66137,178532,88198,90334
2014/12/1,高雄市,三民區,134885,347619,168859,178760
2014/12/1,高雄市,新興區,22730,52534,25292,27242
2014/12/1,高雄市,前金區,12557,27832,13392,14440
2014/12/1,高雄市,苓雅區,72170,175854,85047,90807
2014/12/1,高雄市,前鎮區,78093,193952,95757,98195
2014/12/1,高雄市,旗津區,10954,28958,15010,13948
2014/12/1,高雄市,小港區,66012,156171,77893,78278
2014/12/1,高雄市,鳳山區,135440,354093,174499,179594
2014/12/1,高雄市,林園區,25394,70476,35853,34623
2014/12/1,高雄市,大寮區,40902,111191,57243,53948
2014/12/1,高雄市,大樹區,13296,43190,22200,20990
2014/12/1,高雄市,大社區,12658,34455,17566,16889
2014/12/1,高雄市,仁武區,30353,80994,41381,39613
2014/12/1,高雄市,鳥松區,17499,43735,22235,21500
2014/12/1,高雄市,岡山區,34443,97751,48636,49115
2014/12/1,高雄市,橋頭區,13185,37198,18957,18241
2014/12/1,高雄市,燕巢區,10340,30397,16116,14281
2014/12/1,高雄市,田寮區,3405,7680,4254,3426
2014/12/1,高雄市,阿蓮區,9386,29566,14921,14645
2014/12/1,高雄市,路竹區,16686,53064,27123,25941
2014/12/1,高雄市,湖內區,10346,29399,15050,14349
2014/12/1,高雄市,茄萣區,10404,30690,15882,14808
2014/12/1,高雄市,永安區,5806,14148,7107,7041
2014/12/1,高雄市,彌陀區,6701,19854,10274,9580
2014/12/1,高雄市,梓官區,12429,36384,18782,17602
2014/12/1,高雄市,旗山區,13856,38100,19770,18330
2014/12/1,高雄市,美濃區,14480,41258,21586,19672
2014/12/1,高雄市,六龜區,5646,13663,7384,6279
2014/12/1,高雄市,甲仙區,2372,6420,3401,3019
2014/12/1,高雄市,杉林區,4831,12531,6821,5710
2014/12/1,高雄市,內門區,5063,15178,8224,6954
2014/12/1,高雄市,茂林區,584,1915,948,967
2014/12/1,高雄市,桃源區,1315,4296,2262,2034
2014/12/1,高雄市,那瑪夏區,861,3204,1662,1542
2014/12/1,宜蘭縣,宜蘭市,35248,95885,46907,48978
2014/12/1,宜蘭縣,羅東鎮,25819,72533,34588,37945
2014/12/1,宜蘭縣,蘇澳鎮,13976,41018,20938,20080
2014/12/1,宜蘭縣,頭城鎮,10073,29890,15440,14450
2014/12/1,宜蘭縣,礁溪鄉,13331,35945,18765,17180
2014/12/1,宜蘭縣,壯圍鄉,8439,24492,12935,11557
2014/12/1,宜蘭縣,員山鄉,11368,32377,17207,15170
2014/12/1,宜蘭縣,冬山鄉,18562,53482,27510,25972
2014/12/1,宜蘭縣,五結鄉,14103,39378,20401,18977
2014/12/1,宜蘭縣,三星鄉,8167,21503,11576,9927
2014/12/1,宜蘭縣,大同鄉,1884,6127,3318,2809
2014/12/1,宜蘭縣,南澳鄉,1902,6147,3229,2918
2014/12/1,新竹縣,竹北市,58159,165118,82329,82789
2014/12/1,新竹縣,關西鎮,9541,30751,16376,14375
2014/12/1,新竹縣,新埔鎮,10629,34427,18298,16129
2014/12/1,新竹縣,竹東鎮,32276,96059,48297,47762
2014/12/1,新竹縣,湖口鄉,25193,77210,39236,37974
2014/12/1,新竹縣,橫山鄉,4529,13810,7489,6321
2014/12/1,新竹縣,新豐鄉,17447,55826,28643,27183
2014/12/1,新竹縣,芎林鄉,6438,20301,10747,9554
2014/12/1,新竹縣,寶山鄉,5119,14365,7760,6605
2014/12/1,新竹縣,北埔鄉,3143,9784,5274,4510
2014/12/1,新竹縣,峨眉鄉,2085,5744,3186,2558
2014/12/1,新竹縣,尖石鄉,2838,9506,5038,4468
2014/12/1,新竹縣,五峰鄉,1750,4729,2571,2158
2014/12/1,苗栗縣,苗栗市,30557,90963,45489,45474
2014/12/1,苗栗縣,苑裡鎮,14414,48589,25170,23419
2014/12/1,苗栗縣,通霄鎮,11586,36941,19479,17462
2014/12/1,苗栗縣,竹南鎮,27232,83622,42227,41395
2014/12/1,苗栗縣,頭份市,33062,102654,51840,50814
2014/12/1,苗栗縣,後龍鎮,11880,38360,20176,18184
2014/12/1,苗栗縣,卓蘭鎮,6145,18353,9603,8750
2014/12/1,苗栗縣,大湖鄉,5440,15549,8237,7312
2014/12/1,苗栗縣,公館鄉,10635,34847,18073,16774
2014/12/1,苗栗縣,銅鑼鄉,6135,18909,10033,8876
2014/12/1,苗栗縣,南庄鄉,3974,10674,5856,4818
2014/12/1,苗栗縣,頭屋鄉,3645,11377,5984,5393
2014/12/1,苗栗縣,三義鄉,5464,17235,9018,8217
2014/12/1,苗栗縣,西湖鄉,2687,7589,4209,3380
2014/12/1,苗栗縣,造橋鄉,4134,13456,7064,6392
2014/12/1,苗栗縣,三灣鄉,2423,7132,3878,3254
2014/12/1,苗栗縣,獅潭鄉,1741,4725,2620,2105
2014/12/1,苗栗縣,泰安鄉,1970,6157,3281,2876
2014/12/1,彰化縣,彰化市,74854,235022,116570,118452
2014/12/1,彰化縣,鹿港鎮,23700,86100,43908,42192
2014/12/1,彰化縣,和美鎮,25920,90741,46412,44329
2014/12/1,彰化縣,北斗鎮,10398,33198,16771,16427
2014/12/1,彰化縣,員林市,38326,124725,62382,62343
2014/12/1,彰化縣,溪湖鎮,15958,55788,28397,27391
2014/12/1,彰化縣,田中鎮,12907,42745,22123,20622
2014/12/1,彰化縣,二林鎮,14813,52330,27030,25300
2014/12/1,彰化縣,線西鄉,4295,17119,8871,8248
2014/12/1,彰化縣,伸港鄉,9470,36182,18526,17656
2014/12/1,彰化縣,福興鄉,12518,47810,24931,22879
2014/12/1,彰化縣,秀水鄉,10355,39326,20333,18993
2014/12/1,彰化縣,花壇鄉,13661,45916,23636,22280
2014/12/1,彰化縣,芬園鄉,6876,24155,12731,11424
2014/12/1,彰化縣,大村鄉,10740,36457,18902,17555
2014/12/1,彰化縣,埔鹽鄉,8979,33184,17412,15772
2014/12/1,彰化縣,埔心鄉,10331,34905,18013,16892
2014/12/1,彰化縣,永靖鄉,10787,38200,19885,18315
2014/12/1,彰化縣,社頭鄉,12716,43705,22484,21221
2014/12/1,彰化縣,二水鄉,5336,15830,8300,7530
2014/12/1,彰化縣,田尾鄉,7842,27834,14444,13390
2014/12/1,彰化縣,埤頭鄉,8886,31045,16148,14897
2014/12/1,彰化縣,芳苑鄉,10116,34744,18398,16346
2014/12/1,彰化縣,大城鄉,5335,17797,9653,8144
2014/12/1,彰化縣,竹塘鄉,4619,15863,8360,7503
2014/12/1,彰化縣,溪州鄉,8883,30753,16121,14632
2014/12/1,南投縣,南投市,34269,102314,51326,50988
2014/12/1,南投縣,埔里鎮,28859,83021,41703,41318
2014/12/1,南投縣,草屯鎮,32528,99209,50119,49090
2014/12/1,南投縣,竹山鎮,19955,56662,29120,27542
2014/12/1,南投縣,集集鎮,4376,11390,5962,5428
2014/12/1,南投縣,名間鄉,12537,40019,21007,19012
2014/12/1,南投縣,鹿谷鄉,7534,18538,9845,8693
2014/12/1,南投縣,中寮鄉,5646,15566,8464,7102
2014/12/1,南投縣,魚池鄉,5738,16501,8655,7846
2014/12/1,南投縣,國姓鄉,7296,19715,10661,9054
2014/12/1,南投縣,水里鄉,7224,18717,9819,8898
2014/12/1,南投縣,信義鄉,5243,16813,9033,7780
2014/12/1,南投縣,仁愛鄉,4935,15850,8185,7665
2014/12/1,雲林縣,斗六市,37033,108098,54011,54087
2014/12/1,雲林縣,斗南鎮,15739,46013,23377,22636
2014/12/1,雲林縣,虎尾鎮,23954,70269,35654,34615
2014/12/1,雲林縣,西螺鎮,14425,47187,23974,23213
2014/12/1,雲林縣,土庫鎮,9211,29697,15514,14183
2014/12/1,雲林縣,北港鎮,15954,41528,21586,19942
2014/12/1,雲林縣,古坑鄉,10929,32686,17249,15437
2014/12/1,雲林縣,大埤鄉,6751,19989,10742,9247
2014/12/1,雲林縣,莿桐鄉,9250,29599,15546,14053
2014/12/1,雲林縣,林內鄉,5903,18970,9918,9052
2014/12/1,雲林縣,二崙鄉,8922,28323,15160,13163
2014/12/1,雲林縣,崙背鄉,8509,25896,13668,12228
2014/12/1,雲林縣,麥寮鄉,13837,43880,22229,21651
2014/12/1,雲林縣,東勢鄉,5801,15865,8687,7178
2014/12/1,雲林縣,褒忠鄉,4408,13605,7295,6310
2014/12/1,雲林縣,臺西鄉,8788,24995,13434,11561
2014/12/1,雲林縣,元長鄉,9428,27307,14891,12416
2014/12/1,雲林縣,四湖鄉,8993,25415,13773,11642
2014/12/1,雲林縣,口湖鄉,9640,29017,15386,13631
2014/12/1,雲林縣,水林鄉,10251,27017,14801,12216
2014/12/1,嘉義縣,太保市,12158,37038,19077,17961
2014/12/1,嘉義縣,朴子市,15405,43250,21923,21327
2014/12/1,嘉義縣,布袋鎮,10115,28423,14565,13858
2014/12/1,嘉義縣,大林鎮,11389,32159,16479,15680
2014/12/1,嘉義縣,民雄鄉,24041,71903,36837,35066
2014/12/1,嘉義縣,溪口鄉,5435,15393,8224,7169
2014/12/1,嘉義縣,新港鄉,10589,33186,17576,15610
2014/12/1,嘉義縣,六腳鄉,9024,24613,13052,11561
2014/12/1,嘉義縣,東石鄉,9439,26235,13921,12314
2014/12/1,嘉義縣,義竹鄉,7550,19578,10177,9401
2014/12/1,嘉義縣,鹿草鄉,5820,16384,8771,7613
2014/12/1,嘉義縣,水上鄉,17834,50726,26176,24550
2014/12/1,嘉義縣,中埔鄉,15945,46156,24039,22117
2014/12/1,嘉義縣,竹崎鄉,11592,36924,19704,17220
2014/12/1,嘉義縣,梅山鄉,6762,20304,10782,9522
2014/12/1,嘉義縣,番路鄉,4304,12089,6537,5552
2014/12/1,嘉義縣,大埔鄉,1943,4658,2427,2231
2014/12/1,嘉義縣,阿里山鄉,1955,5764,3057,2707
2014/12/1,屏東縣,屏東市,73417,203866,101314,102552
2014/12/1,屏東縣,潮州鎮,18967,54738,27465,27273
2014/12/1,屏東縣,東港鎮,16238,48262,24412,23850
2014/12/1,屏東縣,恆春鎮,11203,30859,15780,15079
2014/12/1,屏東縣,萬丹鄉,14696,52085,26949,25136
2014/12/1,屏東縣,長治鄉,9959,30429,15887,14542
2014/12/1,屏東縣,麟洛鄉,3720,11313,5848,5465
2014/12/1,屏東縣,九如鄉,6765,22172,11474,10698
2014/12/1,屏東縣,里港鄉,8100,26814,13616,13198
2014/12/1,屏東縣,鹽埔鄉,7843,26629,13814,12815
2014/12/1,屏東縣,高樹鄉,9417,25520,13595,11925
2014/12/1,屏東縣,萬巒鄉,6455,20918,10984,9934
2014/12/1,屏東縣,內埔鄉,18413,56148,29135,27013
2014/12/1,屏東縣,竹田鄉,5634,17719,9408,8311
2014/12/1,屏東縣,新埤鄉,3443,10232,5428,4804
2014/12/1,屏東縣,枋寮鄉,8567,25482,13336,12146
2014/12/1,屏東縣,新園鄉,11746,36692,19020,17672
2014/12/1,屏東縣,崁頂鄉,4416,16374,8340,8034
2014/12/1,屏東縣,林邊鄉,7009,19235,9904,9331
2014/12/1,屏東縣,南州鄉,3663,11026,5645,5381
2014/12/1,屏東縣,佳冬鄉,7036,20247,10531,9716
2014/12/1,屏東縣,琉球鄉,4278,12675,6984,5691
2014/12/1,屏東縣,車城鄉,3499,9121,4906,4215
2014/12/1,屏東縣,滿州鄉,3029,8126,4440,3686
2014/12/1,屏東縣,枋山鄉,2130,5749,3049,2700
2014/12/1,屏東縣,三地門鄉,2283,7784,3935,3849
2014/12/1,屏東縣,霧臺鄉,1045,3435,1752,1683
2014/12/1,屏東縣,瑪家鄉,1962,6718,3443,3275
2014/12/1,屏東縣,泰武鄉,1287,5289,2766,2523
2014/12/1,屏東縣,來義鄉,2225,7648,3899,3749
2014/12/1,屏東縣,春日鄉,1346,4866,2503,2363
2014/12/1,屏東縣,獅子鄉,1507,4882,2519,2363
2014/12/1,屏東縣,牡丹鄉,1863,4864,2506,2358
2014/12/1,臺東縣,臺東市,38989,106929,53757,53172
2014/12/1,臺東縣,成功鎮,5448,14943,7908,7035
2014/12/1,臺東縣,關山鎮,3235,9111,4796,4315
2014/12/1,臺東縣,卑南鄉,6655,17700,9411,8289
2014/12/1,臺東縣,大武鄉,2526,6565,3408,3157
2014/12/1,臺東縣,太麻里鄉,4609,11507,6107,5400
2014/12/1,臺東縣,東河鄉,3750,9000,4964,4036
2014/12/1,臺東縣,長濱鄉,2934,7756,4397,3359
2014/12/1,臺東縣,鹿野鄉,3092,8202,4396,3806
2014/12/1,臺東縣,池上鄉,3263,8591,4510,4081
2014/12/1,臺東縣,綠島鄉,1098,3808,2004,1804
2014/12/1,臺東縣,延平鄉,1068,3614,1947,1667
2014/12/1,臺東縣,海端鄉,1092,4378,2343,2035
2014/12/1,臺東縣,達仁鄉,1463,3721,2027,1694
2014/12/1,臺東縣,金峰鄉,1111,3669,1895,1774
2014/12/1,臺東縣,蘭嶼鄉,1741,4976,2526,2450
2014/12/1,花蓮縣,花蓮市,41279,106368,51667,54701
2014/12/1,花蓮縣,鳳林鎮,4417,11237,5903,5334
2014/12/1,花蓮縣,玉里鎮,8943,25396,13600,11796
2014/12/1,花蓮縣,新城鄉,7539,20286,10474,9812
2014/12/1,花蓮縣,吉安鄉,31064,82577,41916,40661
2014/12/1,花蓮縣,壽豐鄉,7016,18237,9744,8493
2014/12/1,花蓮縣,光復鄉,5053,13395,7131,6264
2014/12/1,花蓮縣,豐濱鄉,1741,4706,2604,2102
2014/12/1,花蓮縣,瑞穗鄉,4656,12107,6509,5598
2014/12/1,花蓮縣,富里鄉,3993,10849,5916,4933
2014/12/1,花蓮縣,秀林鄉,4775,15494,8011,7483
2014/12/1,花蓮縣,萬榮鄉,2089,6530,3446,3084
2014/12/1,花蓮縣,卓溪鄉,1678,6210,3403,2807
2014/12/1,澎湖縣,馬公市,23014,60335,30661,29674
2014/12/1,澎湖縣,湖西鄉,5324,14315,7566,6749
2014/12/1,澎湖縣,白沙鄉,3336,9799,5128,4671
2014/12/1,澎湖縣,西嶼鄉,2933,8438,4335,4103
2014/12/1,澎湖縣,望安鄉,1988,5117,2747,2370
2014/12/1,澎湖縣,七美鄉,1322,3754,1955,1799
2014/12/1,基隆市,中正區,22472,53094,27225,25869
2014/12/1,基隆市,七堵區,20931,53974,27291,26683
2014/12/1,基隆市,暖暖區,15221,38188,19294,18894
2014/12/1,基隆市,仁愛區,19438,46244,22803,23441
2014/12/1,基隆市,中山區,19312,48733,24811,23922
2014/12/1,基隆市,安樂區,32258,81580,40616,40964
2014/12/1,基隆市,信義區,20860,51264,25565,25699
2014/12/1,新竹市,東區,75066,206843,101915,104928
2014/12/1,新竹市,北區,54350,148753,73001,75752
2014/12/1,新竹市,香山區,25723,76392,38920,37472
2014/12/1,嘉義市,東區,45185,123370,59853,63517
2014/12/1,嘉義市,西區,53091,147513,72560,74953
2014/12/1,金門縣,金城鎮,12443,40933,20555,20378
2014/12/1,金門縣,金湖鎮,8313,27368,13801,13567
2014/12/1,金門縣,金沙鎮,6024,19465,9640,9825
2014/12/1,金門縣,金寧鄉,7661,27307,13793,13514
2014/12/1,金門縣,烈嶼鄉,3009,11978,5910,6068
2014/12/1,金門縣,烏坵鄉,134,672,335,337
2014/12/1,連江縣,南竿鄉,1428,7496,4281,3215
2014/12/1,連江縣,北竿鄉,475,2320,1275,1045
2014/12/1,連江縣,莒光鄉,266,1424,832,592
2014/12/1,連江縣,東引鄉,305,1266,765,501
2015/1/1,總計,新北市,1497722,3967571,1951873,2015698
2015/1/1,總計,臺北市,1037834,2704133,1296292,1407841
2015/1/1,總計,桃園市,734191,2061501,1033911,1027590
2015/1/1,總計,臺中市,913340,2721709,1347756,1373953
2015/1/1,總計,臺南市,668414,1884641,944175,940466
2015/1/1,總計,高雄市,1065667,2779355,1383118,1396237
2015/1/1,總計,臺灣省,2431590,7180643,3671346,3509297
2015/1/1,總計,宜蘭縣,163030,458691,232774,225917
2015/1/1,總計,新竹縣,179404,537907,275402,262505
2015/1/1,總計,苗栗縣,183219,567092,292182,274910
2015/1/1,總計,彰化縣,378836,1291312,660645,630667
2015/1/1,總計,南投縣,176198,513970,263701,250269
2015/1/1,總計,雲林縣,237796,704784,366590,338194
2015/1/1,總計,嘉義縣,181352,524276,273069,251207
2015/1/1,總計,屏東縣,283271,847155,434180,412975
2015/1/1,總計,臺東縣,82064,224218,116254,107964
2015/1/1,總計,花蓮縣,124288,333240,170234,163006
2015/1/1,總計,澎湖縣,37959,101803,52429,49374
2015/1/1,總計,基隆市,150590,373011,187549,185462
2015/1/1,總計,新竹市,155296,432259,213933,218326
2015/1/1,總計,嘉義市,98287,270925,132404,138521
2015/1/1,總計,福建省,40125,140725,71446,69279
2015/1/1,總計,金門縣,37649,128187,64275,63912
2015/1/1,總計,連江縣,2476,12538,7171,5367
2015/1/1,新北市,板橋區,204905,555924,272272,283652
2015/1/1,新北市,三重區,147493,389199,192328,196871
2015/1/1,新北市,中和區,162394,415277,203006,212271
2015/1/1,新北市,永和區,90680,227221,108227,118994
2015/1/1,新北市,新莊區,147243,411913,202041,209872
2015/1/1,新北市,新店區,122812,299691,145039,154652
2015/1/1,新北市,樹林區,65068,184153,92128,92025
2015/1/1,新北市,鶯歌區,29284,89136,44636,44500
2015/1/1,新北市,三峽區,40380,111641,56314,55327
2015/1/1,新北市,淡水區,68356,159187,76732,82455
2015/1/1,新北市,汐止區,84200,195167,95705,99462
2015/1/1,新北市,瑞芳區,16079,41280,20848,20432
2015/1/1,新北市,土城區,85566,239310,118579,120731
2015/1/1,新北市,蘆洲區,68964,199739,98298,101441
2015/1/1,新北市,五股區,29324,82255,41509,40746
2015/1/1,新北市,泰山區,27722,78491,39084,39407
2015/1/1,新北市,林口區,37919,97887,47922,49965
2015/1/1,新北市,深坑區,9326,23622,11851,11771
2015/1/1,新北市,石碇區,3368,7865,4332,3533
2015/1/1,新北市,坪林區,2484,6468,3610,2858
2015/1/1,新北市,三芝區,9284,23490,12090,11400
2015/1/1,新北市,石門區,4285,12730,6630,6100
2015/1/1,新北市,八里區,13779,37226,18626,18600
2015/1/1,新北市,平溪區,2356,4942,2721,2221
2015/1/1,新北市,雙溪區,3837,9413,5059,4354
2015/1/1,新北市,貢寮區,4428,13097,6692,6405
2015/1/1,新北市,金山區,7011,22396,11104,11292
2015/1/1,新北市,萬里區,7376,22687,11432,11255
2015/1/1,新北市,烏來區,1799,6164,3058,3106
2015/1/1,臺北市,松山區,80051,210433,99375,111058
2015/1/1,臺北市,信義區,89207,229854,110258,119596
2015/1/1,臺北市,大安區,120229,313926,146965,166961
2015/1/1,臺北市,中山區,98459,230833,107811,123022
2015/1/1,臺北市,中正區,65110,163403,78143,85260
2015/1/1,臺北市,大同區,51197,131036,64042,66994
2015/1/1,臺北市,萬華區,78148,194833,96278,98555
2015/1/1,臺北市,文山區,103349,274129,132016,142113
2015/1/1,臺北市,南港區,45923,121386,59280,62106
2015/1/1,臺北市,內湖區,105468,286047,137050,148997
2015/1/1,臺北市,士林區,105599,290649,140594,150055
2015/1/1,臺北市,北投區,95094,257604,124480,133124
2015/1/1,桃園市,桃園區,156557,418040,204190,213850
2015/1/1,桃園市,中壢區,138729,382074,189565,192509
2015/1/1,桃園市,大溪區,30841,91994,47364,44630
2015/1/1,桃園市,楊梅區,53737,157407,79815,77592
2015/1/1,桃園市,蘆竹區,54153,151546,75714,75832
2015/1/1,桃園市,大園區,29930,84618,43507,41111
2015/1/1,桃園市,龜山區,54522,142213,71555,70658
2015/1/1,桃園市,八德區,63683,181717,91805,89912
2015/1/1,桃園市,龍潭區,39316,116420,58793,57627
2015/1/1,桃園市,平鎮區,72381,212817,106524,106293
2015/1/1,桃園市,新屋區,15553,48054,25743,22311
2015/1/1,桃園市,觀音區,21059,63680,33339,30341
2015/1/1,桃園市,復興區,3730,10921,5997,4924
2015/1/1,臺中市,中區,7844,19338,9611,9727
2015/1/1,臺中市,東區,27110,74944,37454,37490
2015/1/1,臺中市,南區,45995,120182,57992,62190
2015/1/1,臺中市,西區,44746,115767,55108,60659
2015/1/1,臺中市,北區,58263,147529,70986,76543
2015/1/1,臺中市,西屯區,80741,218788,105384,113404
2015/1/1,臺中市,南屯區,58440,162100,77879,84221
2015/1/1,臺中市,北屯區,92137,260117,125453,134664
2015/1/1,臺中市,豐原區,52186,166472,82450,84022
2015/1/1,臺中市,東勢區,17245,51473,26594,24879
2015/1/1,臺中市,大甲區,22548,77575,39198,38377
2015/1/1,臺中市,清水區,26041,85969,44234,41735
2015/1/1,臺中市,沙鹿區,27148,87905,44618,43287
2015/1/1,臺中市,梧棲區,16888,56666,28555,28111
2015/1/1,臺中市,后里區,15453,54119,27599,26520
2015/1/1,臺中市,神岡區,18704,64941,33286,31655
2015/1/1,臺中市,潭子區,34751,105280,52244,53036
2015/1/1,臺中市,大雅區,27965,92721,46420,46301
2015/1/1,臺中市,新社區,7486,25243,13146,12097
2015/1/1,臺中市,石岡區,4893,15391,8003,7388
2015/1/1,臺中市,外埔區,9304,31796,16343,15453
2015/1/1,臺中市,大安區,5355,19631,10364,9267
2015/1/1,臺中市,烏日區,22683,71550,36114,35436
2015/1/1,臺中市,大肚區,16682,56388,28876,27512
2015/1/1,臺中市,龍井區,22064,76169,38605,37564
2015/1/1,臺中市,霧峰區,19583,64495,32923,31572
2015/1/1,臺中市,太平區,60033,181807,90592,91215
2015/1/1,臺中市,大里區,66636,206536,101927,104609
2015/1/1,臺中市,和平區,4416,10817,5798,5019
2015/1/1,臺南市,新營區,28421,78248,38801,39447
2015/1/1,臺南市,鹽水區,10077,26304,13726,12578
2015/1/1,臺南市,白河區,10987,29710,15558,14152
2015/1/1,臺南市,柳營區,7841,21825,11370,10455
2015/1/1,臺南市,後壁區,8888,24545,12779,11766
2015/1/1,臺南市,東山區,8290,21894,11621,10273
2015/1/1,臺南市,麻豆區,15452,45057,22916,22141
2015/1/1,臺南市,下營區,9113,25054,12921,12133
2015/1/1,臺南市,六甲區,7710,22801,11798,11003
2015/1/1,臺南市,官田區,7790,21670,11078,10592
2015/1/1,臺南市,大內區,3968,10241,5458,4783
2015/1/1,臺南市,佳里區,20289,59530,29544,29986
2015/1/1,臺南市,學甲區,9653,26913,13768,13145
2015/1/1,臺南市,西港區,8046,24885,12609,12276
2015/1/1,臺南市,七股區,8110,23613,12287,11326
2015/1/1,臺南市,將軍區,7338,20548,10447,10101
2015/1/1,臺南市,北門區,4360,11666,5882,5784
2015/1/1,臺南市,新化區,14199,43773,22387,21386
2015/1/1,臺南市,善化區,16321,46181,23341,22840
2015/1/1,臺南市,新市區,11535,35524,17831,17693
2015/1/1,臺南市,安定區,9761,30275,15545,14730
2015/1/1,臺南市,山上區,2691,7499,3927,3572
2015/1/1,臺南市,玉井區,5113,14537,7561,6976
2015/1/1,臺南市,楠西區,3532,10114,5350,4764
2015/1/1,臺南市,南化區,2864,8991,4873,4118
2015/1/1,臺南市,左鎮區,1996,5175,2886,2289
2015/1/1,臺南市,仁德區,26577,73179,37257,35922
2015/1/1,臺南市,歸仁區,21985,67509,34318,33191
2015/1/1,臺南市,關廟區,10892,34874,18032,16842
2015/1/1,臺南市,龍崎區,1576,4283,2322,1961
2015/1/1,臺南市,永康區,81100,228818,113090,115728
2015/1/1,臺南市,東區,71903,190243,91492,98751
2015/1/1,臺南市,南區,44747,125726,62527,63199
2015/1/1,臺南市,北區,49743,132597,64872,67725
2015/1/1,臺南市,安南區,60187,187922,95075,92847
2015/1/1,臺南市,安平區,24568,64992,30950,34042
2015/1/1,臺南市,中西區,30791,77925,37976,39949
2015/1/1,高雄市,鹽埕區,10887,25411,12674,12737
2015/1/1,高雄市,鼓山區,55541,135759,65934,69825
2015/1/1,高雄市,左營區,77136,195777,94928,100849
2015/1/1,高雄市,楠梓區,66223,178666,88237,90429
2015/1/1,高雄市,三民區,134958,347611,168848,178763
2015/1/1,高雄市,新興區,22726,52540,25290,27250
2015/1/1,高雄市,前金區,12546,27733,13346,14387
2015/1/1,高雄市,苓雅區,72201,175762,84957,90805
2015/1/1,高雄市,前鎮區,78125,193842,95698,98144
2015/1/1,高雄市,旗津區,10955,28907,14986,13921
2015/1/1,高雄市,小港區,66080,156205,77922,78283
2015/1/1,高雄市,鳳山區,135669,354412,174627,179785
2015/1/1,高雄市,林園區,25419,70485,35843,34642
2015/1/1,高雄市,大寮區,40940,111231,57256,53975
2015/1/1,高雄市,大樹區,13313,43237,22213,21024
2015/1/1,高雄市,大社區,12665,34449,17557,16892
2015/1/1,高雄市,仁武區,30409,81088,41444,39644
2015/1/1,高雄市,鳥松區,17539,43809,22293,21516
2015/1/1,高雄市,岡山區,34467,97787,48653,49134
2015/1/1,高雄市,橋頭區,13198,37227,18976,18251
2015/1/1,高雄市,燕巢區,10338,30364,16113,14251
2015/1/1,高雄市,田寮區,3399,7643,4235,3408
2015/1/1,高雄市,阿蓮區,9395,29555,14909,14646
2015/1/1,高雄市,路竹區,16699,53071,27140,25931
2015/1/1,高雄市,湖內區,10385,29418,15070,14348
2015/1/1,高雄市,茄萣區,10441,30649,15854,14795
2015/1/1,高雄市,永安區,5805,14111,7087,7024
2015/1/1,高雄市,彌陀區,6714,19827,10260,9567
2015/1/1,高雄市,梓官區,12449,36406,18805,17601
2015/1/1,高雄市,旗山區,13847,38079,19766,18313
2015/1/1,高雄市,美濃區,14502,41167,21537,19630
2015/1/1,高雄市,六龜區,5653,13652,7382,6270
2015/1/1,高雄市,甲仙區,2380,6415,3399,3016
2015/1/1,高雄市,杉林區,4832,12520,6814,5706
2015/1/1,高雄市,內門區,5066,15158,8214,6944
2015/1/1,高雄市,茂林區,584,1910,943,967
2015/1/1,高雄市,桃源區,1317,4278,2255,2023
2015/1/1,高雄市,那瑪夏區,864,3194,1653,1541
2015/1/1,宜蘭縣,宜蘭市,35270,95914,46911,49003
2015/1/1,宜蘭縣,羅東鎮,25869,72584,34605,37979
2015/1/1,宜蘭縣,蘇澳鎮,13983,40988,20918,20070
2015/1/1,宜蘭縣,頭城鎮,10080,29869,15433,14436
2015/1/1,宜蘭縣,礁溪鄉,13354,35946,18764,17182
2015/1/1,宜蘭縣,壯圍鄉,8441,24443,12912,11531
2015/1/1,宜蘭縣,員山鄉,11371,32396,17219,15177
2015/1/1,宜蘭縣,冬山鄉,18570,53473,27510,25963
2015/1/1,宜蘭縣,五結鄉,14121,39345,20383,18962
2015/1/1,宜蘭縣,三星鄉,8183,21487,11576,9911
2015/1/1,宜蘭縣,大同鄉,1883,6121,3321,2800
2015/1/1,宜蘭縣,南澳鄉,1905,6125,3222,2903
2015/1/1,新竹縣,竹北市,58327,165540,82537,83003
2015/1/1,新竹縣,關西鎮,9543,30657,16338,14319
2015/1/1,新竹縣,新埔鎮,10622,34407,18286,16121
2015/1/1,新竹縣,竹東鎮,32308,96046,48292,47754
2015/1/1,新竹縣,湖口鄉,25231,77215,39242,37973
2015/1/1,新竹縣,橫山鄉,4518,13741,7455,6286
2015/1/1,新竹縣,新豐鄉,17471,55924,28706,27218
2015/1/1,新竹縣,芎林鄉,6437,20314,10740,9574
2015/1/1,新竹縣,寶山鄉,5131,14337,7753,6584
2015/1/1,新竹縣,北埔鄉,3141,9782,5267,4515
2015/1/1,新竹縣,峨眉鄉,2087,5734,3183,2551
2015/1/1,新竹縣,尖石鄉,2838,9498,5037,4461
2015/1/1,新竹縣,五峰鄉,1750,4712,2566,2146
2015/1/1,苗栗縣,苗栗市,30564,90946,45477,45469
2015/1/1,苗栗縣,苑裡鎮,14418,48578,25163,23415
2015/1/1,苗栗縣,通霄鎮,11573,36894,19444,17450
2015/1/1,苗栗縣,竹南鎮,27287,83737,42292,41445
2015/1/1,苗栗縣,頭份市,33098,102738,51867,50871
2015/1/1,苗栗縣,後龍鎮,11881,38319,20164,18155
2015/1/1,苗栗縣,卓蘭鎮,6146,18339,9596,8743
2015/1/1,苗栗縣,大湖鄉,5433,15518,8227,7291
2015/1/1,苗栗縣,公館鄉,10636,34812,18048,16764
2015/1/1,苗栗縣,銅鑼鄉,6137,18885,10009,8876
2015/1/1,苗栗縣,南庄鄉,3970,10663,5853,4810
2015/1/1,苗栗縣,頭屋鄉,3649,11392,5986,5406
2015/1/1,苗栗縣,三義鄉,5471,17238,9011,8227
2015/1/1,苗栗縣,西湖鄉,2685,7583,4208,3375
2015/1/1,苗栗縣,造橋鄉,4142,13458,7065,6393
2015/1/1,苗栗縣,三灣鄉,2421,7121,3875,3246
2015/1/1,苗栗縣,獅潭鄉,1738,4717,2616,2101
2015/1/1,苗栗縣,泰安鄉,1970,6154,3281,2873
2015/1/1,彰化縣,彰化市,74916,235078,116608,118470
2015/1/1,彰化縣,鹿港鎮,23728,86156,43930,42226
2015/1/1,彰化縣,和美鎮,25932,90765,46436,44329
2015/1/1,彰化縣,北斗鎮,10404,33219,16772,16447
2015/1/1,彰化縣,員林市,38343,124741,62357,62384
2015/1/1,彰化縣,溪湖鎮,15966,55786,28400,27386
2015/1/1,彰化縣,田中鎮,12926,42720,22106,20614
2015/1/1,彰化縣,二林鎮,14822,52320,27031,25289
2015/1/1,彰化縣,線西鄉,4300,17123,8869,8254
2015/1/1,彰化縣,伸港鄉,9472,36218,18547,17671
2015/1/1,彰化縣,福興鄉,12532,47807,24917,22890
2015/1/1,彰化縣,秀水鄉,10372,39340,20342,18998
2015/1/1,彰化縣,花壇鄉,13668,45897,23635,22262
2015/1/1,彰化縣,芬園鄉,6873,24131,12718,11413
2015/1/1,彰化縣,大村鄉,10750,36461,18908,17553
2015/1/1,彰化縣,埔鹽鄉,8972,33162,17408,15754
2015/1/1,彰化縣,埔心鄉,10325,34853,17993,16860
2015/1/1,彰化縣,永靖鄉,10793,38181,19887,18294
2015/1/1,彰化縣,社頭鄉,12714,43674,22465,21209
2015/1/1,彰化縣,二水鄉,5338,15821,8293,7528
2015/1/1,彰化縣,田尾鄉,7840,27801,14418,13383
2015/1/1,彰化縣,埤頭鄉,8882,31041,16152,14889
2015/1/1,彰化縣,芳苑鄉,10120,34683,18354,16329
2015/1/1,彰化縣,大城鄉,5336,17779,9641,8138
2015/1/1,彰化縣,竹塘鄉,4617,15846,8356,7490
2015/1/1,彰化縣,溪州鄉,8895,30709,16102,14607
2015/1/1,南投縣,南投市,34281,102356,51345,51011
2015/1/1,南投縣,埔里鎮,28856,82919,41654,41265
2015/1/1,南投縣,草屯鎮,32552,99183,50090,49093
2015/1/1,南投縣,竹山鎮,19959,56559,29066,27493
2015/1/1,南投縣,集集鎮,4382,11387,5956,5431
2015/1/1,南投縣,名間鄉,12549,40007,21014,18993
2015/1/1,南投縣,鹿谷鄉,7560,18521,9833,8688
2015/1/1,南投縣,中寮鄉,5638,15539,8455,7084
2015/1/1,南投縣,魚池鄉,5738,16496,8648,7848
2015/1/1,南投縣,國姓鄉,7287,19672,10636,9036
2015/1/1,南投縣,水里鄉,7212,18676,9796,8880
2015/1/1,南投縣,信義鄉,5241,16803,9031,7772
2015/1/1,南投縣,仁愛鄉,4943,15852,8177,7675
2015/1/1,雲林縣,斗六市,37064,108175,54056,54119
2015/1/1,雲林縣,斗南鎮,15734,45966,23351,22615
2015/1/1,雲林縣,虎尾鎮,24013,70367,35714,34653
2015/1/1,雲林縣,西螺鎮,14417,47157,23962,23195
2015/1/1,雲林縣,土庫鎮,9211,29646,15491,14155
2015/1/1,雲林縣,北港鎮,15959,41474,21555,19919
2015/1/1,雲林縣,古坑鄉,10928,32630,17209,15421
2015/1/1,雲林縣,大埤鄉,6753,19956,10718,9238
2015/1/1,雲林縣,莿桐鄉,9258,29572,15521,14051
2015/1/1,雲林縣,林內鄉,5907,18935,9903,9032
2015/1/1,雲林縣,二崙鄉,8943,28321,15170,13151
2015/1/1,雲林縣,崙背鄉,8502,25844,13640,12204
2015/1/1,雲林縣,麥寮鄉,13846,43937,22246,21691
2015/1/1,雲林縣,東勢鄉,5795,15807,8661,7146
2015/1/1,雲林縣,褒忠鄉,4404,13584,7283,6301
2015/1/1,雲林縣,臺西鄉,8778,24968,13414,11554
2015/1/1,雲林縣,元長鄉,9426,27232,14858,12374
2015/1/1,雲林縣,四湖鄉,8984,25309,13716,11593
2015/1/1,雲林縣,口湖鄉,9630,28954,15350,13604
2015/1/1,雲林縣,水林鄉,10244,26950,14772,12178
2015/1/1,嘉義縣,太保市,12174,37055,19077,17978
2015/1/1,嘉義縣,朴子市,15403,43240,21919,21321
2015/1/1,嘉義縣,布袋鎮,10115,28367,14527,13840
2015/1/1,嘉義縣,大林鎮,11380,32106,16458,15648
2015/1/1,嘉義縣,民雄鄉,24070,71929,36837,35092
2015/1/1,嘉義縣,溪口鄉,5421,15333,8189,7144
2015/1/1,嘉義縣,新港鄉,10588,33158,17553,15605
2015/1/1,嘉義縣,六腳鄉,9020,24562,13037,11525
2015/1/1,嘉義縣,東石鄉,9438,26184,13889,12295
2015/1/1,嘉義縣,義竹鄉,7558,19556,10171,9385
2015/1/1,嘉義縣,鹿草鄉,5812,16344,8755,7589
2015/1/1,嘉義縣,水上鄉,17857,50699,26188,24511
2015/1/1,嘉義縣,中埔鄉,15953,46119,24019,22100
2015/1/1,嘉義縣,竹崎鄉,11595,36870,19678,17192
2015/1/1,嘉義縣,梅山鄉,6761,20279,10767,9512
2015/1/1,嘉義縣,番路鄉,4306,12058,6522,5536
2015/1/1,嘉義縣,大埔鄉,1946,4662,2428,2234
2015/1/1,嘉義縣,阿里山鄉,1955,5755,3055,2700
2015/1/1,屏東縣,屏東市,73440,203809,101291,102518
2015/1/1,屏東縣,潮州鎮,18984,54731,27468,27263
2015/1/1,屏東縣,東港鎮,16247,48241,24401,23840
2015/1/1,屏東縣,恆春鎮,11216,30884,15796,15088
2015/1/1,屏東縣,萬丹鄉,14719,52034,26928,25106
2015/1/1,屏東縣,長治鄉,9959,30385,15862,14523
2015/1/1,屏東縣,麟洛鄉,3723,11310,5848,5462
2015/1/1,屏東縣,九如鄉,6766,22148,11472,10676
2015/1/1,屏東縣,里港鄉,8115,26813,13606,13207
2015/1/1,屏東縣,鹽埔鄉,7857,26621,13813,12808
2015/1/1,屏東縣,高樹鄉,9404,25482,13564,11918
2015/1/1,屏東縣,萬巒鄉,6454,20877,10963,9914
2015/1/1,屏東縣,內埔鄉,18424,56090,29101,26989
2015/1/1,屏東縣,竹田鄉,5634,17680,9392,8288
2015/1/1,屏東縣,新埤鄉,3442,10223,5429,4794
2015/1/1,屏東縣,枋寮鄉,8562,25472,13327,12145
2015/1/1,屏東縣,新園鄉,11746,36635,18972,17663
2015/1/1,屏東縣,崁頂鄉,4423,16350,8319,8031
2015/1/1,屏東縣,林邊鄉,7006,19188,9878,9310
2015/1/1,屏東縣,南州鄉,3667,10996,5624,5372
2015/1/1,屏東縣,佳冬鄉,7037,20228,10519,9709
2015/1/1,屏東縣,琉球鄉,4278,12643,6962,5681
2015/1/1,屏東縣,車城鄉,3496,9077,4885,4192
2015/1/1,屏東縣,滿州鄉,3025,8101,4437,3664
2015/1/1,屏東縣,枋山鄉,2126,5732,3044,2688
2015/1/1,屏東縣,三地門鄉,2280,7767,3927,3840
2015/1/1,屏東縣,霧臺鄉,1046,3417,1742,1675
2015/1/1,屏東縣,瑪家鄉,1964,6707,3439,3268
2015/1/1,屏東縣,泰武鄉,1286,5268,2754,2514
2015/1/1,屏東縣,來義鄉,2227,7645,3899,3746
2015/1/1,屏東縣,春日鄉,1346,4873,2504,2369
2015/1/1,屏東縣,獅子鄉,1510,4873,2512,2361
2015/1/1,屏東縣,牡丹鄉,1862,4855,2502,2353
2015/1/1,臺東縣,臺東市,38980,106908,53755,53153
2015/1/1,臺東縣,成功鎮,5449,14907,7887,7020
2015/1/1,臺東縣,關山鎮,3234,9089,4784,4305
2015/1/1,臺東縣,卑南鄉,6661,17674,9381,8293
2015/1/1,臺東縣,大武鄉,2523,6529,3385,3144
2015/1/1,臺東縣,太麻里鄉,4613,11486,6099,5387
2015/1/1,臺東縣,東河鄉,3751,8981,4958,4023
2015/1/1,臺東縣,長濱鄉,2930,7730,4384,3346
2015/1/1,臺東縣,鹿野鄉,3090,8183,4380,3803
2015/1/1,臺東縣,池上鄉,3260,8588,4511,4077
2015/1/1,臺東縣,綠島鄉,1103,3812,2008,1804
2015/1/1,臺東縣,延平鄉,1070,3613,1946,1667
2015/1/1,臺東縣,海端鄉,1090,4371,2338,2033
2015/1/1,臺東縣,達仁鄉,1462,3705,2019,1686
2015/1/1,臺東縣,金峰鄉,1111,3665,1892,1773
2015/1/1,臺東縣,蘭嶼鄉,1737,4977,2527,2450
2015/1/1,花蓮縣,花蓮市,41309,106393,51674,54719
2015/1/1,花蓮縣,鳳林鎮,4413,11216,5890,5326
2015/1/1,花蓮縣,玉里鎮,8937,25359,13570,11789
2015/1/1,花蓮縣,新城鄉,7536,20277,10462,9815
2015/1/1,花蓮縣,吉安鄉,31098,82589,41910,40679
2015/1/1,花蓮縣,壽豐鄉,7011,18231,9737,8494
2015/1/1,花蓮縣,光復鄉,5051,13381,7128,6253
2015/1/1,花蓮縣,豐濱鄉,1741,4684,2597,2087
2015/1/1,花蓮縣,瑞穗鄉,4656,12066,6489,5577
2015/1/1,花蓮縣,富里鄉,3992,10817,5899,4918
2015/1/1,花蓮縣,秀林鄉,4776,15509,8031,7478
2015/1/1,花蓮縣,萬榮鄉,2088,6525,3445,3080
2015/1/1,花蓮縣,卓溪鄉,1680,6193,3402,2791
2015/1/1,澎湖縣,馬公市,23054,60391,30699,29692
2015/1/1,澎湖縣,湖西鄉,5322,14308,7552,6756
2015/1/1,澎湖縣,白沙鄉,3341,9801,5128,4673
2015/1/1,澎湖縣,西嶼鄉,2931,8435,4339,4096
2015/1/1,澎湖縣,望安鄉,1989,5118,2750,2368
2015/1/1,澎湖縣,七美鄉,1322,3750,1961,1789
2015/1/1,基隆市,中正區,22484,53070,27198,25872
2015/1/1,基隆市,七堵區,20978,53989,27300,26689
2015/1/1,基隆市,暖暖區,15235,38203,19297,18906
2015/1/1,基隆市,仁愛區,19452,46214,22809,23405
2015/1/1,基隆市,中山區,19308,48672,24776,23896
2015/1/1,基隆市,安樂區,32257,81606,40624,40982
2015/1/1,基隆市,信義區,20876,51257,25545,25712
2015/1/1,新竹市,東區,75186,207081,102017,105064
2015/1/1,新竹市,北區,54359,148766,72989,75777
2015/1/1,新竹市,香山區,25751,76412,38927,37485
2015/1/1,嘉義市,東區,45176,123365,59857,63508
2015/1/1,嘉義市,西區,53111,147560,72547,75013
2015/1/1,金門縣,金城鎮,12452,41064,20608,20456
2015/1/1,金門縣,金湖鎮,8327,27476,13857,13619
2015/1/1,金門縣,金沙鎮,6035,19529,9667,9862
2015/1/1,金門縣,金寧鄉,7688,27408,13867,13541
2015/1/1,金門縣,烈嶼鄉,3013,12035,5939,6096
2015/1/1,金門縣,烏坵鄉,134,675,337,338
2015/1/1,連江縣,南竿鄉,1426,7518,4291,3227
2015/1/1,連江縣,北竿鄉,477,2321,1277,1044
2015/1/1,連江縣,莒光鄉,266,1431,836,595
2015/1/1,連江縣,東引鄉,307,1268,767,501
2015/2/1,總計,新北市,1498285,3967419,1951626,2015793
2015/2/1,總計,臺北市,1038197,2705113,1296676,1408437
2015/2/1,總計,桃園市,735193,2065966,1035775,1030191
2015/2/1,總計,臺中市,914122,2723479,1348443,1375036
2015/2/1,總計,臺南市,668730,1884863,944179,940684
2015/2/1,總計,高雄市,1066150,2779527,1383011,1396516
2015/2/1,總計,臺灣省,2432285,7178156,3669993,3508163
2015/2/1,總計,宜蘭縣,163078,458490,232700,225790
2015/2/1,總計,新竹縣,179594,537978,275462,262516
2015/2/1,總計,苗栗縣,183253,567004,292164,274840
2015/2/1,總計,彰化縣,378955,1291053,660395,630658
2015/2/1,總計,南投縣,176266,513696,263558,250138
2015/2/1,總計,雲林縣,237824,704241,366287,337954
2015/2/1,總計,嘉義縣,181337,523835,272846,250989
2015/2/1,總計,屏東縣,283321,846650,433937,412713
2015/2/1,總計,臺東縣,82119,224092,116186,107906
2015/2/1,總計,花蓮縣,124267,333070,170124,162946
2015/2/1,總計,澎湖縣,37977,101850,52462,49388
2015/2/1,總計,基隆市,150606,372956,187501,185455
2015/2/1,總計,新竹市,155394,432366,214017,218349
2015/2/1,總計,嘉義市,98294,270875,132354,138521
2015/2/1,總計,福建省,40176,141011,71572,69439
2015/2/1,總計,金門縣,37701,128477,64409,64068
2015/2/1,總計,連江縣,2475,12534,7163,5371
2015/2/1,新北市,板橋區,204882,555684,272112,283572
2015/2/1,新北市,三重區,147520,389112,192273,196839
2015/2/1,新北市,中和區,162421,415055,202897,212158
2015/2/1,新北市,永和區,90665,227066,108143,118923
2015/2/1,新北市,新莊區,147343,412079,202109,209970
2015/2/1,新北市,新店區,122900,299852,145118,154734
2015/2/1,新北市,樹林區,65056,184102,92072,92030
2015/2/1,新北市,鶯歌區,29269,89024,44607,44417
2015/2/1,新北市,三峽區,40429,111685,56314,55371
2015/2/1,新北市,淡水區,68479,159386,76828,82558
2015/2/1,新北市,汐止區,84225,195146,95659,99487
2015/2/1,新北市,瑞芳區,16084,41256,20850,20406
2015/2/1,新北市,土城區,85586,239265,118548,120717
2015/2/1,新北市,蘆洲區,68969,199745,98302,101443
2015/2/1,新北市,五股區,29356,82292,41517,40775
2015/2/1,新北市,泰山區,27727,78508,39086,39422
2015/2/1,新北市,林口區,38008,98063,47992,50071
2015/2/1,新北市,深坑區,9330,23590,11834,11756
2015/2/1,新北市,石碇區,3367,7861,4336,3525
2015/2/1,新北市,坪林區,2486,6486,3624,2862
2015/2/1,新北市,三芝區,9297,23508,12100,11408
2015/2/1,新北市,石門區,4286,12740,6631,6109
2015/2/1,新北市,八里區,13797,37255,18627,18628
2015/2/1,新北市,平溪區,2357,4947,2720,2227
2015/2/1,新北市,雙溪區,3835,9403,5057,4346
2015/2/1,新北市,貢寮區,4418,13070,6676,6394
2015/2/1,新北市,金山區,7013,22391,11107,11284
2015/2/1,新北市,萬里區,7382,22680,11428,11252
2015/2/1,新北市,烏來區,1798,6168,3059,3109
2015/2/1,臺北市,松山區,80091,210504,99405,111099
2015/2/1,臺北市,信義區,89194,229803,110232,119571
2015/2/1,臺北市,大安區,120245,313983,146975,167008
2015/2/1,臺北市,中山區,98484,230892,107803,123089
2015/2/1,臺北市,中正區,65159,163469,78177,85292
2015/2/1,臺北市,大同區,51219,131077,64071,67006
2015/2/1,臺北市,萬華區,78122,194893,96303,98590
2015/2/1,臺北市,文山區,103403,274276,132052,142224
2015/2/1,臺北市,南港區,45955,121414,59300,62114
2015/2/1,臺北市,內湖區,105525,286254,137198,149056
2015/2/1,臺北市,士林區,105661,290814,140642,150172
2015/2/1,臺北市,北投區,95139,257734,124518,133216
2015/2/1,桃園市,桃園區,156780,419079,204646,214433
2015/2/1,桃園市,中壢區,138928,383037,189954,193083
2015/2/1,桃園市,大溪區,30864,92116,47423,44693
2015/2/1,桃園市,楊梅區,53789,157769,80010,77759
2015/2/1,桃園市,蘆竹區,54206,151942,75900,76042
2015/2/1,桃園市,大園區,29979,84692,43550,41142
2015/2/1,桃園市,龜山區,54571,142496,71676,70820
2015/2/1,桃園市,八德區,63829,182188,91963,90225
2015/2/1,桃園市,龍潭區,39343,116559,58830,57729
2015/2/1,桃園市,平鎮區,72521,213358,106724,106634
2015/2/1,桃園市,新屋區,15565,48065,25731,22334
2015/2/1,桃園市,觀音區,21085,63731,33370,30361
2015/2/1,桃園市,復興區,3733,10934,5998,4936
2015/2/1,臺中市,中區,7837,19313,9608,9705
2015/2/1,臺中市,東區,27119,75002,37499,37503
2015/2/1,臺中市,南區,46043,120310,58013,62297
2015/2/1,臺中市,西區,44802,115829,55171,60658
2015/2/1,臺中市,北區,58250,147525,70964,76561
2015/2/1,臺中市,西屯區,80803,219049,105501,113548
2015/2/1,臺中市,南屯區,58536,162343,77979,84364
2015/2/1,臺中市,北屯區,92305,260437,125557,134880
2015/2/1,臺中市,豐原區,52215,166524,82453,84071
2015/2/1,臺中市,東勢區,17241,51444,26574,24870
2015/2/1,臺中市,大甲區,22538,77545,39187,38358
2015/2/1,臺中市,清水區,26062,85973,44232,41741
2015/2/1,臺中市,沙鹿區,27195,88020,44658,43362
2015/2/1,臺中市,梧棲區,16898,56682,28554,28128
2015/2/1,臺中市,后里區,15447,54113,27595,26518
2015/2/1,臺中市,神岡區,18722,64975,33313,31662
2015/2/1,臺中市,潭子區,34817,105394,52298,53096
2015/2/1,臺中市,大雅區,27995,92806,46453,46353
2015/2/1,臺中市,新社區,7488,25236,13147,12089
2015/2/1,臺中市,石岡區,4890,15371,7997,7374
2015/2/1,臺中市,外埔區,9302,31808,16347,15461
2015/2/1,臺中市,大安區,5356,19633,10362,9271
2015/2/1,臺中市,烏日區,22693,71623,36140,35483
2015/2/1,臺中市,大肚區,16697,56420,28905,27515
2015/2/1,臺中市,龍井區,22072,76178,38604,37574
2015/2/1,臺中市,霧峰區,19581,64500,32928,31572
2015/2/1,臺中市,太平區,60108,181975,90660,91315
2015/2/1,臺中市,大里區,66695,206646,101952,104694
2015/2/1,臺中市,和平區,4415,10805,5792,5013
2015/2/1,臺南市,新營區,28448,78288,38819,39469
2015/2/1,臺南市,鹽水區,10077,26284,13719,12565
2015/2/1,臺南市,白河區,10987,29671,15528,14143
2015/2/1,臺南市,柳營區,7838,21776,11346,10430
2015/2/1,臺南市,後壁區,8884,24498,12758,11740
2015/2/1,臺南市,東山區,8291,21865,11604,10261
2015/2/1,臺南市,麻豆區,15453,45053,22906,22147
2015/2/1,臺南市,下營區,9117,25056,12918,12138
2015/2/1,臺南市,六甲區,7708,22771,11782,10989
2015/2/1,臺南市,官田區,7791,21673,11083,10590
2015/2/1,臺南市,大內區,3960,10234,5451,4783
2015/2/1,臺南市,佳里區,20294,59522,29547,29975
2015/2/1,臺南市,學甲區,9663,26883,13758,13125
2015/2/1,臺南市,西港區,8041,24886,12605,12281
2015/2/1,臺南市,七股區,8105,23587,12272,11315
2015/2/1,臺南市,將軍區,7336,20509,10423,10086
2015/2/1,臺南市,北門區,4356,11658,5877,5781
2015/2/1,臺南市,新化區,14192,43741,22361,21380
2015/2/1,臺南市,善化區,16347,46230,23366,22864
2015/2/1,臺南市,新市區,11574,35592,17878,17714
2015/2/1,臺南市,安定區,9770,30292,15556,14736
2015/2/1,臺南市,山上區,2692,7498,3924,3574
2015/2/1,臺南市,玉井區,5114,14534,7554,6980
2015/2/1,臺南市,楠西區,3530,10112,5348,4764
2015/2/1,臺南市,南化區,2866,8976,4859,4117
2015/2/1,臺南市,左鎮區,1996,5167,2881,2286
2015/2/1,臺南市,仁德區,26580,73215,37272,35943
2015/2/1,臺南市,歸仁區,22007,67573,34347,33226
2015/2/1,臺南市,關廟區,10883,34834,18005,16829
2015/2/1,臺南市,龍崎區,1577,4277,2321,1956
2015/2/1,臺南市,永康區,81183,229010,113176,115834
2015/2/1,臺南市,東區,71917,190158,91431,98727
2015/2/1,臺南市,南區,44769,125758,62534,63224
2015/2/1,臺南市,北區,49748,132666,64883,67783
2015/2/1,臺南市,安南區,60246,188042,95128,92914
2015/2/1,臺南市,安平區,24591,65046,30983,34063
2015/2/1,臺南市,中西區,30799,77928,37976,39952
2015/2/1,高雄市,鹽埕區,10888,25379,12649,12730
2015/2/1,高雄市,鼓山區,55594,135910,65986,69924
2015/2/1,高雄市,左營區,77172,195820,94907,100913
2015/2/1,高雄市,楠梓區,66285,178746,88293,90453
2015/2/1,高雄市,三民區,134953,347528,168783,178745
2015/2/1,高雄市,新興區,22728,52517,25280,27237
2015/2/1,高雄市,前金區,12553,27728,13352,14376
2015/2/1,高雄市,苓雅區,72163,175691,84899,90792
2015/2/1,高雄市,前鎮區,78147,193717,95626,98091
2015/2/1,高雄市,旗津區,10977,28929,14996,13933
2015/2/1,高雄市,小港區,66084,156177,77901,78276
2015/2/1,高雄市,鳳山區,135814,354708,174769,179939
2015/2/1,高雄市,林園區,25426,70477,35819,34658
2015/2/1,高雄市,大寮區,40949,111269,57265,54004
2015/2/1,高雄市,大樹區,13324,43246,22217,21029
2015/2/1,高雄市,大社區,12665,34452,17544,16908
2015/2/1,高雄市,仁武區,30433,81163,41461,39702
2015/2/1,高雄市,鳥松區,17539,43800,22298,21502
2015/2/1,高雄市,岡山區,34473,97808,48663,49145
2015/2/1,高雄市,橋頭區,13204,37231,18983,18248
2015/2/1,高雄市,燕巢區,10344,30366,16110,14256
2015/2/1,高雄市,田寮區,3402,7617,4222,3395
2015/2/1,高雄市,阿蓮區,9388,29534,14898,14636
2015/2/1,高雄市,路竹區,16714,53062,27133,25929
2015/2/1,高雄市,湖內區,10397,29428,15075,14353
2015/2/1,高雄市,茄萣區,10444,30627,15844,14783
2015/2/1,高雄市,永安區,5800,14108,7087,7021
2015/2/1,高雄市,彌陀區,6740,19804,10246,9558
2015/2/1,高雄市,梓官區,12495,36459,18826,17633
2015/2/1,高雄市,旗山區,13844,38047,19753,18294
2015/2/1,高雄市,美濃區,14519,41120,21509,19611
2015/2/1,高雄市,六龜區,5652,13656,7376,6280
2015/2/1,高雄市,甲仙區,2373,6401,3392,3009
2015/2/1,高雄市,杉林區,4834,12509,6811,5698
2015/2/1,高雄市,內門區,5064,15133,8196,6937
2015/2/1,高雄市,茂林區,584,1900,938,962
2015/2/1,高雄市,桃源區,1320,4276,2254,2022
2015/2/1,高雄市,那瑪夏區,865,3184,1650,1534
2015/2/1,宜蘭縣,宜蘭市,35245,95865,46866,48999
2015/2/1,宜蘭縣,羅東鎮,25881,72569,34595,37974
2015/2/1,宜蘭縣,蘇澳鎮,13988,40975,20904,20071
2015/2/1,宜蘭縣,頭城鎮,10080,29863,15431,14432
2015/2/1,宜蘭縣,礁溪鄉,13359,35888,18737,17151
2015/2/1,宜蘭縣,壯圍鄉,8441,24417,12914,11503
2015/2/1,宜蘭縣,員山鄉,11367,32374,17217,15157
2015/2/1,宜蘭縣,冬山鄉,18592,53486,27530,25956
2015/2/1,宜蘭縣,五結鄉,14136,39318,20373,18945
2015/2/1,宜蘭縣,三星鄉,8203,21493,11595,9898
2015/2/1,宜蘭縣,大同鄉,1882,6127,3323,2804
2015/2/1,宜蘭縣,南澳鄉,1904,6115,3215,2900
2015/2/1,新竹縣,竹北市,58477,165877,82693,83184
2015/2/1,新竹縣,關西鎮,9531,30573,16308,14265
2015/2/1,新竹縣,新埔鎮,10613,34354,18271,16083
2015/2/1,新竹縣,竹東鎮,32328,96054,48310,47744
2015/2/1,新竹縣,湖口鄉,25255,77156,39216,37940
2015/2/1,新竹縣,橫山鄉,4515,13739,7450,6289
2015/2/1,新竹縣,新豐鄉,17496,55947,28715,27232
2015/2/1,新竹縣,芎林鄉,6437,20299,10740,9559
2015/2/1,新竹縣,寶山鄉,5127,14314,7738,6576
2015/2/1,新竹縣,北埔鄉,3138,9784,5267,4517
2015/2/1,新竹縣,峨眉鄉,2088,5716,3170,2546
2015/2/1,新竹縣,尖石鄉,2838,9457,5023,4434
2015/2/1,新竹縣,五峰鄉,1751,4708,2561,2147
2015/2/1,苗栗縣,苗栗市,30569,90920,45459,45461
2015/2/1,苗栗縣,苑裡鎮,14414,48569,25164,23405
2015/2/1,苗栗縣,通霄鎮,11562,36815,19401,17414
2015/2/1,苗栗縣,竹南鎮,27306,83765,42307,41458
2015/2/1,苗栗縣,頭份市,33130,102884,51953,50931
2015/2/1,苗栗縣,後龍鎮,11878,38293,20150,18143
2015/2/1,苗栗縣,卓蘭鎮,6136,18343,9601,8742
2015/2/1,苗栗縣,大湖鄉,5424,15474,8210,7264
2015/2/1,苗栗縣,公館鄉,10646,34809,18058,16751
2015/2/1,苗栗縣,銅鑼鄉,6141,18873,9994,8879
2015/2/1,苗栗縣,南庄鄉,3973,10657,5854,4803
2015/2/1,苗栗縣,頭屋鄉,3653,11390,5989,5401
2015/2/1,苗栗縣,三義鄉,5468,17219,9002,8217
2015/2/1,苗栗縣,西湖鄉,2688,7580,4209,3371
2015/2/1,苗栗縣,造橋鄉,4139,13444,7056,6388
2015/2/1,苗栗縣,三灣鄉,2423,7106,3872,3234
2015/2/1,苗栗縣,獅潭鄉,1734,4704,2608,2096
2015/2/1,苗栗縣,泰安鄉,1969,6159,3277,2882
2015/2/1,彰化縣,彰化市,74942,235061,116575,118486
2015/2/1,彰化縣,鹿港鎮,23740,86112,43909,42203
2015/2/1,彰化縣,和美鎮,25956,90791,46438,44353
2015/2/1,彰化縣,北斗鎮,10407,33223,16769,16454
2015/2/1,彰化縣,員林市,38372,124747,62329,62418
2015/2/1,彰化縣,溪湖鎮,15968,55768,28389,27379
2015/2/1,彰化縣,田中鎮,12926,42682,22085,20597
2015/2/1,彰化縣,二林鎮,14823,52290,27001,25289
2015/2/1,彰化縣,線西鄉,4300,17101,8867,8234
2015/2/1,彰化縣,伸港鄉,9480,36237,18542,17695
2015/2/1,彰化縣,福興鄉,12536,47816,24908,22908
2015/2/1,彰化縣,秀水鄉,10378,39319,20328,18991
2015/2/1,彰化縣,花壇鄉,13669,45913,23650,22263
2015/2/1,彰化縣,芬園鄉,6872,24132,12723,11409
2015/2/1,彰化縣,大村鄉,10751,36412,18866,17546
2015/2/1,彰化縣,埔鹽鄉,8971,33159,17416,15743
2015/2/1,彰化縣,埔心鄉,10321,34880,18010,16870
2015/2/1,彰化縣,永靖鄉,10795,38180,19882,18298
2015/2/1,彰化縣,社頭鄉,12714,43672,22459,21213
2015/2/1,彰化縣,二水鄉,5339,15795,8280,7515
2015/2/1,彰化縣,田尾鄉,7841,27774,14398,13376
2015/2/1,彰化縣,埤頭鄉,8885,31031,16148,14883
2015/2/1,彰化縣,芳苑鄉,10123,34656,18332,16324
2015/2/1,彰化縣,大城鄉,5333,17780,9646,8134
2015/2/1,彰化縣,竹塘鄉,4617,15833,8356,7477
2015/2/1,彰化縣,溪州鄉,8896,30689,16089,14600
2015/2/1,南投縣,南投市,34295,102295,51300,50995
2015/2/1,南投縣,埔里鎮,28881,82879,41633,41246
2015/2/1,南投縣,草屯鎮,32555,99201,50107,49094
2015/2/1,南投縣,竹山鎮,19957,56505,29035,27470
2015/2/1,南投縣,集集鎮,4382,11376,5945,5431
2015/2/1,南投縣,名間鄉,12551,39995,21009,18986
2015/2/1,南投縣,鹿谷鄉,7576,18507,9840,8667
2015/2/1,南投縣,中寮鄉,5643,15522,8445,7077
2015/2/1,南投縣,魚池鄉,5737,16502,8654,7848
2015/2/1,南投縣,國姓鄉,7291,19658,10624,9034
2015/2/1,南投縣,水里鄉,7206,18645,9776,8869
2015/2/1,南投縣,信義鄉,5246,16775,9023,7752
2015/2/1,南投縣,仁愛鄉,4946,15836,8167,7669
2015/2/1,雲林縣,斗六市,37110,108209,54063,54146
2015/2/1,雲林縣,斗南鎮,15729,45968,23353,22615
2015/2/1,雲林縣,虎尾鎮,24035,70369,35697,34672
2015/2/1,雲林縣,西螺鎮,14437,47153,23955,23198
2015/2/1,雲林縣,土庫鎮,9214,29642,15488,14154
2015/2/1,雲林縣,北港鎮,15952,41414,21516,19898
2015/2/1,雲林縣,古坑鄉,10918,32589,17183,15406
2015/2/1,雲林縣,大埤鄉,6745,19929,10710,9219
2015/2/1,雲林縣,莿桐鄉,9252,29517,15503,14014
2015/2/1,雲林縣,林內鄉,5901,18886,9871,9015
2015/2/1,雲林縣,二崙鄉,8960,28312,15172,13140
2015/2/1,雲林縣,崙背鄉,8505,25822,13633,12189
2015/2/1,雲林縣,麥寮鄉,13845,43940,22245,21695
2015/2/1,雲林縣,東勢鄉,5782,15756,8638,7118
2015/2/1,雲林縣,褒忠鄉,4400,13563,7272,6291
2015/2/1,雲林縣,臺西鄉,8770,24935,13387,11548
2015/2/1,雲林縣,元長鄉,9420,27177,14833,12344
2015/2/1,雲林縣,四湖鄉,8983,25238,13689,11549
2015/2/1,雲林縣,口湖鄉,9629,28911,15326,13585
2015/2/1,雲林縣,水林鄉,10237,26911,14753,12158
2015/2/1,嘉義縣,太保市,12188,37089,19090,17999
2015/2/1,嘉義縣,朴子市,15406,43220,21917,21303
2015/2/1,嘉義縣,布袋鎮,10103,28312,14494,13818
2015/2/1,嘉義縣,大林鎮,11380,32058,16426,15632
2015/2/1,嘉義縣,民雄鄉,24095,71951,36841,35110
2015/2/1,嘉義縣,溪口鄉,5412,15302,8174,7128
2015/2/1,嘉義縣,新港鄉,10583,33121,17537,15584
2015/2/1,嘉義縣,六腳鄉,9014,24496,13007,11489
2015/2/1,嘉義縣,東石鄉,9423,26143,13868,12275
2015/2/1,嘉義縣,義竹鄉,7552,19517,10141,9376
2015/2/1,嘉義縣,鹿草鄉,5809,16328,8749,7579
2015/2/1,嘉義縣,水上鄉,17858,50673,26193,24480
2015/2/1,嘉義縣,中埔鄉,15942,46062,23991,22071
2015/2/1,嘉義縣,竹崎鄉,11608,36854,19672,17182
2015/2/1,嘉義縣,梅山鄉,6762,20252,10756,9496
2015/2/1,嘉義縣,番路鄉,4308,12053,6521,5532
2015/2/1,嘉義縣,大埔鄉,1944,4653,2419,2234
2015/2/1,嘉義縣,阿里山鄉,1950,5751,3050,2701
2015/2/1,屏東縣,屏東市,73439,203708,101243,102465
2015/2/1,屏東縣,潮州鎮,19002,54754,27472,27282
2015/2/1,屏東縣,東港鎮,16262,48194,24390,23804
2015/2/1,屏東縣,恆春鎮,11219,30866,15779,15087
2015/2/1,屏東縣,萬丹鄉,14729,52030,26926,25104
2015/2/1,屏東縣,長治鄉,9965,30355,15852,14503
2015/2/1,屏東縣,麟洛鄉,3723,11299,5848,5451
2015/2/1,屏東縣,九如鄉,6780,22152,11469,10683
2015/2/1,屏東縣,里港鄉,8117,26825,13622,13203
2015/2/1,屏東縣,鹽埔鄉,7855,26612,13811,12801
2015/2/1,屏東縣,高樹鄉,9397,25461,13554,11907
2015/2/1,屏東縣,萬巒鄉,6453,20866,10946,9920
2015/2/1,屏東縣,內埔鄉,18414,56042,29069,26973
2015/2/1,屏東縣,竹田鄉,5638,17668,9381,8287
2015/2/1,屏東縣,新埤鄉,3433,10210,5424,4786
2015/2/1,屏東縣,枋寮鄉,8567,25469,13324,12145
2015/2/1,屏東縣,新園鄉,11750,36602,18959,17643
2015/2/1,屏東縣,崁頂鄉,4422,16326,8303,8023
2015/2/1,屏東縣,林邊鄉,7003,19148,9854,9294
2015/2/1,屏東縣,南州鄉,3665,10992,5622,5370
2015/2/1,屏東縣,佳冬鄉,7038,20207,10510,9697
2015/2/1,屏東縣,琉球鄉,4285,12632,6964,5668
2015/2/1,屏東縣,車城鄉,3488,9064,4876,4188
2015/2/1,屏東縣,滿州鄉,3025,8093,4435,3658
2015/2/1,屏東縣,枋山鄉,2125,5720,3039,2681
2015/2/1,屏東縣,三地門鄉,2281,7764,3926,3838
2015/2/1,屏東縣,霧臺鄉,1047,3415,1743,1672
2015/2/1,屏東縣,瑪家鄉,1969,6710,3435,3275
2015/2/1,屏東縣,泰武鄉,1286,5265,2757,2508
2015/2/1,屏東縣,來義鄉,2229,7629,3895,3734
2015/2/1,屏東縣,春日鄉,1344,4856,2496,2360
2015/2/1,屏東縣,獅子鄉,1509,4868,2511,2357
2015/2/1,屏東縣,牡丹鄉,1862,4848,2502,2346
2015/2/1,臺東縣,臺東市,39030,106916,53771,53145
2015/2/1,臺東縣,成功鎮,5443,14887,7881,7006
2015/2/1,臺東縣,關山鎮,3234,9074,4772,4302
2015/2/1,臺東縣,卑南鄉,6659,17667,9373,8294
2015/2/1,臺東縣,大武鄉,2520,6515,3373,3142
2015/2/1,臺東縣,太麻里鄉,4613,11455,6084,5371
2015/2/1,臺東縣,東河鄉,3757,8966,4953,4013
2015/2/1,臺東縣,長濱鄉,2935,7730,4386,3344
2015/2/1,臺東縣,鹿野鄉,3088,8192,4386,3806
2015/2/1,臺東縣,池上鄉,3256,8570,4494,4076
2015/2/1,臺東縣,綠島鄉,1106,3823,2011,1812
2015/2/1,臺東縣,延平鄉,1071,3611,1945,1666
2015/2/1,臺東縣,海端鄉,1090,4349,2328,2021
2015/2/1,臺東縣,達仁鄉,1459,3695,2013,1682
2015/2/1,臺東縣,金峰鄉,1113,3661,1888,1773
2015/2/1,臺東縣,蘭嶼鄉,1745,4981,2528,2453
2015/2/1,花蓮縣,花蓮市,41292,106322,51658,54664
2015/2/1,花蓮縣,鳳林鎮,4412,11219,5882,5337
2015/2/1,花蓮縣,玉里鎮,8940,25320,13552,11768
2015/2/1,花蓮縣,新城鄉,7538,20248,10440,9808
2015/2/1,花蓮縣,吉安鄉,31112,82629,41923,40706
2015/2/1,花蓮縣,壽豐鄉,7015,18208,9722,8486
2015/2/1,花蓮縣,光復鄉,5036,13366,7110,6256
2015/2/1,花蓮縣,豐濱鄉,1742,4682,2594,2088
2015/2/1,花蓮縣,瑞穗鄉,4654,12060,6483,5577
2015/2/1,花蓮縣,富里鄉,3989,10806,5894,4912
2015/2/1,花蓮縣,秀林鄉,4769,15517,8036,7481
2015/2/1,花蓮縣,萬榮鄉,2087,6513,3435,3078
2015/2/1,花蓮縣,卓溪鄉,1681,6180,3395,2785
2015/2/1,澎湖縣,馬公市,23071,60454,30737,29717
2015/2/1,澎湖縣,湖西鄉,5322,14319,7561,6758
2015/2/1,澎湖縣,白沙鄉,3338,9786,5123,4663
2015/2/1,澎湖縣,西嶼鄉,2934,8432,4333,4099
2015/2/1,澎湖縣,望安鄉,1991,5107,2746,2361
2015/2/1,澎湖縣,七美鄉,1321,3752,1962,1790
2015/2/1,基隆市,中正區,22475,53052,27188,25864
2015/2/1,基隆市,七堵區,20988,54006,27308,26698
2015/2/1,基隆市,暖暖區,15236,38196,19289,18907
2015/2/1,基隆市,仁愛區,19437,46161,22785,23376
2015/2/1,基隆市,中山區,19302,48655,24765,23890
2015/2/1,基隆市,安樂區,32283,81619,40627,40992
2015/2/1,基隆市,信義區,20885,51267,25539,25728
2015/2/1,新竹市,東區,75259,207218,102107,105111
2015/2/1,新竹市,北區,54377,148757,72997,75760
2015/2/1,新竹市,香山區,25758,76391,38913,37478
2015/2/1,嘉義市,東區,45184,123342,59826,63516
2015/2/1,嘉義市,西區,53110,147533,72528,75005
2015/2/1,金門縣,金城鎮,12451,41110,20629,20481
2015/2/1,金門縣,金湖鎮,8336,27516,13879,13637
2015/2/1,金門縣,金沙鎮,6050,19595,9694,9901
2015/2/1,金門縣,金寧鄉,7712,27520,13922,13598
2015/2/1,金門縣,烈嶼鄉,3018,12066,5950,6116
2015/2/1,金門縣,烏坵鄉,134,670,335,335
2015/2/1,連江縣,南竿鄉,1425,7523,4292,3231
2015/2/1,連江縣,北竿鄉,477,2313,1273,1040
2015/2/1,連江縣,莒光鄉,266,1431,833,598
2015/2/1,連江縣,東引鄉,307,1267,765,502
2015/3/1,總計,新北市,1499369,3965649,1950623,2015026
2015/3/1,總計,臺北市,1039180,2705958,1297022,1408936
2015/3/1,總計,桃園市,737120,2072736,1038857,1033879
2015/3/1,總計,臺中市,915732,2725497,1349271,1376226
2015/3/1,總計,臺南市,669249,1885106,944216,940890
2015/3/1,總計,高雄市,1066924,2779136,1382597,1396539
2015/3/1,總計,臺灣省,2434209,7173777,3667497,3506280
2015/3/1,總計,宜蘭縣,163291,458370,232647,225723
2015/3/1,總計,新竹縣,179934,538071,275524,262547
2015/3/1,總計,苗栗縣,183375,566585,291916,274669
2015/3/1,總計,彰化縣,379250,1290495,660038,630457
2015/3/1,總計,南投縣,176393,513092,263215,249877
2015/3/1,總計,雲林縣,237911,703407,365843,337564
2015/3/1,總計,嘉義縣,181389,523162,272478,250684
2015/3/1,總計,屏東縣,283395,845779,433494,412285
2015/3/1,總計,臺東縣,82166,223831,116071,107760
2015/3/1,總計,花蓮縣,124373,332837,169974,162863
2015/3/1,總計,澎湖縣,38049,101856,52452,49404
2015/3/1,總計,基隆市,150689,372969,187496,185473
2015/3/1,總計,新竹市,155585,432456,214029,218427
2015/3/1,總計,嘉義市,98409,270867,132320,138547
2015/3/1,總計,福建省,40321,141428,71761,69667
2015/3/1,總計,金門縣,37838,128924,64625,64299
2015/3/1,總計,連江縣,2483,12504,7136,5368
2015/3/1,新北市,板橋區,205021,555452,271962,283490
2015/3/1,新北市,三重區,147554,388733,192029,196704
2015/3/1,新北市,中和區,162467,414845,202830,212015
2015/3/1,新北市,永和區,90664,226948,108069,118879
2015/3/1,新北市,新莊區,147526,412116,202107,210009
2015/3/1,新北市,新店區,122989,299663,144995,154668
2015/3/1,新北市,樹林區,65067,183967,91995,91972
2015/3/1,新北市,鶯歌區,29257,88709,44465,44244
2015/3/1,新北市,三峽區,40519,111764,56336,55428
2015/3/1,新北市,淡水區,68664,159626,76953,82673
2015/3/1,新北市,汐止區,84280,195113,95615,99498
2015/3/1,新北市,瑞芳區,16069,41159,20806,20353
2015/3/1,新北市,土城區,85615,239101,118471,120630
2015/3/1,新北市,蘆洲區,69005,199648,98284,101364
2015/3/1,新北市,五股區,29385,82269,41517,40752
2015/3/1,新北市,泰山區,27754,78484,39046,39438
2015/3/1,新北市,林口區,38155,98362,48125,50237
2015/3/1,新北市,深坑區,9332,23574,11829,11745
2015/3/1,新北市,石碇區,3370,7859,4336,3523
2015/3/1,新北市,坪林區,2487,6486,3619,2867
2015/3/1,新北市,三芝區,9293,23472,12082,11390
2015/3/1,新北市,石門區,4290,12692,6603,6089
2015/3/1,新北市,八里區,13815,37213,18604,18609
2015/3/1,新北市,平溪區,2354,4931,2718,2213
2015/3/1,新北市,雙溪區,3835,9370,5053,4317
2015/3/1,新北市,貢寮區,4415,13013,6647,6366
2015/3/1,新北市,金山區,7009,22327,11073,11254
2015/3/1,新北市,萬里區,7381,22611,11404,11207
2015/3/1,新北市,烏來區,1797,6142,3050,3092
2015/3/1,臺北市,松山區,80185,210653,99496,111157
2015/3/1,臺北市,信義區,89230,229716,110175,119541
2015/3/1,臺北市,大安區,120315,314227,147071,167156
2015/3/1,臺北市,中山區,98580,230867,107768,123099
2015/3/1,臺北市,中正區,65209,163577,78220,85357
2015/3/1,臺北市,大同區,51310,131141,64110,67031
2015/3/1,臺北市,萬華區,78135,194720,96203,98517
2015/3/1,臺北市,文山區,103562,274423,132122,142301
2015/3/1,臺北市,南港區,45982,121439,59321,62118
2015/3/1,臺北市,內湖區,105674,286424,137269,149155
2015/3/1,臺北市,士林區,105790,290875,140709,150166
2015/3/1,臺北市,北投區,95208,257896,124558,133338
2015/3/1,桃園市,桃園區,157207,420784,205358,215426
2015/3/1,桃園市,中壢區,139261,384252,190564,193688
2015/3/1,桃園市,大溪區,30926,92394,47522,44872
2015/3/1,桃園市,楊梅區,53924,158220,80206,78014
2015/3/1,桃園市,蘆竹區,54350,152453,76144,76309
2015/3/1,桃園市,大園區,30049,84776,43583,41193
2015/3/1,桃園市,龜山區,54716,142924,71892,71032
2015/3/1,桃園市,八德區,64052,182879,92287,90592
2015/3/1,桃園市,龍潭區,39440,116867,58967,57900
2015/3/1,桃園市,平鎮區,72740,214232,107112,107120
2015/3/1,桃園市,新屋區,15595,48169,25787,22382
2015/3/1,桃園市,觀音區,21126,63861,33441,30420
2015/3/1,桃園市,復興區,3734,10925,5994,4931
2015/3/1,臺中市,中區,7839,19302,9598,9704
2015/3/1,臺中市,東區,27149,75038,37522,37516
2015/3/1,臺中市,南區,46134,120496,58080,62416
2015/3/1,臺中市,西區,44854,115827,55185,60642
2015/3/1,臺中市,北區,58255,147445,70900,76545
2015/3/1,臺中市,西屯區,80973,219362,105666,113696
2015/3/1,臺中市,南屯區,58677,162539,78037,84502
2015/3/1,臺中市,北屯區,92656,261119,125887,135232
2015/3/1,臺中市,豐原區,52277,166611,82485,84126
2015/3/1,臺中市,東勢區,17233,51402,26556,24846
2015/3/1,臺中市,大甲區,22547,77573,39188,38385
2015/3/1,臺中市,清水區,26074,85934,44208,41726
2015/3/1,臺中市,沙鹿區,27248,88148,44722,43426
2015/3/1,臺中市,梧棲區,16933,56733,28586,28147
2015/3/1,臺中市,后里區,15477,54109,27586,26523
2015/3/1,臺中市,神岡區,18731,64970,33296,31674
2015/3/1,臺中市,潭子區,34902,105507,52364,53143
2015/3/1,臺中市,大雅區,28077,92943,46514,46429
2015/3/1,臺中市,新社區,7498,25229,13131,12098
2015/3/1,臺中市,石岡區,4891,15340,7983,7357
2015/3/1,臺中市,外埔區,9306,31749,16318,15431
2015/3/1,臺中市,大安區,5361,19598,10351,9247
2015/3/1,臺中市,烏日區,22731,71694,36175,35519
2015/3/1,臺中市,大肚區,16718,56359,28879,27480
2015/3/1,臺中市,龍井區,22099,76151,38582,37569
2015/3/1,臺中市,霧峰區,19614,64499,32920,31579
2015/3/1,臺中市,太平區,60248,182249,90777,91472
2015/3/1,臺中市,大里區,66816,206789,101997,104792
2015/3/1,臺中市,和平區,4414,10782,5778,5004
2015/3/1,臺南市,新營區,28458,78346,38844,39502
2015/3/1,臺南市,鹽水區,10071,26235,13690,12545
2015/3/1,臺南市,白河區,10979,29635,15504,14131
2015/3/1,臺南市,柳營區,7838,21723,11313,10410
2015/3/1,臺南市,後壁區,8891,24494,12746,11748
2015/3/1,臺南市,東山區,8284,21828,11578,10250
2015/3/1,臺南市,麻豆區,15471,45070,22908,22162
2015/3/1,臺南市,下營區,9112,25013,12899,12114
2015/3/1,臺南市,六甲區,7706,22750,11766,10984
2015/3/1,臺南市,官田區,7787,21633,11066,10567
2015/3/1,臺南市,大內區,3961,10235,5454,4781
2015/3/1,臺南市,佳里區,20316,59593,29594,29999
2015/3/1,臺南市,學甲區,9654,26823,13728,13095
2015/3/1,臺南市,西港區,8050,24881,12611,12270
2015/3/1,臺南市,七股區,8106,23545,12237,11308
2015/3/1,臺南市,將軍區,7333,20468,10409,10059
2015/3/1,臺南市,北門區,4353,11616,5854,5762
2015/3/1,臺南市,新化區,14206,43757,22352,21405
2015/3/1,臺南市,善化區,16391,46350,23433,22917
2015/3/1,臺南市,新市區,11609,35661,17910,17751
2015/3/1,臺南市,安定區,9784,30278,15541,14737
2015/3/1,臺南市,山上區,2693,7496,3923,3573
2015/3/1,臺南市,玉井區,5118,14524,7551,6973
2015/3/1,臺南市,楠西區,3530,10113,5348,4765
2015/3/1,臺南市,南化區,2864,8949,4846,4103
2015/3/1,臺南市,左鎮區,1993,5137,2866,2271
2015/3/1,臺南市,仁德區,26605,73195,37268,35927
2015/3/1,臺南市,歸仁區,22030,67613,34368,33245
2015/3/1,臺南市,關廟區,10885,34806,17981,16825
2015/3/1,臺南市,龍崎區,1577,4266,2318,1948
2015/3/1,臺南市,永康區,81307,229330,113335,115995
2015/3/1,臺南市,東區,71951,190086,91411,98675
2015/3/1,臺南市,南區,44788,125798,62540,63258
2015/3/1,臺南市,北區,49756,132620,64857,67763
2015/3/1,臺南市,安南區,60341,188225,95200,93025
2015/3/1,臺南市,安平區,24618,65093,30984,34109
2015/3/1,臺南市,中西區,30833,77921,37983,39938
2015/3/1,高雄市,鹽埕區,10874,25363,12636,12727
2015/3/1,高雄市,鼓山區,55659,136048,66062,69986
2015/3/1,高雄市,左營區,77242,195932,94953,100979
2015/3/1,高雄市,楠梓區,66391,178785,88271,90514
2015/3/1,高雄市,三民區,135043,347554,168770,178784
2015/3/1,高雄市,新興區,22740,52446,25249,27197
2015/3/1,高雄市,前金區,12539,27651,13300,14351
2015/3/1,高雄市,苓雅區,72151,175464,84785,90679
2015/3/1,高雄市,前鎮區,78194,193601,95540,98061
2015/3/1,高雄市,旗津區,10991,28887,14987,13900
2015/3/1,高雄市,小港區,66094,156086,77848,78238
2015/3/1,高雄市,鳳山區,136004,354976,174852,180124
2015/3/1,高雄市,林園區,25428,70451,35795,34656
2015/3/1,高雄市,大寮區,41011,111332,57273,54059
2015/3/1,高雄市,大樹區,13331,43222,22216,21006
2015/3/1,高雄市,大社區,12664,34448,17541,16907
2015/3/1,高雄市,仁武區,30498,81194,41460,39734
2015/3/1,高雄市,鳥松區,17527,43748,22271,21477
2015/3/1,高雄市,岡山區,34477,97794,48648,49146
2015/3/1,高雄市,橋頭區,13217,37299,19013,18286
2015/3/1,高雄市,燕巢區,10338,30313,16082,14231
2015/3/1,高雄市,田寮區,3403,7613,4215,3398
2015/3/1,高雄市,阿蓮區,9387,29508,14883,14625
2015/3/1,高雄市,路竹區,16750,53028,27123,25905
2015/3/1,高雄市,湖內區,10419,29454,15068,14386
2015/3/1,高雄市,茄萣區,10445,30591,15834,14757
2015/3/1,高雄市,永安區,5796,14084,7071,7013
2015/3/1,高雄市,彌陀區,6753,19786,10235,9551
2015/3/1,高雄市,梓官區,12499,36424,18827,17597
2015/3/1,高雄市,旗山區,13841,38002,19718,18284
2015/3/1,高雄市,美濃區,14544,41101,21503,19598
2015/3/1,高雄市,六龜區,5645,13628,7361,6267
2015/3/1,高雄市,甲仙區,2373,6370,3383,2987
2015/3/1,高雄市,杉林區,4826,12493,6806,5687
2015/3/1,高雄市,內門區,5063,15123,8190,6933
2015/3/1,高雄市,茂林區,580,1888,934,954
2015/3/1,高雄市,桃源區,1323,4277,2252,2025
2015/3/1,高雄市,那瑪夏區,864,3172,1642,1530
2015/3/1,宜蘭縣,宜蘭市,35287,95913,46872,49041
2015/3/1,宜蘭縣,羅東鎮,25907,72554,34578,37976
2015/3/1,宜蘭縣,蘇澳鎮,14004,40928,20892,20036
2015/3/1,宜蘭縣,頭城鎮,10095,29862,15433,14429
2015/3/1,宜蘭縣,礁溪鄉,13372,35824,18722,17102
2015/3/1,宜蘭縣,壯圍鄉,8449,24401,12914,11487
2015/3/1,宜蘭縣,員山鄉,11371,32317,17182,15135
2015/3/1,宜蘭縣,冬山鄉,18621,53522,27555,25967
2015/3/1,宜蘭縣,五結鄉,14174,39349,20392,18957
2015/3/1,宜蘭縣,三星鄉,8225,21471,11579,9892
2015/3/1,宜蘭縣,大同鄉,1881,6124,3323,2801
2015/3/1,宜蘭縣,南澳鄉,1905,6105,3205,2900
2015/3/1,新竹縣,竹北市,58690,166303,82924,83379
2015/3/1,新竹縣,關西鎮,9518,30476,16249,14227
2015/3/1,新竹縣,新埔鎮,10615,34275,18246,16029
2015/3/1,新竹縣,竹東鎮,32345,96064,48307,47757
2015/3/1,新竹縣,湖口鄉,25302,77105,39189,37916
2015/3/1,新竹縣,橫山鄉,4506,13691,7431,6260
2015/3/1,新竹縣,新豐鄉,17552,55990,28730,27260
2015/3/1,新竹縣,芎林鄉,6449,20297,10738,9559
2015/3/1,新竹縣,寶山鄉,5143,14313,7747,6566
2015/3/1,新竹縣,北埔鄉,3138,9784,5265,4519
2015/3/1,新竹縣,峨眉鄉,2085,5689,3156,2533
2015/3/1,新竹縣,尖石鄉,2845,9417,4997,4420
2015/3/1,新竹縣,五峰鄉,1746,4667,2545,2122
2015/3/1,苗栗縣,苗栗市,30599,90877,45427,45450
2015/3/1,苗栗縣,苑裡鎮,14431,48503,25115,23388
2015/3/1,苗栗縣,通霄鎮,11543,36708,19339,17369
2015/3/1,苗栗縣,竹南鎮,27353,83834,42334,41500
2015/3/1,苗栗縣,頭份市,33184,102936,51960,50976
2015/3/1,苗栗縣,後龍鎮,11877,38253,20136,18117
2015/3/1,苗栗縣,卓蘭鎮,6142,18299,9577,8722
2015/3/1,苗栗縣,大湖鄉,5417,15434,8188,7246
2015/3/1,苗栗縣,公館鄉,10646,34779,18042,16737
2015/3/1,苗栗縣,銅鑼鄉,6137,18828,9976,8852
2015/3/1,苗栗縣,南庄鄉,3972,10639,5846,4793
2015/3/1,苗栗縣,頭屋鄉,3654,11376,5978,5398
2015/3/1,苗栗縣,三義鄉,5465,17197,8997,8200
2015/3/1,苗栗縣,西湖鄉,2690,7559,4199,3360
2015/3/1,苗栗縣,造橋鄉,4141,13451,7068,6383
2015/3/1,苗栗縣,三灣鄉,2420,7082,3866,3216
2015/3/1,苗栗縣,獅潭鄉,1732,4685,2600,2085
2015/3/1,苗栗縣,泰安鄉,1972,6145,3268,2877
2015/3/1,彰化縣,彰化市,74965,235111,116559,118552
2015/3/1,彰化縣,鹿港鎮,23797,86179,43923,42256
2015/3/1,彰化縣,和美鎮,25979,90781,46407,44374
2015/3/1,彰化縣,北斗鎮,10421,33203,16764,16439
2015/3/1,彰化縣,員林市,38410,124723,62299,62424
2015/3/1,彰化縣,溪湖鎮,15986,55791,28389,27402
2015/3/1,彰化縣,田中鎮,12930,42638,22062,20576
2015/3/1,彰化縣,二林鎮,14816,52213,26963,25250
2015/3/1,彰化縣,線西鄉,4312,17095,8858,8237
2015/3/1,彰化縣,伸港鄉,9490,36236,18536,17700
2015/3/1,彰化縣,福興鄉,12524,47747,24888,22859
2015/3/1,彰化縣,秀水鄉,10387,39333,20333,19000
2015/3/1,彰化縣,花壇鄉,13671,45906,23651,22255
2015/3/1,彰化縣,芬園鄉,6872,24085,12703,11382
2015/3/1,彰化縣,大村鄉,10773,36397,18872,17525
2015/3/1,彰化縣,埔鹽鄉,8981,33131,17386,15745
2015/3/1,彰化縣,埔心鄉,10346,34907,18020,16887
2015/3/1,彰化縣,永靖鄉,10802,38145,19864,18281
2015/3/1,彰化縣,社頭鄉,12735,43631,22447,21184
2015/3/1,彰化縣,二水鄉,5339,15766,8260,7506
2015/3/1,彰化縣,田尾鄉,7857,27746,14386,13360
2015/3/1,彰化縣,埤頭鄉,8894,30986,16133,14853
2015/3/1,彰化縣,芳苑鄉,10120,34575,18293,16282
2015/3/1,彰化縣,大城鄉,5330,17724,9620,8104
2015/3/1,彰化縣,竹塘鄉,4619,15788,8334,7454
2015/3/1,彰化縣,溪州鄉,8894,30658,16088,14570
2015/3/1,南投縣,南投市,34320,102283,51289,50994
2015/3/1,南投縣,埔里鎮,28915,82808,41581,41227
2015/3/1,南投縣,草屯鎮,32566,99101,50064,49037
2015/3/1,南投縣,竹山鎮,19971,56443,29002,27441
2015/3/1,南投縣,集集鎮,4378,11356,5930,5426
2015/3/1,南投縣,名間鄉,12552,39920,20981,18939
2015/3/1,南投縣,鹿谷鄉,7622,18462,9811,8651
2015/3/1,南投縣,中寮鄉,5648,15491,8429,7062
2015/3/1,南投縣,魚池鄉,5738,16468,8621,7847
2015/3/1,南投縣,國姓鄉,7285,19632,10616,9016
2015/3/1,南投縣,水里鄉,7219,18604,9750,8854
2015/3/1,南投縣,信義鄉,5240,16731,8996,7735
2015/3/1,南投縣,仁愛鄉,4939,15793,8145,7648
2015/3/1,雲林縣,斗六市,37177,108231,54064,54167
2015/3/1,雲林縣,斗南鎮,15736,45920,23330,22590
2015/3/1,雲林縣,虎尾鎮,24082,70327,35671,34656
2015/3/1,雲林縣,西螺鎮,14447,47094,23951,23143
2015/3/1,雲林縣,土庫鎮,9215,29620,15466,14154
2015/3/1,雲林縣,北港鎮,15945,41330,21468,19862
2015/3/1,雲林縣,古坑鄉,10922,32550,17175,15375
2015/3/1,雲林縣,大埤鄉,6737,19893,10688,9205
2015/3/1,雲林縣,莿桐鄉,9252,29499,15492,14007
2015/3/1,雲林縣,林內鄉,5910,18846,9852,8994
2015/3/1,雲林縣,二崙鄉,8960,28271,15138,13133
2015/3/1,雲林縣,崙背鄉,8501,25782,13616,12166
2015/3/1,雲林縣,麥寮鄉,13852,43952,22231,21721
2015/3/1,雲林縣,東勢鄉,5775,15693,8601,7092
2015/3/1,雲林縣,褒忠鄉,4401,13528,7252,6276
2015/3/1,雲林縣,臺西鄉,8765,24877,13349,11528
2015/3/1,雲林縣,元長鄉,9420,27141,14809,12332
2015/3/1,雲林縣,四湖鄉,8972,25167,13650,11517
2015/3/1,雲林縣,口湖鄉,9623,28837,15311,13526
2015/3/1,雲林縣,水林鄉,10219,26849,14729,12120
2015/3/1,嘉義縣,太保市,12202,37078,19073,18005
2015/3/1,嘉義縣,朴子市,15420,43233,21917,21316
2015/3/1,嘉義縣,布袋鎮,10082,28245,14453,13792
2015/3/1,嘉義縣,大林鎮,11395,32012,16408,15604
2015/3/1,嘉義縣,民雄鄉,24125,71968,36838,35130
2015/3/1,嘉義縣,溪口鄉,5403,15260,8150,7110
2015/3/1,嘉義縣,新港鄉,10591,33084,17516,15568
2015/3/1,嘉義縣,六腳鄉,9003,24453,12986,11467
2015/3/1,嘉義縣,東石鄉,9411,26029,13810,12219
2015/3/1,嘉義縣,義竹鄉,7540,19478,10123,9355
2015/3/1,嘉義縣,鹿草鄉,5809,16308,8742,7566
2015/3/1,嘉義縣,水上鄉,17866,50627,26152,24475
2015/3/1,嘉義縣,中埔鄉,15946,45989,23957,22032
2015/3/1,嘉義縣,竹崎鄉,11624,36783,19652,17131
2015/3/1,嘉義縣,梅山鄉,6773,20228,10741,9487
2015/3/1,嘉義縣,番路鄉,4305,11998,6497,5501
2015/3/1,嘉義縣,大埔鄉,1943,4634,2410,2224
2015/3/1,嘉義縣,阿里山鄉,1951,5755,3053,2702
2015/3/1,屏東縣,屏東市,73464,203606,101180,102426
2015/3/1,屏東縣,潮州鎮,19019,54779,27492,27287
2015/3/1,屏東縣,東港鎮,16284,48177,24415,23762
2015/3/1,屏東縣,恆春鎮,11204,30863,15780,15083
2015/3/1,屏東縣,萬丹鄉,14743,51996,26902,25094
2015/3/1,屏東縣,長治鄉,9972,30330,15827,14503
2015/3/1,屏東縣,麟洛鄉,3726,11269,5837,5432
2015/3/1,屏東縣,九如鄉,6791,22139,11462,10677
2015/3/1,屏東縣,里港鄉,8114,26836,13628,13208
2015/3/1,屏東縣,鹽埔鄉,7847,26546,13779,12767
2015/3/1,屏東縣,高樹鄉,9392,25411,13521,11890
2015/3/1,屏東縣,萬巒鄉,6463,20840,10926,9914
2015/3/1,屏東縣,內埔鄉,18418,55999,29041,26958
2015/3/1,屏東縣,竹田鄉,5639,17640,9364,8276
2015/3/1,屏東縣,新埤鄉,3430,10179,5416,4763
2015/3/1,屏東縣,枋寮鄉,8555,25447,13317,12130
2015/3/1,屏東縣,新園鄉,11755,36530,18908,17622
2015/3/1,屏東縣,崁頂鄉,4432,16305,8286,8019
2015/3/1,屏東縣,林邊鄉,6987,19093,9824,9269
2015/3/1,屏東縣,南州鄉,3666,10961,5611,5350
2015/3/1,屏東縣,佳冬鄉,7036,20181,10502,9679
2015/3/1,屏東縣,琉球鄉,4291,12571,6927,5644
2015/3/1,屏東縣,車城鄉,3483,9032,4869,4163
2015/3/1,屏東縣,滿州鄉,3022,8096,4438,3658
2015/3/1,屏東縣,枋山鄉,2127,5700,3032,2668
2015/3/1,屏東縣,三地門鄉,2286,7755,3924,3831
2015/3/1,屏東縣,霧臺鄉,1050,3403,1736,1667
2015/3/1,屏東縣,瑪家鄉,1969,6699,3430,3269
2015/3/1,屏東縣,泰武鄉,1287,5255,2755,2500
2015/3/1,屏東縣,來義鄉,2226,7600,3876,3724
2015/3/1,屏東縣,春日鄉,1345,4846,2485,2361
2015/3/1,屏東縣,獅子鄉,1511,4850,2504,2346
2015/3/1,屏東縣,牡丹鄉,1861,4845,2500,2345
2015/3/1,臺東縣,臺東市,39061,106890,53790,53100
2015/3/1,臺東縣,成功鎮,5454,14855,7856,6999
2015/3/1,臺東縣,關山鎮,3229,9073,4765,4308
2015/3/1,臺東縣,卑南鄉,6661,17634,9349,8285
2015/3/1,臺東縣,大武鄉,2525,6474,3356,3118
2015/3/1,臺東縣,太麻里鄉,4610,11442,6069,5373
2015/3/1,臺東縣,東河鄉,3755,8944,4940,4004
2015/3/1,臺東縣,長濱鄉,2938,7711,4380,3331
2015/3/1,臺東縣,鹿野鄉,3087,8171,4378,3793
2015/3/1,臺東縣,池上鄉,3260,8565,4493,4072
2015/3/1,臺東縣,綠島鄉,1107,3827,2018,1809
2015/3/1,臺東縣,延平鄉,1071,3591,1938,1653
2015/3/1,臺東縣,海端鄉,1091,4351,2325,2026
2015/3/1,臺東縣,達仁鄉,1458,3679,2009,1670
2015/3/1,臺東縣,金峰鄉,1112,3650,1881,1769
2015/3/1,臺東縣,蘭嶼鄉,1747,4974,2524,2450
2015/3/1,花蓮縣,花蓮市,41368,106348,51663,54685
2015/3/1,花蓮縣,鳳林鎮,4410,11208,5882,5326
2015/3/1,花蓮縣,玉里鎮,8929,25295,13530,11765
2015/3/1,花蓮縣,新城鄉,7542,20224,10427,9797
2015/3/1,花蓮縣,吉安鄉,31149,82644,41919,40725
2015/3/1,花蓮縣,壽豐鄉,7016,18181,9705,8476
2015/3/1,花蓮縣,光復鄉,5035,13304,7080,6224
2015/3/1,花蓮縣,豐濱鄉,1741,4666,2590,2076
2015/3/1,花蓮縣,瑞穗鄉,4654,12022,6461,5561
2015/3/1,花蓮縣,富里鄉,3995,10774,5878,4896
2015/3/1,花蓮縣,秀林鄉,4768,15507,8033,7474
2015/3/1,花蓮縣,萬榮鄉,2087,6510,3427,3083
2015/3/1,花蓮縣,卓溪鄉,1679,6154,3379,2775
2015/3/1,澎湖縣,馬公市,23135,60501,30755,29746
2015/3/1,澎湖縣,湖西鄉,5321,14280,7529,6751
2015/3/1,澎湖縣,白沙鄉,3339,9776,5117,4659
2015/3/1,澎湖縣,西嶼鄉,2935,8419,4337,4082
2015/3/1,澎湖縣,望安鄉,1992,5120,2753,2367
2015/3/1,澎湖縣,七美鄉,1327,3760,1961,1799
2015/3/1,基隆市,中正區,22473,53014,27176,25838
2015/3/1,基隆市,七堵區,20983,53973,27277,26696
2015/3/1,基隆市,暖暖區,15276,38237,19304,18933
2015/3/1,基隆市,仁愛區,19458,46185,22802,23383
2015/3/1,基隆市,中山區,19309,48644,24758,23886
2015/3/1,基隆市,安樂區,32305,81643,40641,41002
2015/3/1,基隆市,信義區,20885,51273,25538,25735
2015/3/1,新竹市,東區,75348,207297,102125,105172
2015/3/1,新竹市,北區,54436,148741,72968,75773
2015/3/1,新竹市,香山區,25801,76418,38936,37482
2015/3/1,嘉義市,東區,45240,123303,59810,63493
2015/3/1,嘉義市,西區,53169,147564,72510,75054
2015/3/1,金門縣,金城鎮,12479,41221,20683,20538
2015/3/1,金門縣,金湖鎮,8365,27646,13940,13706
2015/3/1,金門縣,金沙鎮,6084,19675,9717,9958
2015/3/1,金門縣,金寧鄉,7746,27609,13969,13640
2015/3/1,金門縣,烈嶼鄉,3030,12106,5982,6124
2015/3/1,金門縣,烏坵鄉,134,667,334,333
2015/3/1,連江縣,南竿鄉,1424,7491,4259,3232
2015/3/1,連江縣,北竿鄉,480,2309,1273,1036
2015/3/1,連江縣,莒光鄉,268,1442,844,598
2015/3/1,連江縣,東引鄉,311,1262,760,502
2015/4/1,總計,新北市,1500880,3964888,1950106,2014782
2015/4/1,總計,臺北市,1040094,2705949,1296967,1408982
2015/4/1,總計,桃園市,738778,2077929,1041031,1036898
2015/4/1,總計,臺中市,917011,2727460,1350049,1377411
2015/4/1,總計,臺南市,669552,1885287,944224,941063
2015/4/1,總計,高雄市,1067459,2778914,1382344,1396570
2015/4/1,總計,臺灣省,2435874,7170052,3665381,3504671
2015/4/1,總計,宜蘭縣,163487,458273,232544,225729
2015/4/1,總計,新竹縣,180218,538153,275522,262631
2015/4/1,總計,苗栗縣,183492,566199,291714,274485
2015/4/1,總計,彰化縣,379480,1289792,659613,630179
2015/4/1,總計,南投縣,176428,512460,262898,249562
2015/4/1,總計,雲林縣,237979,702881,365587,337294
2015/4/1,總計,嘉義縣,181497,522587,272177,250410
2015/4/1,總計,屏東縣,283471,845079,433156,411923
2015/4/1,總計,臺東縣,82182,223559,115901,107658
2015/4/1,總計,花蓮縣,124467,332674,169883,162791
2015/4/1,總計,澎湖縣,38101,101842,52447,49395
2015/4/1,總計,基隆市,150785,372985,187461,185524
2015/4/1,總計,新竹市,155773,432559,214112,218447
2015/4/1,總計,嘉義市,98514,271009,132366,138643
2015/4/1,總計,福建省,40431,141908,72018,69890
2015/4/1,總計,金門縣,37942,129423,64889,64534
2015/4/1,總計,連江縣,2489,12485,7129,5356
2015/4/1,新北市,板橋區,205117,555170,271817,283353
2015/4/1,新北市,三重區,147737,388761,192025,196736
2015/4/1,新北市,中和區,162529,414681,202683,211998
2015/4/1,新北市,永和區,90699,226835,107929,118906
2015/4/1,新北市,新莊區,147740,412126,202114,210012
2015/4/1,新北市,新店區,123077,299445,144829,154616
2015/4/1,新北市,樹林區,65096,183984,92019,91965
2015/4/1,新北市,鶯歌區,29289,88497,44387,44110
2015/4/1,新北市,三峽區,40628,111909,56417,55492
2015/4/1,新北市,淡水區,68887,159863,77046,82817
2015/4/1,新北市,汐止區,84352,195178,95648,99530
2015/4/1,新北市,瑞芳區,16069,41111,20795,20316
2015/4/1,新北市,土城區,85694,238976,118398,120578
2015/4/1,新北市,蘆洲區,69047,199599,98287,101312
2015/4/1,新北市,五股區,29447,82278,41528,40750
2015/4/1,新北市,泰山區,27802,78488,39069,39419
2015/4/1,新北市,林口區,38270,98524,48221,50303
2015/4/1,新北市,深坑區,9343,23525,11806,11719
2015/4/1,新北市,石碇區,3365,7834,4325,3509
2015/4/1,新北市,坪林區,2488,6480,3614,2866
2015/4/1,新北市,三芝區,9301,23475,12075,11400
2015/4/1,新北市,石門區,4293,12670,6589,6081
2015/4/1,新北市,八里區,13824,37203,18601,18602
2015/4/1,新北市,平溪區,2354,4927,2713,2214
2015/4/1,新北市,雙溪區,3839,9357,5048,4309
2015/4/1,新北市,貢寮區,4415,12983,6629,6354
2015/4/1,新北市,金山區,7011,22312,11072,11240
2015/4/1,新北市,萬里區,7376,22568,11375,11193
2015/4/1,新北市,烏來區,1791,6129,3047,3082
2015/4/1,臺北市,松山區,80297,210800,99558,111242
2015/4/1,臺北市,信義區,89325,229677,110174,119503
2015/4/1,臺北市,大安區,120446,314378,147154,167224
2015/4/1,臺北市,中山區,98633,230871,107771,123100
2015/4/1,臺北市,中正區,65264,163536,78160,85376
2015/4/1,臺北市,大同區,51362,131106,64097,67009
2015/4/1,臺北市,萬華區,78143,194462,96067,98395
2015/4/1,臺北市,文山區,103686,274605,132202,142403
2015/4/1,臺北市,南港區,46033,121496,59351,62145
2015/4/1,臺北市,內湖區,105801,286537,137275,149262
2015/4/1,臺北市,士林區,105838,290778,140675,150103
2015/4/1,臺北市,北投區,95266,257703,124483,133220
2015/4/1,桃園市,桃園區,157590,421957,205864,216093
2015/4/1,桃園市,中壢區,139548,385189,190925,194264
2015/4/1,桃園市,大溪區,31002,92589,47593,44996
2015/4/1,桃園市,楊梅區,54064,158676,80444,78232
2015/4/1,桃園市,蘆竹區,54437,152884,76321,76563
2015/4/1,桃園市,大園區,30104,84886,43622,41264
2015/4/1,桃園市,龜山區,54835,143307,72034,71273
2015/4/1,桃園市,八德區,64255,183519,92560,90959
2015/4/1,桃園市,龍潭區,39546,117123,59077,58046
2015/4/1,桃園市,平鎮區,72885,214753,107332,107421
2015/4/1,桃園市,新屋區,15619,48194,25798,22396
2015/4/1,桃園市,觀音區,21164,63934,33476,30458
2015/4/1,桃園市,復興區,3729,10918,5985,4933
2015/4/1,臺中市,中區,7836,19286,9597,9689
2015/4/1,臺中市,東區,27189,75027,37517,37510
2015/4/1,臺中市,南區,46186,120564,58111,62453
2015/4/1,臺中市,西區,44922,115844,55180,60664
2015/4/1,臺中市,北區,58305,147511,70935,76576
2015/4/1,臺中市,西屯區,81075,219601,105763,113838
2015/4/1,臺中市,南屯區,58832,162768,78139,84629
2015/4/1,臺中市,北屯區,92896,261487,126036,135451
2015/4/1,臺中市,豐原區,52321,166616,82499,84117
2015/4/1,臺中市,東勢區,17240,51383,26543,24840
2015/4/1,臺中市,大甲區,22559,77588,39195,38393
2015/4/1,臺中市,清水區,26125,85960,44213,41747
2015/4/1,臺中市,沙鹿區,27306,88333,44811,43522
2015/4/1,臺中市,梧棲區,16963,56808,28616,28192
2015/4/1,臺中市,后里區,15505,54148,27587,26561
2015/4/1,臺中市,神岡區,18752,64988,33297,31691
2015/4/1,臺中市,潭子區,34947,105549,52367,53182
2015/4/1,臺中市,大雅區,28110,93044,46570,46474
2015/4/1,臺中市,新社區,7485,25195,13111,12084
2015/4/1,臺中市,石岡區,4898,15344,7979,7365
2015/4/1,臺中市,外埔區,9304,31732,16308,15424
2015/4/1,臺中市,大安區,5371,19612,10358,9254
2015/4/1,臺中市,烏日區,22791,71788,36213,35575
2015/4/1,臺中市,大肚區,16760,56423,28909,27514
2015/4/1,臺中市,龍井區,22112,76169,38584,37585
2015/4/1,臺中市,霧峰區,19631,64556,32933,31623
2015/4/1,臺中市,太平區,60281,182388,90830,91558
2015/4/1,臺中市,大里區,66894,206991,102078,104913
2015/4/1,臺中市,和平區,4415,10757,5770,4987
2015/4/1,臺南市,新營區,28480,78349,38824,39525
2015/4/1,臺南市,鹽水區,10073,26238,13698,12540
2015/4/1,臺南市,白河區,10965,29568,15462,14106
2015/4/1,臺南市,柳營區,7835,21700,11308,10392
2015/4/1,臺南市,後壁區,8903,24480,12742,11738
2015/4/1,臺南市,東山區,8265,21781,11557,10224
2015/4/1,臺南市,麻豆區,15479,45037,22898,22139
2015/4/1,臺南市,下營區,9109,24993,12886,12107
2015/4/1,臺南市,六甲區,7707,22745,11772,10973
2015/4/1,臺南市,官田區,7792,21620,11055,10565
2015/4/1,臺南市,大內區,3952,10205,5446,4759
2015/4/1,臺南市,佳里區,20316,59644,29611,30033
2015/4/1,臺南市,學甲區,9660,26800,13716,13084
2015/4/1,臺南市,西港區,8056,24889,12613,12276
2015/4/1,臺南市,七股區,8105,23527,12217,11310
2015/4/1,臺南市,將軍區,7323,20446,10403,10043
2015/4/1,臺南市,北門區,4349,11597,5845,5752
2015/4/1,臺南市,新化區,14213,43784,22364,21420
2015/4/1,臺南市,善化區,16450,46431,23465,22966
2015/4/1,臺南市,新市區,11617,35658,17907,17751
2015/4/1,臺南市,安定區,9804,30307,15549,14758
2015/4/1,臺南市,山上區,2694,7492,3923,3569
2015/4/1,臺南市,玉井區,5119,14509,7543,6966
2015/4/1,臺南市,楠西區,3532,10100,5348,4752
2015/4/1,臺南市,南化區,2863,8942,4840,4102
2015/4/1,臺南市,左鎮區,1994,5132,2867,2265
2015/4/1,臺南市,仁德區,26638,73242,37298,35944
2015/4/1,臺南市,歸仁區,22027,67630,34375,33255
2015/4/1,臺南市,關廟區,10893,34802,17969,16833
2015/4/1,臺南市,龍崎區,1576,4260,2315,1945
2015/4/1,臺南市,永康區,81386,229558,113419,116139
2015/4/1,臺南市,東區,71940,190025,91399,98626
2015/4/1,臺南市,南區,44790,125833,62582,63251
2015/4/1,臺南市,北區,49756,132614,64827,67787
2015/4/1,臺南市,安南區,60426,188396,95255,93141
2015/4/1,臺南市,安平區,24641,65104,30991,34113
2015/4/1,臺南市,中西區,30824,77849,37935,39914
2015/4/1,高雄市,鹽埕區,10855,25307,12616,12691
2015/4/1,高雄市,鼓山區,55675,136017,66061,69956
2015/4/1,高雄市,左營區,77294,195896,94898,100998
2015/4/1,高雄市,楠梓區,66525,179030,88366,90664
2015/4/1,高雄市,三民區,135059,347482,168720,178762
2015/4/1,高雄市,新興區,22734,52397,25228,27169
2015/4/1,高雄市,前金區,12549,27635,13286,14349
2015/4/1,高雄市,苓雅區,72168,175326,84732,90594
2015/4/1,高雄市,前鎮區,78191,193493,95484,98009
2015/4/1,高雄市,旗津區,10993,28891,14988,13903
2015/4/1,高雄市,小港區,66154,156074,77843,78231
2015/4/1,高雄市,鳳山區,136127,355101,174848,180253
2015/4/1,高雄市,林園區,25437,70455,35797,34658
2015/4/1,高雄市,大寮區,41029,111368,57269,54099
2015/4/1,高雄市,大樹區,13337,43222,22208,21014
2015/4/1,高雄市,大社區,12656,34458,17540,16918
2015/4/1,高雄市,仁武區,30552,81339,41565,39774
2015/4/1,高雄市,鳥松區,17551,43787,22300,21487
2015/4/1,高雄市,岡山區,34475,97768,48626,49142
2015/4/1,高雄市,橋頭區,13209,37296,19001,18295
2015/4/1,高雄市,燕巢區,10329,30271,16047,14224
2015/4/1,高雄市,田寮區,3398,7588,4204,3384
2015/4/1,高雄市,阿蓮區,9395,29495,14875,14620
2015/4/1,高雄市,路竹區,16783,53023,27120,25903
2015/4/1,高雄市,湖內區,10439,29485,15086,14399
2015/4/1,高雄市,茄萣區,10445,30545,15806,14739
2015/4/1,高雄市,永安區,5792,14090,7073,7017
2015/4/1,高雄市,彌陀區,6752,19763,10225,9538
2015/4/1,高雄市,梓官區,12508,36422,18823,17599
2015/4/1,高雄市,旗山區,13850,37973,19694,18279
2015/4/1,高雄市,美濃區,14547,41091,21519,19572
2015/4/1,高雄市,六龜區,5642,13604,7340,6264
2015/4/1,高雄市,甲仙區,2369,6353,3372,2981
2015/4/1,高雄市,杉林區,4813,12453,6797,5656
2015/4/1,高雄市,內門區,5061,15097,8174,6923
2015/4/1,高雄市,茂林區,579,1884,931,953
2015/4/1,高雄市,桃源區,1325,4264,2238,2026
2015/4/1,高雄市,那瑪夏區,862,3171,1644,1527
2015/4/1,宜蘭縣,宜蘭市,35326,95929,46854,49075
2015/4/1,宜蘭縣,羅東鎮,25944,72593,34573,38020
2015/4/1,宜蘭縣,蘇澳鎮,14003,40886,20868,20018
2015/4/1,宜蘭縣,頭城鎮,10099,29843,15419,14424
2015/4/1,宜蘭縣,礁溪鄉,13380,35832,18713,17119
2015/4/1,宜蘭縣,壯圍鄉,8448,24361,12892,11469
2015/4/1,宜蘭縣,員山鄉,11384,32285,17163,15122
2015/4/1,宜蘭縣,冬山鄉,18669,53513,27564,25949
2015/4/1,宜蘭縣,五結鄉,14204,39366,20407,18959
2015/4/1,宜蘭縣,三星鄉,8247,21471,11573,9898
2015/4/1,宜蘭縣,大同鄉,1879,6101,3316,2785
2015/4/1,宜蘭縣,南澳鄉,1904,6093,3202,2891
2015/4/1,新竹縣,竹北市,58902,166799,83152,83647
2015/4/1,新竹縣,關西鎮,9523,30382,16206,14176
2015/4/1,新竹縣,新埔鎮,10606,34222,18211,16011
2015/4/1,新竹縣,竹東鎮,32385,96032,48290,47742
2015/4/1,新竹縣,湖口鄉,25319,77019,39153,37866
2015/4/1,新竹縣,橫山鄉,4503,13669,7418,6251
2015/4/1,新竹縣,新豐鄉,17575,56002,28727,27275
2015/4/1,新竹縣,芎林鄉,6453,20277,10723,9554
2015/4/1,新竹縣,寶山鄉,5147,14284,7725,6559
2015/4/1,新竹縣,北埔鄉,3135,9775,5259,4516
2015/4/1,新竹縣,峨眉鄉,2086,5686,3155,2531
2015/4/1,新竹縣,尖石鄉,2842,9369,4972,4397
2015/4/1,新竹縣,五峰鄉,1742,4637,2531,2106
2015/4/1,苗栗縣,苗栗市,30622,90852,45422,45430
2015/4/1,苗栗縣,苑裡鎮,14429,48407,25068,23339
2015/4/1,苗栗縣,通霄鎮,11550,36641,19306,17335
2015/4/1,苗栗縣,竹南鎮,27430,83960,42400,41560
2015/4/1,苗栗縣,頭份市,33222,102948,51969,50979
2015/4/1,苗栗縣,後龍鎮,11875,38177,20094,18083
2015/4/1,苗栗縣,卓蘭鎮,6134,18262,9554,8708
2015/4/1,苗栗縣,大湖鄉,5415,15426,8174,7252
2015/4/1,苗栗縣,公館鄉,10637,34724,18010,16714
2015/4/1,苗栗縣,銅鑼鄉,6143,18823,9967,8856
2015/4/1,苗栗縣,南庄鄉,3976,10626,5836,4790
2015/4/1,苗栗縣,頭屋鄉,3651,11352,5966,5386
2015/4/1,苗栗縣,三義鄉,5452,17162,8980,8182
2015/4/1,苗栗縣,西湖鄉,2690,7541,4193,3348
2015/4/1,苗栗縣,造橋鄉,4143,13426,7049,6377
2015/4/1,苗栗縣,三灣鄉,2420,7081,3870,3211
2015/4/1,苗栗縣,獅潭鄉,1735,4666,2590,2076
2015/4/1,苗栗縣,泰安鄉,1968,6125,3266,2859
2015/4/1,彰化縣,彰化市,75022,235003,116471,118532
2015/4/1,彰化縣,鹿港鎮,23839,86222,43955,42267
2015/4/1,彰化縣,和美鎮,26023,90816,46419,44397
2015/4/1,彰化縣,北斗鎮,10427,33214,16763,16451
2015/4/1,彰化縣,員林市,38426,124677,62291,62386
2015/4/1,彰化縣,溪湖鎮,15991,55739,28377,27362
2015/4/1,彰化縣,田中鎮,12935,42590,22040,20550
2015/4/1,彰化縣,二林鎮,14810,52126,26915,25211
2015/4/1,彰化縣,線西鄉,4316,17085,8857,8228
2015/4/1,彰化縣,伸港鄉,9508,36221,18521,17700
2015/4/1,彰化縣,福興鄉,12520,47711,24870,22841
2015/4/1,彰化縣,秀水鄉,10399,39327,20326,19001
2015/4/1,彰化縣,花壇鄉,13682,45881,23636,22245
2015/4/1,彰化縣,芬園鄉,6873,24064,12690,11374
2015/4/1,彰化縣,大村鄉,10783,36417,18878,17539
2015/4/1,彰化縣,埔鹽鄉,8987,33096,17362,15734
2015/4/1,彰化縣,埔心鄉,10348,34881,18006,16875
2015/4/1,彰化縣,永靖鄉,10804,38124,19845,18279
2015/4/1,彰化縣,社頭鄉,12731,43591,22413,21178
2015/4/1,彰化縣,二水鄉,5342,15758,8254,7504
2015/4/1,彰化縣,田尾鄉,7863,27712,14378,13334
2015/4/1,彰化縣,埤頭鄉,8910,30947,16110,14837
2015/4/1,彰化縣,芳苑鄉,10116,34502,18257,16245
2015/4/1,彰化縣,大城鄉,5327,17682,9588,8094
2015/4/1,彰化縣,竹塘鄉,4613,15776,8327,7449
2015/4/1,彰化縣,溪州鄉,8885,30630,16064,14566
2015/4/1,南投縣,南投市,34344,102279,51282,50997
2015/4/1,南投縣,埔里鎮,28923,82731,41536,41195
2015/4/1,南投縣,草屯鎮,32580,98995,50005,48990
2015/4/1,南投縣,竹山鎮,19966,56379,28961,27418
2015/4/1,南投縣,集集鎮,4375,11315,5906,5409
2015/4/1,南投縣,名間鄉,12554,39894,20984,18910
2015/4/1,南投縣,鹿谷鄉,7631,18411,9785,8626
2015/4/1,南投縣,中寮鄉,5645,15463,8418,7045
2015/4/1,南投縣,魚池鄉,5737,16439,8603,7836
2015/4/1,南投縣,國姓鄉,7284,19575,10600,8975
2015/4/1,南投縣,水里鄉,7211,18547,9726,8821
2015/4/1,南投縣,信義鄉,5243,16674,8963,7711
2015/4/1,南投縣,仁愛鄉,4935,15758,8129,7629
2015/4/1,雲林縣,斗六市,37231,108216,54045,54171
2015/4/1,雲林縣,斗南鎮,15744,45861,23295,22566
2015/4/1,雲林縣,虎尾鎮,24108,70341,35677,34664
2015/4/1,雲林縣,西螺鎮,14444,47122,23958,23164
2015/4/1,雲林縣,土庫鎮,9214,29609,15466,14143
2015/4/1,雲林縣,北港鎮,15943,41341,21456,19885
2015/4/1,雲林縣,古坑鄉,10918,32516,17171,15345
2015/4/1,雲林縣,大埤鄉,6748,19876,10679,9197
2015/4/1,雲林縣,莿桐鄉,9253,29420,15455,13965
2015/4/1,雲林縣,林內鄉,5917,18908,9897,9011
2015/4/1,雲林縣,二崙鄉,8965,28239,15127,13112
2015/4/1,雲林縣,崙背鄉,8497,25747,13603,12144
2015/4/1,雲林縣,麥寮鄉,13874,43975,22240,21735
2015/4/1,雲林縣,東勢鄉,5769,15649,8583,7066
2015/4/1,雲林縣,褒忠鄉,4398,13497,7239,6258
2015/4/1,雲林縣,臺西鄉,8758,24820,13312,11508
2015/4/1,雲林縣,元長鄉,9407,27081,14779,12302
2015/4/1,雲林縣,四湖鄉,8961,25095,13609,11486
2015/4/1,雲林縣,口湖鄉,9624,28774,15287,13487
2015/4/1,雲林縣,水林鄉,10206,26794,14709,12085
2015/4/1,嘉義縣,太保市,12218,37085,19090,17995
2015/4/1,嘉義縣,朴子市,15434,43233,21896,21337
2015/4/1,嘉義縣,布袋鎮,10078,28180,14409,13771
2015/4/1,嘉義縣,大林鎮,11402,32017,16404,15613
2015/4/1,嘉義縣,民雄鄉,24167,71940,36850,35090
2015/4/1,嘉義縣,溪口鄉,5409,15250,8144,7106
2015/4/1,嘉義縣,新港鄉,10597,33044,17489,15555
2015/4/1,嘉義縣,六腳鄉,8999,24411,12966,11445
2015/4/1,嘉義縣,東石鄉,9405,25946,13767,12179
2015/4/1,嘉義縣,義竹鄉,7535,19442,10100,9342
2015/4/1,嘉義縣,鹿草鄉,5809,16277,8730,7547
2015/4/1,嘉義縣,水上鄉,17872,50568,26134,24434
2015/4/1,嘉義縣,中埔鄉,15958,45938,23932,22006
2015/4/1,嘉義縣,竹崎鄉,11638,36738,19630,17108
2015/4/1,嘉義縣,梅山鄉,6770,20187,10710,9477
2015/4/1,嘉義縣,番路鄉,4309,11966,6477,5489
2015/4/1,嘉義縣,大埔鄉,1942,4619,2404,2215
2015/4/1,嘉義縣,阿里山鄉,1955,5746,3045,2701
2015/4/1,屏東縣,屏東市,73470,203469,101114,102355
2015/4/1,屏東縣,潮州鎮,19032,54781,27481,27300
2015/4/1,屏東縣,東港鎮,16294,48183,24428,23755
2015/4/1,屏東縣,恆春鎮,11234,30889,15804,15085
2015/4/1,屏東縣,萬丹鄉,14755,51932,26864,25068
2015/4/1,屏東縣,長治鄉,9971,30320,15827,14493
2015/4/1,屏東縣,麟洛鄉,3725,11239,5823,5416
2015/4/1,屏東縣,九如鄉,6808,22145,11450,10695
2015/4/1,屏東縣,里港鄉,8104,26821,13630,13191
2015/4/1,屏東縣,鹽埔鄉,7838,26519,13770,12749
2015/4/1,屏東縣,高樹鄉,9385,25360,13507,11853
2015/4/1,屏東縣,萬巒鄉,6465,20846,10933,9913
2015/4/1,屏東縣,內埔鄉,18430,55944,29006,26938
2015/4/1,屏東縣,竹田鄉,5639,17624,9353,8271
2015/4/1,屏東縣,新埤鄉,3428,10147,5395,4752
2015/4/1,屏東縣,枋寮鄉,8553,25414,13305,12109
2015/4/1,屏東縣,新園鄉,11756,36475,18878,17597
2015/4/1,屏東縣,崁頂鄉,4424,16285,8276,8009
2015/4/1,屏東縣,林邊鄉,6985,19094,9819,9275
2015/4/1,屏東縣,南州鄉,3665,10948,5611,5337
2015/4/1,屏東縣,佳冬鄉,7023,20154,10482,9672
2015/4/1,屏東縣,琉球鄉,4294,12544,6906,5638
2015/4/1,屏東縣,車城鄉,3488,9034,4874,4160
2015/4/1,屏東縣,滿州鄉,3015,8078,4428,3650
2015/4/1,屏東縣,枋山鄉,2129,5677,3017,2660
2015/4/1,屏東縣,三地門鄉,2284,7749,3926,3823
2015/4/1,屏東縣,霧臺鄉,1049,3382,1725,1657
2015/4/1,屏東縣,瑪家鄉,1992,6689,3419,3270
2015/4/1,屏東縣,泰武鄉,1295,5257,2762,2495
2015/4/1,屏東縣,來義鄉,2226,7565,3858,3707
2015/4/1,屏東縣,春日鄉,1346,4840,2486,2354
2015/4/1,屏東縣,獅子鄉,1510,4842,2501,2341
2015/4/1,屏東縣,牡丹鄉,1859,4833,2498,2335
2015/4/1,臺東縣,臺東市,39087,106862,53749,53113
2015/4/1,臺東縣,成功鎮,5450,14836,7843,6993
2015/4/1,臺東縣,關山鎮,3220,9042,4749,4293
2015/4/1,臺東縣,卑南鄉,6660,17594,9339,8255
2015/4/1,臺東縣,大武鄉,2530,6475,3358,3117
2015/4/1,臺東縣,太麻里鄉,4612,11407,6057,5350
2015/4/1,臺東縣,東河鄉,3747,8913,4916,3997
2015/4/1,臺東縣,長濱鄉,2937,7681,4367,3314
2015/4/1,臺東縣,鹿野鄉,3085,8157,4364,3793
2015/4/1,臺東縣,池上鄉,3259,8544,4484,4060
2015/4/1,臺東縣,綠島鄉,1109,3823,2014,1809
2015/4/1,臺東縣,延平鄉,1073,3596,1937,1659
2015/4/1,臺東縣,海端鄉,1090,4347,2319,2028
2015/4/1,臺東縣,達仁鄉,1454,3661,2000,1661
2015/4/1,臺東縣,金峰鄉,1112,3634,1875,1759
2015/4/1,臺東縣,蘭嶼鄉,1757,4987,2530,2457
2015/4/1,花蓮縣,花蓮市,41397,106336,51642,54694
2015/4/1,花蓮縣,鳳林鎮,4411,11202,5877,5325
2015/4/1,花蓮縣,玉里鎮,8933,25278,13514,11764
2015/4/1,花蓮縣,新城鄉,7560,20229,10424,9805
2015/4/1,花蓮縣,吉安鄉,31189,82664,41923,40741
2015/4/1,花蓮縣,壽豐鄉,7020,18160,9702,8458
2015/4/1,花蓮縣,光復鄉,5036,13280,7066,6214
2015/4/1,花蓮縣,豐濱鄉,1739,4644,2577,2067
2015/4/1,花蓮縣,瑞穗鄉,4660,12001,6457,5544
2015/4/1,花蓮縣,富里鄉,3994,10759,5872,4887
2015/4/1,花蓮縣,秀林鄉,4766,15504,8034,7470
2015/4/1,花蓮縣,萬榮鄉,2086,6493,3428,3065
2015/4/1,花蓮縣,卓溪鄉,1676,6124,3367,2757
2015/4/1,澎湖縣,馬公市,23167,60502,30758,29744
2015/4/1,澎湖縣,湖西鄉,5338,14291,7539,6752
2015/4/1,澎湖縣,白沙鄉,3342,9761,5109,4652
2015/4/1,澎湖縣,西嶼鄉,2936,8403,4321,4082
2015/4/1,澎湖縣,望安鄉,1990,5123,2757,2366
2015/4/1,澎湖縣,七美鄉,1328,3762,1963,1799
2015/4/1,基隆市,中正區,22475,52978,27151,25827
2015/4/1,基隆市,七堵區,21015,54038,27300,26738
2015/4/1,基隆市,暖暖區,15308,38285,19306,18979
2015/4/1,基隆市,仁愛區,19449,46145,22771,23374
2015/4/1,基隆市,中山區,19291,48552,24724,23828
2015/4/1,基隆市,安樂區,32333,81651,40643,41008
2015/4/1,基隆市,信義區,20914,51336,25566,25770
2015/4/1,新竹市,東區,75457,207440,102197,105243
2015/4/1,新竹市,北區,54467,148729,72969,75760
2015/4/1,新竹市,香山區,25849,76390,38946,37444
2015/4/1,嘉義市,東區,45263,123365,59823,63542
2015/4/1,嘉義市,西區,53251,147644,72543,75101
2015/4/1,金門縣,金城鎮,12511,41441,20809,20632
2015/4/1,金門縣,金湖鎮,8384,27722,13982,13740
2015/4/1,金門縣,金沙鎮,6098,19732,9746,9986
2015/4/1,金門縣,金寧鄉,7780,27698,14010,13688
2015/4/1,金門縣,烈嶼鄉,3035,12160,6006,6154
2015/4/1,金門縣,烏坵鄉,134,670,336,334
2015/4/1,連江縣,南竿鄉,1427,7468,4250,3218
2015/4/1,連江縣,北竿鄉,482,2313,1277,1036
2015/4/1,連江縣,莒光鄉,267,1440,839,601
2015/4/1,連江縣,東引鄉,313,1264,763,501
2015/5/1,總計,新北市,1502618,3965926,1950360,2015566
2015/5/1,總計,臺北市,1040859,2705921,1296713,1409208
2015/5/1,總計,桃園市,740590,2082165,1042873,1039292
2015/5/1,總計,臺中市,918547,2729291,1350841,1378450
2015/5/1,總計,臺南市,669850,1885240,944081,941159
2015/5/1,總計,高雄市,1068314,2778793,1382192,1396601
2015/5/1,總計,臺灣省,2437961,7167094,3663714,3503380
2015/5/1,總計,宜蘭縣,163753,458250,232505,225745
2015/5/1,總計,新竹縣,180738,538712,275858,262854
2015/5/1,總計,苗栗縣,183642,565795,291509,274286
2015/5/1,總計,彰化縣,379763,1289506,659401,630105
2015/5/1,總計,南投縣,176518,511940,262655,249285
2015/5/1,總計,雲林縣,238049,702304,365288,337016
2015/5/1,總計,嘉義縣,181578,522065,271907,250158
2015/5/1,總計,屏東縣,283600,844445,432823,411622
2015/5/1,總計,臺東縣,82205,223326,115775,107551
2015/5/1,總計,花蓮縣,124553,332472,169761,162711
2015/5/1,總計,澎湖縣,38121,101838,52474,49364
2015/5/1,總計,基隆市,150832,372791,187332,185459
2015/5/1,總計,新竹市,156035,432692,214138,218554
2015/5/1,總計,嘉義市,98574,270958,132288,138670
2015/5/1,總計,福建省,40507,142115,72116,69999
2015/5/1,總計,金門縣,38013,129639,65003,64636
2015/5/1,總計,連江縣,2494,12476,7113,5363
2015/5/1,新北市,板橋區,205240,555114,271753,283361
2015/5/1,新北市,三重區,147788,388590,191953,196637
2015/5/1,新北市,中和區,162637,414757,202668,212089
2015/5/1,新北市,永和區,90688,226718,107886,118832
2015/5/1,新北市,新莊區,148023,412359,202150,210209
2015/5/1,新北市,新店區,123232,299589,144875,154714
2015/5/1,新北市,樹林區,65179,183979,92011,91968
2015/5/1,新北市,鶯歌區,29312,88425,44369,44056
2015/5/1,新北市,三峽區,40706,112074,56475,55599
2015/5/1,新北市,淡水區,69104,160171,77168,83003
2015/5/1,新北市,汐止區,84497,195295,95685,99610
2015/5/1,新北市,瑞芳區,16064,41076,20787,20289
2015/5/1,新北市,土城區,85726,238900,118322,120578
2015/5/1,新北市,蘆洲區,69136,199681,98316,101365
2015/5/1,新北市,五股區,29547,82426,41611,40815
2015/5/1,新北市,泰山區,27817,78538,39101,39437
2015/5/1,新北市,林口區,38436,98807,48342,50465
2015/5/1,新北市,深坑區,9372,23569,11828,11741
2015/5/1,新北市,石碇區,3366,7818,4313,3505
2015/5/1,新北市,坪林區,2491,6479,3607,2872
2015/5/1,新北市,三芝區,9312,23479,12085,11394
2015/5/1,新北市,石門區,4295,12670,6588,6082
2015/5/1,新北市,八里區,13868,37253,18639,18614
2015/5/1,新北市,平溪區,2351,4920,2712,2208
2015/5/1,新北市,雙溪區,3838,9339,5042,4297
2015/5/1,新北市,貢寮區,4410,12945,6607,6338
2015/5/1,新北市,金山區,7004,22276,11052,11224
2015/5/1,新北市,萬里區,7384,22576,11376,11200
2015/5/1,新北市,烏來區,1795,6103,3039,3064
2015/5/1,臺北市,松山區,80361,210794,99499,111295
2015/5/1,臺北市,信義區,89406,229653,110129,119524
2015/5/1,臺北市,大安區,120518,314360,147109,167251
2015/5/1,臺北市,中山區,98682,230941,107793,123148
2015/5/1,臺北市,中正區,65279,163446,78128,85318
2015/5/1,臺北市,大同區,51385,131030,64063,66967
2015/5/1,臺北市,萬華區,78124,194296,95970,98326
2015/5/1,臺北市,文山區,103802,274722,132235,142487
2015/5/1,臺北市,南港區,46073,121552,59362,62190
2015/5/1,臺北市,內湖區,105973,286764,137362,149402
2015/5/1,臺北市,士林區,105896,290711,140656,150055
2015/5/1,臺北市,北投區,95360,257652,124407,133245
2015/5/1,桃園市,桃園區,157948,422892,206310,216582
2015/5/1,桃園市,中壢區,139873,386062,191265,194797
2015/5/1,桃園市,大溪區,31076,92729,47636,45093
2015/5/1,桃園市,楊梅區,54227,158982,80558,78424
2015/5/1,桃園市,蘆竹區,54593,153283,76484,76799
2015/5/1,桃園市,大園區,30175,84976,43670,41306
2015/5/1,桃園市,龜山區,54963,143524,72135,71389
2015/5/1,桃園市,八德區,64454,184058,92796,91262
2015/5/1,桃園市,龍潭區,39628,117329,59184,58145
2015/5/1,桃園市,平鎮區,73058,215147,107523,107624
2015/5/1,桃園市,新屋區,15641,48232,25800,22432
2015/5/1,桃園市,觀音區,21221,64015,33515,30500
2015/5/1,桃園市,復興區,3733,10936,5997,4939
2015/5/1,臺中市,中區,7817,19240,9592,9648
2015/5/1,臺中市,東區,27210,75071,37516,37555
2015/5/1,臺中市,南區,46259,120657,58154,62503
2015/5/1,臺中市,西區,44938,115865,55190,60675
2015/5/1,臺中市,北區,58326,147515,70908,76607
2015/5/1,臺中市,西屯區,81286,219904,105917,113987
2015/5/1,臺中市,南屯區,58976,163023,78200,84823
2015/5/1,臺中市,北屯區,93150,261877,126191,135686
2015/5/1,臺中市,豐原區,52373,166595,82520,84075
2015/5/1,臺中市,東勢區,17269,51381,26555,24826
2015/5/1,臺中市,大甲區,22575,77617,39186,38431
2015/5/1,臺中市,清水區,26203,85976,44227,41749
2015/5/1,臺中市,沙鹿區,27416,88505,44894,43611
2015/5/1,臺中市,梧棲區,16986,56829,28634,28195
2015/5/1,臺中市,后里區,15560,54170,27589,26581
2015/5/1,臺中市,神岡區,18786,64998,33292,31706
2015/5/1,臺中市,潭子區,35036,105697,52437,53260
2015/5/1,臺中市,大雅區,28146,93086,46564,46522
2015/5/1,臺中市,新社區,7481,25145,13086,12059
2015/5/1,臺中市,石岡區,4895,15315,7960,7355
2015/5/1,臺中市,外埔區,9316,31732,16314,15418
2015/5/1,臺中市,大安區,5371,19588,10356,9232
2015/5/1,臺中市,烏日區,22840,71887,36252,35635
2015/5/1,臺中市,大肚區,16779,56416,28915,27501
2015/5/1,臺中市,龍井區,22143,76183,38620,37563
2015/5/1,臺中市,霧峰區,19628,64527,32918,31609
2015/5/1,臺中市,太平區,60373,182606,90935,91671
2015/5/1,臺中市,大里區,66994,207141,102151,104990
2015/5/1,臺中市,和平區,4415,10745,5768,4977
2015/5/1,臺南市,新營區,28496,78260,38776,39484
2015/5/1,臺南市,鹽水區,10080,26244,13705,12539
2015/5/1,臺南市,白河區,10956,29528,15446,14082
2015/5/1,臺南市,柳營區,7829,21702,11306,10396
2015/5/1,臺南市,後壁區,8899,24454,12730,11724
2015/5/1,臺南市,東山區,8265,21766,11553,10213
2015/5/1,臺南市,麻豆區,15491,45024,22882,22142
2015/5/1,臺南市,下營區,9103,24963,12870,12093
2015/5/1,臺南市,六甲區,7708,22724,11755,10969
2015/5/1,臺南市,官田區,7786,21606,11040,10566
2015/5/1,臺南市,大內區,3946,10168,5440,4728
2015/5/1,臺南市,佳里區,20319,59646,29603,30043
2015/5/1,臺南市,學甲區,9662,26777,13709,13068
2015/5/1,臺南市,西港區,8066,24889,12609,12280
2015/5/1,臺南市,七股區,8103,23536,12212,11324
2015/5/1,臺南市,將軍區,7318,20406,10379,10027
2015/5/1,臺南市,北門區,4346,11593,5849,5744
2015/5/1,臺南市,新化區,14215,43764,22341,21423
2015/5/1,臺南市,善化區,16496,46512,23494,23018
2015/5/1,臺南市,新市區,11624,35659,17905,17754
2015/5/1,臺南市,安定區,9807,30296,15551,14745
2015/5/1,臺南市,山上區,2698,7496,3925,3571
2015/5/1,臺南市,玉井區,5122,14492,7537,6955
2015/5/1,臺南市,楠西區,3535,10088,5341,4747
2015/5/1,臺南市,南化區,2864,8939,4833,4106
2015/5/1,臺南市,左鎮區,1993,5126,2867,2259
2015/5/1,臺南市,仁德區,26666,73300,37321,35979
2015/5/1,臺南市,歸仁區,22049,67672,34402,33270
2015/5/1,臺南市,關廟區,10907,34789,17967,16822
2015/5/1,臺南市,龍崎區,1576,4253,2308,1945
2015/5/1,臺南市,永康區,81449,229777,113513,116264
2015/5/1,臺南市,東區,71913,189829,91296,98533
2015/5/1,臺南市,南區,44832,125862,62578,63284
2015/5/1,臺南市,北區,49768,132641,64816,67825
2015/5/1,臺南市,安南區,60475,188494,95300,93194
2015/5/1,臺南市,安平區,24659,65123,30998,34125
2015/5/1,臺南市,中西區,30829,77842,37924,39918
2015/5/1,高雄市,鹽埕區,10850,25247,12587,12660
2015/5/1,高雄市,鼓山區,55736,136021,66034,69987
2015/5/1,高雄市,左營區,77339,195981,94968,101013
2015/5/1,高雄市,楠梓區,66643,179138,88437,90701
2015/5/1,高雄市,三民區,135106,347270,168617,178653
2015/5/1,高雄市,新興區,22732,52339,25196,27143
2015/5/1,高雄市,前金區,12572,27631,13271,14360
2015/5/1,高雄市,苓雅區,72155,175140,84662,90478
2015/5/1,高雄市,前鎮區,78246,193319,95404,97915
2015/5/1,高雄市,旗津區,11000,28880,14988,13892
2015/5/1,高雄市,小港區,66207,156130,77869,78261
2015/5/1,高雄市,鳳山區,136300,355282,174851,180431
2015/5/1,高雄市,林園區,25442,70418,35763,34655
2015/5/1,高雄市,大寮區,41095,111445,57288,54157
2015/5/1,高雄市,大樹區,13345,43200,22198,21002
2015/5/1,高雄市,大社區,12676,34456,17532,16924
2015/5/1,高雄市,仁武區,30627,81484,41642,39842
2015/5/1,高雄市,鳥松區,17573,43821,22325,21496
2015/5/1,高雄市,岡山區,34496,97780,48601,49179
2015/5/1,高雄市,橋頭區,13212,37297,19005,18292
2015/5/1,高雄市,燕巢區,10353,30282,16050,14232
2015/5/1,高雄市,田寮區,3401,7581,4202,3379
2015/5/1,高雄市,阿蓮區,9393,29456,14864,14592
2015/5/1,高雄市,路竹區,16774,53050,27131,25919
2015/5/1,高雄市,湖內區,10480,29552,15120,14432
2015/5/1,高雄市,茄萣區,10446,30527,15792,14735
2015/5/1,高雄市,永安區,5785,14100,7086,7014
2015/5/1,高雄市,彌陀區,6761,19755,10220,9535
2015/5/1,高雄市,梓官區,12520,36442,18830,17612
2015/5/1,高雄市,旗山區,13862,37973,19695,18278
2015/5/1,高雄市,美濃區,14544,41057,21518,19539
2015/5/1,高雄市,六龜區,5634,13564,7317,6247
2015/5/1,高雄市,甲仙區,2368,6334,3363,2971
2015/5/1,高雄市,杉林區,4814,12459,6801,5658
2015/5/1,高雄市,內門區,5062,15082,8165,6917
2015/5/1,高雄市,茂林區,578,1884,928,956
2015/5/1,高雄市,桃源區,1325,4253,2231,2022
2015/5/1,高雄市,那瑪夏區,862,3163,1641,1522
2015/5/1,宜蘭縣,宜蘭市,35376,95937,46869,49068
2015/5/1,宜蘭縣,羅東鎮,26014,72655,34585,38070
2015/5/1,宜蘭縣,蘇澳鎮,14001,40836,20847,19989
2015/5/1,宜蘭縣,頭城鎮,10113,29850,15422,14428
2015/5/1,宜蘭縣,礁溪鄉,13414,35881,18735,17146
2015/5/1,宜蘭縣,壯圍鄉,8450,24321,12867,11454
2015/5/1,宜蘭縣,員山鄉,11390,32267,17160,15107
2015/5/1,宜蘭縣,冬山鄉,18710,53526,27555,25971
2015/5/1,宜蘭縣,五結鄉,14243,39352,20399,18953
2015/5/1,宜蘭縣,三星鄉,8252,21429,11550,9879
2015/5/1,宜蘭縣,大同鄉,1883,6102,3316,2786
2015/5/1,宜蘭縣,南澳鄉,1907,6094,3200,2894
2015/5/1,新竹縣,竹北市,59272,167489,83534,83955
2015/5/1,新竹縣,關西鎮,9520,30309,16173,14136
2015/5/1,新竹縣,新埔鎮,10611,34206,18202,16004
2015/5/1,新竹縣,竹東鎮,32422,96071,48300,47771
2015/5/1,新竹縣,湖口鄉,25370,77027,39167,37860
2015/5/1,新竹縣,橫山鄉,4508,13651,7420,6231
2015/5/1,新竹縣,新豐鄉,17610,55986,28711,27275
2015/5/1,新竹縣,芎林鄉,6459,20286,10733,9553
2015/5/1,新竹縣,寶山鄉,5165,14305,7738,6567
2015/5/1,新竹縣,北埔鄉,3132,9738,5239,4499
2015/5/1,新竹縣,峨眉鄉,2081,5681,3153,2528
2015/5/1,新竹縣,尖石鄉,2843,9346,4971,4375
2015/5/1,新竹縣,五峰鄉,1745,4617,2517,2100
2015/5/1,苗栗縣,苗栗市,30638,90774,45364,45410
2015/5/1,苗栗縣,苑裡鎮,14433,48299,25015,23284
2015/5/1,苗栗縣,通霄鎮,11552,36599,19283,17316
2015/5/1,苗栗縣,竹南鎮,27504,84055,42444,41611
2015/5/1,苗栗縣,頭份市,33288,102999,51985,51014
2015/5/1,苗栗縣,後龍鎮,11881,38122,20079,18043
2015/5/1,苗栗縣,卓蘭鎮,6136,18240,9535,8705
2015/5/1,苗栗縣,大湖鄉,5420,15405,8163,7242
2015/5/1,苗栗縣,公館鄉,10616,34645,17980,16665
2015/5/1,苗栗縣,銅鑼鄉,6136,18807,9959,8848
2015/5/1,苗栗縣,南庄鄉,3974,10601,5828,4773
2015/5/1,苗栗縣,頭屋鄉,3648,11325,5956,5369
2015/5/1,苗栗縣,三義鄉,5456,17141,8978,8163
2015/5/1,苗栗縣,西湖鄉,2691,7521,4179,3342
2015/5/1,苗栗縣,造橋鄉,4146,13424,7047,6377
2015/5/1,苗栗縣,三灣鄉,2421,7071,3864,3207
2015/5/1,苗栗縣,獅潭鄉,1735,4663,2591,2072
2015/5/1,苗栗縣,泰安鄉,1967,6104,3259,2845
2015/5/1,彰化縣,彰化市,75042,234950,116460,118490
2015/5/1,彰化縣,鹿港鎮,23879,86236,43956,42280
2015/5/1,彰化縣,和美鎮,26066,90927,46471,44456
2015/5/1,彰化縣,北斗鎮,10439,33210,16759,16451
2015/5/1,彰化縣,員林市,38449,124674,62270,62404
2015/5/1,彰化縣,溪湖鎮,16004,55716,28359,27357
2015/5/1,彰化縣,田中鎮,12947,42567,22031,20536
2015/5/1,彰化縣,二林鎮,14813,52076,26875,25201
2015/5/1,彰化縣,線西鄉,4316,17085,8852,8233
2015/5/1,彰化縣,伸港鄉,9518,36196,18524,17672
2015/5/1,彰化縣,福興鄉,12528,47698,24859,22839
2015/5/1,彰化縣,秀水鄉,10433,39348,20337,19011
2015/5/1,彰化縣,花壇鄉,13690,45896,23641,22255
2015/5/1,彰化縣,芬園鄉,6881,24036,12673,11363
2015/5/1,彰化縣,大村鄉,10794,36406,18860,17546
2015/5/1,彰化縣,埔鹽鄉,8994,33084,17366,15718
2015/5/1,彰化縣,埔心鄉,10359,34902,18015,16887
2015/5/1,彰化縣,永靖鄉,10811,38120,19826,18294
2015/5/1,彰化縣,社頭鄉,12746,43557,22396,21161
2015/5/1,彰化縣,二水鄉,5334,15724,8238,7486
2015/5/1,彰化縣,田尾鄉,7861,27661,14356,13305
2015/5/1,彰化縣,埤頭鄉,8908,30925,16086,14839
2015/5/1,彰化縣,芳苑鄉,10110,34469,18242,16227
2015/5/1,彰化縣,大城鄉,5328,17652,9567,8085
2015/5/1,彰化縣,竹塘鄉,4617,15769,8321,7448
2015/5/1,彰化縣,溪州鄉,8896,30622,16061,14561
2015/5/1,南投縣,南投市,34368,102218,51262,50956
2015/5/1,南投縣,埔里鎮,28924,82695,41525,41170
2015/5/1,南投縣,草屯鎮,32614,98945,49995,48950
2015/5/1,南投縣,竹山鎮,19981,56316,28926,27390
2015/5/1,南投縣,集集鎮,4375,11310,5906,5404
2015/5/1,南投縣,名間鄉,12565,39834,20946,18888
2015/5/1,南投縣,鹿谷鄉,7644,18372,9768,8604
2015/5/1,南投縣,中寮鄉,5645,15451,8413,7038
2015/5/1,南投縣,魚池鄉,5734,16397,8578,7819
2015/5/1,南投縣,國姓鄉,7288,19558,10595,8963
2015/5/1,南投縣,水里鄉,7202,18520,9719,8801
2015/5/1,南投縣,信義鄉,5243,16616,8924,7692
2015/5/1,南投縣,仁愛鄉,4935,15708,8098,7610
2015/5/1,雲林縣,斗六市,37281,108212,54016,54196
2015/5/1,雲林縣,斗南鎮,15732,45810,23273,22537
2015/5/1,雲林縣,虎尾鎮,24145,70378,35692,34686
2015/5/1,雲林縣,西螺鎮,14458,47081,23919,23162
2015/5/1,雲林縣,土庫鎮,9215,29563,15452,14111
2015/5/1,雲林縣,北港鎮,15916,41316,21452,19864
2015/5/1,雲林縣,古坑鄉,10928,32499,17155,15344
2015/5/1,雲林縣,大埤鄉,6753,19845,10656,9189
2015/5/1,雲林縣,莿桐鄉,9257,29369,15433,13936
2015/5/1,雲林縣,林內鄉,5916,18943,9924,9019
2015/5/1,雲林縣,二崙鄉,8962,28205,15113,13092
2015/5/1,雲林縣,崙背鄉,8499,25688,13585,12103
2015/5/1,雲林縣,麥寮鄉,13894,43990,22257,21733
2015/5/1,雲林縣,東勢鄉,5762,15589,8555,7034
2015/5/1,雲林縣,褒忠鄉,4405,13473,7227,6246
2015/5/1,雲林縣,臺西鄉,8762,24780,13290,11490
2015/5/1,雲林縣,元長鄉,9402,27031,14749,12282
2015/5/1,雲林縣,四湖鄉,8960,25058,13582,11476
2015/5/1,雲林縣,口湖鄉,9616,28729,15266,13463
2015/5/1,雲林縣,水林鄉,10186,26745,14692,12053
2015/5/1,嘉義縣,太保市,12225,37081,19090,17991
2015/5/1,嘉義縣,朴子市,15445,43192,21874,21318
2015/5/1,嘉義縣,布袋鎮,10068,28113,14376,13737
2015/5/1,嘉義縣,大林鎮,11404,31962,16379,15583
2015/5/1,嘉義縣,民雄鄉,24196,71912,36831,35081
2015/5/1,嘉義縣,溪口鄉,5410,15219,8136,7083
2015/5/1,嘉義縣,新港鄉,10604,33018,17466,15552
2015/5/1,嘉義縣,六腳鄉,8997,24376,12955,11421
2015/5/1,嘉義縣,東石鄉,9397,25901,13736,12165
2015/5/1,嘉義縣,義竹鄉,7531,19391,10080,9311
2015/5/1,嘉義縣,鹿草鄉,5807,16250,8717,7533
2015/5/1,嘉義縣,水上鄉,17884,50567,26138,24429
2015/5/1,嘉義縣,中埔鄉,15974,45886,23909,21977
2015/5/1,嘉義縣,竹崎鄉,11650,36725,19610,17115
2015/5/1,嘉義縣,梅山鄉,6769,20166,10698,9468
2015/5/1,嘉義縣,番路鄉,4321,11956,6466,5490
2015/5/1,嘉義縣,大埔鄉,1941,4614,2403,2211
2015/5/1,嘉義縣,阿里山鄉,1955,5736,3043,2693
2015/5/1,屏東縣,屏東市,73482,203311,101046,102265
2015/5/1,屏東縣,潮州鎮,19041,54786,27469,27317
2015/5/1,屏東縣,東港鎮,16296,48145,24407,23738
2015/5/1,屏東縣,恆春鎮,11241,30852,15795,15057
2015/5/1,屏東縣,萬丹鄉,14756,51891,26843,25048
2015/5/1,屏東縣,長治鄉,9989,30334,15821,14513
2015/5/1,屏東縣,麟洛鄉,3726,11221,5808,5413
2015/5/1,屏東縣,九如鄉,6814,22123,11448,10675
2015/5/1,屏東縣,里港鄉,8121,26888,13677,13211
2015/5/1,屏東縣,鹽埔鄉,7839,26504,13766,12738
2015/5/1,屏東縣,高樹鄉,9397,25318,13488,11830
2015/5/1,屏東縣,萬巒鄉,6475,20823,10920,9903
2015/5/1,屏東縣,內埔鄉,18446,55935,28985,26950
2015/5/1,屏東縣,竹田鄉,5639,17594,9337,8257
2015/5/1,屏東縣,新埤鄉,3423,10110,5379,4731
2015/5/1,屏東縣,枋寮鄉,8563,25391,13292,12099
2015/5/1,屏東縣,新園鄉,11766,36424,18840,17584
2015/5/1,屏東縣,崁頂鄉,4429,16268,8269,7999
2015/5/1,屏東縣,林邊鄉,6978,19066,9809,9257
2015/5/1,屏東縣,南州鄉,3664,10934,5608,5326
2015/5/1,屏東縣,佳冬鄉,7016,20130,10465,9665
2015/5/1,屏東縣,琉球鄉,4296,12541,6898,5643
2015/5/1,屏東縣,車城鄉,3482,9008,4865,4143
2015/5/1,屏東縣,滿州鄉,3016,8081,4427,3654
2015/5/1,屏東縣,枋山鄉,2126,5672,3017,2655
2015/5/1,屏東縣,三地門鄉,2285,7740,3920,3820
2015/5/1,屏東縣,霧臺鄉,1049,3377,1725,1652
2015/5/1,屏東縣,瑪家鄉,1997,6685,3414,3271
2015/5/1,屏東縣,泰武鄉,1298,5245,2756,2489
2015/5/1,屏東縣,來義鄉,2222,7558,3854,3704
2015/5/1,屏東縣,春日鄉,1349,4834,2482,2352
2015/5/1,屏東縣,獅子鄉,1515,4830,2496,2334
2015/5/1,屏東縣,牡丹鄉,1864,4826,2497,2329
2015/5/1,臺東縣,臺東市,39105,106780,53723,53057
2015/5/1,臺東縣,成功鎮,5453,14799,7823,6976
2015/5/1,臺東縣,關山鎮,3218,9034,4734,4300
2015/5/1,臺東縣,卑南鄉,6667,17609,9348,8261
2015/5/1,臺東縣,大武鄉,2529,6452,3344,3108
2015/5/1,臺東縣,太麻里鄉,4609,11410,6056,5354
2015/5/1,臺東縣,東河鄉,3762,8915,4915,4000
2015/5/1,臺東縣,長濱鄉,2935,7651,4348,3303
2015/5/1,臺東縣,鹿野鄉,3086,8151,4359,3792
2015/5/1,臺東縣,池上鄉,3256,8522,4471,4051
2015/5/1,臺東縣,綠島鄉,1107,3816,2014,1802
2015/5/1,臺東縣,延平鄉,1071,3584,1923,1661
2015/5/1,臺東縣,海端鄉,1090,4342,2316,2026
2015/5/1,臺東縣,達仁鄉,1454,3649,1996,1653
2015/5/1,臺東縣,金峰鄉,1108,3634,1879,1755
2015/5/1,臺東縣,蘭嶼鄉,1755,4978,2526,2452
2015/5/1,花蓮縣,花蓮市,41438,106301,51576,54725
2015/5/1,花蓮縣,鳳林鎮,4419,11181,5858,5323
2015/5/1,花蓮縣,玉里鎮,8930,25247,13493,11754
2015/5/1,花蓮縣,新城鄉,7545,20175,10407,9768
2015/5/1,花蓮縣,吉安鄉,31223,82700,41965,40735
2015/5/1,花蓮縣,壽豐鄉,7024,18166,9716,8450
2015/5/1,花蓮縣,光復鄉,5030,13262,7059,6203
2015/5/1,花蓮縣,豐濱鄉,1740,4629,2569,2060
2015/5/1,花蓮縣,瑞穗鄉,4681,12006,6451,5555
2015/5/1,花蓮縣,富里鄉,3997,10743,5869,4874
2015/5/1,花蓮縣,秀林鄉,4764,15497,8024,7473
2015/5/1,花蓮縣,萬榮鄉,2085,6468,3418,3050
2015/5/1,花蓮縣,卓溪鄉,1677,6097,3356,2741
2015/5/1,澎湖縣,馬公市,23162,60484,30762,29722
2015/5/1,澎湖縣,湖西鄉,5361,14317,7560,6757
2015/5/1,澎湖縣,白沙鄉,3345,9754,5106,4648
2015/5/1,澎湖縣,西嶼鄉,2940,8410,4328,4082
2015/5/1,澎湖縣,望安鄉,1988,5117,2761,2356
2015/5/1,澎湖縣,七美鄉,1325,3756,1957,1799
2015/5/1,基隆市,中正區,22490,52892,27104,25788
2015/5/1,基隆市,七堵區,21035,54046,27304,26742
2015/5/1,基隆市,暖暖區,15333,38319,19309,19010
2015/5/1,基隆市,仁愛區,19464,46132,22741,23391
2015/5/1,基隆市,中山區,19273,48483,24687,23796
2015/5/1,基隆市,安樂區,32329,81589,40604,40985
2015/5/1,基隆市,信義區,20908,51330,25583,25747
2015/5/1,新竹市,東區,75596,207529,102210,105319
2015/5/1,新竹市,北區,54538,148769,72993,75776
2015/5/1,新竹市,香山區,25901,76394,38935,37459
2015/5/1,嘉義市,東區,45290,123319,59776,63543
2015/5/1,嘉義市,西區,53284,147639,72512,75127
2015/5/1,金門縣,金城鎮,12526,41511,20848,20663
2015/5/1,金門縣,金湖鎮,8401,27759,13988,13771
2015/5/1,金門縣,金沙鎮,6102,19748,9758,9990
2015/5/1,金門縣,金寧鄉,7808,27768,14049,13719
2015/5/1,金門縣,烈嶼鄉,3042,12182,6024,6158
2015/5/1,金門縣,烏坵鄉,134,671,336,335
2015/5/1,連江縣,南竿鄉,1430,7454,4229,3225
2015/5/1,連江縣,北竿鄉,484,2311,1282,1029
2015/5/1,連江縣,莒光鄉,267,1446,840,606
2015/5/1,連江縣,東引鄉,313,1265,762,503
2015/6/1,總計,新北市,1503844,3966052,1950254,2015798
2015/6/1,總計,臺北市,1041379,2706030,1296639,1409391
2015/6/1,總計,桃園市,742046,2086081,1044593,1041488
2015/6/1,總計,臺中市,920195,2731500,1351793,1379707
2015/6/1,總計,臺南市,670228,1885376,944116,941260
2015/6/1,總計,高雄市,1069177,2778835,1381933,1396902
2015/6/1,總計,臺灣省,2439626,7165361,3662532,3502829
2015/6/1,總計,宜蘭縣,163974,458313,232497,225816
2015/6/1,總計,新竹縣,181120,539173,276045,263128
2015/6/1,總計,苗栗縣,183736,565704,291471,274233
2015/6/1,總計,彰化縣,380058,1289274,659194,630080
2015/6/1,總計,南投縣,176609,511518,262429,249089
2015/6/1,總計,雲林縣,238079,701898,365048,336850
2015/6/1,總計,嘉義縣,181653,521591,271681,249910
2015/6/1,總計,屏東縣,283712,843981,432531,411450
2015/6/1,總計,臺東縣,82246,223189,115668,107521
2015/6/1,總計,花蓮縣,124617,332424,169695,162729
2015/6/1,總計,澎湖縣,37981,101753,52464,49289
2015/6/1,總計,基隆市,150947,372787,187317,185470
2015/6/1,總計,新竹市,156266,432860,214222,218638
2015/6/1,總計,嘉義市,98628,270896,132270,138626
2015/6/1,總計,福建省,40580,142327,72207,70120
2015/6/1,總計,金門縣,38082,129831,65071,64760
2015/6/1,總計,連江縣,2498,12496,7136,5360
2015/6/1,新北市,板橋區,205379,555138,271775,283363
2015/6/1,新北市,三重區,147882,388502,191909,196593
2015/6/1,新北市,中和區,162672,414528,202544,211984
2015/6/1,新北市,永和區,90744,226715,107868,118847
2015/6/1,新北市,新莊區,148136,412363,202115,210248
2015/6/1,新北市,新店區,123333,299656,144912,154744
2015/6/1,新北市,樹林區,65236,184028,91986,92042
2015/6/1,新北市,鶯歌區,29345,88396,44346,44050
2015/6/1,新北市,三峽區,40758,112059,56450,55609
2015/6/1,新北市,淡水區,69261,160444,77281,83163
2015/6/1,新北市,汐止區,84587,195374,95679,99695
2015/6/1,新北市,瑞芳區,16068,41024,20754,20270
2015/6/1,新北市,土城區,85742,238790,118247,120543
2015/6/1,新北市,蘆洲區,69212,199739,98367,101372
2015/6/1,新北市,五股區,29610,82437,41626,40811
2015/6/1,新北市,泰山區,27835,78484,39073,39411
2015/6/1,新北市,林口區,38529,98978,48448,50530
2015/6/1,新北市,深坑區,9382,23561,11816,11745
2015/6/1,新北市,石碇區,3364,7824,4318,3506
2015/6/1,新北市,坪林區,2495,6483,3619,2864
2015/6/1,新北市,三芝區,9315,23469,12081,11388
2015/6/1,新北市,石門區,4306,12652,6577,6075
2015/6/1,新北市,八里區,13884,37288,18652,18636
2015/6/1,新北市,平溪區,2350,4900,2702,2198
2015/6/1,新北市,雙溪區,3829,9319,5030,4289
2015/6/1,新北市,貢寮區,4402,12913,6593,6320
2015/6/1,新北市,金山區,7003,22260,11044,11216
2015/6/1,新北市,萬里區,7387,22600,11388,11212
2015/6/1,新北市,烏來區,1798,6128,3054,3074
2015/6/1,臺北市,松山區,80345,210648,99392,111256
2015/6/1,臺北市,信義區,89407,229605,110093,119512
2015/6/1,臺北市,大安區,120572,314361,147126,167235
2015/6/1,臺北市,中山區,98754,230990,107809,123181
2015/6/1,臺北市,中正區,65382,163447,78079,85368
2015/6/1,臺北市,大同區,51432,130991,64053,66938
2015/6/1,臺北市,萬華區,78159,194278,95952,98326
2015/6/1,臺北市,文山區,103885,274903,132324,142579
2015/6/1,臺北市,南港區,46136,121640,59403,62237
2015/6/1,臺北市,內湖區,105967,286696,137324,149372
2015/6/1,臺北市,士林區,105901,290688,140646,150042
2015/6/1,臺北市,北投區,95439,257783,124438,133345
2015/6/1,桃園市,桃園區,158259,423658,206658,217000
2015/6/1,桃園市,中壢區,140059,386679,191544,195135
2015/6/1,桃園市,大溪區,31123,92845,47674,45171
2015/6/1,桃園市,楊梅區,54374,159382,80768,78614
2015/6/1,桃園市,蘆竹區,54695,153583,76598,76985
2015/6/1,桃園市,大園區,30249,85105,43769,41336
2015/6/1,桃園市,龜山區,55079,143859,72248,71611
2015/6/1,桃園市,八德區,64651,184493,93026,91467
2015/6/1,桃園市,龍潭區,39678,117491,59254,58237
2015/6/1,桃園市,平鎮區,73209,215617,107671,107946
2015/6/1,桃園市,新屋區,15658,48296,25842,22454
2015/6/1,桃園市,觀音區,21284,64127,33551,30576
2015/6/1,桃園市,復興區,3728,10946,5990,4956
2015/6/1,臺中市,中區,7820,19231,9594,9637
2015/6/1,臺中市,東區,27225,75044,37513,37531
2015/6/1,臺中市,南區,46398,120919,58272,62647
2015/6/1,臺中市,西區,44992,115824,55153,60671
2015/6/1,臺中市,北區,58338,147446,70858,76588
2015/6/1,臺中市,西屯區,81490,220270,106106,114164
2015/6/1,臺中市,南屯區,59145,163250,78325,84925
2015/6/1,臺中市,北屯區,93394,262204,126314,135890
2015/6/1,臺中市,豐原區,52462,166665,82573,84092
2015/6/1,臺中市,東勢區,17269,51313,26517,24796
2015/6/1,臺中市,大甲區,22590,77640,39201,38439
2015/6/1,臺中市,清水區,26236,85971,44227,41744
2015/6/1,臺中市,沙鹿區,27501,88715,44993,43722
2015/6/1,臺中市,梧棲區,17015,56906,28668,28238
2015/6/1,臺中市,后里區,15591,54186,27591,26595
2015/6/1,臺中市,神岡區,18800,64995,33277,31718
2015/6/1,臺中市,潭子區,35114,105819,52486,53333
2015/6/1,臺中市,大雅區,28181,93226,46639,46587
2015/6/1,臺中市,新社區,7484,25153,13084,12069
2015/6/1,臺中市,石岡區,4900,15309,7953,7356
2015/6/1,臺中市,外埔區,9330,31746,16328,15418
2015/6/1,臺中市,大安區,5385,19572,10336,9236
2015/6/1,臺中市,烏日區,22907,72018,36305,35713
2015/6/1,臺中市,大肚區,16795,56428,28917,27511
2015/6/1,臺中市,龍井區,22170,76245,38639,37606
2015/6/1,臺中市,霧峰區,19655,64563,32937,31626
2015/6/1,臺中市,太平區,60463,182783,90996,91787
2015/6/1,臺中市,大里區,67126,207339,102235,105104
2015/6/1,臺中市,和平區,4419,10720,5756,4964
2015/6/1,臺南市,新營區,28506,78216,38751,39465
2015/6/1,臺南市,鹽水區,10084,26221,13688,12533
2015/6/1,臺南市,白河區,10956,29500,15434,14066
2015/6/1,臺南市,柳營區,7833,21691,11298,10393
2015/6/1,臺南市,後壁區,8898,24448,12732,11716
2015/6/1,臺南市,東山區,8265,21731,11541,10190
2015/6/1,臺南市,麻豆區,15501,45020,22890,22130
2015/6/1,臺南市,下營區,9093,24948,12862,12086
2015/6/1,臺南市,六甲區,7711,22687,11737,10950
2015/6/1,臺南市,官田區,7780,21593,11028,10565
2015/6/1,臺南市,大內區,3945,10153,5433,4720
2015/6/1,臺南市,佳里區,20319,59618,29585,30033
2015/6/1,臺南市,學甲區,9669,26733,13682,13051
2015/6/1,臺南市,西港區,8078,24879,12594,12285
2015/6/1,臺南市,七股區,8099,23518,12209,11309
2015/6/1,臺南市,將軍區,7317,20412,10386,10026
2015/6/1,臺南市,北門區,4343,11580,5842,5738
2015/6/1,臺南市,新化區,14221,43755,22334,21421
2015/6/1,臺南市,善化區,16536,46577,23527,23050
2015/6/1,臺南市,新市區,11643,35682,17911,17771
2015/6/1,臺南市,安定區,9828,30276,15540,14736
2015/6/1,臺南市,山上區,2691,7489,3918,3571
2015/6/1,臺南市,玉井區,5119,14455,7517,6938
2015/6/1,臺南市,楠西區,3539,10086,5344,4742
2015/6/1,臺南市,南化區,2865,8948,4835,4113
2015/6/1,臺南市,左鎮區,1992,5105,2860,2245
2015/6/1,臺南市,仁德區,26697,73374,37356,36018
2015/6/1,臺南市,歸仁區,22064,67686,34398,33288
2015/6/1,臺南市,關廟區,10906,34783,17965,16818
2015/6/1,臺南市,龍崎區,1573,4246,2302,1944
2015/6/1,臺南市,永康區,81495,229999,113645,116354
2015/6/1,臺南市,東區,71882,189708,91240,98468
2015/6/1,臺南市,南區,44844,125824,62560,63264
2015/6/1,臺南市,北區,49805,132638,64808,67830
2015/6/1,臺南市,安南區,60609,188741,95438,93303
2015/6/1,臺南市,安平區,24690,65219,31023,34196
2015/6/1,臺南市,中西區,30832,77837,37903,39934
2015/6/1,高雄市,鹽埕區,10839,25220,12578,12642
2015/6/1,高雄市,鼓山區,55832,136152,66071,70081
2015/6/1,高雄市,左營區,77414,196001,94938,101063
2015/6/1,高雄市,楠梓區,66768,179292,88511,90781
2015/6/1,高雄市,三民區,135175,347252,168548,178704
2015/6/1,高雄市,新興區,22724,52271,25175,27096
2015/6/1,高雄市,前金區,12554,27581,13242,14339
2015/6/1,高雄市,苓雅區,72172,175013,84590,90423
2015/6/1,高雄市,前鎮區,78323,193326,95354,97972
2015/6/1,高雄市,旗津區,11000,28854,14964,13890
2015/6/1,高雄市,小港區,66249,156083,77837,78246
2015/6/1,高雄市,鳳山區,136471,355510,174931,180579
2015/6/1,高雄市,林園區,25466,70395,35737,34658
2015/6/1,高雄市,大寮區,41159,111500,57290,54210
2015/6/1,高雄市,大樹區,13354,43152,22167,20985
2015/6/1,高雄市,大社區,12680,34473,17551,16922
2015/6/1,高雄市,仁武區,30681,81636,41717,39919
2015/6/1,高雄市,鳥松區,17588,43789,22302,21487
2015/6/1,高雄市,岡山區,34522,97745,48597,49148
2015/6/1,高雄市,橋頭區,13219,37306,19017,18289
2015/6/1,高雄市,燕巢區,10361,30259,16040,14219
2015/6/1,高雄市,田寮區,3394,7545,4182,3363
2015/6/1,高雄市,阿蓮區,9376,29428,14849,14579
2015/6/1,高雄市,路竹區,16783,53063,27130,25933
2015/6/1,高雄市,湖內區,10493,29543,15122,14421
2015/6/1,高雄市,茄萣區,10447,30528,15784,14744
2015/6/1,高雄市,永安區,5789,14105,7084,7021
2015/6/1,高雄市,彌陀區,6756,19731,10213,9518
2015/6/1,高雄市,梓官區,12532,36449,18834,17615
2015/6/1,高雄市,旗山區,13862,37938,19676,18262
2015/6/1,高雄市,美濃區,14546,41029,21497,19532
2015/6/1,高雄市,六龜區,5638,13559,7312,6247
2015/6/1,高雄市,甲仙區,2366,6326,3357,2969
2015/6/1,高雄市,杉林區,4819,12437,6797,5640
2015/6/1,高雄市,內門區,5062,15053,8144,6909
2015/6/1,高雄市,茂林區,579,1886,930,956
2015/6/1,高雄市,桃源區,1323,4244,2227,2017
2015/6/1,高雄市,那瑪夏區,861,3161,1638,1523
2015/6/1,宜蘭縣,宜蘭市,35418,95973,46882,49091
2015/6/1,宜蘭縣,羅東鎮,26053,72676,34585,38091
2015/6/1,宜蘭縣,蘇澳鎮,14020,40851,20846,20005
2015/6/1,宜蘭縣,頭城鎮,10118,29857,15425,14432
2015/6/1,宜蘭縣,礁溪鄉,13448,35861,18728,17133
2015/6/1,宜蘭縣,壯圍鄉,8465,24316,12863,11453
2015/6/1,宜蘭縣,員山鄉,11401,32263,17151,15112
2015/6/1,宜蘭縣,冬山鄉,18723,53512,27543,25969
2015/6/1,宜蘭縣,五結鄉,14270,39402,20413,18989
2015/6/1,宜蘭縣,三星鄉,8266,21430,11550,9880
2015/6/1,宜蘭縣,大同鄉,1884,6097,3315,2782
2015/6/1,宜蘭縣,南澳鄉,1908,6075,3196,2879
2015/6/1,新竹縣,竹北市,59533,168072,83827,84245
2015/6/1,新竹縣,關西鎮,9523,30244,16147,14097
2015/6/1,新竹縣,新埔鎮,10613,34183,18186,15997
2015/6/1,新竹縣,竹東鎮,32444,96040,48253,47787
2015/6/1,新竹縣,湖口鄉,25417,77070,39166,37904
2015/6/1,新竹縣,橫山鄉,4509,13629,7416,6213
2015/6/1,新竹縣,新豐鄉,17633,55987,28716,27271
2015/6/1,新竹縣,芎林鄉,6467,20294,10735,9559
2015/6/1,新竹縣,寶山鄉,5172,14308,7739,6569
2015/6/1,新竹縣,北埔鄉,3133,9721,5229,4492
2015/6/1,新竹縣,峨眉鄉,2083,5681,3157,2524
2015/6/1,新竹縣,尖石鄉,2848,9331,4961,4370
2015/6/1,新竹縣,五峰鄉,1745,4613,2513,2100
2015/6/1,苗栗縣,苗栗市,30639,90782,45371,45411
2015/6/1,苗栗縣,苑裡鎮,14435,48218,24973,23245
2015/6/1,苗栗縣,通霄鎮,11561,36577,19271,17306
2015/6/1,苗栗縣,竹南鎮,27547,84096,42480,41616
2015/6/1,苗栗縣,頭份市,33311,103057,51998,51059
2015/6/1,苗栗縣,後龍鎮,11876,38095,20058,18037
2015/6/1,苗栗縣,卓蘭鎮,6128,18239,9537,8702
2015/6/1,苗栗縣,大湖鄉,5432,15395,8158,7237
2015/6/1,苗栗縣,公館鄉,10623,34645,17977,16668
2015/6/1,苗栗縣,銅鑼鄉,6138,18798,9954,8844
2015/6/1,苗栗縣,南庄鄉,3973,10601,5830,4771
2015/6/1,苗栗縣,頭屋鄉,3650,11317,5962,5355
2015/6/1,苗栗縣,三義鄉,5460,17111,8966,8145
2015/6/1,苗栗縣,西湖鄉,2690,7523,4183,3340
2015/6/1,苗栗縣,造橋鄉,4153,13445,7055,6390
2015/6/1,苗栗縣,三灣鄉,2421,7067,3857,3210
2015/6/1,苗栗縣,獅潭鄉,1738,4646,2584,2062
2015/6/1,苗栗縣,泰安鄉,1961,6092,3257,2835
2015/6/1,彰化縣,彰化市,75096,234947,116456,118491
2015/6/1,彰化縣,鹿港鎮,23910,86275,43962,42313
2015/6/1,彰化縣,和美鎮,26096,90931,46467,44464
2015/6/1,彰化縣,北斗鎮,10442,33208,16762,16446
2015/6/1,彰化縣,員林市,38486,124653,62220,62433
2015/6/1,彰化縣,溪湖鎮,16022,55735,28354,27381
2015/6/1,彰化縣,田中鎮,12966,42569,22028,20541
2015/6/1,彰化縣,二林鎮,14816,52038,26854,25184
2015/6/1,彰化縣,線西鄉,4313,17065,8839,8226
2015/6/1,彰化縣,伸港鄉,9537,36221,18533,17688
2015/6/1,彰化縣,福興鄉,12529,47669,24839,22830
2015/6/1,彰化縣,秀水鄉,10456,39352,20344,19008
2015/6/1,彰化縣,花壇鄉,13689,45867,23621,22246
2015/6/1,彰化縣,芬園鄉,6880,24011,12659,11352
2015/6/1,彰化縣,大村鄉,10807,36412,18874,17538
2015/6/1,彰化縣,埔鹽鄉,8991,33045,17339,15706
2015/6/1,彰化縣,埔心鄉,10371,34899,18010,16889
2015/6/1,彰化縣,永靖鄉,10816,38128,19833,18295
2015/6/1,彰化縣,社頭鄉,12756,43557,22400,21157
2015/6/1,彰化縣,二水鄉,5336,15715,8229,7486
2015/6/1,彰化縣,田尾鄉,7863,27649,14346,13303
2015/6/1,彰化縣,埤頭鄉,8918,30928,16087,14841
2015/6/1,彰化縣,芳苑鄉,10109,34461,18249,16212
2015/6/1,彰化縣,大城鄉,5327,17610,9546,8064
2015/6/1,彰化縣,竹塘鄉,4625,15739,8300,7439
2015/6/1,彰化縣,溪州鄉,8901,30590,16043,14547
2015/6/1,南投縣,南投市,34397,102178,51226,50952
2015/6/1,南投縣,埔里鎮,28945,82687,41531,41156
2015/6/1,南投縣,草屯鎮,32629,98875,49950,48925
2015/6/1,南投縣,竹山鎮,19981,56228,28881,27347
2015/6/1,南投縣,集集鎮,4376,11301,5899,5402
2015/6/1,南投縣,名間鄉,12572,39801,20920,18881
2015/6/1,南投縣,鹿谷鄉,7657,18351,9762,8589
2015/6/1,南投縣,中寮鄉,5651,15459,8415,7044
2015/6/1,南投縣,魚池鄉,5738,16370,8570,7800
2015/6/1,南投縣,國姓鄉,7284,19524,10579,8945
2015/6/1,南投縣,水里鄉,7203,18493,9707,8786
2015/6/1,南投縣,信義鄉,5245,16585,8909,7676
2015/6/1,南投縣,仁愛鄉,4931,15666,8080,7586
2015/6/1,雲林縣,斗六市,37321,108262,54043,54219
2015/6/1,雲林縣,斗南鎮,15728,45778,23234,22544
2015/6/1,雲林縣,虎尾鎮,24182,70405,35693,34712
2015/6/1,雲林縣,西螺鎮,14479,47089,23915,23174
2015/6/1,雲林縣,土庫鎮,9218,29546,15449,14097
2015/6/1,雲林縣,北港鎮,15906,41297,21453,19844
2015/6/1,雲林縣,古坑鄉,10928,32478,17138,15340
2015/6/1,雲林縣,大埤鄉,6745,19809,10643,9166
2015/6/1,雲林縣,莿桐鄉,9259,29363,15426,13937
2015/6/1,雲林縣,林內鄉,5920,18921,9915,9006
2015/6/1,雲林縣,二崙鄉,8954,28165,15096,13069
2015/6/1,雲林縣,崙背鄉,8501,25652,13571,12081
2015/6/1,雲林縣,麥寮鄉,13912,44034,22269,21765
2015/6/1,雲林縣,東勢鄉,5762,15582,8558,7024
2015/6/1,雲林縣,褒忠鄉,4406,13441,7209,6232
2015/6/1,雲林縣,臺西鄉,8756,24756,13269,11487
2015/6/1,雲林縣,元長鄉,9383,26988,14734,12254
2015/6/1,雲林縣,四湖鄉,8942,24980,13545,11435
2015/6/1,雲林縣,口湖鄉,9603,28673,15233,13440
2015/6/1,雲林縣,水林鄉,10174,26679,14655,12024
2015/6/1,嘉義縣,太保市,12258,37036,19064,17972
2015/6/1,嘉義縣,朴子市,15461,43175,21859,21316
2015/6/1,嘉義縣,布袋鎮,10068,28079,14360,13719
2015/6/1,嘉義縣,大林鎮,11397,31917,16349,15568
2015/6/1,嘉義縣,民雄鄉,24230,71904,36825,35079
2015/6/1,嘉義縣,溪口鄉,5405,15209,8129,7080
2015/6/1,嘉義縣,新港鄉,10612,32990,17464,15526
2015/6/1,嘉義縣,六腳鄉,8996,24334,12939,11395
2015/6/1,嘉義縣,東石鄉,9394,25851,13716,12135
2015/6/1,嘉義縣,義竹鄉,7530,19367,10076,9291
2015/6/1,嘉義縣,鹿草鄉,5803,16196,8695,7501
2015/6/1,嘉義縣,水上鄉,17882,50541,26120,24421
2015/6/1,嘉義縣,中埔鄉,15967,45844,23882,21962
2015/6/1,嘉義縣,竹崎鄉,11662,36735,19620,17115
2015/6/1,嘉義縣,梅山鄉,6761,20138,10692,9446
2015/6/1,嘉義縣,番路鄉,4323,11942,6458,5484
2015/6/1,嘉義縣,大埔鄉,1947,4608,2401,2207
2015/6/1,嘉義縣,阿里山鄉,1957,5725,3032,2693
2015/6/1,屏東縣,屏東市,73538,203220,100963,102257
2015/6/1,屏東縣,潮州鎮,19045,54761,27446,27315
2015/6/1,屏東縣,東港鎮,16301,48118,24389,23729
2015/6/1,屏東縣,恆春鎮,11253,30852,15806,15046
2015/6/1,屏東縣,萬丹鄉,14764,51864,26848,25016
2015/6/1,屏東縣,長治鄉,9998,30346,15825,14521
2015/6/1,屏東縣,麟洛鄉,3730,11227,5812,5415
2015/6/1,屏東縣,九如鄉,6818,22115,11452,10663
2015/6/1,屏東縣,里港鄉,8127,26942,13717,13225
2015/6/1,屏東縣,鹽埔鄉,7836,26466,13748,12718
2015/6/1,屏東縣,高樹鄉,9397,25267,13451,11816
2015/6/1,屏東縣,萬巒鄉,6477,20812,10916,9896
2015/6/1,屏東縣,內埔鄉,18466,55938,28986,26952
2015/6/1,屏東縣,竹田鄉,5644,17607,9345,8262
2015/6/1,屏東縣,新埤鄉,3418,10090,5368,4722
2015/6/1,屏東縣,枋寮鄉,8552,25342,13269,12073
2015/6/1,屏東縣,新園鄉,11759,36397,18827,17570
2015/6/1,屏東縣,崁頂鄉,4433,16234,8234,8000
2015/6/1,屏東縣,林邊鄉,6976,19057,9807,9250
2015/6/1,屏東縣,南州鄉,3667,10935,5608,5327
2015/6/1,屏東縣,佳冬鄉,7004,20099,10436,9663
2015/6/1,屏東縣,琉球鄉,4305,12533,6891,5642
2015/6/1,屏東縣,車城鄉,3482,9002,4857,4145
2015/6/1,屏東縣,滿州鄉,3021,8068,4414,3654
2015/6/1,屏東縣,枋山鄉,2128,5672,3017,2655
2015/6/1,屏東縣,三地門鄉,2288,7725,3916,3809
2015/6/1,屏東縣,霧臺鄉,1051,3366,1717,1649
2015/6/1,屏東縣,瑪家鄉,2001,6677,3406,3271
2015/6/1,屏東縣,泰武鄉,1299,5244,2760,2484
2015/6/1,屏東縣,來義鄉,2215,7551,3845,3706
2015/6/1,屏東縣,春日鄉,1348,4822,2474,2348
2015/6/1,屏東縣,獅子鄉,1514,4830,2498,2332
2015/6/1,屏東縣,牡丹鄉,1857,4802,2483,2319
2015/6/1,臺東縣,臺東市,39148,106844,53734,53110
2015/6/1,臺東縣,成功鎮,5456,14768,7808,6960
2015/6/1,臺東縣,關山鎮,3214,9031,4735,4296
2015/6/1,臺東縣,卑南鄉,6659,17553,9310,8243
2015/6/1,臺東縣,大武鄉,2533,6423,3336,3087
2015/6/1,臺東縣,太麻里鄉,4613,11414,6058,5356
2015/6/1,臺東縣,東河鄉,3762,8887,4897,3990
2015/6/1,臺東縣,長濱鄉,2935,7657,4355,3302
2015/6/1,臺東縣,鹿野鄉,3091,8147,4358,3789
2015/6/1,臺東縣,池上鄉,3250,8496,4456,4040
2015/6/1,臺東縣,綠島鄉,1105,3814,2009,1805
2015/6/1,臺東縣,延平鄉,1073,3565,1908,1657
2015/6/1,臺東縣,海端鄉,1090,4332,2308,2024
2015/6/1,臺東縣,達仁鄉,1452,3634,1985,1649
2015/6/1,臺東縣,金峰鄉,1107,3631,1878,1753
2015/6/1,臺東縣,蘭嶼鄉,1758,4993,2533,2460
2015/6/1,花蓮縣,花蓮市,41452,106183,51505,54678
2015/6/1,花蓮縣,鳳林鎮,4417,11154,5844,5310
2015/6/1,花蓮縣,玉里鎮,8916,25202,13465,11737
2015/6/1,花蓮縣,新城鄉,7549,20182,10410,9772
2015/6/1,花蓮縣,吉安鄉,31289,82869,42048,40821
2015/6/1,花蓮縣,壽豐鄉,7016,18151,9702,8449
2015/6/1,花蓮縣,光復鄉,5026,13271,7053,6218
2015/6/1,花蓮縣,豐濱鄉,1737,4610,2555,2055
2015/6/1,花蓮縣,瑞穗鄉,4683,12001,6449,5552
2015/6/1,花蓮縣,富里鄉,4001,10729,5854,4875
2015/6/1,花蓮縣,秀林鄉,4765,15505,8026,7479
2015/6/1,花蓮縣,萬榮鄉,2089,6477,3429,3048
2015/6/1,花蓮縣,卓溪鄉,1677,6090,3355,2735
2015/6/1,澎湖縣,馬公市,23003,60390,30742,29648
2015/6/1,澎湖縣,湖西鄉,5381,14333,7564,6769
2015/6/1,澎湖縣,白沙鄉,3343,9735,5101,4634
2015/6/1,澎湖縣,西嶼鄉,2941,8409,4329,4080
2015/6/1,澎湖縣,望安鄉,1984,5112,2758,2354
2015/6/1,澎湖縣,七美鄉,1329,3774,1970,1804
2015/6/1,基隆市,中正區,22499,52859,27086,25773
2015/6/1,基隆市,七堵區,21053,54074,27325,26749
2015/6/1,基隆市,暖暖區,15365,38372,19325,19047
2015/6/1,基隆市,仁愛區,19468,46106,22752,23354
2015/6/1,基隆市,中山區,19283,48441,24650,23791
2015/6/1,基隆市,安樂區,32346,81589,40600,40989
2015/6/1,基隆市,信義區,20933,51346,25579,25767
2015/6/1,新竹市,東區,75742,207671,102299,105372
2015/6/1,新竹市,北區,54591,148838,73017,75821
2015/6/1,新竹市,香山區,25933,76351,38906,37445
2015/6/1,嘉義市,東區,45321,123329,59774,63555
2015/6/1,嘉義市,西區,53307,147567,72496,75071
2015/6/1,金門縣,金城鎮,12535,41604,20880,20724
2015/6/1,金門縣,金湖鎮,8430,27841,14024,13817
2015/6/1,金門縣,金沙鎮,6104,19807,9782,10025
2015/6/1,金門縣,金寧鄉,7831,27703,14010,13693
2015/6/1,金門縣,烈嶼鄉,3048,12207,6039,6168
2015/6/1,金門縣,烏坵鄉,134,669,336,333
2015/6/1,連江縣,南竿鄉,1428,7458,4234,3224
2015/6/1,連江縣,北竿鄉,487,2313,1287,1026
2015/6/1,連江縣,莒光鄉,270,1454,847,607
2015/6/1,連江縣,東引鄉,313,1271,768,503
2015/7/1,總計,新北市,1504931,3966071,1950070,2016001
2015/7/1,總計,臺北市,1041195,2703444,1295296,1408148
2015/7/1,總計,桃園市,743618,2089553,1046019,1043534
2015/7/1,總計,臺中市,921667,2733761,1352687,1381074
2015/7/1,總計,臺南市,670583,1885077,943900,941177
2015/7/1,總計,高雄市,1069713,2778276,1381604,1396672
2015/7/1,總計,臺灣省,2441249,7162559,3660852,3501707
2015/7/1,總計,宜蘭縣,164238,458299,232479,225820
2015/7/1,總計,新竹縣,181435,539620,276302,263318
2015/7/1,總計,苗栗縣,183780,565300,291251,274049
2015/7/1,總計,彰化縣,380394,1288930,658895,630035
2015/7/1,總計,南投縣,176697,511060,262181,248879
2015/7/1,總計,雲林縣,238168,701280,364728,336552
2015/7/1,總計,嘉義縣,181710,521186,271480,249706
2015/7/1,總計,屏東縣,283862,843522,432233,411289
2015/7/1,總計,臺東縣,82233,223025,115554,107471
2015/7/1,總計,花蓮縣,124670,332242,169594,162648
2015/7/1,總計,澎湖縣,37986,101777,52455,49322
2015/7/1,總計,基隆市,150987,372620,187230,185390
2015/7/1,總計,新竹市,156462,432966,214282,218684
2015/7/1,總計,嘉義市,98627,270732,132188,138544
2015/7/1,總計,福建省,40712,142967,72521,70446
2015/7/1,總計,金門縣,38202,130461,65385,65076
2015/7/1,總計,連江縣,2510,12506,7136,5370
2015/7/1,新北市,板橋區,205460,554877,271619,283258
2015/7/1,新北市,三重區,147916,388450,191838,196612
2015/7/1,新北市,中和區,162746,414604,202508,212096
2015/7/1,新北市,永和區,90678,226305,107669,118636
2015/7/1,新北市,新莊區,148285,412361,202099,210262
2015/7/1,新北市,新店區,123410,299718,144945,154773
2015/7/1,新北市,樹林區,65297,184047,91988,92059
2015/7/1,新北市,鶯歌區,29363,88347,44305,44042
2015/7/1,新北市,三峽區,40811,112118,56464,55654
2015/7/1,新北市,淡水區,69457,160775,77433,83342
2015/7/1,新北市,汐止區,84677,195525,95744,99781
2015/7/1,新北市,瑞芳區,16064,40999,20749,20250
2015/7/1,新北市,土城區,85735,238634,118153,120481
2015/7/1,新北市,蘆洲區,69275,199698,98355,101343
2015/7/1,新北市,五股區,29673,82526,41663,40863
2015/7/1,新北市,泰山區,27894,78554,39110,39444
2015/7/1,新北市,林口區,38652,99205,48593,50612
2015/7/1,新北市,深坑區,9389,23542,11810,11732
2015/7/1,新北市,石碇區,3362,7818,4316,3502
2015/7/1,新北市,坪林區,2491,6483,3615,2868
2015/7/1,新北市,三芝區,9314,23429,12057,11372
2015/7/1,新北市,石門區,4309,12649,6565,6084
2015/7/1,新北市,八里區,13899,37333,18687,18646
2015/7/1,新北市,平溪區,2351,4884,2686,2198
2015/7/1,新北市,雙溪區,3826,9306,5026,4280
2015/7/1,新北市,貢寮區,4404,12889,6583,6306
2015/7/1,新北市,金山區,7001,22214,11016,11198
2015/7/1,新北市,萬里區,7396,22632,11415,11217
2015/7/1,新北市,烏來區,1796,6149,3059,3090
2015/7/1,臺北市,松山區,80267,210226,99179,111047
2015/7/1,臺北市,信義區,89384,229380,109988,119392
2015/7/1,臺北市,大安區,120416,313607,146749,166858
2015/7/1,臺北市,中山區,98760,230678,107678,123000
2015/7/1,臺北市,中正區,65308,163168,77946,85222
2015/7/1,臺北市,大同區,51411,130834,63938,66896
2015/7/1,臺北市,萬華區,78144,194141,95878,98263
2015/7/1,臺北市,文山區,103918,274913,132333,142580
2015/7/1,臺北市,南港區,46212,121757,59475,62282
2015/7/1,臺北市,內湖區,105992,286582,137252,149330
2015/7/1,臺北市,士林區,105935,290507,140521,149986
2015/7/1,臺北市,北投區,95448,257651,124359,133292
2015/7/1,桃園市,桃園區,158490,424177,206842,217335
2015/7/1,桃園市,中壢區,140298,387163,191684,195479
2015/7/1,桃園市,大溪區,31182,92894,47706,45188
2015/7/1,桃園市,楊梅區,54526,159664,80900,78764
2015/7/1,桃園市,蘆竹區,54831,153928,76753,77175
2015/7/1,桃園市,大園區,30300,85175,43815,41360
2015/7/1,桃園市,龜山區,55188,144228,72408,71820
2015/7/1,桃園市,八德區,64906,185173,93355,91818
2015/7/1,桃園市,龍潭區,39776,117699,59328,58371
2015/7/1,桃園市,平鎮區,73377,215993,107813,108180
2015/7/1,桃園市,新屋區,15662,48273,25823,22450
2015/7/1,桃園市,觀音區,21350,64227,33594,30633
2015/7/1,桃園市,復興區,3732,10959,5998,4961
2015/7/1,臺中市,中區,7851,19210,9578,9632
2015/7/1,臺中市,東區,27242,74996,37476,37520
2015/7/1,臺中市,南區,46468,121055,58343,62712
2015/7/1,臺中市,西區,44995,115794,55109,60685
2015/7/1,臺中市,北區,58330,147380,70762,76618
2015/7/1,臺中市,西屯區,81664,220635,106286,114349
2015/7/1,臺中市,南屯區,59265,163474,78413,85061
2015/7/1,臺中市,北屯區,93661,262611,126499,136112
2015/7/1,臺中市,豐原區,52498,166619,82537,84082
2015/7/1,臺中市,東勢區,17289,51323,26504,24819
2015/7/1,臺中市,大甲區,22620,77679,39199,38480
2015/7/1,臺中市,清水區,26274,85994,44231,41763
2015/7/1,臺中市,沙鹿區,27582,88888,45079,43809
2015/7/1,臺中市,梧棲區,17058,56983,28698,28285
2015/7/1,臺中市,后里區,15609,54204,27593,26611
2015/7/1,臺中市,神岡區,18825,65043,33295,31748
2015/7/1,臺中市,潭子區,35210,106023,52613,53410
2015/7/1,臺中市,大雅區,28223,93285,46663,46622
2015/7/1,臺中市,新社區,7488,25121,13071,12050
2015/7/1,臺中市,石岡區,4901,15321,7951,7370
2015/7/1,臺中市,外埔區,9346,31783,16336,15447
2015/7/1,臺中市,大安區,5396,19581,10345,9236
2015/7/1,臺中市,烏日區,22967,72141,36361,35780
2015/7/1,臺中市,大肚區,16843,56505,28943,27562
2015/7/1,臺中市,龍井區,22223,76268,38655,37613
2015/7/1,臺中市,霧峰區,19660,64578,32926,31652
2015/7/1,臺中市,太平區,60558,183064,91133,91931
2015/7/1,臺中市,大里區,67203,207487,102324,105163
2015/7/1,臺中市,和平區,4418,10716,5764,4952
2015/7/1,臺南市,新營區,28543,78191,38727,39464
2015/7/1,臺南市,鹽水區,10091,26202,13688,12514
2015/7/1,臺南市,白河區,10955,29447,15413,14034
2015/7/1,臺南市,柳營區,7834,21672,11290,10382
2015/7/1,臺南市,後壁區,8900,24446,12706,11740
2015/7/1,臺南市,東山區,8264,21709,11530,10179
2015/7/1,臺南市,麻豆區,15509,44978,22877,22101
2015/7/1,臺南市,下營區,9110,24939,12859,12080
2015/7/1,臺南市,六甲區,7714,22653,11718,10935
2015/7/1,臺南市,官田區,7802,21640,11051,10589
2015/7/1,臺南市,大內區,3939,10122,5421,4701
2015/7/1,臺南市,佳里區,20344,59627,29585,30042
2015/7/1,臺南市,學甲區,9680,26749,13695,13054
2015/7/1,臺南市,西港區,8092,24883,12604,12279
2015/7/1,臺南市,七股區,8091,23466,12178,11288
2015/7/1,臺南市,將軍區,7315,20395,10381,10014
2015/7/1,臺南市,北門區,4342,11577,5842,5735
2015/7/1,臺南市,新化區,14224,43781,22352,21429
2015/7/1,臺南市,善化區,16604,46628,23550,23078
2015/7/1,臺南市,新市區,11650,35661,17895,17766
2015/7/1,臺南市,安定區,9848,30315,15571,14744
2015/7/1,臺南市,山上區,2689,7483,3911,3572
2015/7/1,臺南市,玉井區,5116,14424,7504,6920
2015/7/1,臺南市,楠西區,3544,10072,5341,4731
2015/7/1,臺南市,南化區,2868,8943,4830,4113
2015/7/1,臺南市,左鎮區,1993,5099,2859,2240
2015/7/1,臺南市,仁德區,26723,73509,37407,36102
2015/7/1,臺南市,歸仁區,22092,67746,34423,33323
2015/7/1,臺南市,關廟區,10925,34793,17968,16825
2015/7/1,臺南市,龍崎區,1572,4234,2295,1939
2015/7/1,臺南市,永康區,81522,230072,113646,116426
2015/7/1,臺南市,東區,71772,189260,91020,98240
2015/7/1,臺南市,南區,44865,125844,62566,63278
2015/7/1,臺南市,北區,49813,132607,64777,67830
2015/7/1,臺南市,安南區,60694,188921,95534,93387
2015/7/1,臺南市,安平區,24737,65293,31049,34244
2015/7/1,臺南市,中西區,30807,77696,37837,39859
2015/7/1,高雄市,鹽埕區,10837,25174,12553,12621
2015/7/1,高雄市,鼓山區,55887,136330,66149,70181
2015/7/1,高雄市,左營區,77440,195992,94885,101107
2015/7/1,高雄市,楠梓區,66880,179328,88520,90808
2015/7/1,高雄市,三民區,135206,346979,168435,178544
2015/7/1,高雄市,新興區,22715,52163,25141,27022
2015/7/1,高雄市,前金區,12556,27534,13235,14299
2015/7/1,高雄市,苓雅區,72165,174868,84532,90336
2015/7/1,高雄市,前鎮區,78345,193149,95252,97897
2015/7/1,高雄市,旗津區,10995,28803,14939,13864
2015/7/1,高雄市,小港區,66278,155999,77814,78185
2015/7/1,高雄市,鳳山區,136567,355546,174914,180632
2015/7/1,高雄市,林園區,25466,70377,35724,34653
2015/7/1,高雄市,大寮區,41231,111599,57323,54276
2015/7/1,高雄市,大樹區,13363,43156,22180,20976
2015/7/1,高雄市,大社區,12707,34516,17576,16940
2015/7/1,高雄市,仁武區,30766,81810,41787,40023
2015/7/1,高雄市,鳥松區,17603,43806,22310,21496
2015/7/1,高雄市,岡山區,34518,97746,48626,49120
2015/7/1,高雄市,橋頭區,13226,37349,19039,18310
2015/7/1,高雄市,燕巢區,10364,30239,16023,14216
2015/7/1,高雄市,田寮區,3393,7532,4177,3355
2015/7/1,高雄市,阿蓮區,9363,29377,14820,14557
2015/7/1,高雄市,路竹區,16779,53039,27122,25917
2015/7/1,高雄市,湖內區,10499,29551,15120,14431
2015/7/1,高雄市,茄萣區,10446,30560,15802,14758
2015/7/1,高雄市,永安區,5778,14109,7078,7031
2015/7/1,高雄市,彌陀區,6761,19720,10200,9520
2015/7/1,高雄市,梓官區,12543,36465,18848,17617
2015/7/1,高雄市,旗山區,13850,37862,19628,18234
2015/7/1,高雄市,美濃區,14531,40966,21480,19486
2015/7/1,高雄市,六龜區,5642,13550,7302,6248
2015/7/1,高雄市,甲仙區,2372,6326,3357,2969
2015/7/1,高雄市,杉林區,4816,12428,6793,5635
2015/7/1,高雄市,內門區,5059,15051,8137,6914
2015/7/1,高雄市,茂林區,579,1879,928,951
2015/7/1,高雄市,桃源區,1326,4243,2222,2021
2015/7/1,高雄市,那瑪夏區,861,3155,1633,1522
2015/7/1,宜蘭縣,宜蘭市,35498,96039,46911,49128
2015/7/1,宜蘭縣,羅東鎮,26054,72584,34534,38050
2015/7/1,宜蘭縣,蘇澳鎮,14034,40827,20835,19992
2015/7/1,宜蘭縣,頭城鎮,10126,29857,15424,14433
2015/7/1,宜蘭縣,礁溪鄉,13479,35851,18706,17145
2015/7/1,宜蘭縣,壯圍鄉,8472,24292,12853,11439
2015/7/1,宜蘭縣,員山鄉,11437,32314,17184,15130
2015/7/1,宜蘭縣,冬山鄉,18758,53540,27547,25993
2015/7/1,宜蘭縣,五結鄉,14301,39427,20431,18996
2015/7/1,宜蘭縣,三星鄉,8291,21434,11557,9877
2015/7/1,宜蘭縣,大同鄉,1882,6098,3316,2782
2015/7/1,宜蘭縣,南澳鄉,1906,6036,3181,2855
2015/7/1,新竹縣,竹北市,59764,168571,84079,84492
2015/7/1,新竹縣,關西鎮,9523,30178,16119,14059
2015/7/1,新竹縣,新埔鎮,10615,34168,18182,15986
2015/7/1,新竹縣,竹東鎮,32464,96027,48260,47767
2015/7/1,新竹縣,湖口鄉,25459,77061,39162,37899
2015/7/1,新竹縣,橫山鄉,4505,13607,7401,6206
2015/7/1,新竹縣,新豐鄉,17655,56055,28751,27304
2015/7/1,新竹縣,芎林鄉,6472,20301,10748,9553
2015/7/1,新竹縣,寶山鄉,5177,14335,7748,6587
2015/7/1,新竹縣,北埔鄉,3130,9711,5231,4480
2015/7/1,新竹縣,峨眉鄉,2081,5675,3155,2520
2015/7/1,新竹縣,尖石鄉,2845,9317,4948,4369
2015/7/1,新竹縣,五峰鄉,1745,4614,2518,2096
2015/7/1,苗栗縣,苗栗市,30652,90767,45356,45411
2015/7/1,苗栗縣,苑裡鎮,14431,48076,24904,23172
2015/7/1,苗栗縣,通霄鎮,11562,36493,19233,17260
2015/7/1,苗栗縣,竹南鎮,27563,84141,42483,41658
2015/7/1,苗栗縣,頭份市,33359,103127,52025,51102
2015/7/1,苗栗縣,後龍鎮,11871,38034,20031,18003
2015/7/1,苗栗縣,卓蘭鎮,6124,18217,9527,8690
2015/7/1,苗栗縣,大湖鄉,5435,15356,8140,7216
2015/7/1,苗栗縣,公館鄉,10622,34594,17974,16620
2015/7/1,苗栗縣,銅鑼鄉,6130,18780,9940,8840
2015/7/1,苗栗縣,南庄鄉,3966,10597,5831,4766
2015/7/1,苗栗縣,頭屋鄉,3653,11299,5955,5344
2015/7/1,苗栗縣,三義鄉,5460,17095,8945,8150
2015/7/1,苗栗縣,西湖鄉,2685,7507,4168,3339
2015/7/1,苗栗縣,造橋鄉,4156,13434,7051,6383
2015/7/1,苗栗縣,三灣鄉,2419,7055,3853,3202
2015/7/1,苗栗縣,獅潭鄉,1734,4645,2581,2064
2015/7/1,苗栗縣,泰安鄉,1958,6083,3254,2829
2015/7/1,彰化縣,彰化市,75141,234864,116379,118485
2015/7/1,彰化縣,鹿港鎮,23942,86329,43970,42359
2015/7/1,彰化縣,和美鎮,26142,90913,46439,44474
2015/7/1,彰化縣,北斗鎮,10461,33208,16755,16453
2015/7/1,彰化縣,員林市,38536,124677,62219,62458
2015/7/1,彰化縣,溪湖鎮,16026,55723,28349,27374
2015/7/1,彰化縣,田中鎮,12984,42579,22041,20538
2015/7/1,彰化縣,二林鎮,14830,52004,26846,25158
2015/7/1,彰化縣,線西鄉,4309,17023,8819,8204
2015/7/1,彰化縣,伸港鄉,9554,36272,18560,17712
2015/7/1,彰化縣,福興鄉,12531,47603,24807,22796
2015/7/1,彰化縣,秀水鄉,10463,39347,20341,19006
2015/7/1,彰化縣,花壇鄉,13720,45887,23628,22259
2015/7/1,彰化縣,芬園鄉,6876,24026,12649,11377
2015/7/1,彰化縣,大村鄉,10808,36435,18893,17542
2015/7/1,彰化縣,埔鹽鄉,8992,33009,17315,15694
2015/7/1,彰化縣,埔心鄉,10379,34875,17992,16883
2015/7/1,彰化縣,永靖鄉,10820,38097,19815,18282
2015/7/1,彰化縣,社頭鄉,12761,43516,22364,21152
2015/7/1,彰化縣,二水鄉,5337,15687,8216,7471
2015/7/1,彰化縣,田尾鄉,7875,27639,14343,13296
2015/7/1,彰化縣,埤頭鄉,8925,30883,16061,14822
2015/7/1,彰化縣,芳苑鄉,10120,34454,18232,16222
2015/7/1,彰化縣,大城鄉,5327,17596,9539,8057
2015/7/1,彰化縣,竹塘鄉,4620,15700,8290,7410
2015/7/1,彰化縣,溪州鄉,8915,30584,16033,14551
2015/7/1,南投縣,南投市,34414,102060,51169,50891
2015/7/1,南投縣,埔里鎮,28952,82560,41446,41114
2015/7/1,南投縣,草屯鎮,32658,98854,49944,48910
2015/7/1,南投縣,竹山鎮,19986,56206,28859,27347
2015/7/1,南投縣,集集鎮,4366,11267,5881,5386
2015/7/1,南投縣,名間鄉,12586,39797,20915,18882
2015/7/1,南投縣,鹿谷鄉,7666,18333,9748,8585
2015/7/1,南投縣,中寮鄉,5653,15429,8401,7028
2015/7/1,南投縣,魚池鄉,5742,16377,8584,7793
2015/7/1,南投縣,國姓鄉,7298,19469,10547,8922
2015/7/1,南投縣,水里鄉,7189,18476,9700,8776
2015/7/1,南投縣,信義鄉,5248,16559,8901,7658
2015/7/1,南投縣,仁愛鄉,4939,15673,8086,7587
2015/7/1,雲林縣,斗六市,37374,108292,54063,54229
2015/7/1,雲林縣,斗南鎮,15726,45730,23211,22519
2015/7/1,雲林縣,虎尾鎮,24247,70458,35729,34729
2015/7/1,雲林縣,西螺鎮,14491,47038,23907,23131
2015/7/1,雲林縣,土庫鎮,9219,29515,15426,14089
2015/7/1,雲林縣,北港鎮,15909,41200,21385,19815
2015/7/1,雲林縣,古坑鄉,10918,32412,17090,15322
2015/7/1,雲林縣,大埤鄉,6744,19782,10631,9151
2015/7/1,雲林縣,莿桐鄉,9256,29315,15417,13898
2015/7/1,雲林縣,林內鄉,5920,18867,9885,8982
2015/7/1,雲林縣,二崙鄉,8941,28097,15066,13031
2015/7/1,雲林縣,崙背鄉,8494,25607,13538,12069
2015/7/1,雲林縣,麥寮鄉,13934,44122,22316,21806
2015/7/1,雲林縣,東勢鄉,5761,15557,8541,7016
2015/7/1,雲林縣,褒忠鄉,4400,13384,7182,6202
2015/7/1,雲林縣,臺西鄉,8752,24703,13226,11477
2015/7/1,雲林縣,元長鄉,9384,26961,14717,12244
2015/7/1,雲林縣,四湖鄉,8931,24933,13530,11403
2015/7/1,雲林縣,口湖鄉,9599,28643,15227,13416
2015/7/1,雲林縣,水林鄉,10168,26664,14641,12023
2015/7/1,嘉義縣,太保市,12270,37057,19069,17988
2015/7/1,嘉義縣,朴子市,15464,43089,21828,21261
2015/7/1,嘉義縣,布袋鎮,10060,28052,14344,13708
2015/7/1,嘉義縣,大林鎮,11389,31877,16324,15553
2015/7/1,嘉義縣,民雄鄉,24252,71880,36814,35066
2015/7/1,嘉義縣,溪口鄉,5404,15175,8113,7062
2015/7/1,嘉義縣,新港鄉,10619,32951,17425,15526
2015/7/1,嘉義縣,六腳鄉,8995,24300,12922,11378
2015/7/1,嘉義縣,東石鄉,9382,25843,13706,12137
2015/7/1,嘉義縣,義竹鄉,7527,19337,10067,9270
2015/7/1,嘉義縣,鹿草鄉,5809,16179,8686,7493
2015/7/1,嘉義縣,水上鄉,17896,50541,26127,24414
2015/7/1,嘉義縣,中埔鄉,15975,45837,23862,21975
2015/7/1,嘉義縣,竹崎鄉,11676,36700,19616,17084
2015/7/1,嘉義縣,梅山鄉,6767,20122,10689,9433
2015/7/1,嘉義縣,番路鄉,4326,11936,6460,5476
2015/7/1,嘉義縣,大埔鄉,1944,4601,2403,2198
2015/7/1,嘉義縣,阿里山鄉,1955,5709,3025,2684
2015/7/1,屏東縣,屏東市,73570,203060,100806,102254
2015/7/1,屏東縣,潮州鎮,19075,54727,27436,27291
2015/7/1,屏東縣,東港鎮,16302,48084,24361,23723
2015/7/1,屏東縣,恆春鎮,11271,30888,15831,15057
2015/7/1,屏東縣,萬丹鄉,14786,51871,26857,25014
2015/7/1,屏東縣,長治鄉,10007,30368,15847,14521
2015/7/1,屏東縣,麟洛鄉,3739,11241,5821,5420
2015/7/1,屏東縣,九如鄉,6821,22098,11455,10643
2015/7/1,屏東縣,里港鄉,8133,26932,13701,13231
2015/7/1,屏東縣,鹽埔鄉,7829,26449,13747,12702
2015/7/1,屏東縣,高樹鄉,9391,25253,13434,11819
2015/7/1,屏東縣,萬巒鄉,6483,20814,10910,9904
2015/7/1,屏東縣,內埔鄉,18477,55892,28967,26925
2015/7/1,屏東縣,竹田鄉,5640,17589,9335,8254
2015/7/1,屏東縣,新埤鄉,3417,10078,5367,4711
2015/7/1,屏東縣,枋寮鄉,8549,25298,13251,12047
2015/7/1,屏東縣,新園鄉,11766,36402,18830,17572
2015/7/1,屏東縣,崁頂鄉,4440,16212,8217,7995
2015/7/1,屏東縣,林邊鄉,6972,19041,9788,9253
2015/7/1,屏東縣,南州鄉,3669,10924,5602,5322
2015/7/1,屏東縣,佳冬鄉,6994,20053,10415,9638
2015/7/1,屏東縣,琉球鄉,4304,12515,6884,5631
2015/7/1,屏東縣,車城鄉,3484,9004,4857,4147
2015/7/1,屏東縣,滿州鄉,3019,8047,4404,3643
2015/7/1,屏東縣,枋山鄉,2128,5669,3020,2649
2015/7/1,屏東縣,三地門鄉,2294,7729,3911,3818
2015/7/1,屏東縣,霧臺鄉,1052,3359,1715,1644
2015/7/1,屏東縣,瑪家鄉,2009,6702,3424,3278
2015/7/1,屏東縣,泰武鄉,1299,5235,2759,2476
2015/7/1,屏東縣,來義鄉,2218,7541,3837,3704
2015/7/1,屏東縣,春日鄉,1347,4816,2469,2347
2015/7/1,屏東縣,獅子鄉,1517,4828,2497,2331
2015/7/1,屏東縣,牡丹鄉,1860,4803,2478,2325
2015/7/1,臺東縣,臺東市,39170,106829,53711,53118
2015/7/1,臺東縣,成功鎮,5449,14764,7808,6956
2015/7/1,臺東縣,關山鎮,3219,9009,4727,4282
2015/7/1,臺東縣,卑南鄉,6666,17573,9317,8256
2015/7/1,臺東縣,大武鄉,2524,6395,3323,3072
2015/7/1,臺東縣,太麻里鄉,4608,11400,6050,5350
2015/7/1,臺東縣,東河鄉,3761,8861,4874,3987
2015/7/1,臺東縣,長濱鄉,2929,7638,4340,3298
2015/7/1,臺東縣,鹿野鄉,3083,8135,4351,3784
2015/7/1,臺東縣,池上鄉,3250,8477,4449,4028
2015/7/1,臺東縣,綠島鄉,1105,3805,1998,1807
2015/7/1,臺東縣,延平鄉,1074,3573,1912,1661
2015/7/1,臺東縣,海端鄉,1089,4331,2311,2020
2015/7/1,臺東縣,達仁鄉,1446,3616,1978,1638
2015/7/1,臺東縣,金峰鄉,1105,3617,1872,1745
2015/7/1,臺東縣,蘭嶼鄉,1755,5002,2533,2469
2015/7/1,花蓮縣,花蓮市,41435,105986,51427,54559
2015/7/1,花蓮縣,鳳林鎮,4420,11143,5838,5305
2015/7/1,花蓮縣,玉里鎮,8910,25142,13434,11708
2015/7/1,花蓮縣,新城鄉,7553,20162,10386,9776
2015/7/1,花蓮縣,吉安鄉,31346,82994,42099,40895
2015/7/1,花蓮縣,壽豐鄉,7029,18189,9718,8471
2015/7/1,花蓮縣,光復鄉,5031,13288,7067,6221
2015/7/1,花蓮縣,豐濱鄉,1735,4589,2542,2047
2015/7/1,花蓮縣,瑞穗鄉,4680,11977,6434,5543
2015/7/1,花蓮縣,富里鄉,3997,10710,5844,4866
2015/7/1,花蓮縣,秀林鄉,4773,15520,8027,7493
2015/7/1,花蓮縣,萬榮鄉,2085,6468,3426,3042
2015/7/1,花蓮縣,卓溪鄉,1676,6074,3352,2722
2015/7/1,澎湖縣,馬公市,22989,60383,30722,29661
2015/7/1,澎湖縣,湖西鄉,5398,14369,7594,6775
2015/7/1,澎湖縣,白沙鄉,3344,9721,5098,4623
2015/7/1,澎湖縣,西嶼鄉,2943,8411,4320,4091
2015/7/1,澎湖縣,望安鄉,1986,5112,2751,2361
2015/7/1,澎湖縣,七美鄉,1326,3781,1970,1811
2015/7/1,基隆市,中正區,22524,52873,27090,25783
2015/7/1,基隆市,七堵區,21062,54062,27320,26742
2015/7/1,基隆市,暖暖區,15382,38342,19302,19040
2015/7/1,基隆市,仁愛區,19422,45958,22680,23278
2015/7/1,基隆市,中山區,19278,48423,24617,23806
2015/7/1,基隆市,安樂區,32370,81559,40612,40947
2015/7/1,基隆市,信義區,20949,51403,25609,25794
2015/7/1,新竹市,東區,75813,207549,102252,105297
2015/7/1,新竹市,北區,54672,148945,73068,75877
2015/7/1,新竹市,香山區,25977,76472,38962,37510
2015/7/1,嘉義市,東區,45290,123216,59710,63506
2015/7/1,嘉義市,西區,53337,147516,72478,75038
2015/7/1,金門縣,金城鎮,12586,41856,21011,20845
2015/7/1,金門縣,金湖鎮,8443,27950,14089,13861
2015/7/1,金門縣,金沙鎮,6112,19889,9828,10061
2015/7/1,金門縣,金寧鄉,7876,27815,14045,13770
2015/7/1,金門縣,烈嶼鄉,3051,12283,6077,6206
2015/7/1,金門縣,烏坵鄉,134,668,335,333
2015/7/1,連江縣,南竿鄉,1432,7463,4236,3227
2015/7/1,連江縣,北竿鄉,490,2308,1284,1024
2015/7/1,連江縣,莒光鄉,274,1471,856,615
2015/7/1,連江縣,東引鄉,314,1264,760,504
2015/8/1,總計,新北市,1506779,3966533,1950169,2016364
2015/8/1,總計,臺北市,1041891,2701571,1294376,1407195
2015/8/1,總計,桃園市,745438,2092977,1047557,1045420
2015/8/1,總計,臺中市,923740,2736813,1353974,1382839
2015/8/1,總計,臺南市,671258,1885079,943832,941247
2015/8/1,總計,高雄市,1070753,2777948,1381252,1396696
2015/8/1,總計,臺灣省,2443771,7160459,3659563,3500896
2015/8/1,總計,宜蘭縣,164443,458375,232495,225880
2015/8/1,總計,新竹縣,181903,540193,276547,263646
2015/8/1,總計,苗栗縣,183979,564855,291026,273829
2015/8/1,總計,彰化縣,380842,1288529,658616,629913
2015/8/1,總計,南投縣,176792,510632,261982,248650
2015/8/1,總計,雲林縣,238339,700846,364520,336326
2015/8/1,總計,嘉義縣,181835,520910,271271,249639
2015/8/1,總計,屏東縣,284058,842976,431936,411040
2015/8/1,總計,臺東縣,82307,222967,115506,107461
2015/8/1,總計,花蓮縣,124735,332091,169513,162578
2015/8/1,總計,澎湖縣,38005,101734,52421,49313
2015/8/1,總計,基隆市,151091,372604,187205,185399
2015/8/1,總計,新竹市,156725,433091,214362,218729
2015/8/1,總計,嘉義市,98717,270656,132163,138493
2015/8/1,總計,福建省,40888,143623,72875,70748
2015/8/1,總計,金門縣,38371,131099,65734,65365
2015/8/1,總計,連江縣,2517,12524,7141,5383
2015/8/1,新北市,板橋區,205566,554545,271473,283072
2015/8/1,新北市,三重區,148093,388387,191780,196607
2015/8/1,新北市,中和區,162879,414501,202463,212038
2015/8/1,新北市,永和區,90682,225972,107540,118432
2015/8/1,新北市,新莊區,148527,412497,202147,210350
2015/8/1,新北市,新店區,123652,299891,145027,154864
2015/8/1,新北市,樹林區,65335,184065,91971,92094
2015/8/1,新北市,鶯歌區,29393,88268,44261,44007
2015/8/1,新北市,三峽區,40858,112170,56491,55679
2015/8/1,新北市,淡水區,69673,160990,77467,83523
2015/8/1,新北市,汐止區,84801,195672,95802,99870
2015/8/1,新北市,瑞芳區,16088,40982,20747,20235
2015/8/1,新北市,土城區,85786,238607,118129,120478
2015/8/1,新北市,蘆洲區,69373,199814,98424,101390
2015/8/1,新北市,五股區,29739,82680,41712,40968
2015/8/1,新北市,泰山區,27932,78625,39135,39490
2015/8/1,新北市,林口區,38777,99462,48742,50720
2015/8/1,新北市,深坑區,9401,23544,11815,11729
2015/8/1,新北市,石碇區,3360,7825,4319,3506
2015/8/1,新北市,坪林區,2492,6481,3613,2868
2015/8/1,新北市,三芝區,9332,23454,12068,11386
2015/8/1,新北市,石門區,4307,12645,6568,6077
2015/8/1,新北市,八里區,13935,37400,18700,18700
2015/8/1,新北市,平溪區,2353,4895,2694,2201
2015/8/1,新北市,雙溪區,3830,9291,5022,4269
2015/8/1,新北市,貢寮區,4405,12879,6575,6304
2015/8/1,新北市,金山區,7008,22200,10995,11205
2015/8/1,新北市,萬里區,7402,22645,11434,11211
2015/8/1,新北市,烏來區,1800,6146,3055,3091
2015/8/1,臺北市,松山區,80275,209856,98961,110895
2015/8/1,臺北市,信義區,89426,229199,109873,119326
2015/8/1,臺北市,大安區,120423,313191,146575,166616
2015/8/1,臺北市,中山區,98858,230592,107649,122943
2015/8/1,臺北市,中正區,65265,162673,77709,84964
2015/8/1,臺北市,大同區,51424,130749,63916,66833
2015/8/1,臺北市,萬華區,78185,194132,95864,98268
2015/8/1,臺北市,文山區,104046,274841,132254,142587
2015/8/1,臺北市,南港區,46311,121847,59522,62325
2015/8/1,臺北市,內湖區,106114,286588,137269,149319
2015/8/1,臺北市,士林區,106025,290389,140452,149937
2015/8/1,臺北市,北投區,95539,257514,124332,133182
2015/8/1,桃園市,桃園區,158837,424852,207122,217730
2015/8/1,桃園市,中壢區,140608,387558,191831,195727
2015/8/1,桃園市,大溪區,31249,93012,47733,45279
2015/8/1,桃園市,楊梅區,54657,159968,81043,78925
2015/8/1,桃園市,蘆竹區,54988,154310,76931,77379
2015/8/1,桃園市,大園區,30350,85184,43820,41364
2015/8/1,桃園市,龜山區,55312,144543,72590,71953
2015/8/1,桃園市,八德區,65178,185665,93567,92098
2015/8/1,桃園市,龍潭區,39878,117863,59415,58448
2015/8/1,桃園市,平鎮區,73543,216406,108011,108395
2015/8/1,桃園市,新屋區,15699,48330,25846,22484
2015/8/1,桃園市,觀音區,21405,64376,33672,30704
2015/8/1,桃園市,復興區,3734,10910,5976,4934
2015/8/1,臺中市,中區,7886,19158,9549,9609
2015/8/1,臺中市,東區,27288,75040,37498,37542
2015/8/1,臺中市,南區,46625,121371,58503,62868
2015/8/1,臺中市,西區,45063,115799,55114,60685
2015/8/1,臺中市,北區,58365,147352,70755,76597
2015/8/1,臺中市,西屯區,81969,221113,106499,114614
2015/8/1,臺中市,南屯區,59423,163786,78554,85232
2015/8/1,臺中市,北屯區,94024,263344,126837,136507
2015/8/1,臺中市,豐原區,52543,166623,82548,84075
2015/8/1,臺中市,東勢區,17301,51336,26496,24840
2015/8/1,臺中市,大甲區,22665,77737,39205,38532
2015/8/1,臺中市,清水區,26338,86072,44269,41803
2015/8/1,臺中市,沙鹿區,27695,89031,45147,43884
2015/8/1,臺中市,梧棲區,17076,56979,28699,28280
2015/8/1,臺中市,后里區,15628,54210,27600,26610
2015/8/1,臺中市,神岡區,18864,65116,33310,31806
2015/8/1,臺中市,潭子區,35282,106171,52667,53504
2015/8/1,臺中市,大雅區,28273,93386,46690,46696
2015/8/1,臺中市,新社區,7495,25146,13075,12071
2015/8/1,臺中市,石岡區,4903,15323,7955,7368
2015/8/1,臺中市,外埔區,9358,31787,16331,15456
2015/8/1,臺中市,大安區,5398,19583,10348,9235
2015/8/1,臺中市,烏日區,23027,72203,36359,35844
2015/8/1,臺中市,大肚區,16901,56519,28966,27553
2015/8/1,臺中市,龍井區,22262,76384,38715,37669
2015/8/1,臺中市,霧峰區,19668,64544,32878,31666
2015/8/1,臺中市,太平區,60675,183316,91250,92066
2015/8/1,臺中市,大里區,67322,207670,102402,105268
2015/8/1,臺中市,和平區,4423,10714,5755,4959
2015/8/1,臺南市,新營區,28584,78195,38728,39467
2015/8/1,臺南市,鹽水區,10103,26202,13701,12501
2015/8/1,臺南市,白河區,10949,29399,15394,14005
2015/8/1,臺南市,柳營區,7830,21630,11280,10350
2015/8/1,臺南市,後壁區,8909,24420,12686,11734
2015/8/1,臺南市,東山區,8257,21679,11512,10167
2015/8/1,臺南市,麻豆區,15531,44960,22844,22116
2015/8/1,臺南市,下營區,9102,24918,12847,12071
2015/8/1,臺南市,六甲區,7718,22644,11710,10934
2015/8/1,臺南市,官田區,7827,21694,11076,10618
2015/8/1,臺南市,大內區,3934,10115,5418,4697
2015/8/1,臺南市,佳里區,20377,59657,29597,30060
2015/8/1,臺南市,學甲區,9673,26729,13674,13055
2015/8/1,臺南市,西港區,8105,24910,12615,12295
2015/8/1,臺南市,七股區,8083,23437,12160,11277
2015/8/1,臺南市,將軍區,7322,20378,10375,10003
2015/8/1,臺南市,北門區,4335,11565,5835,5730
2015/8/1,臺南市,新化區,14220,43761,22349,21412
2015/8/1,臺南市,善化區,16678,46736,23599,23137
2015/8/1,臺南市,新市區,11687,35764,17949,17815
2015/8/1,臺南市,安定區,9861,30304,15566,14738
2015/8/1,臺南市,山上區,2688,7484,3912,3572
2015/8/1,臺南市,玉井區,5112,14386,7485,6901
2015/8/1,臺南市,楠西區,3543,10063,5334,4729
2015/8/1,臺南市,南化區,2868,8940,4827,4113
2015/8/1,臺南市,左鎮區,1991,5089,2852,2237
2015/8/1,臺南市,仁德區,26749,73557,37438,36119
2015/8/1,臺南市,歸仁區,22137,67783,34442,33341
2015/8/1,臺南市,關廟區,10950,34784,17961,16823
2015/8/1,臺南市,龍崎區,1572,4228,2290,1938
2015/8/1,臺南市,永康區,81675,230202,113713,116489
2015/8/1,臺南市,東區,71753,189031,90886,98145
2015/8/1,臺南市,南區,44906,125838,62554,63284
2015/8/1,臺南市,北區,49873,132590,64766,67824
2015/8/1,臺南市,安南區,60798,189103,95639,93464
2015/8/1,臺南市,安平區,24774,65348,31077,34271
2015/8/1,臺南市,中西區,30784,77556,37741,39815
2015/8/1,高雄市,鹽埕區,10838,25126,12522,12604
2015/8/1,高雄市,鼓山區,55990,136388,66182,70206
2015/8/1,高雄市,左營區,77495,195870,94780,101090
2015/8/1,高雄市,楠梓區,67025,179442,88551,90891
2015/8/1,高雄市,三民區,135280,346738,168291,178447
2015/8/1,高雄市,新興區,22720,52084,25108,26976
2015/8/1,高雄市,前金區,12561,27509,13234,14275
2015/8/1,高雄市,苓雅區,72211,174818,84502,90316
2015/8/1,高雄市,前鎮區,78409,193009,95174,97835
2015/8/1,高雄市,旗津區,11008,28832,14955,13877
2015/8/1,高雄市,小港區,66342,155996,77813,78183
2015/8/1,高雄市,鳳山區,136740,355568,174889,180679
2015/8/1,高雄市,林園區,25482,70339,35702,34637
2015/8/1,高雄市,大寮區,41253,111638,57316,54322
2015/8/1,高雄市,大樹區,13384,43145,22172,20973
2015/8/1,高雄市,大社區,12709,34525,17579,16946
2015/8/1,高雄市,仁武區,30865,82000,41877,40123
2015/8/1,高雄市,鳥松區,17629,43843,22333,21510
2015/8/1,高雄市,岡山區,34553,97769,48617,49152
2015/8/1,高雄市,橋頭區,13244,37363,19051,18312
2015/8/1,高雄市,燕巢區,10369,30229,16013,14216
2015/8/1,高雄市,田寮區,3390,7526,4175,3351
2015/8/1,高雄市,阿蓮區,9361,29368,14807,14561
2015/8/1,高雄市,路竹區,16791,53050,27109,25941
2015/8/1,高雄市,湖內區,10518,29567,15124,14443
2015/8/1,高雄市,茄萣區,10452,30582,15811,14771
2015/8/1,高雄市,永安區,5778,14126,7084,7042
2015/8/1,高雄市,彌陀區,6762,19689,10193,9496
2015/8/1,高雄市,梓官區,12548,36458,18837,17621
2015/8/1,高雄市,旗山區,13861,37861,19632,18229
2015/8/1,高雄市,美濃區,14534,40931,21464,19467
2015/8/1,高雄市,六龜區,5642,13524,7300,6224
2015/8/1,高雄市,甲仙區,2368,6320,3358,2962
2015/8/1,高雄市,杉林區,4823,12425,6795,5630
2015/8/1,高雄市,內門區,5059,15036,8131,6905
2015/8/1,高雄市,茂林區,579,1882,930,952
2015/8/1,高雄市,桃源區,1321,4228,2211,2017
2015/8/1,高雄市,那瑪夏區,859,3144,1630,1514
2015/8/1,宜蘭縣,宜蘭市,35529,96011,46898,49113
2015/8/1,宜蘭縣,羅東鎮,26065,72616,34528,38088
2015/8/1,宜蘭縣,蘇澳鎮,14050,40835,20832,20003
2015/8/1,宜蘭縣,頭城鎮,10123,29833,15404,14429
2015/8/1,宜蘭縣,礁溪鄉,13512,35883,18734,17149
2015/8/1,宜蘭縣,壯圍鄉,8490,24295,12858,11437
2015/8/1,宜蘭縣,員山鄉,11459,32323,17174,15149
2015/8/1,宜蘭縣,冬山鄉,18786,53530,27554,25976
2015/8/1,宜蘭縣,五結鄉,14334,39466,20445,19021
2015/8/1,宜蘭縣,三星鄉,8307,21457,11584,9873
2015/8/1,宜蘭縣,大同鄉,1879,6086,3301,2785
2015/8/1,宜蘭縣,南澳鄉,1909,6040,3183,2857
2015/8/1,新竹縣,竹北市,60025,169095,84334,84761
2015/8/1,新竹縣,關西鎮,9529,30120,16092,14028
2015/8/1,新竹縣,新埔鎮,10641,34181,18196,15985
2015/8/1,新竹縣,竹東鎮,32525,96045,48241,47804
2015/8/1,新竹縣,湖口鄉,25543,77166,39229,37937
2015/8/1,新竹縣,橫山鄉,4495,13582,7374,6208
2015/8/1,新竹縣,新豐鄉,17695,56098,28767,27331
2015/8/1,新竹縣,芎林鄉,6485,20291,10742,9549
2015/8/1,新竹縣,寶山鄉,5166,14337,7745,6592
2015/8/1,新竹縣,北埔鄉,3130,9693,5224,4469
2015/8/1,新竹縣,峨眉鄉,2083,5662,3141,2521
2015/8/1,新竹縣,尖石鄉,2845,9308,4942,4366
2015/8/1,新竹縣,五峰鄉,1741,4615,2520,2095
2015/8/1,苗栗縣,苗栗市,30702,90729,45326,45403
2015/8/1,苗栗縣,苑裡鎮,14435,47969,24858,23111
2015/8/1,苗栗縣,通霄鎮,11564,36386,19181,17205
2015/8/1,苗栗縣,竹南鎮,27650,84176,42481,41695
2015/8/1,苗栗縣,頭份市,33433,103218,52067,51151
2015/8/1,苗栗縣,後龍鎮,11873,38001,20016,17985
2015/8/1,苗栗縣,卓蘭鎮,6126,18157,9500,8657
2015/8/1,苗栗縣,大湖鄉,5430,15350,8140,7210
2015/8/1,苗栗縣,公館鄉,10610,34541,17952,16589
2015/8/1,苗栗縣,銅鑼鄉,6135,18762,9933,8829
2015/8/1,苗栗縣,南庄鄉,3964,10585,5819,4766
2015/8/1,苗栗縣,頭屋鄉,3657,11259,5940,5319
2015/8/1,苗栗縣,三義鄉,5457,17066,8941,8125
2015/8/1,苗栗縣,西湖鄉,2682,7486,4156,3330
2015/8/1,苗栗縣,造橋鄉,4158,13443,7052,6391
2015/8/1,苗栗縣,三灣鄉,2412,7026,3843,3183
2015/8/1,苗栗縣,獅潭鄉,1733,4634,2572,2062
2015/8/1,苗栗縣,泰安鄉,1958,6067,3249,2818
2015/8/1,彰化縣,彰化市,75258,234799,116316,118483
2015/8/1,彰化縣,員林市,38586,124706,62236,62470
2015/8/1,彰化縣,鹿港鎮,23973,86318,43964,42354
2015/8/1,彰化縣,和美鎮,26211,90934,46440,44494
2015/8/1,彰化縣,北斗鎮,10478,33163,16730,16433
2015/8/1,彰化縣,溪湖鎮,16038,55710,28334,27376
2015/8/1,彰化縣,田中鎮,13003,42569,22035,20534
2015/8/1,彰化縣,二林鎮,14840,51954,26805,25149
2015/8/1,彰化縣,線西鄉,4318,17017,8812,8205
2015/8/1,彰化縣,伸港鄉,9574,36339,18602,17737
2015/8/1,彰化縣,福興鄉,12540,47604,24798,22806
2015/8/1,彰化縣,秀水鄉,10472,39318,20321,18997
2015/8/1,彰化縣,花壇鄉,13747,45884,23617,22267
2015/8/1,彰化縣,芬園鄉,6887,24040,12662,11378
2015/8/1,彰化縣,大村鄉,10835,36446,18899,17547
2015/8/1,彰化縣,埔鹽鄉,8996,32986,17312,15674
2015/8/1,彰化縣,埔心鄉,10382,34850,17972,16878
2015/8/1,彰化縣,永靖鄉,10826,38046,19784,18262
2015/8/1,彰化縣,社頭鄉,12764,43504,22354,21150
2015/8/1,彰化縣,二水鄉,5334,15660,8199,7461
2015/8/1,彰化縣,田尾鄉,7877,27610,14315,13295
2015/8/1,彰化縣,埤頭鄉,8935,30877,16057,14820
2015/8/1,彰化縣,芳苑鄉,10115,34399,18219,16180
2015/8/1,彰化縣,大城鄉,5325,17565,9525,8040
2015/8/1,彰化縣,竹塘鄉,4620,15663,8282,7381
2015/8/1,彰化縣,溪州鄉,8908,30568,16026,14542
2015/8/1,南投縣,南投市,34455,101930,51121,50809
2015/8/1,南投縣,埔里鎮,28953,82448,41378,41070
2015/8/1,南投縣,草屯鎮,32679,98817,49948,48869
2015/8/1,南投縣,竹山鎮,20005,56176,28851,27325
2015/8/1,南投縣,集集鎮,4365,11262,5867,5395
2015/8/1,南投縣,名間鄉,12595,39773,20891,18882
2015/8/1,南投縣,鹿谷鄉,7661,18323,9755,8568
2015/8/1,南投縣,中寮鄉,5657,15412,8390,7022
2015/8/1,南投縣,魚池鄉,5741,16365,8577,7788
2015/8/1,南投縣,國姓鄉,7305,19451,10540,8911
2015/8/1,南投縣,水里鄉,7194,18449,9691,8758
2015/8/1,南投縣,信義鄉,5244,16531,8871,7660
2015/8/1,南投縣,仁愛鄉,4938,15695,8102,7593
2015/8/1,雲林縣,斗六市,37449,108317,54064,54253
2015/8/1,雲林縣,斗南鎮,15742,45708,23205,22503
2015/8/1,雲林縣,虎尾鎮,24290,70499,35754,34745
2015/8/1,雲林縣,西螺鎮,14486,46962,23860,23102
2015/8/1,雲林縣,土庫鎮,9223,29480,15405,14075
2015/8/1,雲林縣,北港鎮,15903,41140,21361,19779
2015/8/1,雲林縣,古坑鄉,10928,32410,17082,15328
2015/8/1,雲林縣,大埤鄉,6744,19761,10621,9140
2015/8/1,雲林縣,莿桐鄉,9257,29308,15404,13904
2015/8/1,雲林縣,林內鄉,5929,18853,9877,8976
2015/8/1,雲林縣,二崙鄉,8942,28048,15042,13006
2015/8/1,雲林縣,崙背鄉,8505,25585,13527,12058
2015/8/1,雲林縣,麥寮鄉,13945,44136,22345,21791
2015/8/1,雲林縣,東勢鄉,5755,15507,8521,6986
2015/8/1,雲林縣,褒忠鄉,4403,13370,7179,6191
2015/8/1,雲林縣,臺西鄉,8752,24685,13211,11474
2015/8/1,雲林縣,元長鄉,9384,26946,14710,12236
2015/8/1,雲林縣,四湖鄉,8932,24890,13509,11381
2015/8/1,雲林縣,口湖鄉,9601,28607,15210,13397
2015/8/1,雲林縣,水林鄉,10169,26634,14633,12001
2015/8/1,嘉義縣,太保市,12306,37114,19097,18017
2015/8/1,嘉義縣,朴子市,15496,43026,21793,21233
2015/8/1,嘉義縣,布袋鎮,10060,28036,14327,13709
2015/8/1,嘉義縣,大林鎮,11390,31831,16290,15541
2015/8/1,嘉義縣,民雄鄉,24294,71930,36838,35092
2015/8/1,嘉義縣,溪口鄉,5400,15170,8111,7059
2015/8/1,嘉義縣,新港鄉,10620,32917,17400,15517
2015/8/1,嘉義縣,六腳鄉,8987,24264,12897,11367
2015/8/1,嘉義縣,東石鄉,9386,25827,13691,12136
2015/8/1,嘉義縣,義竹鄉,7522,19313,10063,9250
2015/8/1,嘉義縣,鹿草鄉,5806,16166,8681,7485
2015/8/1,嘉義縣,水上鄉,17904,50495,26093,24402
2015/8/1,嘉義縣,中埔鄉,15988,45828,23853,21975
2015/8/1,嘉義縣,竹崎鄉,11685,36667,19591,17076
2015/8/1,嘉義縣,梅山鄉,6765,20081,10667,9414
2015/8/1,嘉義縣,番路鄉,4327,11931,6454,5477
2015/8/1,嘉義縣,大埔鄉,1942,4602,2402,2200
2015/8/1,嘉義縣,阿里山鄉,1957,5712,3023,2689
2015/8/1,屏東縣,屏東市,73627,202950,100754,102196
2015/8/1,屏東縣,潮州鎮,19127,54787,27449,27338
2015/8/1,屏東縣,東港鎮,16325,48079,24355,23724
2015/8/1,屏東縣,恆春鎮,11297,30889,15828,15061
2015/8/1,屏東縣,萬丹鄉,14789,51825,26832,24993
2015/8/1,屏東縣,長治鄉,10007,30342,15826,14516
2015/8/1,屏東縣,麟洛鄉,3744,11240,5825,5415
2015/8/1,屏東縣,九如鄉,6829,22099,11444,10655
2015/8/1,屏東縣,里港鄉,8139,26928,13707,13221
2015/8/1,屏東縣,鹽埔鄉,7834,26440,13746,12694
2015/8/1,屏東縣,高樹鄉,9381,25221,13423,11798
2015/8/1,屏東縣,萬巒鄉,6484,20797,10910,9887
2015/8/1,屏東縣,內埔鄉,18486,55822,28929,26893
2015/8/1,屏東縣,竹田鄉,5643,17608,9337,8271
2015/8/1,屏東縣,新埤鄉,3417,10065,5368,4697
2015/8/1,屏東縣,枋寮鄉,8541,25247,13235,12012
2015/8/1,屏東縣,新園鄉,11758,36328,18788,17540
2015/8/1,屏東縣,崁頂鄉,4452,16182,8208,7974
2015/8/1,屏東縣,林邊鄉,6960,19014,9767,9247
2015/8/1,屏東縣,南州鄉,3671,10907,5590,5317
2015/8/1,屏東縣,佳冬鄉,6997,20026,10412,9614
2015/8/1,屏東縣,琉球鄉,4307,12503,6879,5624
2015/8/1,屏東縣,車城鄉,3483,8986,4850,4136
2015/8/1,屏東縣,滿州鄉,3015,8055,4404,3651
2015/8/1,屏東縣,枋山鄉,2132,5664,3018,2646
2015/8/1,屏東縣,三地門鄉,2291,7702,3890,3812
2015/8/1,屏東縣,霧臺鄉,1051,3344,1708,1636
2015/8/1,屏東縣,瑪家鄉,2014,6740,3443,3297
2015/8/1,屏東縣,泰武鄉,1303,5223,2748,2475
2015/8/1,屏東縣,來義鄉,2221,7548,3840,3708
2015/8/1,屏東縣,春日鄉,1348,4807,2463,2344
2015/8/1,屏東縣,獅子鄉,1525,4822,2492,2330
2015/8/1,屏東縣,牡丹鄉,1860,4786,2468,2318
2015/8/1,臺東縣,臺東市,39219,106836,53699,53137
2015/8/1,臺東縣,成功鎮,5447,14749,7795,6954
2015/8/1,臺東縣,關山鎮,3210,8974,4710,4264
2015/8/1,臺東縣,卑南鄉,6663,17575,9323,8252
2015/8/1,臺東縣,大武鄉,2524,6380,3324,3056
2015/8/1,臺東縣,太麻里鄉,4612,11396,6052,5344
2015/8/1,臺東縣,東河鄉,3775,8885,4892,3993
2015/8/1,臺東縣,長濱鄉,2930,7625,4331,3294
2015/8/1,臺東縣,鹿野鄉,3082,8124,4349,3775
2015/8/1,臺東縣,池上鄉,3250,8493,4450,4043
2015/8/1,臺東縣,綠島鄉,1107,3805,1985,1820
2015/8/1,臺東縣,延平鄉,1073,3569,1908,1661
2015/8/1,臺東縣,海端鄉,1092,4319,2308,2011
2015/8/1,臺東縣,達仁鄉,1446,3602,1974,1628
2015/8/1,臺東縣,金峰鄉,1108,3611,1867,1744
2015/8/1,臺東縣,蘭嶼鄉,1769,5024,2539,2485
2015/8/1,花蓮縣,花蓮市,41457,105914,51411,54503
2015/8/1,花蓮縣,鳳林鎮,4413,11124,5829,5295
2015/8/1,花蓮縣,玉里鎮,8913,25132,13435,11697
2015/8/1,花蓮縣,新城鄉,7564,20180,10386,9794
2015/8/1,花蓮縣,吉安鄉,31366,83030,42083,40947
2015/8/1,花蓮縣,壽豐鄉,7038,18161,9707,8454
2015/8/1,花蓮縣,光復鄉,5032,13277,7068,6209
2015/8/1,花蓮縣,豐濱鄉,1730,4569,2538,2031
2015/8/1,花蓮縣,瑞穗鄉,4679,11951,6424,5527
2015/8/1,花蓮縣,富里鄉,4005,10693,5841,4852
2015/8/1,花蓮縣,秀林鄉,4779,15532,8034,7498
2015/8/1,花蓮縣,萬榮鄉,2081,6451,3411,3040
2015/8/1,花蓮縣,卓溪鄉,1678,6077,3346,2731
2015/8/1,澎湖縣,馬公市,22994,60372,30713,29659
2015/8/1,澎湖縣,湖西鄉,5399,14370,7598,6772
2015/8/1,澎湖縣,白沙鄉,3350,9719,5097,4622
2015/8/1,澎湖縣,西嶼鄉,2940,8391,4306,4085
2015/8/1,澎湖縣,望安鄉,1988,5106,2744,2362
2015/8/1,澎湖縣,七美鄉,1334,3776,1963,1813
2015/8/1,基隆市,中正區,22537,52861,27066,25795
2015/8/1,基隆市,七堵區,21096,54062,27313,26749
2015/8/1,基隆市,暖暖區,15418,38373,19317,19056
2015/8/1,基隆市,仁愛區,19418,45896,22672,23224
2015/8/1,基隆市,中山區,19277,48418,24603,23815
2015/8/1,基隆市,安樂區,32370,81514,40588,40926
2015/8/1,基隆市,信義區,20975,51480,25646,25834
2015/8/1,新竹市,東區,75944,207516,102261,105255
2015/8/1,新竹市,北區,54734,148983,73078,75905
2015/8/1,新竹市,香山區,26047,76592,39023,37569
2015/8/1,嘉義市,東區,45301,123093,59659,63434
2015/8/1,嘉義市,西區,53416,147563,72504,75059
2015/8/1,金門縣,金城鎮,12648,42080,21136,20944
2015/8/1,金門縣,金湖鎮,8486,28100,14170,13930
2015/8/1,金門縣,金沙鎮,6131,19961,9871,10090
2015/8/1,金門縣,金寧鄉,7914,27950,14110,13840
2015/8/1,金門縣,烈嶼鄉,3058,12343,6113,6230
2015/8/1,金門縣,烏坵鄉,134,665,334,331
2015/8/1,連江縣,南竿鄉,1437,7452,4226,3226
2015/8/1,連江縣,北竿鄉,490,2316,1284,1032
2015/8/1,連江縣,莒光鄉,275,1488,870,618
2015/8/1,連江縣,東引鄉,315,1268,761,507
2015/9/1,總計,新北市,1509592,3967483,1950355,2017128
2015/9/1,總計,臺北市,1043493,2700115,1293595,1406520
2015/9/1,總計,桃園市,747932,2096432,1048951,1047481
2015/9/1,總計,臺中市,925847,2738553,1354644,1383909
2015/9/1,總計,臺南市,672047,1885037,943719,941318
2015/9/1,總計,高雄市,1072321,2777870,1381100,1396770
2015/9/1,總計,臺灣省,2447498,7158808,3658627,3500181
2015/9/1,總計,宜蘭縣,164738,458261,232404,225857
2015/9/1,總計,新竹縣,182414,540605,276760,263845
2015/9/1,總計,苗栗縣,184262,564549,290926,273623
2015/9/1,總計,彰化縣,381399,1288295,658443,629852
2015/9/1,總計,南投縣,176910,510094,261732,248362
2015/9/1,總計,雲林縣,238523,700437,364272,336165
2015/9/1,總計,嘉義縣,181995,520670,271135,249535
2015/9/1,總計,屏東縣,284314,842425,431615,410810
2015/9/1,總計,臺東縣,82353,222910,115469,107441
2015/9/1,總計,花蓮縣,124816,332026,169432,162594
2015/9/1,總計,澎湖縣,38502,102204,52708,49496
2015/9/1,總計,基隆市,151231,372511,187176,185335
2015/9/1,總計,新竹市,157297,433348,214494,218854
2015/9/1,總計,嘉義市,98744,270473,132061,138412
2015/9/1,總計,福建省,40958,144450,73332,71118
2015/9/1,總計,金門縣,38432,131905,66168,65737
2015/9/1,總計,連江縣,2526,12545,7164,5381
2015/9/1,新北市,板橋區,205844,554401,271381,283020
2015/9/1,新北市,三重區,148362,388456,191854,196602
2015/9/1,新北市,中和區,163119,414581,202430,212151
2015/9/1,新北市,永和區,90735,225662,107330,118332
2015/9/1,新北市,新莊區,148894,412630,202170,210460
2015/9/1,新北市,新店區,123865,299897,144995,154902
2015/9/1,新北市,樹林區,65393,184021,91961,92060
2015/9/1,新北市,鶯歌區,29405,88145,44216,43929
2015/9/1,新北市,三峽區,40976,112360,56555,55805
2015/9/1,新北市,淡水區,69994,161390,77649,83741
2015/9/1,新北市,汐止區,84997,195809,95839,99970
2015/9/1,新北市,瑞芳區,16118,40954,20722,20232
2015/9/1,新北市,土城區,85903,238463,118060,120403
2015/9/1,新北市,蘆洲區,69463,199924,98458,101466
2015/9/1,新北市,五股區,29830,82816,41786,41030
2015/9/1,新北市,泰山區,27971,78618,39130,39488
2015/9/1,新北市,林口區,38974,99710,48859,50851
2015/9/1,新北市,深坑區,9434,23589,11832,11757
2015/9/1,新北市,石碇區,3367,7833,4324,3509
2015/9/1,新北市,坪林區,2497,6492,3621,2871
2015/9/1,新北市,三芝區,9354,23466,12082,11384
2015/9/1,新北市,石門區,4317,12645,6562,6083
2015/9/1,新北市,八里區,13971,37517,18745,18772
2015/9/1,新北市,平溪區,2351,4893,2694,2199
2015/9/1,新北市,雙溪區,3824,9262,4999,4263
2015/9/1,新北市,貢寮區,4405,12868,6572,6296
2015/9/1,新北市,金山區,7011,22213,11004,11209
2015/9/1,新北市,萬里區,7410,22694,11459,11235
2015/9/1,新北市,烏來區,1808,6174,3066,3108
2015/9/1,臺北市,松山區,80272,209362,98710,110652
2015/9/1,臺北市,信義區,89583,229084,109793,119291
2015/9/1,臺北市,大安區,120507,312596,146348,166248
2015/9/1,臺北市,中山區,99126,230709,107699,123010
2015/9/1,臺北市,中正區,65285,162322,77542,84780
2015/9/1,臺北市,大同區,51527,130757,63907,66850
2015/9/1,臺北市,萬華區,78304,194126,95829,98297
2015/9/1,臺北市,文山區,104256,274875,132246,142629
2015/9/1,臺北市,南港區,46425,121965,59588,62377
2015/9/1,臺北市,內湖區,106355,286693,137313,149380
2015/9/1,臺北市,士林區,106154,290229,140347,149882
2015/9/1,臺北市,北投區,95699,257397,124273,133124
2015/9/1,桃園市,桃園區,159309,425335,207294,218041
2015/9/1,桃園市,中壢區,141076,388187,192051,196136
2015/9/1,桃園市,大溪區,31351,93101,47777,45324
2015/9/1,桃園市,楊梅區,54824,160257,81146,79111
2015/9/1,桃園市,蘆竹區,55161,154627,77100,77527
2015/9/1,桃園市,大園區,30401,85266,43845,41421
2015/9/1,桃園市,龜山區,55473,144913,72763,72150
2015/9/1,桃園市,八德區,65545,186237,93797,92440
2015/9/1,桃園市,龍潭區,40024,117987,59459,58528
2015/9/1,桃園市,平鎮區,73846,216781,108185,108596
2015/9/1,桃園市,新屋區,15727,48352,25857,22495
2015/9/1,桃園市,觀音區,21468,64481,33716,30765
2015/9/1,桃園市,復興區,3727,10908,5961,4947
2015/9/1,臺中市,中區,7887,19103,9512,9591
2015/9/1,臺中市,東區,27340,75084,37513,37571
2015/9/1,臺中市,南區,46719,121515,58544,62971
2015/9/1,臺中市,西區,45110,115723,55079,60644
2015/9/1,臺中市,北區,58453,147360,70783,76577
2015/9/1,臺中市,西屯區,82220,221254,106613,114641
2015/9/1,臺中市,南屯區,59574,163935,78640,85295
2015/9/1,臺中市,北屯區,94433,263795,127007,136788
2015/9/1,臺中市,豐原區,52615,166635,82524,84111
2015/9/1,臺中市,東勢區,17310,51300,26460,24840
2015/9/1,臺中市,大甲區,22700,77702,39180,38522
2015/9/1,臺中市,清水區,26388,86093,44283,41810
2015/9/1,臺中市,沙鹿區,27822,89233,45224,44009
2015/9/1,臺中市,梧棲區,17112,56970,28700,28270
2015/9/1,臺中市,后里區,15638,54219,27597,26622
2015/9/1,臺中市,神岡區,18881,65158,33335,31823
2015/9/1,臺中市,潭子區,35411,106315,52740,53575
2015/9/1,臺中市,大雅區,28324,93509,46737,46772
2015/9/1,臺中市,新社區,7509,25107,13055,12052
2015/9/1,臺中市,石岡區,4904,15298,7945,7353
2015/9/1,臺中市,外埔區,9372,31818,16342,15476
2015/9/1,臺中市,大安區,5400,19578,10342,9236
2015/9/1,臺中市,烏日區,23079,72241,36369,35872
2015/9/1,臺中市,大肚區,16949,56534,28963,27571
2015/9/1,臺中市,龍井區,22285,76445,38724,37721
2015/9/1,臺中市,霧峰區,19676,64558,32872,31686
2015/9/1,臺中市,太平區,60837,183467,91320,92147
2015/9/1,臺中市,大里區,67475,207880,102478,105402
2015/9/1,臺中市,和平區,4424,10724,5763,4961
2015/9/1,臺南市,新營區,28659,78162,38718,39444
2015/9/1,臺南市,鹽水區,10111,26155,13674,12481
2015/9/1,臺南市,白河區,10945,29372,15376,13996
2015/9/1,臺南市,柳營區,7833,21638,11280,10358
2015/9/1,臺南市,後壁區,8916,24407,12678,11729
2015/9/1,臺南市,東山區,8253,21668,11515,10153
2015/9/1,臺南市,麻豆區,15565,44970,22836,22134
2015/9/1,臺南市,下營區,9093,24885,12826,12059
2015/9/1,臺南市,六甲區,7727,22626,11695,10931
2015/9/1,臺南市,官田區,7855,21702,11093,10609
2015/9/1,臺南市,大內區,3929,10098,5412,4686
2015/9/1,臺南市,佳里區,20408,59624,29574,30050
2015/9/1,臺南市,學甲區,9678,26713,13656,13057
2015/9/1,臺南市,西港區,8113,24920,12616,12304
2015/9/1,臺南市,七股區,8077,23409,12148,11261
2015/9/1,臺南市,將軍區,7319,20360,10374,9986
2015/9/1,臺南市,北門區,4330,11544,5826,5718
2015/9/1,臺南市,新化區,14281,43795,22360,21435
2015/9/1,臺南市,善化區,16748,46815,23647,23168
2015/9/1,臺南市,新市區,11728,35790,17967,17823
2015/9/1,臺南市,安定區,9869,30287,15554,14733
2015/9/1,臺南市,山上區,2680,7465,3904,3561
2015/9/1,臺南市,玉井區,5115,14386,7483,6903
2015/9/1,臺南市,楠西區,3541,10066,5337,4729
2015/9/1,臺南市,南化區,2868,8933,4824,4109
2015/9/1,臺南市,左鎮區,1992,5081,2848,2233
2015/9/1,臺南市,仁德區,26800,73668,37497,36171
2015/9/1,臺南市,歸仁區,22189,67766,34428,33338
2015/9/1,臺南市,關廟區,10958,34764,17956,16808
2015/9/1,臺南市,龍崎區,1572,4221,2285,1936
2015/9/1,臺南市,永康區,81759,230359,113769,116590
2015/9/1,臺南市,東區,71754,188837,90787,98050
2015/9/1,臺南市,南區,44959,125839,62553,63286
2015/9/1,臺南市,北區,49933,132723,64819,67904
2015/9/1,臺南市,安南區,60895,189176,95656,93520
2015/9/1,臺南市,安平區,24819,65369,31075,34294
2015/9/1,臺南市,中西區,30776,77444,37673,39771
2015/9/1,高雄市,鹽埕區,10841,25067,12478,12589
2015/9/1,高雄市,鼓山區,56142,136442,66190,70252
2015/9/1,高雄市,左營區,77612,195972,94832,101140
2015/9/1,高雄市,楠梓區,67264,179629,88595,91034
2015/9/1,高雄市,三民區,135388,346540,168224,178316
2015/9/1,高雄市,新興區,22721,52034,25084,26950
2015/9/1,高雄市,前金區,12579,27497,13232,14265
2015/9/1,高雄市,苓雅區,72301,174700,84461,90239
2015/9/1,高雄市,前鎮區,78447,192906,95091,97815
2015/9/1,高雄市,旗津區,11044,28921,15001,13920
2015/9/1,高雄市,小港區,66398,156013,77803,78210
2015/9/1,高雄市,鳳山區,137026,355766,174969,180797
2015/9/1,高雄市,林園區,25505,70303,35688,34615
2015/9/1,高雄市,大寮區,41307,111619,57323,54296
2015/9/1,高雄市,大樹區,13391,43115,22161,20954
2015/9/1,高雄市,大社區,12734,34537,17595,16942
2015/9/1,高雄市,仁武區,30991,82134,41929,40205
2015/9/1,高雄市,鳥松區,17656,43844,22312,21532
2015/9/1,高雄市,岡山區,34624,97741,48611,49130
2015/9/1,高雄市,橋頭區,13274,37334,19021,18313
2015/9/1,高雄市,燕巢區,10377,30223,16017,14206
2015/9/1,高雄市,田寮區,3379,7521,4175,3346
2015/9/1,高雄市,阿蓮區,9366,29366,14807,14559
2015/9/1,高雄市,路竹區,16808,53023,27092,25931
2015/9/1,高雄市,湖內區,10557,29600,15130,14470
2015/9/1,高雄市,茄萣區,10449,30547,15796,14751
2015/9/1,高雄市,永安區,5745,14119,7084,7035
2015/9/1,高雄市,彌陀區,6760,19669,10172,9497
2015/9/1,高雄市,梓官區,12554,36438,18824,17614
2015/9/1,高雄市,旗山區,13875,37856,19633,18223
2015/9/1,高雄市,美濃區,14540,40901,21451,19450
2015/9/1,高雄市,六龜區,5645,13514,7292,6222
2015/9/1,高雄市,甲仙區,2367,6292,3346,2946
2015/9/1,高雄市,杉林區,4823,12422,6791,5631
2015/9/1,高雄市,內門區,5068,15015,8124,6891
2015/9/1,高雄市,茂林區,580,1883,928,955
2015/9/1,高雄市,桃源區,1324,4230,2215,2015
2015/9/1,高雄市,那瑪夏區,859,3137,1623,1514
2015/9/1,宜蘭縣,宜蘭市,35610,95995,46895,49100
2015/9/1,宜蘭縣,羅東鎮,26072,72550,34480,38070
2015/9/1,宜蘭縣,蘇澳鎮,14074,40813,20822,19991
2015/9/1,宜蘭縣,頭城鎮,10135,29815,15392,14423
2015/9/1,宜蘭縣,礁溪鄉,13562,35895,18738,17157
2015/9/1,宜蘭縣,壯圍鄉,8498,24264,12849,11415
2015/9/1,宜蘭縣,員山鄉,11478,32317,17168,15149
2015/9/1,宜蘭縣,冬山鄉,18822,53558,27558,26000
2015/9/1,宜蘭縣,五結鄉,14389,39493,20455,19038
2015/9/1,宜蘭縣,三星鄉,8308,21449,11579,9870
2015/9/1,宜蘭縣,大同鄉,1879,6080,3295,2785
2015/9/1,宜蘭縣,南澳鄉,1911,6032,3173,2859
2015/9/1,新竹縣,竹北市,60333,169593,84606,84987
2015/9/1,新竹縣,關西鎮,9535,30058,16065,13993
2015/9/1,新竹縣,新埔鎮,10662,34141,18181,15960
2015/9/1,新竹縣,竹東鎮,32581,96023,48225,47798
2015/9/1,新竹縣,湖口鄉,25612,77187,39222,37965
2015/9/1,新竹縣,橫山鄉,4496,13584,7379,6205
2015/9/1,新竹縣,新豐鄉,17737,56108,28759,27349
2015/9/1,新竹縣,芎林鄉,6488,20280,10750,9530
2015/9/1,新竹縣,寶山鄉,5170,14335,7747,6588
2015/9/1,新竹縣,北埔鄉,3130,9694,5226,4468
2015/9/1,新竹縣,峨眉鄉,2081,5648,3129,2519
2015/9/1,新竹縣,尖石鄉,2846,9335,4947,4388
2015/9/1,新竹縣,五峰鄉,1743,4619,2524,2095
2015/9/1,苗栗縣,苗栗市,30749,90633,45283,45350
2015/9/1,苗栗縣,苑裡鎮,14459,47929,24839,23090
2015/9/1,苗栗縣,通霄鎮,11556,36310,19147,17163
2015/9/1,苗栗縣,竹南鎮,27771,84276,42537,41739
2015/9/1,苗栗縣,頭份市,33507,103262,52098,51164
2015/9/1,苗栗縣,後龍鎮,11870,37934,19986,17948
2015/9/1,苗栗縣,卓蘭鎮,6133,18122,9485,8637
2015/9/1,苗栗縣,大湖鄉,5434,15334,8136,7198
2015/9/1,苗栗縣,公館鄉,10616,34523,17954,16569
2015/9/1,苗栗縣,銅鑼鄉,6146,18774,9939,8835
2015/9/1,苗栗縣,南庄鄉,3962,10572,5810,4762
2015/9/1,苗栗縣,頭屋鄉,3660,11256,5936,5320
2015/9/1,苗栗縣,三義鄉,5470,17051,8941,8110
2015/9/1,苗栗縣,西湖鄉,2677,7471,4149,3322
2015/9/1,苗栗縣,造橋鄉,4150,13404,7036,6368
2015/9/1,苗栗縣,三灣鄉,2410,7012,3837,3175
2015/9/1,苗栗縣,獅潭鄉,1732,4623,2567,2056
2015/9/1,苗栗縣,泰安鄉,1960,6063,3246,2817
2015/9/1,彰化縣,彰化市,75375,234722,116256,118466
2015/9/1,彰化縣,員林市,38655,124676,62219,62457
2015/9/1,彰化縣,鹿港鎮,24028,86341,43976,42365
2015/9/1,彰化縣,和美鎮,26272,90956,46464,44492
2015/9/1,彰化縣,北斗鎮,10503,33164,16726,16438
2015/9/1,彰化縣,溪湖鎮,16060,55703,28311,27392
2015/9/1,彰化縣,田中鎮,13023,42527,22012,20515
2015/9/1,彰化縣,二林鎮,14853,51932,26788,25144
2015/9/1,彰化縣,線西鄉,4322,16992,8802,8190
2015/9/1,彰化縣,伸港鄉,9612,36392,18630,17762
2015/9/1,彰化縣,福興鄉,12549,47580,24790,22790
2015/9/1,彰化縣,秀水鄉,10489,39330,20332,18998
2015/9/1,彰化縣,花壇鄉,13772,45885,23612,22273
2015/9/1,彰化縣,芬園鄉,6888,24045,12666,11379
2015/9/1,彰化縣,大村鄉,10865,36488,18905,17583
2015/9/1,彰化縣,埔鹽鄉,9004,32982,17316,15666
2015/9/1,彰化縣,埔心鄉,10394,34836,17956,16880
2015/9/1,彰化縣,永靖鄉,10832,38024,19771,18253
2015/9/1,彰化縣,社頭鄉,12774,43492,22347,21145
2015/9/1,彰化縣,二水鄉,5338,15643,8201,7442
2015/9/1,彰化縣,田尾鄉,7885,27601,14302,13299
2015/9/1,彰化縣,埤頭鄉,8936,30874,16036,14838
2015/9/1,彰化縣,芳苑鄉,10125,34368,18217,16151
2015/9/1,彰化縣,大城鄉,5322,17550,9512,8038
2015/9/1,彰化縣,竹塘鄉,4621,15647,8280,7367
2015/9/1,彰化縣,溪州鄉,8902,30545,16016,14529
2015/9/1,南投縣,南投市,34493,101795,51066,50729
2015/9/1,南投縣,埔里鎮,28976,82356,41331,41025
2015/9/1,南投縣,草屯鎮,32724,98766,49928,48838
2015/9/1,南投縣,竹山鎮,20023,56101,28823,27278
2015/9/1,南投縣,集集鎮,4359,11231,5846,5385
2015/9/1,南投縣,名間鄉,12603,39776,20890,18886
2015/9/1,南投縣,鹿谷鄉,7661,18294,9733,8561
2015/9/1,南投縣,中寮鄉,5660,15388,8381,7007
2015/9/1,南投縣,魚池鄉,5742,16345,8568,7777
2015/9/1,南投縣,國姓鄉,7301,19401,10516,8885
2015/9/1,南投縣,水里鄉,7187,18415,9668,8747
2015/9/1,南投縣,信義鄉,5244,16516,8869,7647
2015/9/1,南投縣,仁愛鄉,4937,15710,8113,7597
2015/9/1,雲林縣,斗六市,37547,108346,54070,54276
2015/9/1,雲林縣,斗南鎮,15764,45662,23183,22479
2015/9/1,雲林縣,虎尾鎮,24366,70533,35785,34748
2015/9/1,雲林縣,西螺鎮,14486,46911,23826,23085
2015/9/1,雲林縣,土庫鎮,9220,29464,15402,14062
2015/9/1,雲林縣,北港鎮,15912,41112,21336,19776
2015/9/1,雲林縣,古坑鄉,10939,32389,17073,15316
2015/9/1,雲林縣,大埤鄉,6750,19761,10620,9141
2015/9/1,雲林縣,莿桐鄉,9264,29271,15387,13884
2015/9/1,雲林縣,林內鄉,5935,18804,9843,8961
2015/9/1,雲林縣,二崙鄉,8927,28007,15009,12998
2015/9/1,雲林縣,崙背鄉,8503,25560,13515,12045
2015/9/1,雲林縣,麥寮鄉,13960,44224,22377,21847
2015/9/1,雲林縣,東勢鄉,5746,15473,8510,6963
2015/9/1,雲林縣,褒忠鄉,4403,13351,7169,6182
2015/9/1,雲林縣,臺西鄉,8753,24663,13205,11458
2015/9/1,雲林縣,元長鄉,9377,26917,14708,12209
2015/9/1,雲林縣,四湖鄉,8917,24842,13483,11359
2015/9/1,雲林縣,口湖鄉,9599,28552,15170,13382
2015/9/1,雲林縣,水林鄉,10155,26595,14601,11994
2015/9/1,嘉義縣,太保市,12348,37133,19108,18025
2015/9/1,嘉義縣,朴子市,15538,43022,21804,21218
2015/9/1,嘉義縣,布袋鎮,10057,28008,14319,13689
2015/9/1,嘉義縣,大林鎮,11391,31768,16268,15500
2015/9/1,嘉義縣,民雄鄉,24343,71944,36830,35114
2015/9/1,嘉義縣,溪口鄉,5392,15164,8108,7056
2015/9/1,嘉義縣,新港鄉,10623,32890,17374,15516
2015/9/1,嘉義縣,六腳鄉,8991,24261,12896,11365
2015/9/1,嘉義縣,東石鄉,9381,25813,13685,12128
2015/9/1,嘉義縣,義竹鄉,7509,19281,10038,9243
2015/9/1,嘉義縣,鹿草鄉,5799,16141,8678,7463
2015/9/1,嘉義縣,水上鄉,17934,50512,26095,24417
2015/9/1,嘉義縣,中埔鄉,15992,45812,23838,21974
2015/9/1,嘉義縣,竹崎鄉,11701,36639,19575,17064
2015/9/1,嘉義縣,梅山鄉,6766,20055,10653,9402
2015/9/1,嘉義縣,番路鄉,4326,11919,6448,5471
2015/9/1,嘉義縣,大埔鄉,1944,4599,2399,2200
2015/9/1,嘉義縣,阿里山鄉,1960,5709,3019,2690
2015/9/1,屏東縣,屏東市,73728,202778,100664,102114
2015/9/1,屏東縣,潮州鎮,19157,54748,27412,27336
2015/9/1,屏東縣,東港鎮,16340,48066,24336,23730
2015/9/1,屏東縣,恆春鎮,11312,30881,15830,15051
2015/9/1,屏東縣,萬丹鄉,14801,51793,26810,24983
2015/9/1,屏東縣,長治鄉,10013,30348,15828,14520
2015/9/1,屏東縣,麟洛鄉,3751,11246,5839,5407
2015/9/1,屏東縣,九如鄉,6846,22126,11457,10669
2015/9/1,屏東縣,里港鄉,8143,26942,13713,13229
2015/9/1,屏東縣,鹽埔鄉,7841,26408,13730,12678
2015/9/1,屏東縣,高樹鄉,9384,25211,13420,11791
2015/9/1,屏東縣,萬巒鄉,6476,20787,10904,9883
2015/9/1,屏東縣,內埔鄉,18488,55737,28889,26848
2015/9/1,屏東縣,竹田鄉,5646,17611,9333,8278
2015/9/1,屏東縣,新埤鄉,3426,10074,5371,4703
2015/9/1,屏東縣,枋寮鄉,8543,25190,13200,11990
2015/9/1,屏東縣,新園鄉,11763,36293,18764,17529
2015/9/1,屏東縣,崁頂鄉,4457,16164,8209,7955
2015/9/1,屏東縣,林邊鄉,6961,18976,9744,9232
2015/9/1,屏東縣,南州鄉,3676,10883,5574,5309
2015/9/1,屏東縣,佳冬鄉,6993,20004,10400,9604
2015/9/1,屏東縣,琉球鄉,4308,12501,6879,5622
2015/9/1,屏東縣,車城鄉,3487,8967,4846,4121
2015/9/1,屏東縣,滿州鄉,3014,8036,4396,3640
2015/9/1,屏東縣,枋山鄉,2135,5663,3017,2646
2015/9/1,屏東縣,三地門鄉,2292,7706,3887,3819
2015/9/1,屏東縣,霧臺鄉,1048,3344,1708,1636
2015/9/1,屏東縣,瑪家鄉,2018,6751,3446,3305
2015/9/1,屏東縣,泰武鄉,1303,5225,2750,2475
2015/9/1,屏東縣,來義鄉,2231,7557,3844,3713
2015/9/1,屏東縣,春日鄉,1350,4804,2463,2341
2015/9/1,屏東縣,獅子鄉,1525,4819,2491,2328
2015/9/1,屏東縣,牡丹鄉,1858,4786,2461,2325
2015/9/1,臺東縣,臺東市,39267,106847,53689,53158
2015/9/1,臺東縣,成功鎮,5440,14738,7791,6947
2015/9/1,臺東縣,關山鎮,3207,8970,4706,4264
2015/9/1,臺東縣,卑南鄉,6663,17536,9303,8233
2015/9/1,臺東縣,大武鄉,2525,6358,3318,3040
2015/9/1,臺東縣,太麻里鄉,4622,11386,6056,5330
2015/9/1,臺東縣,東河鄉,3776,8871,4886,3985
2015/9/1,臺東縣,長濱鄉,2932,7609,4321,3288
2015/9/1,臺東縣,鹿野鄉,3090,8134,4364,3770
2015/9/1,臺東縣,池上鄉,3244,8505,4455,4050
2015/9/1,臺東縣,綠島鄉,1090,3804,1981,1823
2015/9/1,臺東縣,延平鄉,1072,3573,1909,1664
2015/9/1,臺東縣,海端鄉,1093,4327,2314,2013
2015/9/1,臺東縣,達仁鄉,1449,3606,1970,1636
2015/9/1,臺東縣,金峰鄉,1108,3613,1868,1745
2015/9/1,臺東縣,蘭嶼鄉,1775,5033,2538,2495
2015/9/1,花蓮縣,花蓮市,41436,105769,51307,54462
2015/9/1,花蓮縣,鳳林鎮,4411,11113,5824,5289
2015/9/1,花蓮縣,玉里鎮,8922,25125,13432,11693
2015/9/1,花蓮縣,新城鄉,7573,20183,10404,9779
2015/9/1,花蓮縣,吉安鄉,31441,83172,42136,41036
2015/9/1,花蓮縣,壽豐鄉,7051,18178,9719,8459
2015/9/1,花蓮縣,光復鄉,5031,13259,7060,6199
2015/9/1,花蓮縣,豐濱鄉,1728,4564,2532,2032
2015/9/1,花蓮縣,瑞穗鄉,4686,11925,6407,5518
2015/9/1,花蓮縣,富里鄉,4004,10669,5828,4841
2015/9/1,花蓮縣,秀林鄉,4773,15575,8048,7527
2015/9/1,花蓮縣,萬榮鄉,2080,6437,3403,3034
2015/9/1,花蓮縣,卓溪鄉,1680,6057,3332,2725
2015/9/1,澎湖縣,馬公市,23485,60841,30991,29850
2015/9/1,澎湖縣,湖西鄉,5415,14384,7609,6775
2015/9/1,澎湖縣,白沙鄉,3351,9732,5112,4620
2015/9/1,澎湖縣,西嶼鄉,2933,8387,4301,4086
2015/9/1,澎湖縣,望安鄉,1984,5089,2736,2353
2015/9/1,澎湖縣,七美鄉,1334,3771,1959,1812
2015/9/1,基隆市,中正區,22564,52848,27056,25792
2015/9/1,基隆市,七堵區,21131,54073,27334,26739
2015/9/1,基隆市,暖暖區,15441,38402,19329,19073
2015/9/1,基隆市,仁愛區,19387,45724,22603,23121
2015/9/1,基隆市,中山區,19296,48404,24606,23798
2015/9/1,基隆市,安樂區,32411,81483,40563,40920
2015/9/1,基隆市,信義區,21001,51577,25685,25892
2015/9/1,新竹市,東區,76301,207705,102356,105349
2015/9/1,新竹市,北區,54881,148989,73080,75909
2015/9/1,新竹市,香山區,26115,76654,39058,37596
2015/9/1,嘉義市,東區,45301,122958,59576,63382
2015/9/1,嘉義市,西區,53443,147515,72485,75030
2015/9/1,金門縣,金城鎮,12659,42160,21187,20973
2015/9/1,金門縣,金湖鎮,8523,28180,14194,13986
2015/9/1,金門縣,金沙鎮,6138,19982,9886,10096
2015/9/1,金門縣,金寧鄉,7921,28579,14450,14129
2015/9/1,金門縣,烈嶼鄉,3057,12340,6118,6222
2015/9/1,金門縣,烏坵鄉,134,664,333,331
2015/9/1,連江縣,南竿鄉,1444,7454,4231,3223
2015/9/1,連江縣,北竿鄉,489,2324,1288,1036
2015/9/1,連江縣,莒光鄉,276,1506,886,620
2015/9/1,連江縣,東引鄉,317,1261,759,502
2015/10/1,總計,新北市,1509904,3968921,1950807,2018114
2015/10/1,總計,臺北市,1043434,2701514,1294125,1407389
2015/10/1,總計,桃園市,748643,2099583,1050299,1049284
2015/10/1,總計,臺中市,926474,2740634,1355436,1385198
2015/10/1,總計,臺南市,671971,1885175,943711,941464
2015/10/1,總計,高雄市,1072344,2778249,1381115,1397134
2015/10/1,總計,臺灣省,2447830,7157748,3657949,3499799
2015/10/1,總計,宜蘭縣,164751,458078,232302,225776
2015/10/1,總計,新竹縣,182596,541078,276972,264106
2015/10/1,總計,苗栗縣,184271,564305,290856,273449
2015/10/1,總計,彰化縣,381457,1288346,658372,629974
2015/10/1,總計,南投縣,176920,509911,261632,248279
2015/10/1,總計,雲林縣,238500,700127,364091,336036
2015/10/1,總計,嘉義縣,181976,520424,271006,249418
2015/10/1,總計,屏東縣,284324,842097,431430,410667
2015/10/1,總計,臺東縣,82357,222708,115365,107343
2015/10/1,總計,花蓮縣,124826,332063,169448,162615
2015/10/1,總計,澎湖縣,38561,102279,52771,49508
2015/10/1,總計,基隆市,151155,372355,187111,185244
2015/10/1,總計,新竹市,157434,433581,214621,218960
2015/10/1,總計,嘉義市,98702,270396,131972,138424
2015/10/1,總計,福建省,41018,144816,73534,71282
2015/10/1,總計,金門縣,38486,132269,66359,65910
2015/10/1,總計,連江縣,2532,12547,7175,5372
2015/10/1,新北市,板橋區,205781,554351,271344,283007
2015/10/1,新北市,三重區,148378,388550,191885,196665
2015/10/1,新北市,中和區,163109,414519,202371,212148
2015/10/1,新北市,永和區,90708,225508,107224,118284
2015/10/1,新北市,新莊區,148941,412898,202291,210607
2015/10/1,新北市,新店區,123856,300096,145054,155042
2015/10/1,新北市,樹林區,65422,184182,92055,92127
2015/10/1,新北市,鶯歌區,29434,88094,44182,43912
2015/10/1,新北市,三峽區,40992,112447,56588,55859
2015/10/1,新北市,淡水區,70074,161674,77798,83876
2015/10/1,新北市,汐止區,84999,195909,95844,100065
2015/10/1,新北市,瑞芳區,16135,41009,20736,20273
2015/10/1,新北市,土城區,85926,238552,118095,120457
2015/10/1,新北市,蘆洲區,69499,200007,98501,101506
2015/10/1,新北市,五股區,29850,82837,41800,41037
2015/10/1,新北市,泰山區,27984,78685,39137,39548
2015/10/1,新北市,林口區,39036,99930,48953,50977
2015/10/1,新北市,深坑區,9433,23573,11819,11754
2015/10/1,新北市,石碇區,3368,7848,4331,3517
2015/10/1,新北市,坪林區,2495,6483,3619,2864
2015/10/1,新北市,三芝區,9360,23498,12102,11396
2015/10/1,新北市,石門區,4319,12641,6554,6087
2015/10/1,新北市,八里區,13990,37562,18765,18797
2015/10/1,新北市,平溪區,2349,4878,2688,2190
2015/10/1,新北市,雙溪區,3829,9264,5007,4257
2015/10/1,新北市,貢寮區,4402,12857,6560,6297
2015/10/1,新北市,金山區,7014,22211,10997,11214
2015/10/1,新北市,萬里區,7407,22684,11441,11243
2015/10/1,新北市,烏來區,1814,6174,3066,3108
2015/10/1,臺北市,松山區,80277,209473,98753,110720
2015/10/1,臺北市,信義區,89548,229133,109803,119330
2015/10/1,臺北市,大安區,120420,312666,146322,166344
2015/10/1,臺北市,中山區,99128,230875,107825,123050
2015/10/1,臺北市,中正區,65264,162222,77495,84727
2015/10/1,臺北市,大同區,51506,130750,63899,66851
2015/10/1,臺北市,萬華區,78303,194271,95889,98382
2015/10/1,臺北市,文山區,104257,275102,132332,142770
2015/10/1,臺北市,南港區,46430,122110,59646,62464
2015/10/1,臺北市,內湖區,106396,287008,137462,149546
2015/10/1,臺北市,士林區,106223,290391,140364,150027
2015/10/1,臺北市,北投區,95682,257513,124335,133178
2015/10/1,桃園市,桃園區,159435,425955,207564,218391
2015/10/1,桃園市,中壢區,141220,388703,192270,196433
2015/10/1,桃園市,大溪區,31402,93213,47799,45414
2015/10/1,桃園市,楊梅區,54933,160574,81277,79297
2015/10/1,桃園市,蘆竹區,55194,154899,77237,77662
2015/10/1,桃園市,大園區,30421,85384,43889,41495
2015/10/1,桃園市,龜山區,55476,145120,72852,72268
2015/10/1,桃園市,八德區,65621,186617,93953,92664
2015/10/1,桃園市,龍潭區,40052,118173,59533,58640
2015/10/1,桃園市,平鎮區,73921,217105,108347,108758
2015/10/1,桃園市,新屋區,15738,48365,25870,22495
2015/10/1,桃園市,觀音區,21503,64561,33739,30822
2015/10/1,桃園市,復興區,3727,10914,5969,4945
2015/10/1,臺中市,中區,7899,19126,9534,9592
2015/10/1,臺中市,東區,27347,75104,37521,37583
2015/10/1,臺中市,南區,46712,121545,58567,62978
2015/10/1,臺中市,西區,45089,115679,55067,60612
2015/10/1,臺中市,北區,58473,147416,70776,76640
2015/10/1,臺中市,西屯區,82304,221508,106718,114790
2015/10/1,臺中市,南屯區,59614,164086,78680,85406
2015/10/1,臺中市,北屯區,94539,264265,127176,137089
2015/10/1,臺中市,豐原區,52624,166702,82552,84150
2015/10/1,臺中市,東勢區,17314,51317,26464,24853
2015/10/1,臺中市,大甲區,22724,77700,39162,38538
2015/10/1,臺中市,清水區,26412,86141,44296,41845
2015/10/1,臺中市,沙鹿區,27877,89363,45287,44076
2015/10/1,臺中市,梧棲區,17128,56994,28709,28285
2015/10/1,臺中市,后里區,15656,54281,27619,26662
2015/10/1,臺中市,神岡區,18893,65190,33335,31855
2015/10/1,臺中市,潭子區,35426,106413,52787,53626
2015/10/1,臺中市,大雅區,28353,93535,46757,46778
2015/10/1,臺中市,新社區,7509,25109,13062,12047
2015/10/1,臺中市,石岡區,4900,15287,7941,7346
2015/10/1,臺中市,外埔區,9396,31854,16356,15498
2015/10/1,臺中市,大安區,5407,19571,10336,9235
2015/10/1,臺中市,烏日區,23094,72352,36429,35923
2015/10/1,臺中市,大肚區,16982,56567,28975,27592
2015/10/1,臺中市,龍井區,22304,76533,38754,37779
2015/10/1,臺中市,霧峰區,19698,64596,32877,31719
2015/10/1,臺中市,太平區,60894,183620,91378,92242
2015/10/1,臺中市,大里區,67479,208066,102569,105497
2015/10/1,臺中市,和平區,4427,10714,5752,4962
2015/10/1,臺南市,新營區,28671,78157,38711,39446
2015/10/1,臺南市,鹽水區,10097,26128,13652,12476
2015/10/1,臺南市,白河區,10941,29325,15356,13969
2015/10/1,臺南市,柳營區,7840,21636,11290,10346
2015/10/1,臺南市,後壁區,8914,24384,12674,11710
2015/10/1,臺南市,東山區,8250,21654,11507,10147
2015/10/1,臺南市,麻豆區,15568,44971,22838,22133
2015/10/1,臺南市,下營區,9098,24874,12824,12050
2015/10/1,臺南市,六甲區,7713,22603,11676,10927
2015/10/1,臺南市,官田區,7850,21708,11097,10611
2015/10/1,臺南市,大內區,3921,10091,5413,4678
2015/10/1,臺南市,佳里區,20395,59608,29556,30052
2015/10/1,臺南市,學甲區,9671,26709,13659,13050
2015/10/1,臺南市,西港區,8112,24933,12617,12316
2015/10/1,臺南市,七股區,8070,23373,12130,11243
2015/10/1,臺南市,將軍區,7321,20333,10359,9974
2015/10/1,臺南市,北門區,4326,11547,5831,5716
2015/10/1,臺南市,新化區,14289,43788,22350,21438
2015/10/1,臺南市,善化區,16777,46861,23668,23193
2015/10/1,臺南市,新市區,11730,35843,17999,17844
2015/10/1,臺南市,安定區,9872,30305,15566,14739
2015/10/1,臺南市,山上區,2676,7455,3901,3554
2015/10/1,臺南市,玉井區,5114,14399,7484,6915
2015/10/1,臺南市,楠西區,3541,10050,5330,4720
2015/10/1,臺南市,南化區,2864,8917,4821,4096
2015/10/1,臺南市,左鎮區,1991,5074,2845,2229
2015/10/1,臺南市,仁德區,26797,73740,37531,36209
2015/10/1,臺南市,歸仁區,22190,67828,34458,33370
2015/10/1,臺南市,關廟區,10952,34745,17944,16801
2015/10/1,臺南市,龍崎區,1569,4208,2277,1931
2015/10/1,臺南市,永康區,81775,230519,113824,116695
2015/10/1,臺南市,東區,71727,188797,90749,98048
2015/10/1,臺南市,南區,44928,125782,62516,63266
2015/10/1,臺南市,北區,49907,132703,64817,67886
2015/10/1,臺南市,安南區,60934,189279,95690,93589
2015/10/1,臺南市,安平區,24809,65396,31077,34319
2015/10/1,臺南市,中西區,30771,77452,37674,39778
2015/10/1,高雄市,鹽埕區,10830,25027,12459,12568
2015/10/1,高雄市,鼓山區,56142,136537,66236,70301
2015/10/1,高雄市,左營區,77596,196083,94867,101216
2015/10/1,高雄市,楠梓區,67288,179678,88585,91093
2015/10/1,高雄市,三民區,135350,346451,168217,178234
2015/10/1,高雄市,新興區,22709,52000,25064,26936
2015/10/1,高雄市,前金區,12551,27459,13228,14231
2015/10/1,高雄市,苓雅區,72282,174701,84444,90257
2015/10/1,高雄市,前鎮區,78422,192798,95038,97760
2015/10/1,高雄市,旗津區,11057,28959,15013,13946
2015/10/1,高雄市,小港區,66449,156081,77792,78289
2015/10/1,高雄市,鳳山區,137053,355963,175048,180915
2015/10/1,高雄市,林園區,25518,70332,35707,34625
2015/10/1,高雄市,大寮區,41296,111558,57310,54248
2015/10/1,高雄市,大樹區,13389,43130,22168,20962
2015/10/1,高雄市,大社區,12730,34536,17591,16945
2015/10/1,高雄市,仁武區,31065,82351,42028,40323
2015/10/1,高雄市,鳥松區,17691,43892,22329,21563
2015/10/1,高雄市,岡山區,34636,97799,48617,49182
2015/10/1,高雄市,橋頭區,13256,37290,18988,18302
2015/10/1,高雄市,燕巢區,10381,30192,15995,14197
2015/10/1,高雄市,田寮區,3370,7500,4163,3337
2015/10/1,高雄市,阿蓮區,9365,29366,14801,14565
2015/10/1,高雄市,路竹區,16807,53050,27096,25954
2015/10/1,高雄市,湖內區,10553,29597,15130,14467
2015/10/1,高雄市,茄萣區,10453,30564,15789,14775
2015/10/1,高雄市,永安區,5743,14134,7096,7038
2015/10/1,高雄市,彌陀區,6756,19669,10163,9506
2015/10/1,高雄市,梓官區,12547,36418,18819,17599
2015/10/1,高雄市,旗山區,13861,37809,19605,18204
2015/10/1,高雄市,美濃區,14542,40867,21442,19425
2015/10/1,高雄市,六龜區,5645,13509,7289,6220
2015/10/1,高雄市,甲仙區,2362,6282,3339,2943
2015/10/1,高雄市,杉林區,4818,12408,6776,5632
2015/10/1,高雄市,內門區,5070,15011,8117,6894
2015/10/1,高雄市,茂林區,580,1886,931,955
2015/10/1,高雄市,桃源區,1322,4225,2212,2013
2015/10/1,高雄市,那瑪夏區,859,3137,1623,1514
2015/10/1,宜蘭縣,宜蘭市,35594,96023,46920,49103
2015/10/1,宜蘭縣,羅東鎮,26059,72472,34456,38016
2015/10/1,宜蘭縣,蘇澳鎮,14065,40776,20798,19978
2015/10/1,宜蘭縣,頭城鎮,10140,29808,15385,14423
2015/10/1,宜蘭縣,礁溪鄉,13564,35853,18713,17140
2015/10/1,宜蘭縣,壯圍鄉,8510,24252,12840,11412
2015/10/1,宜蘭縣,員山鄉,11485,32281,17154,15127
2015/10/1,宜蘭縣,冬山鄉,18838,53579,27549,26030
2015/10/1,宜蘭縣,五結鄉,14397,39489,20448,19041
2015/10/1,宜蘭縣,三星鄉,8304,21425,11569,9856
2015/10/1,宜蘭縣,大同鄉,1884,6080,3296,2784
2015/10/1,宜蘭縣,南澳鄉,1911,6040,3174,2866
2015/10/1,新竹縣,竹北市,60416,169984,84787,85197
2015/10/1,新竹縣,關西鎮,9537,30036,16050,13986
2015/10/1,新竹縣,新埔鎮,10664,34113,18173,15940
2015/10/1,新竹縣,竹東鎮,32636,96078,48248,47830
2015/10/1,新竹縣,湖口鄉,25635,77258,39247,38011
2015/10/1,新竹縣,橫山鄉,4493,13569,7368,6201
2015/10/1,新竹縣,新豐鄉,17749,56102,28767,27335
2015/10/1,新竹縣,芎林鄉,6485,20303,10762,9541
2015/10/1,新竹縣,寶山鄉,5174,14323,7739,6584
2015/10/1,新竹縣,北埔鄉,3132,9690,5222,4468
2015/10/1,新竹縣,峨眉鄉,2080,5641,3124,2517
2015/10/1,新竹縣,尖石鄉,2850,9361,4959,4402
2015/10/1,新竹縣,五峰鄉,1745,4620,2526,2094
2015/10/1,苗栗縣,苗栗市,30732,90567,45250,45317
2015/10/1,苗栗縣,頭份市,33523,103244,52108,51136
2015/10/1,苗栗縣,苑裡鎮,14459,47908,24847,23061
2015/10/1,苗栗縣,通霄鎮,11563,36229,19102,17127
2015/10/1,苗栗縣,竹南鎮,27779,84344,42561,41783
2015/10/1,苗栗縣,後龍鎮,11864,37903,19976,17927
2015/10/1,苗栗縣,卓蘭鎮,6126,18112,9480,8632
2015/10/1,苗栗縣,大湖鄉,5437,15324,8138,7186
2015/10/1,苗栗縣,公館鄉,10612,34518,17959,16559
2015/10/1,苗栗縣,銅鑼鄉,6146,18756,9930,8826
2015/10/1,苗栗縣,南庄鄉,3966,10561,5803,4758
2015/10/1,苗栗縣,頭屋鄉,3664,11258,5937,5321
2015/10/1,苗栗縣,三義鄉,5470,17033,8934,8099
2015/10/1,苗栗縣,西湖鄉,2677,7472,4150,3322
2015/10/1,苗栗縣,造橋鄉,4146,13382,7029,6353
2015/10/1,苗栗縣,三灣鄉,2414,7013,3838,3175
2015/10/1,苗栗縣,獅潭鄉,1731,4617,2566,2051
2015/10/1,苗栗縣,泰安鄉,1962,6064,3248,2816
2015/10/1,彰化縣,彰化市,75384,234742,116238,118504
2015/10/1,彰化縣,員林市,38674,124714,62203,62511
2015/10/1,彰化縣,鹿港鎮,24020,86339,43986,42353
2015/10/1,彰化縣,和美鎮,26274,90994,46478,44516
2015/10/1,彰化縣,北斗鎮,10504,33190,16750,16440
2015/10/1,彰化縣,溪湖鎮,16058,55718,28333,27385
2015/10/1,彰化縣,田中鎮,13031,42535,22007,20528
2015/10/1,彰化縣,二林鎮,14848,51911,26779,25132
2015/10/1,彰化縣,線西鄉,4327,17023,8807,8216
2015/10/1,彰化縣,伸港鄉,9625,36438,18645,17793
2015/10/1,彰化縣,福興鄉,12556,47565,24785,22780
2015/10/1,彰化縣,秀水鄉,10497,39337,20331,19006
2015/10/1,彰化縣,花壇鄉,13774,45915,23617,22298
2015/10/1,彰化縣,芬園鄉,6885,24014,12645,11369
2015/10/1,彰化縣,大村鄉,10853,36486,18908,17578
2015/10/1,彰化縣,埔鹽鄉,9003,32959,17310,15649
2015/10/1,彰化縣,埔心鄉,10401,34821,17951,16870
2015/10/1,彰化縣,永靖鄉,10835,38013,19764,18249
2015/10/1,彰化縣,社頭鄉,12777,43494,22345,21149
2015/10/1,彰化縣,二水鄉,5337,15642,8195,7447
2015/10/1,彰化縣,田尾鄉,7884,27572,14279,13293
2015/10/1,彰化縣,埤頭鄉,8935,30869,16034,14835
2015/10/1,彰化縣,芳苑鄉,10121,34336,18197,16139
2015/10/1,彰化縣,大城鄉,5319,17531,9499,8032
2015/10/1,彰化縣,竹塘鄉,4623,15645,8279,7366
2015/10/1,彰化縣,溪州鄉,8912,30543,16007,14536
2015/10/1,南投縣,南投市,34483,101719,51032,50687
2015/10/1,南投縣,埔里鎮,28971,82301,41309,40992
2015/10/1,南投縣,草屯鎮,32733,98804,49948,48856
2015/10/1,南投縣,竹山鎮,20024,56102,28819,27283
2015/10/1,南投縣,集集鎮,4354,11229,5849,5380
2015/10/1,南投縣,名間鄉,12602,39741,20866,18875
2015/10/1,南投縣,鹿谷鄉,7677,18257,9716,8541
2015/10/1,南投縣,中寮鄉,5660,15386,8373,7013
2015/10/1,南投縣,魚池鄉,5748,16320,8553,7767
2015/10/1,南投縣,國姓鄉,7300,19401,10513,8888
2015/10/1,南投縣,水里鄉,7190,18383,9651,8732
2015/10/1,南投縣,信義鄉,5244,16532,8877,7655
2015/10/1,南投縣,仁愛鄉,4934,15736,8126,7610
2015/10/1,雲林縣,斗六市,37530,108344,54052,54292
2015/10/1,雲林縣,斗南鎮,15770,45621,23155,22466
2015/10/1,雲林縣,虎尾鎮,24365,70502,35798,34704
2015/10/1,雲林縣,西螺鎮,14490,46887,23806,23081
2015/10/1,雲林縣,土庫鎮,9219,29427,15380,14047
2015/10/1,雲林縣,北港鎮,15904,41076,21314,19762
2015/10/1,雲林縣,古坑鄉,10947,32380,17071,15309
2015/10/1,雲林縣,大埤鄉,6748,19759,10621,9138
2015/10/1,雲林縣,莿桐鄉,9257,29242,15374,13868
2015/10/1,雲林縣,林內鄉,5934,18749,9807,8942
2015/10/1,雲林縣,二崙鄉,8928,27998,14997,13001
2015/10/1,雲林縣,崙背鄉,8495,25492,13480,12012
2015/10/1,雲林縣,麥寮鄉,13993,44429,22469,21960
2015/10/1,雲林縣,東勢鄉,5738,15452,8497,6955
2015/10/1,雲林縣,褒忠鄉,4408,13356,7178,6178
2015/10/1,雲林縣,臺西鄉,8748,24634,13189,11445
2015/10/1,雲林縣,元長鄉,9374,26916,14705,12211
2015/10/1,雲林縣,四湖鄉,8911,24788,13466,11322
2015/10/1,雲林縣,口湖鄉,9596,28521,15155,13366
2015/10/1,雲林縣,水林鄉,10145,26554,14577,11977
2015/10/1,嘉義縣,太保市,12369,37166,19134,18032
2015/10/1,嘉義縣,朴子市,15536,42979,21782,21197
2015/10/1,嘉義縣,布袋鎮,10050,27983,14308,13675
2015/10/1,嘉義縣,大林鎮,11383,31737,16260,15477
2015/10/1,嘉義縣,民雄鄉,24348,71948,36824,35124
2015/10/1,嘉義縣,溪口鄉,5392,15146,8097,7049
2015/10/1,嘉義縣,新港鄉,10631,32871,17369,15502
2015/10/1,嘉義縣,六腳鄉,8996,24237,12881,11356
2015/10/1,嘉義縣,東石鄉,9376,25796,13673,12123
2015/10/1,嘉義縣,義竹鄉,7508,19277,10025,9252
2015/10/1,嘉義縣,鹿草鄉,5793,16127,8672,7455
2015/10/1,嘉義縣,水上鄉,17929,50504,26077,24427
2015/10/1,嘉義縣,中埔鄉,15972,45776,23815,21961
2015/10/1,嘉義縣,竹崎鄉,11694,36612,19563,17049
2015/10/1,嘉義縣,梅山鄉,6768,20046,10659,9387
2015/10/1,嘉義縣,番路鄉,4320,11900,6443,5457
2015/10/1,嘉義縣,大埔鄉,1947,4608,2404,2204
2015/10/1,嘉義縣,阿里山鄉,1964,5711,3020,2691
2015/10/1,屏東縣,屏東市,73712,202743,100643,102100
2015/10/1,屏東縣,潮州鎮,19149,54738,27414,27324
2015/10/1,屏東縣,東港鎮,16346,48059,24333,23726
2015/10/1,屏東縣,恆春鎮,11339,30904,15841,15063
2015/10/1,屏東縣,萬丹鄉,14792,51754,26790,24964
2015/10/1,屏東縣,長治鄉,10007,30318,15812,14506
2015/10/1,屏東縣,麟洛鄉,3746,11242,5831,5411
2015/10/1,屏東縣,九如鄉,6844,22094,11440,10654
2015/10/1,屏東縣,里港鄉,8140,26959,13730,13229
2015/10/1,屏東縣,鹽埔鄉,7842,26384,13717,12667
2015/10/1,屏東縣,高樹鄉,9386,25217,13421,11796
2015/10/1,屏東縣,萬巒鄉,6474,20772,10898,9874
2015/10/1,屏東縣,內埔鄉,18495,55712,28863,26849
2015/10/1,屏東縣,竹田鄉,5644,17598,9325,8273
2015/10/1,屏東縣,新埤鄉,3424,10066,5365,4701
2015/10/1,屏東縣,枋寮鄉,8535,25164,13188,11976
2015/10/1,屏東縣,新園鄉,11765,36268,18749,17519
2015/10/1,屏東縣,崁頂鄉,4456,16156,8211,7945
2015/10/1,屏東縣,林邊鄉,6955,18959,9732,9227
2015/10/1,屏東縣,南州鄉,3674,10876,5566,5310
2015/10/1,屏東縣,佳冬鄉,6993,19965,10382,9583
2015/10/1,屏東縣,琉球鄉,4331,12528,6889,5639
2015/10/1,屏東縣,車城鄉,3484,8945,4832,4113
2015/10/1,屏東縣,滿州鄉,3011,8031,4391,3640
2015/10/1,屏東縣,枋山鄉,2138,5672,3021,2651
2015/10/1,屏東縣,三地門鄉,2292,7700,3883,3817
2015/10/1,屏東縣,霧臺鄉,1051,3334,1708,1626
2015/10/1,屏東縣,瑪家鄉,2018,6754,3449,3305
2015/10/1,屏東縣,泰武鄉,1310,5225,2752,2473
2015/10/1,屏東縣,來義鄉,2233,7560,3844,3716
2015/10/1,屏東縣,春日鄉,1352,4806,2459,2347
2015/10/1,屏東縣,獅子鄉,1529,4826,2498,2328
2015/10/1,屏東縣,牡丹鄉,1857,4768,2453,2315
2015/10/1,臺東縣,臺東市,39278,106794,53660,53134
2015/10/1,臺東縣,成功鎮,5439,14709,7777,6932
2015/10/1,臺東縣,關山鎮,3207,8958,4708,4250
2015/10/1,臺東縣,卑南鄉,6656,17514,9289,8225
2015/10/1,臺東縣,大武鄉,2520,6348,3313,3035
2015/10/1,臺東縣,太麻里鄉,4626,11363,6043,5320
2015/10/1,臺東縣,東河鄉,3780,8863,4886,3977
2015/10/1,臺東縣,長濱鄉,2932,7593,4308,3285
2015/10/1,臺東縣,鹿野鄉,3088,8129,4362,3767
2015/10/1,臺東縣,池上鄉,3245,8498,4451,4047
2015/10/1,臺東縣,綠島鄉,1089,3798,1976,1822
2015/10/1,臺東縣,延平鄉,1068,3572,1906,1666
2015/10/1,臺東縣,海端鄉,1092,4323,2310,2013
2015/10/1,臺東縣,達仁鄉,1449,3598,1963,1635
2015/10/1,臺東縣,金峰鄉,1105,3598,1861,1737
2015/10/1,臺東縣,蘭嶼鄉,1783,5050,2552,2498
2015/10/1,花蓮縣,花蓮市,41441,105760,51297,54463
2015/10/1,花蓮縣,鳳林鎮,4413,11126,5831,5295
2015/10/1,花蓮縣,玉里鎮,8919,25078,13410,11668
2015/10/1,花蓮縣,新城鄉,7579,20206,10420,9786
2015/10/1,花蓮縣,吉安鄉,31437,83158,42132,41026
2015/10/1,花蓮縣,壽豐鄉,7062,18203,9730,8473
2015/10/1,花蓮縣,光復鄉,5033,13260,7057,6203
2015/10/1,花蓮縣,豐濱鄉,1723,4561,2532,2029
2015/10/1,花蓮縣,瑞穗鄉,4686,11927,6407,5520
2015/10/1,花蓮縣,富里鄉,4004,10672,5828,4844
2015/10/1,花蓮縣,秀林鄉,4772,15644,8083,7561
2015/10/1,花蓮縣,萬榮鄉,2080,6414,3390,3024
2015/10/1,花蓮縣,卓溪鄉,1677,6054,3331,2723
2015/10/1,澎湖縣,馬公市,23524,60873,31022,29851
2015/10/1,澎湖縣,湖西鄉,5422,14403,7621,6782
2015/10/1,澎湖縣,白沙鄉,3353,9729,5109,4620
2015/10/1,澎湖縣,西嶼鄉,2943,8405,4317,4088
2015/10/1,澎湖縣,望安鄉,1982,5106,2745,2361
2015/10/1,澎湖縣,七美鄉,1337,3763,1957,1806
2015/10/1,基隆市,中正區,22551,52801,27036,25765
2015/10/1,基隆市,七堵區,21142,54093,27360,26733
2015/10/1,基隆市,暖暖區,15445,38408,19338,19070
2015/10/1,基隆市,仁愛區,19360,45665,22571,23094
2015/10/1,基隆市,中山區,19281,48395,24594,23801
2015/10/1,基隆市,安樂區,32386,81404,40515,40889
2015/10/1,基隆市,信義區,20990,51589,25697,25892
2015/10/1,新竹市,東區,76361,207868,102449,105419
2015/10/1,新竹市,北區,54912,149031,73107,75924
2015/10/1,新竹市,香山區,26161,76682,39065,37617
2015/10/1,嘉義市,東區,45287,122925,59534,63391
2015/10/1,嘉義市,西區,53415,147471,72438,75033
2015/10/1,金門縣,金城鎮,12666,42227,21215,21012
2015/10/1,金門縣,金湖鎮,8551,28248,14245,14003
2015/10/1,金門縣,金沙鎮,6139,20032,9912,10120
2015/10/1,金門縣,金寧鄉,7933,28721,14516,14205
2015/10/1,金門縣,烈嶼鄉,3063,12375,6138,6237
2015/10/1,金門縣,烏坵鄉,134,666,333,333
2015/10/1,連江縣,南竿鄉,1448,7438,4219,3219
2015/10/1,連江縣,北竿鄉,490,2324,1289,1035
2015/10/1,連江縣,莒光鄉,278,1527,908,619
2015/10/1,連江縣,東引鄉,316,1258,759,499
2015/11/1,總計,新北市,1510494,3969855,1951187,2018668
2015/11/1,總計,臺北市,1043797,2702809,1294629,1408180
2015/11/1,總計,桃園市,749535,2102513,1051523,1050990
2015/11/1,總計,臺中市,927233,2742503,1356223,1386280
2015/11/1,總計,臺南市,672188,1885390,943790,941600
2015/11/1,總計,高雄市,1072598,2778512,1381020,1397492
2015/11/1,總計,臺灣省,2448645,7157133,3657423,3499710
2015/11/1,總計,宜蘭縣,164855,458070,232253,225817
2015/11/1,總計,新竹縣,182834,541527,277181,264346
2015/11/1,總計,苗栗縣,184356,564111,290784,273327
2015/11/1,總計,彰化縣,381652,1288696,658483,630213
2015/11/1,總計,南投縣,176951,509738,261519,248219
2015/11/1,總計,雲林縣,238450,699793,363950,335843
2015/11/1,總計,嘉義縣,182003,520119,270804,249315
2015/11/1,總計,屏東縣,284338,841669,431197,410472
2015/11/1,總計,臺東縣,82365,222645,115312,107333
2015/11/1,總計,花蓮縣,124930,332033,169424,162609
2015/11/1,總計,澎湖縣,38596,102317,52785,49532
2015/11/1,總計,基隆市,151080,372226,187046,185180
2015/11/1,總計,新竹市,157515,433774,214713,219061
2015/11/1,總計,嘉義市,98720,270415,131972,138443
2015/11/1,總計,福建省,41063,145078,73644,71434
2015/11/1,總計,金門縣,38527,132532,66472,66060
2015/11/1,總計,連江縣,2536,12546,7172,5374
2015/11/1,新北市,板橋區,205754,554289,271283,283006
2015/11/1,新北市,三重區,148440,388473,191801,196672
2015/11/1,新北市,中和區,163118,414467,202352,212115
2015/11/1,新北市,永和區,90719,225482,107220,118262
2015/11/1,新北市,新莊區,149028,413026,202383,210643
2015/11/1,新北市,新店區,123880,300201,145117,155084
2015/11/1,新北市,樹林區,65416,184205,92066,92139
2015/11/1,新北市,鶯歌區,29436,88037,44143,43894
2015/11/1,新北市,三峽區,41052,112569,56653,55916
2015/11/1,新北市,淡水區,70187,161990,77928,84062
2015/11/1,新北市,汐止區,85040,196054,95943,100111
2015/11/1,新北市,瑞芳區,16139,41009,20723,20286
2015/11/1,新北市,土城區,85948,238588,118100,120488
2015/11/1,新北市,蘆洲區,69502,200003,98508,101495
2015/11/1,新北市,五股區,29897,82872,41806,41066
2015/11/1,新北市,泰山區,28008,78750,39167,39583
2015/11/1,新北市,林口區,39103,100101,49022,51079
2015/11/1,新北市,深坑區,9451,23575,11817,11758
2015/11/1,新北市,石碇區,3369,7851,4333,3518
2015/11/1,新北市,坪林區,2494,6481,3618,2863
2015/11/1,新北市,三芝區,9364,23497,12102,11395
2015/11/1,新北市,石門區,4317,12641,6549,6092
2015/11/1,新北市,八里區,13995,37626,18791,18835
2015/11/1,新北市,平溪區,2349,4871,2687,2184
2015/11/1,新北市,雙溪區,3834,9247,5002,4245
2015/11/1,新北市,貢寮區,4405,12869,6565,6304
2015/11/1,新北市,金山區,7013,22233,11008,11225
2015/11/1,新北市,萬里區,7410,22666,11432,11234
2015/11/1,新北市,烏來區,1826,6182,3068,3114
2015/11/1,臺北市,松山區,80245,209460,98734,110726
2015/11/1,臺北市,信義區,89577,229223,109822,119401
2015/11/1,臺北市,大安區,120397,312795,146409,166386
2015/11/1,臺北市,中山區,99168,231060,107895,123165
2015/11/1,臺北市,中正區,65291,162279,77513,84766
2015/11/1,臺北市,大同區,51501,130836,63932,66904
2015/11/1,臺北市,萬華區,78318,194324,95941,98383
2015/11/1,臺北市,文山區,104422,275303,132410,142893
2015/11/1,臺北市,南港區,46428,122134,59648,62486
2015/11/1,臺北市,內湖區,106474,287274,137570,149704
2015/11/1,臺北市,士林區,106281,290532,140384,150148
2015/11/1,臺北市,北投區,95695,257589,124371,133218
2015/11/1,桃園市,桃園區,159576,426565,207793,218772
2015/11/1,桃園市,中壢區,141383,389230,192486,196744
2015/11/1,桃園市,大溪區,31434,93305,47848,45457
2015/11/1,桃園市,楊梅區,55033,160817,81382,79435
2015/11/1,桃園市,蘆竹區,55240,155118,77330,77788
2015/11/1,桃園市,大園區,30457,85423,43892,41531
2015/11/1,桃園市,龜山區,55497,145319,72937,72382
2015/11/1,桃園市,八德區,65755,187003,94110,92893
2015/11/1,桃園市,龍潭區,40074,118271,59580,58691
2015/11/1,桃園市,平鎮區,74061,217495,108516,108979
2015/11/1,桃園市,新屋區,15740,48360,25864,22496
2015/11/1,桃園市,觀音區,21557,64687,33812,30875
2015/11/1,桃園市,復興區,3728,10920,5973,4947
2015/11/1,臺中市,中區,7877,19033,9509,9524
2015/11/1,臺中市,東區,27376,75182,37556,37626
2015/11/1,臺中市,南區,46722,121661,58602,63059
2015/11/1,臺中市,西區,45070,115705,55091,60614
2015/11/1,臺中市,北區,58493,147454,70758,76696
2015/11/1,臺中市,西屯區,82348,221632,106808,114824
2015/11/1,臺中市,南屯區,59654,164290,78747,85543
2015/11/1,臺中市,北屯區,94686,264696,127383,137313
2015/11/1,臺中市,豐原區,52651,166745,82568,84177
2015/11/1,臺中市,東勢區,17308,51313,26449,24864
2015/11/1,臺中市,大甲區,22732,77684,39163,38521
2015/11/1,臺中市,清水區,26424,86142,44285,41857
2015/11/1,臺中市,沙鹿區,27949,89529,45365,44164
2015/11/1,臺中市,梧棲區,17152,57059,28725,28334
2015/11/1,臺中市,后里區,15681,54294,27619,26675
2015/11/1,臺中市,神岡區,18909,65192,33346,31846
2015/11/1,臺中市,潭子區,35449,106495,52819,53676
2015/11/1,臺中市,大雅區,28385,93560,46780,46780
2015/11/1,臺中市,新社區,7512,25081,13058,12023
2015/11/1,臺中市,石岡區,4906,15295,7944,7351
2015/11/1,臺中市,外埔區,9398,31872,16362,15510
2015/11/1,臺中市,大安區,5411,19572,10335,9237
2015/11/1,臺中市,烏日區,23145,72465,36482,35983
2015/11/1,臺中市,大肚區,17004,56625,29010,27615
2015/11/1,臺中市,龍井區,22313,76563,38759,37804
2015/11/1,臺中市,霧峰區,19719,64625,32899,31726
2015/11/1,臺中市,太平區,60985,183777,91436,92341
2015/11/1,臺中市,大里區,67545,208248,102617,105631
2015/11/1,臺中市,和平區,4429,10714,5748,4966
2015/11/1,臺南市,新營區,28662,78144,38684,39460
2015/11/1,臺南市,鹽水區,10099,26132,13654,12478
2015/11/1,臺南市,白河區,10940,29315,15348,13967
2015/11/1,臺南市,柳營區,7846,21647,11303,10344
2015/11/1,臺南市,後壁區,8910,24359,12661,11698
2015/11/1,臺南市,東山區,8246,21649,11504,10145
2015/11/1,臺南市,麻豆區,15573,44966,22837,22129
2015/11/1,臺南市,下營區,9094,24816,12782,12034
2015/11/1,臺南市,六甲區,7727,22592,11672,10920
2015/11/1,臺南市,官田區,7860,21716,11111,10605
2015/11/1,臺南市,大內區,3920,10073,5401,4672
2015/11/1,臺南市,佳里區,20397,59577,29563,30014
2015/11/1,臺南市,學甲區,9674,26688,13648,13040
2015/11/1,臺南市,西港區,8110,24921,12619,12302
2015/11/1,臺南市,七股區,8069,23361,12127,11234
2015/11/1,臺南市,將軍區,7314,20317,10358,9959
2015/11/1,臺南市,北門區,4322,11536,5825,5711
2015/11/1,臺南市,新化區,14285,43831,22354,21477
2015/11/1,臺南市,善化區,16784,46905,23681,23224
2015/11/1,臺南市,新市區,11739,35844,18009,17835
2015/11/1,臺南市,安定區,9878,30307,15555,14752
2015/11/1,臺南市,山上區,2678,7447,3897,3550
2015/11/1,臺南市,玉井區,5112,14390,7483,6907
2015/11/1,臺南市,楠西區,3539,10034,5321,4713
2015/11/1,臺南市,南化區,2860,8902,4816,4086
2015/11/1,臺南市,左鎮區,1990,5069,2842,2227
2015/11/1,臺南市,仁德區,26828,73817,37557,36260
2015/11/1,臺南市,歸仁區,22228,67894,34498,33396
2015/11/1,臺南市,關廟區,10963,34725,17940,16785
2015/11/1,臺南市,龍崎區,1571,4209,2279,1930
2015/11/1,臺南市,永康區,81815,230698,113901,116797
2015/11/1,臺南市,東區,71746,188775,90769,98006
2015/11/1,臺南市,南區,44935,125786,62498,63288
2015/11/1,臺南市,北區,49908,132741,64817,67924
2015/11/1,臺南市,安南區,60992,189403,95743,93660
2015/11/1,臺南市,安平區,24805,65359,31058,34301
2015/11/1,臺南市,中西區,30769,77445,37675,39770
2015/11/1,高雄市,鹽埕區,10841,25029,12456,12573
2015/11/1,高雄市,鼓山區,56162,136594,66222,70372
2015/11/1,高雄市,左營區,77584,196156,94879,101277
2015/11/1,高雄市,楠梓區,67352,179802,88614,91188
2015/11/1,高雄市,三民區,135334,346361,168144,178217
2015/11/1,高雄市,新興區,22702,51955,25047,26908
2015/11/1,高雄市,前金區,12547,27405,13206,14199
2015/11/1,高雄市,苓雅區,72264,174609,84390,90219
2015/11/1,高雄市,前鎮區,78413,192732,94990,97742
2015/11/1,高雄市,旗津區,11060,29010,15046,13964
2015/11/1,高雄市,小港區,66463,156145,77811,78334
2015/11/1,高雄市,鳳山區,137085,356008,175036,180972
2015/11/1,高雄市,林園區,25541,70344,35703,34641
2015/11/1,高雄市,大寮區,41304,111609,57340,54269
2015/11/1,高雄市,大樹區,13392,43160,22180,20980
2015/11/1,高雄市,大社區,12735,34557,17596,16961
2015/11/1,高雄市,仁武區,31129,82492,42063,40429
2015/11/1,高雄市,鳥松區,17712,43943,22342,21601
2015/11/1,高雄市,岡山區,34649,97781,48624,49157
2015/11/1,高雄市,橋頭區,13267,37278,18988,18290
2015/11/1,高雄市,燕巢區,10391,30163,15975,14188
2015/11/1,高雄市,田寮區,3367,7488,4157,3331
2015/11/1,高雄市,阿蓮區,9358,29353,14795,14558
2015/11/1,高雄市,路竹區,16824,53039,27094,25945
2015/11/1,高雄市,湖內區,10556,29621,15139,14482
2015/11/1,高雄市,茄萣區,10460,30557,15792,14765
2015/11/1,高雄市,永安區,5741,14149,7105,7044
2015/11/1,高雄市,彌陀區,6754,19658,10161,9497
2015/11/1,高雄市,梓官區,12550,36424,18817,17607
2015/11/1,高雄市,旗山區,13863,37794,19593,18201
2015/11/1,高雄市,美濃區,14547,40853,21434,19419
2015/11/1,高雄市,六龜區,5639,13480,7273,6207
2015/11/1,高雄市,甲仙區,2361,6282,3339,2943
2015/11/1,高雄市,杉林區,4814,12407,6770,5637
2015/11/1,高雄市,內門區,5075,15009,8120,6889
2015/11/1,高雄市,茂林區,580,1886,931,955
2015/11/1,高雄市,桃源區,1323,4237,2220,2017
2015/11/1,高雄市,那瑪夏區,859,3142,1628,1514
2015/11/1,宜蘭縣,宜蘭市,35617,96035,46909,49126
2015/11/1,宜蘭縣,羅東鎮,26051,72441,34438,38003
2015/11/1,宜蘭縣,蘇澳鎮,14066,40738,20778,19960
2015/11/1,宜蘭縣,頭城鎮,10138,29792,15376,14416
2015/11/1,宜蘭縣,礁溪鄉,13554,35838,18714,17124
2015/11/1,宜蘭縣,壯圍鄉,8523,24279,12853,11426
2015/11/1,宜蘭縣,員山鄉,11501,32283,17146,15137
2015/11/1,宜蘭縣,冬山鄉,18876,53610,27566,26044
2015/11/1,宜蘭縣,五結鄉,14419,39510,20453,19057
2015/11/1,宜蘭縣,三星鄉,8310,21421,11551,9870
2015/11/1,宜蘭縣,大同鄉,1886,6087,3299,2788
2015/11/1,宜蘭縣,南澳鄉,1914,6036,3170,2866
2015/11/1,新竹縣,竹北市,60500,170348,84949,85399
2015/11/1,新竹縣,關西鎮,9537,30002,16041,13961
2015/11/1,新竹縣,新埔鎮,10672,34096,18165,15931
2015/11/1,新竹縣,竹東鎮,32737,96225,48322,47903
2015/11/1,新竹縣,湖口鄉,25655,77308,39275,38033
2015/11/1,新竹縣,橫山鄉,4498,13538,7352,6186
2015/11/1,新竹縣,新豐鄉,17768,56086,28766,27320
2015/11/1,新竹縣,芎林鄉,6481,20269,10750,9519
2015/11/1,新竹縣,寶山鄉,5177,14341,7740,6601
2015/11/1,新竹縣,北埔鄉,3133,9687,5222,4465
2015/11/1,新竹縣,峨眉鄉,2081,5637,3114,2523
2015/11/1,新竹縣,尖石鄉,2850,9369,4965,4404
2015/11/1,新竹縣,五峰鄉,1745,4621,2520,2101
2015/11/1,苗栗縣,苗栗市,30736,90536,45225,45311
2015/11/1,苗栗縣,頭份市,33555,103274,52120,51154
2015/11/1,苗栗縣,苑裡鎮,14472,47876,24836,23040
2015/11/1,苗栗縣,通霄鎮,11571,36189,19088,17101
2015/11/1,苗栗縣,竹南鎮,27805,84399,42590,41809
2015/11/1,苗栗縣,後龍鎮,11858,37846,19945,17901
2015/11/1,苗栗縣,卓蘭鎮,6122,18075,9463,8612
2015/11/1,苗栗縣,大湖鄉,5439,15304,8124,7180
2015/11/1,苗栗縣,公館鄉,10612,34523,17972,16551
2015/11/1,苗栗縣,銅鑼鄉,6148,18744,9927,8817
2015/11/1,苗栗縣,南庄鄉,3972,10566,5809,4757
2015/11/1,苗栗縣,頭屋鄉,3668,11253,5933,5320
2015/11/1,苗栗縣,三義鄉,5479,17016,8934,8082
2015/11/1,苗栗縣,西湖鄉,2673,7461,4150,3311
2015/11/1,苗栗縣,造橋鄉,4139,13353,7007,6346
2015/11/1,苗栗縣,三灣鄉,2414,7018,3846,3172
2015/11/1,苗栗縣,獅潭鄉,1731,4621,2570,2051
2015/11/1,苗栗縣,泰安鄉,1962,6057,3245,2812
2015/11/1,彰化縣,彰化市,75416,234861,116296,118565
2015/11/1,彰化縣,員林市,38697,124790,62220,62570
2015/11/1,彰化縣,鹿港鎮,24040,86351,43981,42370
2015/11/1,彰化縣,和美鎮,26283,91053,46494,44559
2015/11/1,彰化縣,北斗鎮,10502,33193,16753,16440
2015/11/1,彰化縣,溪湖鎮,16071,55727,28334,27393
2015/11/1,彰化縣,田中鎮,13032,42524,21998,20526
2015/11/1,彰化縣,二林鎮,14859,51918,26772,25146
2015/11/1,彰化縣,線西鄉,4328,17037,8813,8224
2015/11/1,彰化縣,伸港鄉,9635,36462,18645,17817
2015/11/1,彰化縣,福興鄉,12557,47588,24806,22782
2015/11/1,彰化縣,秀水鄉,10504,39354,20341,19013
2015/11/1,彰化縣,花壇鄉,13808,45951,23642,22309
2015/11/1,彰化縣,芬園鄉,6882,24010,12646,11364
2015/11/1,彰化縣,大村鄉,10866,36492,18927,17565
2015/11/1,彰化縣,埔鹽鄉,9002,32962,17313,15649
2015/11/1,彰化縣,埔心鄉,10398,34840,17959,16881
2015/11/1,彰化縣,永靖鄉,10841,38007,19768,18239
2015/11/1,彰化縣,社頭鄉,12781,43476,22339,21137
2015/11/1,彰化縣,二水鄉,5341,15637,8195,7442
2015/11/1,彰化縣,田尾鄉,7885,27576,14269,13307
2015/11/1,彰化縣,埤頭鄉,8934,30845,16032,14813
2015/11/1,彰化縣,芳苑鄉,10128,34336,18178,16158
2015/11/1,彰化縣,大城鄉,5323,17525,9500,8025
2015/11/1,彰化縣,竹塘鄉,4628,15642,8268,7374
2015/11/1,彰化縣,溪州鄉,8911,30539,15994,14545
2015/11/1,南投縣,南投市,34493,101673,50997,50676
2015/11/1,南投縣,埔里鎮,28954,82254,41275,40979
2015/11/1,南投縣,草屯鎮,32751,98853,49970,48883
2015/11/1,南投縣,竹山鎮,20025,56083,28801,27282
2015/11/1,南投縣,集集鎮,4349,11222,5848,5374
2015/11/1,南投縣,名間鄉,12601,39691,20847,18844
2015/11/1,南投縣,鹿谷鄉,7690,18250,9717,8533
2015/11/1,南投縣,中寮鄉,5654,15360,8358,7002
2015/11/1,南投縣,魚池鄉,5750,16302,8541,7761
2015/11/1,南投縣,國姓鄉,7312,19388,10501,8887
2015/11/1,南投縣,水里鄉,7195,18357,9638,8719
2015/11/1,南投縣,信義鄉,5240,16540,8881,7659
2015/11/1,南投縣,仁愛鄉,4937,15765,8145,7620
2015/11/1,雲林縣,斗六市,37531,108320,54066,54254
2015/11/1,雲林縣,斗南鎮,15769,45623,23156,22467
2015/11/1,雲林縣,虎尾鎮,24377,70514,35793,34721
2015/11/1,雲林縣,西螺鎮,14482,46835,23790,23045
2015/11/1,雲林縣,土庫鎮,9217,29416,15369,14047
2015/11/1,雲林縣,北港鎮,15901,41032,21297,19735
2015/11/1,雲林縣,古坑鄉,10955,32348,17065,15283
2015/11/1,雲林縣,大埤鄉,6740,19759,10629,9130
2015/11/1,雲林縣,莿桐鄉,9247,29233,15364,13869
2015/11/1,雲林縣,林內鄉,5934,18699,9781,8918
2015/11/1,雲林縣,二崙鄉,8916,27958,14977,12981
2015/11/1,雲林縣,崙背鄉,8490,25477,13481,11996
2015/11/1,雲林縣,麥寮鄉,14001,44504,22507,21997
2015/11/1,雲林縣,東勢鄉,5732,15424,8485,6939
2015/11/1,雲林縣,褒忠鄉,4408,13357,7179,6178
2015/11/1,雲林縣,臺西鄉,8743,24581,13167,11414
2015/11/1,雲林縣,元長鄉,9367,26898,14690,12208
2015/11/1,雲林縣,四湖鄉,8902,24752,13442,11310
2015/11/1,雲林縣,口湖鄉,9598,28520,15152,13368
2015/11/1,雲林縣,水林鄉,10140,26543,14560,11983
2015/11/1,嘉義縣,太保市,12384,37202,19139,18063
2015/11/1,嘉義縣,朴子市,15552,42972,21792,21180
2015/11/1,嘉義縣,布袋鎮,10046,27974,14305,13669
2015/11/1,嘉義縣,大林鎮,11380,31713,16242,15471
2015/11/1,嘉義縣,民雄鄉,24382,71914,36818,35096
2015/11/1,嘉義縣,溪口鄉,5386,15104,8075,7029
2015/11/1,嘉義縣,新港鄉,10635,32831,17337,15494
2015/11/1,嘉義縣,六腳鄉,8985,24198,12866,11332
2015/11/1,嘉義縣,東石鄉,9372,25783,13664,12119
2015/11/1,嘉義縣,義竹鄉,7505,19267,10021,9246
2015/11/1,嘉義縣,鹿草鄉,5795,16129,8672,7457
2015/11/1,嘉義縣,水上鄉,17929,50461,26050,24411
2015/11/1,嘉義縣,中埔鄉,15965,45746,23775,21971
2015/11/1,嘉義縣,竹崎鄉,11697,36572,19539,17033
2015/11/1,嘉義縣,梅山鄉,6761,20033,10647,9386
2015/11/1,嘉義縣,番路鄉,4320,11880,6428,5452
2015/11/1,嘉義縣,大埔鄉,1946,4620,2408,2212
2015/11/1,嘉義縣,阿里山鄉,1963,5720,3026,2694
2015/11/1,屏東縣,屏東市,73702,202633,100575,102058
2015/11/1,屏東縣,潮州鎮,19158,54730,27412,27318
2015/11/1,屏東縣,東港鎮,16370,48086,24334,23752
2015/11/1,屏東縣,恆春鎮,11336,30887,15838,15049
2015/11/1,屏東縣,萬丹鄉,14797,51709,26762,24947
2015/11/1,屏東縣,長治鄉,10016,30303,15803,14500
2015/11/1,屏東縣,麟洛鄉,3753,11245,5838,5407
2015/11/1,屏東縣,九如鄉,6832,22090,11445,10645
2015/11/1,屏東縣,里港鄉,8142,26979,13731,13248
2015/11/1,屏東縣,鹽埔鄉,7833,26377,13715,12662
2015/11/1,屏東縣,高樹鄉,9375,25183,13399,11784
2015/11/1,屏東縣,萬巒鄉,6470,20760,10890,9870
2015/11/1,屏東縣,內埔鄉,18491,55674,28840,26834
2015/11/1,屏東縣,竹田鄉,5649,17576,9314,8262
2015/11/1,屏東縣,新埤鄉,3430,10065,5372,4693
2015/11/1,屏東縣,枋寮鄉,8531,25140,13183,11957
2015/11/1,屏東縣,新園鄉,11766,36248,18749,17499
2015/11/1,屏東縣,崁頂鄉,4459,16160,8214,7946
2015/11/1,屏東縣,林邊鄉,6941,18918,9710,9208
2015/11/1,屏東縣,南州鄉,3680,10867,5564,5303
2015/11/1,屏東縣,佳冬鄉,6981,19929,10361,9568
2015/11/1,屏東縣,琉球鄉,4335,12530,6889,5641
2015/11/1,屏東縣,車城鄉,3485,8937,4823,4114
2015/11/1,屏東縣,滿州鄉,3009,8017,4385,3632
2015/11/1,屏東縣,枋山鄉,2137,5660,3015,2645
2015/11/1,屏東縣,三地門鄉,2291,7704,3886,3818
2015/11/1,屏東縣,霧臺鄉,1055,3327,1704,1623
2015/11/1,屏東縣,瑪家鄉,2019,6773,3458,3315
2015/11/1,屏東縣,泰武鄉,1317,5217,2745,2472
2015/11/1,屏東縣,來義鄉,2236,7567,3846,3721
2015/11/1,屏東縣,春日鄉,1354,4797,2456,2341
2015/11/1,屏東縣,獅子鄉,1528,4818,2491,2327
2015/11/1,屏東縣,牡丹鄉,1860,4763,2450,2313
2015/11/1,臺東縣,臺東市,39289,106788,53666,53122
2015/11/1,臺東縣,成功鎮,5436,14690,7763,6927
2015/11/1,臺東縣,關山鎮,3200,8944,4700,4244
2015/11/1,臺東縣,卑南鄉,6669,17499,9274,8225
2015/11/1,臺東縣,大武鄉,2520,6334,3305,3029
2015/11/1,臺東縣,太麻里鄉,4624,11380,6050,5330
2015/11/1,臺東縣,東河鄉,3779,8861,4878,3983
2015/11/1,臺東縣,長濱鄉,2930,7591,4309,3282
2015/11/1,臺東縣,鹿野鄉,3085,8129,4355,3774
2015/11/1,臺東縣,池上鄉,3239,8503,4447,4056
2015/11/1,臺東縣,綠島鄉,1088,3790,1977,1813
2015/11/1,臺東縣,延平鄉,1071,3576,1910,1666
2015/11/1,臺東縣,海端鄉,1092,4333,2314,2019
2015/11/1,臺東縣,達仁鄉,1455,3589,1957,1632
2015/11/1,臺東縣,金峰鄉,1104,3587,1854,1733
2015/11/1,臺東縣,蘭嶼鄉,1784,5051,2553,2498
2015/11/1,花蓮縣,花蓮市,41474,105759,51282,54477
2015/11/1,花蓮縣,鳳林鎮,4406,11116,5819,5297
2015/11/1,花蓮縣,玉里鎮,8925,25050,13400,11650
2015/11/1,花蓮縣,新城鄉,7587,20191,10420,9771
2015/11/1,花蓮縣,吉安鄉,31497,83237,42176,41061
2015/11/1,花蓮縣,壽豐鄉,7060,18191,9712,8479
2015/11/1,花蓮縣,光復鄉,5025,13227,7040,6187
2015/11/1,花蓮縣,豐濱鄉,1722,4557,2532,2025
2015/11/1,花蓮縣,瑞穗鄉,4697,11935,6415,5520
2015/11/1,花蓮縣,富里鄉,4005,10645,5817,4828
2015/11/1,花蓮縣,秀林鄉,4774,15660,8093,7567
2015/11/1,花蓮縣,萬榮鄉,2083,6421,3391,3030
2015/11/1,花蓮縣,卓溪鄉,1675,6044,3327,2717
2015/11/1,澎湖縣,馬公市,23545,60914,31034,29880
2015/11/1,澎湖縣,湖西鄉,5434,14404,7631,6773
2015/11/1,澎湖縣,白沙鄉,3350,9714,5096,4618
2015/11/1,澎湖縣,西嶼鄉,2946,8426,4329,4097
2015/11/1,澎湖縣,望安鄉,1984,5100,2740,2360
2015/11/1,澎湖縣,七美鄉,1337,3759,1955,1804
2015/11/1,基隆市,中正區,22526,52757,27017,25740
2015/11/1,基隆市,七堵區,21128,54075,27344,26731
2015/11/1,基隆市,暖暖區,15431,38391,19339,19052
2015/11/1,基隆市,仁愛區,19371,45659,22545,23114
2015/11/1,基隆市,中山區,19272,48404,24610,23794
2015/11/1,基隆市,安樂區,32359,81347,40500,40847
2015/11/1,基隆市,信義區,20993,51593,25691,25902
2015/11/1,新竹市,東區,76384,207940,102473,105467
2015/11/1,新竹市,北區,54942,149088,73147,75941
2015/11/1,新竹市,香山區,26189,76746,39093,37653
2015/11/1,嘉義市,東區,45281,122912,59518,63394
2015/11/1,嘉義市,西區,53439,147503,72454,75049
2015/11/1,金門縣,金城鎮,12664,42283,21234,21049
2015/11/1,金門縣,金湖鎮,8569,28328,14276,14052
2015/11/1,金門縣,金沙鎮,6149,20065,9924,10141
2015/11/1,金門縣,金寧鄉,7943,28776,14537,14239
2015/11/1,金門縣,烈嶼鄉,3069,12416,6170,6246
2015/11/1,金門縣,烏坵鄉,133,664,331,333
2015/11/1,連江縣,南竿鄉,1450,7424,4207,3217
2015/11/1,連江縣,北竿鄉,492,2325,1290,1035
2015/11/1,連江縣,莒光鄉,278,1530,909,621
2015/11/1,連江縣,東引鄉,316,1267,766,501
2015/12/1,總計,新北市,1510900,3970644,1951355,2019289
2015/12/1,總計,臺北市,1043948,2704810,1295462,1409348
2015/12/1,總計,桃園市,750501,2105780,1053001,1052779
2015/12/1,總計,臺中市,927901,2744445,1357014,1387431
2015/12/1,總計,臺南市,672325,1885541,943804,941737
2015/12/1,總計,高雄市,1072939,2778918,1380989,1397929
2015/12/1,總計,臺灣省,2449328,7156590,3656660,3499930
2015/12/1,總計,宜蘭縣,164911,458117,232217,225900
2015/12/1,總計,新竹縣,183110,542042,277417,264625
2015/12/1,總計,苗栗縣,184363,563912,290726,273186
2015/12/1,總計,彰化縣,381888,1289072,658561,630511
2015/12/1,總計,南投縣,176988,509490,261379,248111
2015/12/1,總計,雲林縣,238485,699633,363832,335801
2015/12/1,總計,嘉義縣,181969,519839,270681,249158
2015/12/1,總計,屏東縣,284445,841253,430925,410328
2015/12/1,總計,臺東縣,82326,222452,115174,107278
2015/12/1,總計,花蓮縣,124956,331945,169335,162610
2015/12/1,總計,澎湖縣,38612,102304,52769,49535
2015/12/1,總計,基隆市,150987,372105,186942,185163
2015/12/1,總計,新竹市,157586,434060,214795,219265
2015/12/1,總計,嘉義市,98702,270366,131907,138459
2015/12/1,總計,福建省,41136,145346,73762,71584
2015/12/1,總計,金門縣,38588,132799,66591,66208
2015/12/1,總計,連江縣,2548,12547,7171,5376
2015/12/1,新北市,板橋區,205731,554236,271178,283058
2015/12/1,新北市,三重區,148489,388447,191757,196690
2015/12/1,新北市,中和區,163065,414304,202275,212029
2015/12/1,新北市,永和區,90705,225409,107181,118228
2015/12/1,新北市,新莊區,149116,413243,202452,210791
2015/12/1,新北市,新店區,123873,300267,145134,155133
2015/12/1,新北市,樹林區,65432,184249,92082,92167
2015/12/1,新北市,鶯歌區,29425,87965,44144,43821
2015/12/1,新北市,三峽區,41141,112708,56701,56007
2015/12/1,新北市,淡水區,70294,162221,78033,84188
2015/12/1,新北市,汐止區,85024,196028,95902,100126
2015/12/1,新北市,瑞芳區,16142,40976,20708,20268
2015/12/1,新北市,土城區,85968,238703,118153,120550
2015/12/1,新北市,蘆洲區,69521,200095,98555,101540
2015/12/1,新北市,五股區,29946,82923,41842,41081
2015/12/1,新北市,泰山區,27996,78707,39152,39555
2015/12/1,新北市,林口區,39143,100350,49125,51225
2015/12/1,新北市,深坑區,9458,23594,11811,11783
2015/12/1,新北市,石碇區,3372,7855,4336,3519
2015/12/1,新北市,坪林區,2495,6490,3618,2872
2015/12/1,新北市,三芝區,9371,23487,12098,11389
2015/12/1,新北市,石門區,4311,12641,6550,6091
2015/12/1,新北市,八里區,14017,37678,18814,18864
2015/12/1,新北市,平溪區,2352,4874,2691,2183
2015/12/1,新北市,雙溪區,3840,9245,4995,4250
2015/12/1,新北市,貢寮區,4402,12860,6560,6300
2015/12/1,新北市,金山區,7024,22260,11024,11236
2015/12/1,新北市,萬里區,7416,22642,11412,11230
2015/12/1,新北市,烏來區,1831,6187,3072,3115
2015/12/1,臺北市,松山區,80293,209714,98853,110861
2015/12/1,臺北市,信義區,89546,229211,109806,119405
2015/12/1,臺北市,大安區,120402,313058,146483,166575
2015/12/1,臺北市,中山區,99158,231350,107979,123371
2015/12/1,臺北市,中正區,65296,162475,77598,84877
2015/12/1,臺北市,大同區,51516,130929,63996,66933
2015/12/1,臺北市,萬華區,78316,194339,95916,98423
2015/12/1,臺北市,文山區,104415,275367,132457,142910
2015/12/1,臺北市,南港區,46428,122245,59710,62535
2015/12/1,臺北市,內湖區,106545,287566,137719,149847
2015/12/1,臺北市,士林區,106323,290694,140453,150241
2015/12/1,臺北市,北投區,95710,257862,124492,133370
2015/12/1,桃園市,桃園區,159731,427145,208038,219107
2015/12/1,桃園市,中壢區,141551,389782,192765,197017
2015/12/1,桃園市,大溪區,31456,93343,47861,45482
2015/12/1,桃園市,楊梅區,55072,161098,81505,79593
2015/12/1,桃園市,蘆竹區,55315,155403,77458,77945
2015/12/1,桃園市,大園區,30549,85565,43953,41612
2015/12/1,桃園市,龜山區,55547,145580,73047,72533
2015/12/1,桃園市,八德區,65893,187420,94315,93105
2015/12/1,桃園市,龍潭區,40095,118433,59636,58797
2015/12/1,桃園市,平鎮區,74198,217887,108707,109180
2015/12/1,桃園市,新屋區,15751,48409,25884,22525
2015/12/1,桃園市,觀音區,21614,64785,33849,30936
2015/12/1,桃園市,復興區,3729,10930,5983,4947
2015/12/1,臺中市,中區,7879,19020,9501,9519
2015/12/1,臺中市,東區,27381,75182,37544,37638
2015/12/1,臺中市,南區,46738,121786,58656,63130
2015/12/1,臺中市,西區,45057,115693,55080,60613
2015/12/1,臺中市,北區,58528,147547,70773,76774
2015/12/1,臺中市,西屯區,82387,221785,106891,114894
2015/12/1,臺中市,南屯區,59732,164575,78850,85725
2015/12/1,臺中市,北屯區,94794,265159,127599,137560
2015/12/1,臺中市,豐原區,52663,166749,82566,84183
2015/12/1,臺中市,東勢區,17306,51308,26446,24862
2015/12/1,臺中市,大甲區,22718,77714,39171,38543
2015/12/1,臺中市,清水區,26452,86146,44291,41855
2015/12/1,臺中市,沙鹿區,27988,89592,45399,44193
2015/12/1,臺中市,梧棲區,17179,57108,28755,28353
2015/12/1,臺中市,后里區,15707,54344,27633,26711
2015/12/1,臺中市,神岡區,18921,65178,33338,31840
2015/12/1,臺中市,潭子區,35466,106557,52838,53719
2015/12/1,臺中市,大雅區,28428,93661,46816,46845
2015/12/1,臺中市,新社區,7512,25086,13062,12024
2015/12/1,臺中市,石岡區,4901,15295,7948,7347
2015/12/1,臺中市,外埔區,9414,31899,16375,15524
2015/12/1,臺中市,大安區,5413,19542,10318,9224
2015/12/1,臺中市,烏日區,23158,72514,36517,35997
2015/12/1,臺中市,大肚區,17020,56627,29011,27616
2015/12/1,臺中市,龍井區,22343,76666,38812,37854
2015/12/1,臺中市,霧峰區,19724,64657,32906,31751
2015/12/1,臺中市,太平區,61055,183923,91503,92420
2015/12/1,臺中市,大里區,67607,208406,102662,105744
2015/12/1,臺中市,和平區,4430,10726,5753,4973
2015/12/1,臺南市,新營區,28669,78165,38706,39459
2015/12/1,臺南市,鹽水區,10092,26085,13628,12457
2015/12/1,臺南市,白河區,10924,29271,15323,13948
2015/12/1,臺南市,柳營區,7841,21629,11295,10334
2015/12/1,臺南市,後壁區,8907,24329,12638,11691
2015/12/1,臺南市,東山區,8242,21603,11482,10121
2015/12/1,臺南市,麻豆區,15584,44987,22844,22143
2015/12/1,臺南市,下營區,9099,24786,12768,12018
2015/12/1,臺南市,六甲區,7730,22586,11673,10913
2015/12/1,臺南市,官田區,7854,21685,11096,10589
2015/12/1,臺南市,大內區,3907,10054,5393,4661
2015/12/1,臺南市,佳里區,20403,59555,29542,30013
2015/12/1,臺南市,學甲區,9665,26652,13645,13007
2015/12/1,臺南市,西港區,8115,24921,12617,12304
2015/12/1,臺南市,七股區,8069,23365,12128,11237
2015/12/1,臺南市,將軍區,7311,20309,10343,9966
2015/12/1,臺南市,北門區,4319,11527,5823,5704
2015/12/1,臺南市,新化區,14294,43828,22366,21462
2015/12/1,臺南市,善化區,16803,46933,23695,23238
2015/12/1,臺南市,新市區,11746,35853,18018,17835
2015/12/1,臺南市,安定區,9876,30331,15560,14771
2015/12/1,臺南市,山上區,2678,7437,3889,3548
2015/12/1,臺南市,玉井區,5110,14388,7472,6916
2015/12/1,臺南市,楠西區,3538,10032,5318,4714
2015/12/1,臺南市,南化區,2859,8893,4810,4083
2015/12/1,臺南市,左鎮區,1990,5071,2841,2230
2015/12/1,臺南市,仁德區,26859,73887,37590,36297
2015/12/1,臺南市,歸仁區,22252,67906,34503,33403
2015/12/1,臺南市,關廟區,10974,34719,17939,16780
2015/12/1,臺南市,龍崎區,1567,4196,2271,1925
2015/12/1,臺南市,永康區,81796,230806,113945,116861
2015/12/1,臺南市,東區,71744,188865,90780,98085
2015/12/1,臺南市,南區,44941,125738,62473,63265
2015/12/1,臺南市,北區,49896,132651,64782,67869
2015/12/1,臺南市,安南區,61064,189620,95852,93768
2015/12/1,臺南市,安平區,24836,65380,31065,34315
2015/12/1,臺南市,中西區,30771,77498,37691,39807
2015/12/1,高雄市,鹽埕區,10833,25032,12458,12574
2015/12/1,高雄市,鼓山區,56184,136665,66270,70395
2015/12/1,高雄市,左營區,77616,196244,94865,101379
2015/12/1,高雄市,楠梓區,67419,179931,88660,91271
2015/12/1,高雄市,三民區,135265,346169,168063,178106
2015/12/1,高雄市,新興區,22684,51955,25061,26894
2015/12/1,高雄市,前金區,12547,27388,13192,14196
2015/12/1,高雄市,苓雅區,72263,174515,84324,90191
2015/12/1,高雄市,前鎮區,78388,192593,94900,97693
2015/12/1,高雄市,旗津區,11054,29008,15043,13965
2015/12/1,高雄市,小港區,66516,156256,77842,78414
2015/12/1,高雄市,鳳山區,137162,356320,175150,181170
2015/12/1,高雄市,林園區,25559,70401,35727,34674
2015/12/1,高雄市,大寮區,41360,111663,57346,54317
2015/12/1,高雄市,大樹區,13403,43161,22181,20980
2015/12/1,高雄市,大社區,12735,34566,17593,16973
2015/12/1,高雄市,仁武區,31183,82614,42119,40495
2015/12/1,高雄市,鳥松區,17746,43965,22353,21612
2015/12/1,高雄市,岡山區,34654,97827,48635,49192
2015/12/1,高雄市,橋頭區,13268,37317,19002,18315
2015/12/1,高雄市,燕巢區,10395,30124,15956,14168
2015/12/1,高雄市,田寮區,3360,7473,4151,3322
2015/12/1,高雄市,阿蓮區,9361,29319,14777,14542
2015/12/1,高雄市,路竹區,16818,53033,27086,25947
2015/12/1,高雄市,湖內區,10571,29615,15129,14486
2015/12/1,高雄市,茄萣區,10473,30551,15791,14760
2015/12/1,高雄市,永安區,5743,14152,7097,7055
2015/12/1,高雄市,彌陀區,6754,19655,10154,9501
2015/12/1,高雄市,梓官區,12567,36429,18829,17600
2015/12/1,高雄市,旗山區,13862,37770,19576,18194
2015/12/1,高雄市,美濃區,14552,40810,21410,19400
2015/12/1,高雄市,六龜區,5639,13467,7261,6206
2015/12/1,高雄市,甲仙區,2362,6291,3341,2950
2015/12/1,高雄市,杉林區,4805,12383,6765,5618
2015/12/1,高雄市,內門區,5074,14978,8100,6878
2015/12/1,高雄市,茂林區,582,1890,932,958
2015/12/1,高雄市,桃源區,1324,4239,2221,2018
2015/12/1,高雄市,那瑪夏區,858,3149,1629,1520
2015/12/1,宜蘭縣,宜蘭市,35640,96051,46907,49144
2015/12/1,宜蘭縣,羅東鎮,26044,72404,34420,37984
2015/12/1,宜蘭縣,蘇澳鎮,14078,40726,20760,19966
2015/12/1,宜蘭縣,頭城鎮,10140,29798,15376,14422
2015/12/1,宜蘭縣,礁溪鄉,13574,35838,18711,17127
2015/12/1,宜蘭縣,壯圍鄉,8529,24258,12837,11421
2015/12/1,宜蘭縣,員山鄉,11500,32277,17123,15154
2015/12/1,宜蘭縣,冬山鄉,18866,53634,27573,26061
2015/12/1,宜蘭縣,五結鄉,14422,39559,20476,19083
2015/12/1,宜蘭縣,三星鄉,8317,21441,11563,9878
2015/12/1,宜蘭縣,大同鄉,1886,6080,3300,2780
2015/12/1,宜蘭縣,南澳鄉,1915,6051,3171,2880
2015/12/1,新竹縣,竹北市,60662,170790,85135,85655
2015/12/1,新竹縣,關西鎮,9535,29936,16005,13931
2015/12/1,新竹縣,新埔鎮,10680,34111,18173,15938
2015/12/1,新竹縣,竹東鎮,32817,96311,48375,47936
2015/12/1,新竹縣,湖口鄉,25675,77280,39267,38013
2015/12/1,新竹縣,橫山鄉,4490,13515,7337,6178
2015/12/1,新竹縣,新豐鄉,17783,56125,28779,27346
2015/12/1,新竹縣,芎林鄉,6475,20284,10757,9527
2015/12/1,新竹縣,寶山鄉,5184,14325,7739,6586
2015/12/1,新竹縣,北埔鄉,3134,9691,5232,4459
2015/12/1,新竹縣,峨眉鄉,2080,5642,3119,2523
2015/12/1,新竹縣,尖石鄉,2853,9417,4982,4435
2015/12/1,新竹縣,五峰鄉,1742,4615,2517,2098
2015/12/1,苗栗縣,苗栗市,30730,90469,45204,45265
2015/12/1,苗栗縣,頭份市,33544,103239,52104,51135
2015/12/1,苗栗縣,苑裡鎮,14467,47849,24841,23008
2015/12/1,苗栗縣,通霄鎮,11567,36172,19076,17096
2015/12/1,苗栗縣,竹南鎮,27842,84469,42634,41835
2015/12/1,苗栗縣,後龍鎮,11858,37837,19939,17898
2015/12/1,苗栗縣,卓蘭鎮,6122,18057,9440,8617
2015/12/1,苗栗縣,大湖鄉,5430,15276,8117,7159
2015/12/1,苗栗縣,公館鄉,10618,34536,17990,16546
2015/12/1,苗栗縣,銅鑼鄉,6144,18710,9910,8800
2015/12/1,苗栗縣,南庄鄉,3978,10577,5818,4759
2015/12/1,苗栗縣,頭屋鄉,3663,11236,5932,5304
2015/12/1,苗栗縣,三義鄉,5481,17020,8932,8088
2015/12/1,苗栗縣,西湖鄉,2678,7466,4149,3317
2015/12/1,苗栗縣,造橋鄉,4138,13354,7005,6349
2015/12/1,苗栗縣,三灣鄉,2412,6994,3831,3163
2015/12/1,苗栗縣,獅潭鄉,1729,4606,2566,2040
2015/12/1,苗栗縣,泰安鄉,1962,6045,3238,2807
2015/12/1,彰化縣,彰化市,75469,235010,116336,118674
2015/12/1,彰化縣,員林市,38712,124837,62218,62619
2015/12/1,彰化縣,鹿港鎮,24068,86407,43998,42409
2015/12/1,彰化縣,和美鎮,26305,91113,46521,44592
2015/12/1,彰化縣,北斗鎮,10528,33225,16770,16455
2015/12/1,彰化縣,溪湖鎮,16080,55742,28349,27393
2015/12/1,彰化縣,田中鎮,13034,42490,21971,20519
2015/12/1,彰化縣,二林鎮,14855,51882,26750,25132
2015/12/1,彰化縣,線西鄉,4331,17040,8809,8231
2015/12/1,彰化縣,伸港鄉,9639,36464,18643,17821
2015/12/1,彰化縣,福興鄉,12572,47618,24823,22795
2015/12/1,彰化縣,秀水鄉,10511,39352,20352,19000
2015/12/1,彰化縣,花壇鄉,13826,45984,23656,22328
2015/12/1,彰化縣,芬園鄉,6873,24003,12632,11371
2015/12/1,彰化縣,大村鄉,10877,36531,18938,17593
2015/12/1,彰化縣,埔鹽鄉,9005,32954,17313,15641
2015/12/1,彰化縣,埔心鄉,10403,34833,17950,16883
2015/12/1,彰化縣,永靖鄉,10849,37985,19764,18221
2015/12/1,彰化縣,社頭鄉,12784,43492,22337,21155
2015/12/1,彰化縣,二水鄉,5335,15629,8183,7446
2015/12/1,彰化縣,田尾鄉,7893,27567,14268,13299
2015/12/1,彰化縣,埤頭鄉,8944,30869,16039,14830
2015/12/1,彰化縣,芳苑鄉,10136,34352,18177,16175
2015/12/1,彰化縣,大城鄉,5319,17516,9499,8017
2015/12/1,彰化縣,竹塘鄉,4630,15638,8262,7376
2015/12/1,彰化縣,溪州鄉,8910,30539,16003,14536
2015/12/1,南投縣,南投市,34490,101622,50992,50630
2015/12/1,南投縣,埔里鎮,28955,82212,41233,40979
2015/12/1,南投縣,草屯鎮,32776,98837,49957,48880
2015/12/1,南投縣,竹山鎮,20041,56053,28781,27272
2015/12/1,南投縣,集集鎮,4349,11229,5848,5381
2015/12/1,南投縣,名間鄉,12592,39666,20835,18831
2015/12/1,南投縣,鹿谷鄉,7696,18234,9704,8530
2015/12/1,南投縣,中寮鄉,5656,15353,8351,7002
2015/12/1,南投縣,魚池鄉,5758,16289,8534,7755
2015/12/1,南投縣,國姓鄉,7309,19360,10487,8873
2015/12/1,南投縣,水里鄉,7194,18339,9629,8710
2015/12/1,南投縣,信義鄉,5238,16525,8875,7650
2015/12/1,南投縣,仁愛鄉,4934,15771,8153,7618
2015/12/1,雲林縣,斗六市,37558,108359,54065,54294
2015/12/1,雲林縣,斗南鎮,15774,45590,23151,22439
2015/12/1,雲林縣,虎尾鎮,24381,70551,35806,34745
2015/12/1,雲林縣,西螺鎮,14483,46840,23787,23053
2015/12/1,雲林縣,土庫鎮,9224,29401,15368,14033
2015/12/1,雲林縣,北港鎮,15903,41006,21297,19709
2015/12/1,雲林縣,古坑鄉,10946,32326,17048,15278
2015/12/1,雲林縣,大埤鄉,6741,19727,10616,9111
2015/12/1,雲林縣,莿桐鄉,9256,29232,15363,13869
2015/12/1,雲林縣,林內鄉,5927,18664,9766,8898
2015/12/1,雲林縣,二崙鄉,8923,27939,14953,12986
2015/12/1,雲林縣,崙背鄉,8498,25469,13473,11996
2015/12/1,雲林縣,麥寮鄉,14009,44600,22545,22055
2015/12/1,雲林縣,東勢鄉,5730,15391,8465,6926
2015/12/1,雲林縣,褒忠鄉,4406,13349,7172,6177
2015/12/1,雲林縣,臺西鄉,8739,24576,13172,11404
2015/12/1,雲林縣,元長鄉,9362,26857,14667,12190
2015/12/1,雲林縣,四湖鄉,8905,24742,13444,11298
2015/12/1,雲林縣,口湖鄉,9586,28489,15130,13359
2015/12/1,雲林縣,水林鄉,10134,26525,14544,11981
2015/12/1,嘉義縣,太保市,12381,37212,19146,18066
2015/12/1,嘉義縣,朴子市,15548,42956,21776,21180
2015/12/1,嘉義縣,布袋鎮,10041,27954,14300,13654
2015/12/1,嘉義縣,大林鎮,11378,31697,16244,15453
2015/12/1,嘉義縣,民雄鄉,24391,71862,36795,35067
2015/12/1,嘉義縣,溪口鄉,5387,15113,8073,7040
2015/12/1,嘉義縣,新港鄉,10637,32797,17311,15486
2015/12/1,嘉義縣,六腳鄉,8985,24202,12860,11342
2015/12/1,嘉義縣,東石鄉,9366,25751,13653,12098
2015/12/1,嘉義縣,義竹鄉,7504,19258,10011,9247
2015/12/1,嘉義縣,鹿草鄉,5795,16119,8666,7453
2015/12/1,嘉義縣,水上鄉,17926,50431,26054,24377
2015/12/1,嘉義縣,中埔鄉,15951,45724,23776,21948
2015/12/1,嘉義縣,竹崎鄉,11693,36546,19522,17024
2015/12/1,嘉義縣,梅山鄉,6763,20010,10644,9366
2015/12/1,嘉義縣,番路鄉,4314,11865,6416,5449
2015/12/1,嘉義縣,大埔鄉,1942,4621,2408,2213
2015/12/1,嘉義縣,阿里山鄉,1967,5721,3026,2695
2015/12/1,屏東縣,屏東市,73749,202562,100507,102055
2015/12/1,屏東縣,潮州鎮,19174,54719,27391,27328
2015/12/1,屏東縣,東港鎮,16377,48058,24299,23759
2015/12/1,屏東縣,恆春鎮,11345,30874,15826,15048
2015/12/1,屏東縣,萬丹鄉,14808,51647,26740,24907
2015/12/1,屏東縣,長治鄉,10017,30305,15792,14513
2015/12/1,屏東縣,麟洛鄉,3753,11231,5839,5392
2015/12/1,屏東縣,九如鄉,6838,22090,11444,10646
2015/12/1,屏東縣,里港鄉,8151,27040,13755,13285
2015/12/1,屏東縣,鹽埔鄉,7828,26361,13705,12656
2015/12/1,屏東縣,高樹鄉,9367,25163,13384,11779
2015/12/1,屏東縣,萬巒鄉,6479,20765,10884,9881
2015/12/1,屏東縣,內埔鄉,18509,55644,28835,26809
2015/12/1,屏東縣,竹田鄉,5650,17544,9299,8245
2015/12/1,屏東縣,新埤鄉,3423,10058,5367,4691
2015/12/1,屏東縣,枋寮鄉,8530,25120,13174,11946
2015/12/1,屏東縣,新園鄉,11769,36217,18736,17481
2015/12/1,屏東縣,崁頂鄉,4457,16155,8206,7949
2015/12/1,屏東縣,林邊鄉,6927,18896,9699,9197
2015/12/1,屏東縣,南州鄉,3681,10857,5568,5289
2015/12/1,屏東縣,佳冬鄉,6980,19905,10351,9554
2015/12/1,屏東縣,琉球鄉,4346,12517,6876,5641
2015/12/1,屏東縣,車城鄉,3483,8917,4810,4107
2015/12/1,屏東縣,滿州鄉,3006,7999,4382,3617
2015/12/1,屏東縣,枋山鄉,2139,5644,3007,2637
2015/12/1,屏東縣,三地門鄉,2292,7701,3883,3818
2015/12/1,屏東縣,霧臺鄉,1056,3329,1706,1623
2015/12/1,屏東縣,瑪家鄉,2017,6769,3458,3311
2015/12/1,屏東縣,泰武鄉,1314,5217,2749,2468
2015/12/1,屏東縣,來義鄉,2235,7570,3854,3716
2015/12/1,屏東縣,春日鄉,1355,4806,2464,2342
2015/12/1,屏東縣,獅子鄉,1527,4806,2485,2321
2015/12/1,屏東縣,牡丹鄉,1863,4767,2450,2317
2015/12/1,臺東縣,臺東市,39285,106759,53641,53118
2015/12/1,臺東縣,成功鎮,5436,14652,7745,6907
2015/12/1,臺東縣,關山鎮,3196,8923,4685,4238
2015/12/1,臺東縣,卑南鄉,6662,17507,9278,8229
2015/12/1,臺東縣,大武鄉,2514,6324,3304,3020
2015/12/1,臺東縣,太麻里鄉,4626,11374,6042,5332
2015/12/1,臺東縣,東河鄉,3771,8847,4867,3980
2015/12/1,臺東縣,長濱鄉,2926,7579,4298,3281
2015/12/1,臺東縣,鹿野鄉,3082,8107,4336,3771
2015/12/1,臺東縣,池上鄉,3234,8488,4441,4047
2015/12/1,臺東縣,綠島鄉,1088,3775,1972,1803
2015/12/1,臺東縣,延平鄉,1076,3575,1907,1668
2015/12/1,臺東縣,海端鄉,1090,4322,2303,2019
2015/12/1,臺東縣,達仁鄉,1453,3589,1956,1633
2015/12/1,臺東縣,金峰鄉,1103,3586,1853,1733
2015/12/1,臺東縣,蘭嶼鄉,1784,5045,2546,2499
2015/12/1,花蓮縣,花蓮市,41454,105724,51230,54494
2015/12/1,花蓮縣,鳳林鎮,4407,11115,5816,5299
2015/12/1,花蓮縣,玉里鎮,8920,25013,13378,11635
2015/12/1,花蓮縣,新城鄉,7610,20216,10438,9778
2015/12/1,花蓮縣,吉安鄉,31504,83240,42170,41070
2015/12/1,花蓮縣,壽豐鄉,7057,18195,9717,8478
2015/12/1,花蓮縣,光復鄉,5031,13219,7031,6188
2015/12/1,花蓮縣,豐濱鄉,1723,4541,2526,2015
2015/12/1,花蓮縣,瑞穗鄉,4708,11926,6416,5510
2015/12/1,花蓮縣,富里鄉,4012,10633,5806,4827
2015/12/1,花蓮縣,秀林鄉,4774,15666,8098,7568
2015/12/1,花蓮縣,萬榮鄉,2082,6420,3387,3033
2015/12/1,花蓮縣,卓溪鄉,1674,6037,3322,2715
2015/12/1,澎湖縣,馬公市,23563,60924,31029,29895
2015/12/1,澎湖縣,湖西鄉,5444,14413,7643,6770
2015/12/1,澎湖縣,白沙鄉,3347,9710,5091,4619
2015/12/1,澎湖縣,西嶼鄉,2945,8417,4322,4095
2015/12/1,澎湖縣,望安鄉,1979,5091,2734,2357
2015/12/1,澎湖縣,七美鄉,1334,3749,1950,1799
2015/12/1,基隆市,中正區,22491,52710,26994,25716
2015/12/1,基隆市,七堵區,21116,54060,27305,26755
2015/12/1,基隆市,暖暖區,15423,38379,19323,19056
2015/12/1,基隆市,仁愛區,19364,45626,22525,23101
2015/12/1,基隆市,中山區,19260,48397,24620,23777
2015/12/1,基隆市,安樂區,32341,81329,40477,40852
2015/12/1,基隆市,信義區,20992,51604,25698,25906
2015/12/1,新竹市,東區,76442,208142,102564,105578
2015/12/1,新竹市,北區,54943,149156,73131,76025
2015/12/1,新竹市,香山區,26201,76762,39100,37662
2015/12/1,嘉義市,東區,45274,122900,59486,63414
2015/12/1,嘉義市,西區,53428,147466,72421,75045
2015/12/1,金門縣,金城鎮,12681,42344,21255,21089
2015/12/1,金門縣,金湖鎮,8584,28402,14314,14088
2015/12/1,金門縣,金沙鎮,6160,20107,9952,10155
2015/12/1,金門縣,金寧鄉,7957,28833,14552,14281
2015/12/1,金門縣,烈嶼鄉,3073,12450,6187,6263
2015/12/1,金門縣,烏坵鄉,133,663,331,332
2015/12/1,連江縣,南竿鄉,1458,7409,4197,3212
2015/12/1,連江縣,北竿鄉,496,2333,1291,1042
2015/12/1,連江縣,莒光鄉,279,1535,915,620
2015/12/1,連江縣,東引鄉,315,1270,768,502
2016/1/1,總計,新北市,1511307,3971250,1951393,2019857
2016/1/1,總計,臺北市,1043859,2704974,1295411,1409563
2016/1/1,總計,桃園市,751269,2108786,1054308,1054478
2016/1/1,總計,臺中市,928435,2746112,1357629,1388483
2016/1/1,總計,臺南市,672518,1885550,943812,941738
2016/1/1,總計,高雄市,1073237,2778729,1380719,1398010
2016/1/1,總計,臺灣省,2449709,7155139,3655634,3499505
2016/1/1,總計,宜蘭縣,164945,458037,232193,225844
2016/1/1,總計,新竹縣,183398,542513,277668,264845
2016/1/1,總計,苗栗縣,184382,563489,290511,272978
2016/1/1,總計,彰化縣,382003,1289295,658567,630728
2016/1/1,總計,南投縣,176985,509162,261191,247971
2016/1/1,總計,雲林縣,238458,699236,363630,335606
2016/1/1,總計,嘉義縣,181964,519482,270465,249017
2016/1/1,總計,屏東縣,284562,840931,430749,410182
2016/1/1,總計,臺東縣,82307,222244,115058,107186
2016/1/1,總計,花蓮縣,124899,331845,169242,162603
2016/1/1,總計,澎湖縣,38632,102355,52795,49560
2016/1/1,總計,基隆市,150911,372019,186874,185145
2016/1/1,總計,新竹市,157640,434258,214871,219387
2016/1/1,總計,嘉義市,98623,270273,131820,138453
2016/1/1,總計,福建省,41209,145528,73858,71670
2016/1/1,總計,金門縣,38644,132995,66687,66308
2016/1/1,總計,連江縣,2565,12533,7171,5362
2016/1/1,新北市,板橋區,205664,554008,271044,282964
2016/1/1,新北市,三重區,148541,388386,191726,196660
2016/1/1,新北市,中和區,163074,414356,202228,212128
2016/1/1,新北市,永和區,90684,225353,107156,118197
2016/1/1,新北市,新莊區,149167,413443,202520,210923
2016/1/1,新北市,新店區,123906,300283,145133,155150
2016/1/1,新北市,樹林區,65445,184329,92116,92213
2016/1/1,新北市,鶯歌區,29448,87931,44119,43812
2016/1/1,新北市,三峽區,41190,112775,56730,56045
2016/1/1,新北市,淡水區,70441,162441,78135,84306
2016/1/1,新北市,汐止區,85046,196150,95934,100216
2016/1/1,新北市,瑞芳區,16127,40922,20672,20250
2016/1/1,新北市,土城區,85921,238646,118093,120553
2016/1/1,新北市,蘆洲區,69513,200055,98531,101524
2016/1/1,新北市,五股區,29996,82983,41851,41132
2016/1/1,新北市,泰山區,28018,78801,39194,39607
2016/1/1,新北市,林口區,39211,100554,49226,51328
2016/1/1,新北市,深坑區,9463,23614,11828,11786
2016/1/1,新北市,石碇區,3375,7857,4332,3525
2016/1/1,新北市,坪林區,2496,6503,3626,2877
2016/1/1,新北市,三芝區,9360,23452,12080,11372
2016/1/1,新北市,石門區,4312,12645,6554,6091
2016/1/1,新北市,八里區,14035,37711,18814,18897
2016/1/1,新北市,平溪區,2351,4872,2693,2179
2016/1/1,新北市,雙溪區,3843,9233,4989,4244
2016/1/1,新北市,貢寮區,4406,12858,6557,6301
2016/1/1,新北市,金山區,7035,22273,11030,11243
2016/1/1,新北市,萬里區,7406,22634,11408,11226
2016/1/1,新北市,烏來區,1833,6182,3074,3108
2016/1/1,臺北市,松山區,80250,209689,98839,110850
2016/1/1,臺北市,信義區,89499,229139,109759,119380
2016/1/1,臺北市,大安區,120378,312909,146372,166537
2016/1/1,臺北市,中山區,99113,231286,107949,123337
2016/1/1,臺北市,中正區,65275,162549,77655,84894
2016/1/1,臺北市,大同區,51522,131029,64002,67027
2016/1/1,臺北市,萬華區,78341,194314,95882,98432
2016/1/1,臺北市,文山區,104436,275433,132491,142942
2016/1/1,臺北市,南港區,46452,122296,59733,62563
2016/1/1,臺北市,內湖區,106574,287726,137766,149960
2016/1/1,臺北市,士林區,106295,290682,140438,150244
2016/1/1,臺北市,北投區,95724,257922,124525,133397
2016/1/1,桃園市,桃園區,159880,427815,208350,219465
2016/1/1,桃園市,中壢區,141647,390251,192934,197317
2016/1/1,桃園市,大溪區,31458,93388,47865,45523
2016/1/1,桃園市,楊梅區,55130,161301,81593,79708
2016/1/1,桃園市,蘆竹區,55383,155626,77564,78062
2016/1/1,桃園市,大園區,30584,85667,43979,41688
2016/1/1,桃園市,龜山區,55575,145706,73089,72617
2016/1/1,桃園市,八德區,65995,187848,94546,93302
2016/1/1,桃園市,龍潭區,40188,118648,59728,58920
2016/1/1,桃園市,平鎮區,74267,218290,108876,109414
2016/1/1,桃園市,新屋區,15763,48469,25917,22552
2016/1/1,桃園市,觀音區,21675,64845,33885,30960
2016/1/1,桃園市,復興區,3724,10932,5982,4950
2016/1/1,臺中市,中區,7879,19020,9491,9529
2016/1/1,臺中市,東區,27360,75171,37534,37637
2016/1/1,臺中市,南區,46742,121865,58682,63183
2016/1/1,臺中市,西區,45081,115798,55105,60693
2016/1/1,臺中市,北區,58539,147570,70812,76758
2016/1/1,臺中市,西屯區,82461,221942,106902,115040
2016/1/1,臺中市,南屯區,59720,164647,78865,85782
2016/1/1,臺中市,北屯區,94922,265497,127774,137723
2016/1/1,臺中市,豐原區,52654,166729,82528,84201
2016/1/1,臺中市,東勢區,17292,51244,26411,24833
2016/1/1,臺中市,大甲區,22720,77765,39205,38560
2016/1/1,臺中市,清水區,26459,86131,44270,41861
2016/1/1,臺中市,沙鹿區,28061,89783,45481,44302
2016/1/1,臺中市,梧棲區,17196,57159,28769,28390
2016/1/1,臺中市,后里區,15710,54313,27608,26705
2016/1/1,臺中市,神岡區,18915,65210,33343,31867
2016/1/1,臺中市,潭子區,35473,106613,52871,53742
2016/1/1,臺中市,大雅區,28453,93751,46855,46896
2016/1/1,臺中市,新社區,7505,25077,13052,12025
2016/1/1,臺中市,石岡區,4900,15277,7941,7336
2016/1/1,臺中市,外埔區,9422,31868,16358,15510
2016/1/1,臺中市,大安區,5408,19533,10311,9222
2016/1/1,臺中市,烏日區,23196,72590,36582,36008
2016/1/1,臺中市,大肚區,17030,56654,29004,27650
2016/1/1,臺中市,龍井區,22354,76696,38826,37870
2016/1/1,臺中市,霧峰區,19739,64708,32934,31774
2016/1/1,臺中市,太平區,61150,184223,91629,92594
2016/1/1,臺中市,大里區,67662,208571,102755,105816
2016/1/1,臺中市,和平區,4432,10707,5731,4976
2016/1/1,臺南市,新營區,28681,78185,38726,39459
2016/1/1,臺南市,鹽水區,10087,26087,13631,12456
2016/1/1,臺南市,白河區,10922,29236,15308,13928
2016/1/1,臺南市,柳營區,7833,21601,11281,10320
2016/1/1,臺南市,後壁區,8896,24279,12603,11676
2016/1/1,臺南市,東山區,8248,21568,11452,10116
2016/1/1,臺南市,麻豆區,15594,44963,22830,22133
2016/1/1,臺南市,下營區,9091,24755,12757,11998
2016/1/1,臺南市,六甲區,7732,22582,11667,10915
2016/1/1,臺南市,官田區,7838,21659,11084,10575
2016/1/1,臺南市,大內區,3909,10057,5383,4674
2016/1/1,臺南市,佳里區,20409,59544,29528,30016
2016/1/1,臺南市,學甲區,9655,26621,13627,12994
2016/1/1,臺南市,西港區,8114,24898,12602,12296
2016/1/1,臺南市,七股區,8065,23378,12112,11266
2016/1/1,臺南市,將軍區,7304,20286,10332,9954
2016/1/1,臺南市,北門區,4318,11517,5828,5689
2016/1/1,臺南市,新化區,14292,43830,22361,21469
2016/1/1,臺南市,善化區,16815,46931,23702,23229
2016/1/1,臺南市,新市區,11764,35883,18039,17844
2016/1/1,臺南市,安定區,9866,30327,15554,14773
2016/1/1,臺南市,山上區,2676,7422,3882,3540
2016/1/1,臺南市,玉井區,5111,14387,7465,6922
2016/1/1,臺南市,楠西區,3535,10020,5311,4709
2016/1/1,臺南市,南化區,2863,8881,4802,4079
2016/1/1,臺南市,左鎮區,1992,5065,2837,2228
2016/1/1,臺南市,仁德區,26896,73951,37623,36328
2016/1/1,臺南市,歸仁區,22262,67922,34523,33399
2016/1/1,臺南市,關廟區,10964,34693,17922,16771
2016/1/1,臺南市,龍崎區,1566,4195,2269,1926
2016/1/1,臺南市,永康區,81874,230957,114028,116929
2016/1/1,臺南市,東區,71757,188797,90756,98041
2016/1/1,臺南市,南區,44947,125734,62471,63263
2016/1/1,臺南市,北區,49929,132713,64829,67884
2016/1/1,臺南市,安南區,61100,189724,95924,93800
2016/1/1,臺南市,安平區,24858,65430,31099,34331
2016/1/1,臺南市,中西區,30755,77472,37664,39808
2016/1/1,高雄市,鹽埕區,10830,24997,12436,12561
2016/1/1,高雄市,鼓山區,56217,136679,66292,70387
2016/1/1,高雄市,左營區,77645,196362,94917,101445
2016/1/1,高雄市,楠梓區,67517,180113,88728,91385
2016/1/1,高雄市,三民區,135240,345968,167940,178028
2016/1/1,高雄市,新興區,22678,51953,25052,26901
2016/1/1,高雄市,前金區,12515,27369,13168,14201
2016/1/1,高雄市,苓雅區,72247,174419,84279,90140
2016/1/1,高雄市,前鎮區,78344,192484,94816,97668
2016/1/1,高雄市,旗津區,11063,28992,15027,13965
2016/1/1,高雄市,小港區,66547,156220,77842,78378
2016/1/1,高雄市,鳳山區,137260,356507,175188,181319
2016/1/1,高雄市,林園區,25573,70423,35723,34700
2016/1/1,高雄市,大寮區,41376,111675,57357,54318
2016/1/1,高雄市,大樹區,13412,43158,22178,20980
2016/1/1,高雄市,大社區,12738,34585,17591,16994
2016/1/1,高雄市,仁武區,31239,82696,42156,40540
2016/1/1,高雄市,鳥松區,17768,43937,22350,21587
2016/1/1,高雄市,岡山區,34638,97843,48636,49207
2016/1/1,高雄市,橋頭區,13277,37328,19004,18324
2016/1/1,高雄市,燕巢區,10393,30074,15923,14151
2016/1/1,高雄市,田寮區,3359,7457,4140,3317
2016/1/1,高雄市,阿蓮區,9359,29297,14774,14523
2016/1/1,高雄市,路竹區,16834,53081,27118,25963
2016/1/1,高雄市,湖內區,10579,29604,15125,14479
2016/1/1,高雄市,茄萣區,10471,30498,15768,14730
2016/1/1,高雄市,永安區,5735,14118,7083,7035
2016/1/1,高雄市,彌陀區,6756,19657,10147,9510
2016/1/1,高雄市,梓官區,12579,36417,18814,17603
2016/1/1,高雄市,旗山區,13853,37749,19558,18191
2016/1/1,高雄市,美濃區,14565,40776,21390,19386
2016/1/1,高雄市,六龜區,5627,13435,7239,6196
2016/1/1,高雄市,甲仙區,2361,6252,3324,2928
2016/1/1,高雄市,杉林區,4804,12382,6766,5616
2016/1/1,高雄市,內門區,5074,14953,8093,6860
2016/1/1,高雄市,茂林區,582,1893,934,959
2016/1/1,高雄市,桃源區,1325,4232,2216,2016
2016/1/1,高雄市,那瑪夏區,857,3146,1627,1519
2016/1/1,宜蘭縣,宜蘭市,35630,96079,46940,49139
2016/1/1,宜蘭縣,羅東鎮,26053,72453,34432,38021
2016/1/1,宜蘭縣,蘇澳鎮,14072,40698,20738,19960
2016/1/1,宜蘭縣,頭城鎮,10133,29771,15355,14416
2016/1/1,宜蘭縣,礁溪鄉,13577,35815,18696,17119
2016/1/1,宜蘭縣,壯圍鄉,8537,24246,12841,11405
2016/1/1,宜蘭縣,員山鄉,11503,32261,17129,15132
2016/1/1,宜蘭縣,冬山鄉,18878,53580,27547,26033
2016/1/1,宜蘭縣,五結鄉,14430,39582,20494,19088
2016/1/1,宜蘭縣,三星鄉,8329,21435,11559,9876
2016/1/1,宜蘭縣,大同鄉,1887,6078,3302,2776
2016/1/1,宜蘭縣,南澳鄉,1916,6039,3160,2879
2016/1/1,新竹縣,竹北市,60806,171211,85316,85895
2016/1/1,新竹縣,關西鎮,9532,29866,15981,13885
2016/1/1,新竹縣,新埔鎮,10669,34082,18159,15923
2016/1/1,新竹縣,竹東鎮,32945,96497,48486,48011
2016/1/1,新竹縣,湖口鄉,25690,77282,39287,37995
2016/1/1,新竹縣,橫山鄉,4486,13501,7325,6176
2016/1/1,新竹縣,新豐鄉,17796,56156,28793,27363
2016/1/1,新竹縣,芎林鄉,6467,20256,10746,9510
2016/1/1,新竹縣,寶山鄉,5195,14325,7745,6580
2016/1/1,新竹縣,北埔鄉,3139,9682,5226,4456
2016/1/1,新竹縣,峨眉鄉,2079,5635,3117,2518
2016/1/1,新竹縣,尖石鄉,2849,9408,4977,4431
2016/1/1,新竹縣,五峰鄉,1745,4612,2510,2102
2016/1/1,苗栗縣,苗栗市,30717,90399,45187,45212
2016/1/1,苗栗縣,頭份市,33550,103238,52101,51137
2016/1/1,苗栗縣,苑裡鎮,14470,47780,24809,22971
2016/1/1,苗栗縣,通霄鎮,11562,36099,19042,17057
2016/1/1,苗栗縣,竹南鎮,27887,84522,42651,41871
2016/1/1,苗栗縣,後龍鎮,11865,37799,19929,17870
2016/1/1,苗栗縣,卓蘭鎮,6111,18004,9410,8594
2016/1/1,苗栗縣,大湖鄉,5426,15266,8109,7157
2016/1/1,苗栗縣,公館鄉,10611,34509,17963,16546
2016/1/1,苗栗縣,銅鑼鄉,6146,18687,9893,8794
2016/1/1,苗栗縣,南庄鄉,3979,10562,5817,4745
2016/1/1,苗栗縣,頭屋鄉,3660,11221,5921,5300
2016/1/1,苗栗縣,三義鄉,5479,17002,8920,8082
2016/1/1,苗栗縣,西湖鄉,2681,7447,4141,3306
2016/1/1,苗栗縣,造橋鄉,4132,13332,6995,6337
2016/1/1,苗栗縣,三灣鄉,2415,6994,3829,3165
2016/1/1,苗栗縣,獅潭鄉,1728,4596,2563,2033
2016/1/1,苗栗縣,泰安鄉,1963,6032,3231,2801
2016/1/1,彰化縣,彰化市,75503,235056,116355,118701
2016/1/1,彰化縣,員林市,38707,124928,62248,62680
2016/1/1,彰化縣,鹿港鎮,24066,86495,44034,42461
2016/1/1,彰化縣,和美鎮,26312,91154,46527,44627
2016/1/1,彰化縣,北斗鎮,10532,33216,16771,16445
2016/1/1,彰化縣,溪湖鎮,16083,55749,28361,27388
2016/1/1,彰化縣,田中鎮,13042,42464,21963,20501
2016/1/1,彰化縣,二林鎮,14872,51846,26725,25121
2016/1/1,彰化縣,線西鄉,4335,17029,8810,8219
2016/1/1,彰化縣,伸港鄉,9647,36533,18670,17863
2016/1/1,彰化縣,福興鄉,12582,47613,24809,22804
2016/1/1,彰化縣,秀水鄉,10524,39355,20344,19011
2016/1/1,彰化縣,花壇鄉,13845,46065,23682,22383
2016/1/1,彰化縣,芬園鄉,6869,24010,12632,11378
2016/1/1,彰化縣,大村鄉,10890,36522,18934,17588
2016/1/1,彰化縣,埔鹽鄉,8993,32918,17282,15636
2016/1/1,彰化縣,埔心鄉,10395,34772,17926,16846
2016/1/1,彰化縣,永靖鄉,10852,37996,19763,18233
2016/1/1,彰化縣,社頭鄉,12786,43492,22338,21154
2016/1/1,彰化縣,二水鄉,5335,15620,8174,7446
2016/1/1,彰化縣,田尾鄉,7893,27577,14255,13322
2016/1/1,彰化縣,埤頭鄉,8942,30872,16039,14833
2016/1/1,彰化縣,芳苑鄉,10132,34322,18159,16163
2016/1/1,彰化縣,大城鄉,5325,17510,9493,8017
2016/1/1,彰化縣,竹塘鄉,4626,15620,8253,7367
2016/1/1,彰化縣,溪州鄉,8915,30561,16020,14541
2016/1/1,南投縣,南投市,34491,101583,50962,50621
2016/1/1,南投縣,埔里鎮,28930,82127,41172,40955
2016/1/1,南投縣,草屯鎮,32802,98829,49948,48881
2016/1/1,南投縣,竹山鎮,20028,56013,28765,27248
2016/1/1,南投縣,集集鎮,4346,11223,5839,5384
2016/1/1,南投縣,名間鄉,12597,39620,20815,18805
2016/1/1,南投縣,鹿谷鄉,7708,18212,9693,8519
2016/1/1,南投縣,中寮鄉,5654,15340,8347,6993
2016/1/1,南投縣,魚池鄉,5755,16299,8533,7766
2016/1/1,南投縣,國姓鄉,7302,19335,10479,8856
2016/1/1,南投縣,水里鄉,7196,18328,9623,8705
2016/1/1,南投縣,信義鄉,5239,16493,8860,7633
2016/1/1,南投縣,仁愛鄉,4937,15760,8155,7605
2016/1/1,雲林縣,斗六市,37559,108372,54053,54319
2016/1/1,雲林縣,斗南鎮,15770,45566,23141,22425
2016/1/1,雲林縣,虎尾鎮,24409,70598,35849,34749
2016/1/1,雲林縣,西螺鎮,14487,46833,23781,23052
2016/1/1,雲林縣,土庫鎮,9230,29426,15376,14050
2016/1/1,雲林縣,北港鎮,15886,40988,21290,19698
2016/1/1,雲林縣,古坑鄉,10951,32292,17037,15255
2016/1/1,雲林縣,大埤鄉,6740,19728,10617,9111
2016/1/1,雲林縣,莿桐鄉,9255,29223,15357,13866
2016/1/1,雲林縣,林內鄉,5929,18641,9758,8883
2016/1/1,雲林縣,二崙鄉,8914,27896,14940,12956
2016/1/1,雲林縣,崙背鄉,8495,25433,13456,11977
2016/1/1,雲林縣,麥寮鄉,14011,44559,22518,22041
2016/1/1,雲林縣,東勢鄉,5729,15381,8457,6924
2016/1/1,雲林縣,褒忠鄉,4411,13349,7169,6180
2016/1/1,雲林縣,臺西鄉,8731,24527,13147,11380
2016/1/1,雲林縣,元長鄉,9341,26788,14632,12156
2016/1/1,雲林縣,四湖鄉,8896,24675,13417,11258
2016/1/1,雲林縣,口湖鄉,9587,28461,15112,13349
2016/1/1,雲林縣,水林鄉,10127,26500,14523,11977
2016/1/1,嘉義縣,太保市,12390,37218,19138,18080
2016/1/1,嘉義縣,朴子市,15544,42928,21763,21165
2016/1/1,嘉義縣,布袋鎮,10035,27930,14279,13651
2016/1/1,嘉義縣,大林鎮,11382,31658,16221,15437
2016/1/1,嘉義縣,民雄鄉,24417,71884,36809,35075
2016/1/1,嘉義縣,溪口鄉,5382,15092,8068,7024
2016/1/1,嘉義縣,新港鄉,10634,32780,17299,15481
2016/1/1,嘉義縣,六腳鄉,8971,24161,12842,11319
2016/1/1,嘉義縣,東石鄉,9361,25716,13634,12082
2016/1/1,嘉義縣,義竹鄉,7505,19225,9996,9229
2016/1/1,嘉義縣,鹿草鄉,5791,16106,8651,7455
2016/1/1,嘉義縣,水上鄉,17910,50392,26039,24353
2016/1/1,嘉義縣,中埔鄉,15958,45698,23750,21948
2016/1/1,嘉義縣,竹崎鄉,11701,36522,19511,17011
2016/1/1,嘉義縣,梅山鄉,6765,19992,10627,9365
2016/1/1,嘉義縣,番路鄉,4313,11851,6412,5439
2016/1/1,嘉義縣,大埔鄉,1939,4619,2407,2212
2016/1/1,嘉義縣,阿里山鄉,1966,5710,3019,2691
2016/1/1,屏東縣,屏東市,73744,202506,100496,102010
2016/1/1,屏東縣,潮州鎮,19214,54760,27420,27340
2016/1/1,屏東縣,東港鎮,16380,48069,24296,23773
2016/1/1,屏東縣,恆春鎮,11361,30847,15810,15037
2016/1/1,屏東縣,萬丹鄉,14814,51611,26718,24893
2016/1/1,屏東縣,長治鄉,10024,30312,15797,14515
2016/1/1,屏東縣,麟洛鄉,3761,11248,5844,5404
2016/1/1,屏東縣,九如鄉,6848,22097,11446,10651
2016/1/1,屏東縣,里港鄉,8152,27056,13760,13296
2016/1/1,屏東縣,鹽埔鄉,7839,26383,13725,12658
2016/1/1,屏東縣,高樹鄉,9369,25125,13360,11765
2016/1/1,屏東縣,萬巒鄉,6486,20750,10870,9880
2016/1/1,屏東縣,內埔鄉,18507,55610,28805,26805
2016/1/1,屏東縣,竹田鄉,5662,17550,9305,8245
2016/1/1,屏東縣,新埤鄉,3419,10052,5356,4696
2016/1/1,屏東縣,枋寮鄉,8531,25072,13156,11916
2016/1/1,屏東縣,新園鄉,11760,36167,18725,17442
2016/1/1,屏東縣,崁頂鄉,4460,16154,8196,7958
2016/1/1,屏東縣,林邊鄉,6921,18858,9678,9180
2016/1/1,屏東縣,南州鄉,3690,10849,5569,5280
2016/1/1,屏東縣,佳冬鄉,6977,19885,10333,9552
2016/1/1,屏東縣,琉球鄉,4350,12493,6863,5630
2016/1/1,屏東縣,車城鄉,3486,8910,4809,4101
2016/1/1,屏東縣,滿州鄉,3006,7989,4376,3613
2016/1/1,屏東縣,枋山鄉,2136,5638,3000,2638
2016/1/1,屏東縣,三地門鄉,2293,7703,3886,3817
2016/1/1,屏東縣,霧臺鄉,1056,3324,1704,1620
2016/1/1,屏東縣,瑪家鄉,2017,6770,3457,3313
2016/1/1,屏東縣,泰武鄉,1313,5219,2748,2471
2016/1/1,屏東縣,來義鄉,2235,7562,3848,3714
2016/1/1,屏東縣,春日鄉,1355,4800,2461,2339
2016/1/1,屏東縣,獅子鄉,1529,4798,2485,2313
2016/1/1,屏東縣,牡丹鄉,1867,4764,2447,2317
2016/1/1,臺東縣,臺東市,39304,106764,53621,53143
2016/1/1,臺東縣,成功鎮,5426,14610,7721,6889
2016/1/1,臺東縣,關山鎮,3196,8909,4680,4229
2016/1/1,臺東縣,卑南鄉,6653,17475,9262,8213
2016/1/1,臺東縣,大武鄉,2510,6297,3290,3007
2016/1/1,臺東縣,太麻里鄉,4621,11346,6033,5313
2016/1/1,臺東縣,東河鄉,3769,8828,4858,3970
2016/1/1,臺東縣,長濱鄉,2927,7565,4293,3272
2016/1/1,臺東縣,鹿野鄉,3079,8102,4338,3764
2016/1/1,臺東縣,池上鄉,3235,8483,4433,4050
2016/1/1,臺東縣,綠島鄉,1085,3766,1966,1800
2016/1/1,臺東縣,延平鄉,1075,3565,1904,1661
2016/1/1,臺東縣,海端鄉,1089,4316,2308,2008
2016/1/1,臺東縣,達仁鄉,1452,3591,1954,1637
2016/1/1,臺東縣,金峰鄉,1104,3580,1849,1731
2016/1/1,臺東縣,蘭嶼鄉,1782,5047,2548,2499
2016/1/1,花蓮縣,花蓮市,41408,105687,51188,54499
2016/1/1,花蓮縣,鳳林鎮,4404,11099,5809,5290
2016/1/1,花蓮縣,玉里鎮,8920,24982,13350,11632
2016/1/1,花蓮縣,新城鄉,7613,20212,10442,9770
2016/1/1,花蓮縣,吉安鄉,31486,83276,42165,41111
2016/1/1,花蓮縣,壽豐鄉,7065,18185,9717,8468
2016/1/1,花蓮縣,光復鄉,5037,13196,7021,6175
2016/1/1,花蓮縣,豐濱鄉,1724,4545,2529,2016
2016/1/1,花蓮縣,瑞穗鄉,4705,11903,6409,5494
2016/1/1,花蓮縣,富里鄉,4012,10623,5802,4821
2016/1/1,花蓮縣,秀林鄉,4767,15678,8100,7578
2016/1/1,花蓮縣,萬榮鄉,2083,6419,3388,3031
2016/1/1,花蓮縣,卓溪鄉,1675,6040,3322,2718
2016/1/1,澎湖縣,馬公市,23592,61020,31075,29945
2016/1/1,澎湖縣,湖西鄉,5452,14395,7633,6762
2016/1/1,澎湖縣,白沙鄉,3343,9703,5093,4610
2016/1/1,澎湖縣,西嶼鄉,2940,8402,4318,4084
2016/1/1,澎湖縣,望安鄉,1977,5097,2736,2361
2016/1/1,澎湖縣,七美鄉,1328,3738,1940,1798
2016/1/1,基隆市,中正區,22477,52689,26960,25729
2016/1/1,基隆市,七堵區,21123,54086,27309,26777
2016/1/1,基隆市,暖暖區,15412,38393,19327,19066
2016/1/1,基隆市,仁愛區,19336,45563,22494,23069
2016/1/1,基隆市,中山區,19258,48369,24593,23776
2016/1/1,基隆市,安樂區,32329,81298,40463,40835
2016/1/1,基隆市,信義區,20976,51621,25728,25893
2016/1/1,新竹市,東區,76427,208122,102547,105575
2016/1/1,新竹市,北區,54988,149300,73165,76135
2016/1/1,新竹市,香山區,26225,76836,39159,37677
2016/1/1,嘉義市,東區,45263,122877,59465,63412
2016/1/1,嘉義市,西區,53360,147396,72355,75041
2016/1/1,金門縣,金城鎮,12685,42412,21289,21123
2016/1/1,金門縣,金湖鎮,8593,28420,14319,14101
2016/1/1,金門縣,金沙鎮,6171,20132,9961,10171
2016/1/1,金門縣,金寧鄉,7990,28910,14591,14319
2016/1/1,金門縣,烈嶼鄉,3072,12461,6197,6264
2016/1/1,金門縣,烏坵鄉,133,660,330,330
2016/1/1,連江縣,南竿鄉,1468,7397,4195,3202
2016/1/1,連江縣,北竿鄉,494,2327,1293,1034
2016/1/1,連江縣,莒光鄉,282,1538,916,622
2016/1/1,連江縣,東引鄉,321,1271,767,504
2016/2/1,總計,新北市,1511594,3971660,1951290,2020370
2016/2/1,總計,臺北市,1043835,2704410,1295039,1409371
2016/2/1,總計,桃園市,751967,2111148,1055234,1055914
2016/2/1,總計,臺中市,929158,2747561,1358199,1389362
2016/2/1,總計,臺南市,672657,1885453,943687,941766
2016/2/1,總計,高雄市,1073422,2778574,1380388,1398186
2016/2/1,總計,臺灣省,2450076,7152646,3654041,3498605
2016/2/1,總計,宜蘭縣,165041,457995,232142,225853
2016/2/1,總計,新竹縣,183622,542821,277838,264983
2016/2/1,總計,苗栗縣,184390,563084,290289,272795
2016/2/1,總計,彰化縣,382121,1289209,658443,630766
2016/2/1,總計,南投縣,176929,508586,260858,247728
2016/2/1,總計,雲林縣,238418,698753,363341,335412
2016/2/1,總計,嘉義縣,181964,519045,270248,248797
2016/2/1,總計,屏東縣,284581,840408,430490,409918
2016/2/1,總計,臺東縣,82320,222118,115000,107118
2016/2/1,總計,花蓮縣,124880,331801,169166,162635
2016/2/1,總計,澎湖縣,38623,102336,52775,49561
2016/2/1,總計,基隆市,150884,371914,186802,185112
2016/2/1,總計,新竹市,157681,434279,214843,219436
2016/2/1,總計,嘉義市,98622,270297,131806,138491
2016/2/1,總計,福建省,41255,145483,73828,71655
2016/2/1,總計,金門縣,38673,132960,66659,66301
2016/2/1,總計,連江縣,2582,12523,7169,5354
2016/2/1,新北市,板橋區,205669,554062,271058,283004
2016/2/1,新北市,三重區,148562,388400,191689,196711
2016/2/1,新北市,中和區,163066,414234,202159,212075
2016/2/1,新北市,永和區,90679,225350,107124,118226
2016/2/1,新北市,新莊區,149241,413572,202510,211062
2016/2/1,新北市,新店區,123900,300201,145040,155161
2016/2/1,新北市,樹林區,65443,184347,92123,92224
2016/2/1,新北市,鶯歌區,29435,87819,44044,43775
2016/2/1,新北市,三峽區,41210,112913,56775,56138
2016/2/1,新北市,淡水區,70480,162560,78224,84336
2016/2/1,新北市,汐止區,85035,196136,95932,100204
2016/2/1,新北市,瑞芳區,16138,40927,20685,20242
2016/2/1,新北市,土城區,85939,238649,118075,120574
2016/2/1,新北市,蘆洲區,69531,200116,98514,101602
2016/2/1,新北市,五股區,30039,83077,41917,41160
2016/2/1,新北市,泰山區,28010,78776,39167,39609
2016/2/1,新北市,林口區,39297,100786,49320,51466
2016/2/1,新北市,深坑區,9473,23623,11830,11793
2016/2/1,新北市,石碇區,3375,7849,4333,3516
2016/2/1,新北市,坪林區,2496,6508,3622,2886
2016/2/1,新北市,三芝區,9363,23446,12075,11371
2016/2/1,新北市,石門區,4309,12628,6549,6079
2016/2/1,新北市,八里區,14038,37696,18808,18888
2016/2/1,新北市,平溪區,2354,4871,2687,2184
2016/2/1,新北市,雙溪區,3837,9215,4976,4239
2016/2/1,新北市,貢寮區,4405,12840,6555,6285
2016/2/1,新北市,金山區,7031,22257,11024,11233
2016/2/1,新北市,萬里區,7404,22603,11388,11215
2016/2/1,新北市,烏來區,1835,6199,3087,3112
2016/2/1,臺北市,松山區,80229,209684,98794,110890
2016/2/1,臺北市,信義區,89460,228918,109668,119250
2016/2/1,臺北市,大安區,120394,313014,146390,166624
2016/2/1,臺北市,中山區,99108,231309,107993,123316
2016/2/1,臺北市,中正區,65175,162335,77557,84778
2016/2/1,臺北市,大同區,51527,130967,63988,66979
2016/2/1,臺北市,萬華區,78336,194240,95818,98422
2016/2/1,臺北市,文山區,104485,275508,132515,142993
2016/2/1,臺北市,南港區,46458,122252,59724,62528
2016/2/1,臺北市,內湖區,106607,287645,137693,149952
2016/2/1,臺北市,士林區,106339,290716,140453,150263
2016/2/1,臺北市,北投區,95717,257822,124446,133376
2016/2/1,桃園市,桃園區,160048,428412,208632,219780
2016/2/1,桃園市,中壢區,141748,390638,193058,197580
2016/2/1,桃園市,大溪區,31460,93451,47877,45574
2016/2/1,桃園市,楊梅區,55163,161369,81614,79755
2016/2/1,桃園市,蘆竹區,55436,155751,77608,78143
2016/2/1,桃園市,大園區,30583,85687,43963,41724
2016/2/1,桃園市,龜山區,55615,145825,73138,72687
2016/2/1,桃園市,八德區,66084,188177,94702,93475
2016/2/1,桃園市,龍潭區,40228,118786,59774,59012
2016/2/1,桃園市,平鎮區,74360,218565,108990,109575
2016/2/1,桃園市,新屋區,15774,48544,25948,22596
2016/2/1,桃園市,觀音區,21739,64972,33935,31037
2016/2/1,桃園市,復興區,3729,10971,5995,4976
2016/2/1,臺中市,中區,7900,19028,9495,9533
2016/2/1,臺中市,東區,27370,75190,37533,37657
2016/2/1,臺中市,南區,46789,122033,58762,63271
2016/2/1,臺中市,西區,45102,115808,55099,60709
2016/2/1,臺中市,北區,58552,147613,70812,76801
2016/2/1,臺中市,西屯區,82542,222099,106961,115138
2016/2/1,臺中市,南屯區,59799,164794,78953,85841
2016/2/1,臺中市,北屯區,95068,265789,127896,137893
2016/2/1,臺中市,豐原區,52672,166705,82513,84192
2016/2/1,臺中市,東勢區,17280,51245,26391,24854
2016/2/1,臺中市,大甲區,22733,77800,39218,38582
2016/2/1,臺中市,清水區,26460,86116,44254,41862
2016/2/1,臺中市,沙鹿區,28148,89940,45547,44393
2016/2/1,臺中市,梧棲區,17194,57188,28780,28408
2016/2/1,臺中市,后里區,15697,54278,27606,26672
2016/2/1,臺中市,神岡區,18932,65247,33357,31890
2016/2/1,臺中市,潭子區,35503,106675,52884,53791
2016/2/1,臺中市,大雅區,28451,93735,46851,46884
2016/2/1,臺中市,新社區,7511,25054,13030,12024
2016/2/1,臺中市,石岡區,4892,15271,7934,7337
2016/2/1,臺中市,外埔區,9422,31838,16347,15491
2016/2/1,臺中市,大安區,5409,19530,10306,9224
2016/2/1,臺中市,烏日區,23239,72685,36610,36075
2016/2/1,臺中市,大肚區,17048,56689,29019,27670
2016/2/1,臺中市,龍井區,22358,76688,38824,37864
2016/2/1,臺中市,霧峰區,19752,64731,32931,31800
2016/2/1,臺中市,太平區,61192,184287,91699,92588
2016/2/1,臺中市,大里區,67705,208816,102856,105960
2016/2/1,臺中市,和平區,4438,10689,5731,4958
2016/2/1,臺南市,新營區,28704,78249,38751,39498
2016/2/1,臺南市,鹽水區,10082,26067,13626,12441
2016/2/1,臺南市,白河區,10908,29207,15286,13921
2016/2/1,臺南市,柳營區,7840,21568,11262,10306
2016/2/1,臺南市,後壁區,8887,24246,12579,11667
2016/2/1,臺南市,東山區,8251,21541,11427,10114
2016/2/1,臺南市,麻豆區,15604,44967,22822,22145
2016/2/1,臺南市,下營區,9093,24736,12748,11988
2016/2/1,臺南市,六甲區,7728,22564,11652,10912
2016/2/1,臺南市,官田區,7832,21626,11062,10564
2016/2/1,臺南市,大內區,3909,10054,5381,4673
2016/2/1,臺南市,佳里區,20417,59527,29517,30010
2016/2/1,臺南市,學甲區,9656,26593,13620,12973
2016/2/1,臺南市,西港區,8115,24881,12603,12278
2016/2/1,臺南市,七股區,8066,23384,12113,11271
2016/2/1,臺南市,將軍區,7301,20258,10316,9942
2016/2/1,臺南市,北門區,4315,11504,5824,5680
2016/2/1,臺南市,新化區,14282,43814,22355,21459
2016/2/1,臺南市,善化區,16856,46972,23730,23242
2016/2/1,臺南市,新市區,11762,35898,18045,17853
2016/2/1,臺南市,安定區,9857,30322,15549,14773
2016/2/1,臺南市,山上區,2679,7412,3875,3537
2016/2/1,臺南市,玉井區,5120,14384,7463,6921
2016/2/1,臺南市,楠西區,3528,10006,5307,4699
2016/2/1,臺南市,南化區,2861,8864,4795,4069
2016/2/1,臺南市,左鎮區,1990,5055,2829,2226
2016/2/1,臺南市,仁德區,26894,73974,37616,36358
2016/2/1,臺南市,歸仁區,22279,67965,34558,33407
2016/2/1,臺南市,關廟區,10976,34702,17920,16782
2016/2/1,臺南市,龍崎區,1567,4189,2266,1923
2016/2/1,臺南市,永康區,81913,230997,114044,116953
2016/2/1,臺南市,東區,71749,188772,90735,98037
2016/2/1,臺南市,南區,44940,125768,62496,63272
2016/2/1,臺南市,北區,49952,132744,64822,67922
2016/2/1,臺南市,安南區,61147,189788,95937,93851
2016/2/1,臺南市,安平區,24874,65478,31133,34345
2016/2/1,臺南市,中西區,30723,77377,37623,39754
2016/2/1,高雄市,鹽埕區,10821,24983,12422,12561
2016/2/1,高雄市,鼓山區,56274,136774,66351,70423
2016/2/1,高雄市,左營區,77676,196401,94876,101525
2016/2/1,高雄市,楠梓區,67579,180301,88803,91498
2016/2/1,高雄市,三民區,135224,345885,167867,178018
2016/2/1,高雄市,新興區,22654,51871,25020,26851
2016/2/1,高雄市,前金區,12505,27367,13152,14215
2016/2/1,高雄市,苓雅區,72230,174319,84216,90103
2016/2/1,高雄市,前鎮區,78328,192330,94747,97583
2016/2/1,高雄市,旗津區,11069,28948,15002,13946
2016/2/1,高雄市,小港區,66570,156292,77859,78433
2016/2/1,高雄市,鳳山區,137339,356730,175298,181432
2016/2/1,高雄市,林園區,25575,70400,35699,34701
2016/2/1,高雄市,大寮區,41397,111681,57363,54318
2016/2/1,高雄市,大樹區,13419,43144,22163,20981
2016/2/1,高雄市,大社區,12732,34570,17568,17002
2016/2/1,高雄市,仁武區,31276,82804,42192,40612
2016/2/1,高雄市,鳥松區,17752,43911,22324,21587
2016/2/1,高雄市,岡山區,34647,97830,48634,49196
2016/2/1,高雄市,橋頭區,13275,37357,19028,18329
2016/2/1,高雄市,燕巢區,10386,30047,15912,14135
2016/2/1,高雄市,田寮區,3352,7430,4124,3306
2016/2/1,高雄市,阿蓮區,9361,29271,14765,14506
2016/2/1,高雄市,路竹區,16818,53060,27102,25958
2016/2/1,高雄市,湖內區,10586,29581,15094,14487
2016/2/1,高雄市,茄萣區,10466,30461,15740,14721
2016/2/1,高雄市,永安區,5729,14116,7082,7034
2016/2/1,高雄市,彌陀區,6762,19659,10138,9521
2016/2/1,高雄市,梓官區,12567,36367,18779,17588
2016/2/1,高雄市,旗山區,13836,37682,19526,18156
2016/2/1,高雄市,美濃區,14584,40768,21374,19394
2016/2/1,高雄市,六龜區,5627,13421,7228,6193
2016/2/1,高雄市,甲仙區,2357,6252,3329,2923
2016/2/1,高雄市,杉林區,4803,12363,6756,5607
2016/2/1,高雄市,內門區,5077,14928,8079,6849
2016/2/1,高雄市,茂林區,584,1893,933,960
2016/2/1,高雄市,桃源區,1328,4227,2218,2009
2016/2/1,高雄市,那瑪夏區,857,3150,1625,1525
2016/2/1,宜蘭縣,宜蘭市,35648,96090,46941,49149
2016/2/1,宜蘭縣,羅東鎮,26062,72481,34427,38054
2016/2/1,宜蘭縣,蘇澳鎮,14081,40690,20746,19944
2016/2/1,宜蘭縣,頭城鎮,10131,29764,15351,14413
2016/2/1,宜蘭縣,礁溪鄉,13571,35792,18674,17118
2016/2/1,宜蘭縣,壯圍鄉,8542,24218,12825,11393
2016/2/1,宜蘭縣,員山鄉,11514,32283,17137,15146
2016/2/1,宜蘭縣,冬山鄉,18896,53548,27533,26015
2016/2/1,宜蘭縣,五結鄉,14455,39605,20503,19102
2016/2/1,宜蘭縣,三星鄉,8337,21425,11556,9869
2016/2/1,宜蘭縣,大同鄉,1888,6078,3297,2781
2016/2/1,宜蘭縣,南澳鄉,1916,6021,3152,2869
2016/2/1,新竹縣,竹北市,60911,171513,85471,86042
2016/2/1,新竹縣,關西鎮,9523,29841,15962,13879
2016/2/1,新竹縣,新埔鎮,10664,34081,18154,15927
2016/2/1,新竹縣,竹東鎮,33022,96600,48560,48040
2016/2/1,新竹縣,湖口鄉,25731,77323,39280,38043
2016/2/1,新竹縣,橫山鄉,4485,13476,7309,6167
2016/2/1,新竹縣,新豐鄉,17821,56177,28819,27358
2016/2/1,新竹縣,芎林鄉,6473,20264,10750,9514
2016/2/1,新竹縣,寶山鄉,5195,14296,7737,6559
2016/2/1,新竹縣,北埔鄉,3129,9667,5223,4444
2016/2/1,新竹縣,峨眉鄉,2083,5639,3120,2519
2016/2/1,新竹縣,尖石鄉,2845,9352,4955,4397
2016/2/1,新竹縣,五峰鄉,1740,4592,2498,2094
2016/2/1,苗栗縣,苗栗市,30715,90371,45158,45213
2016/2/1,苗栗縣,頭份市,33556,103287,52123,51164
2016/2/1,苗栗縣,苑裡鎮,14474,47692,24754,22938
2016/2/1,苗栗縣,通霄鎮,11546,36022,19008,17014
2016/2/1,苗栗縣,竹南鎮,27911,84551,42654,41897
2016/2/1,苗栗縣,後龍鎮,11867,37752,19915,17837
2016/2/1,苗栗縣,卓蘭鎮,6108,17973,9391,8582
2016/2/1,苗栗縣,大湖鄉,5429,15233,8094,7139
2016/2/1,苗栗縣,公館鄉,10615,34505,17953,16552
2016/2/1,苗栗縣,銅鑼鄉,6146,18657,9878,8779
2016/2/1,苗栗縣,南庄鄉,3974,10531,5802,4729
2016/2/1,苗栗縣,頭屋鄉,3656,11193,5911,5282
2016/2/1,苗栗縣,三義鄉,5478,16990,8916,8074
2016/2/1,苗栗縣,西湖鄉,2677,7431,4136,3295
2016/2/1,苗栗縣,造橋鄉,4131,13301,6984,6317
2016/2/1,苗栗縣,三灣鄉,2414,6986,3824,3162
2016/2/1,苗栗縣,獅潭鄉,1730,4593,2567,2026
2016/2/1,苗栗縣,泰安鄉,1963,6016,3221,2795
2016/2/1,彰化縣,彰化市,75524,235104,116379,118725
2016/2/1,彰化縣,員林市,38713,124954,62237,62717
2016/2/1,彰化縣,鹿港鎮,24085,86516,44072,42444
2016/2/1,彰化縣,和美鎮,26316,91151,46504,44647
2016/2/1,彰化縣,北斗鎮,10535,33215,16754,16461
2016/2/1,彰化縣,溪湖鎮,16106,55780,28376,27404
2016/2/1,彰化縣,田中鎮,13045,42443,21960,20483
2016/2/1,彰化縣,二林鎮,14884,51852,26720,25132
2016/2/1,彰化縣,線西鄉,4333,17017,8806,8211
2016/2/1,彰化縣,伸港鄉,9657,36538,18665,17873
2016/2/1,彰化縣,福興鄉,12579,47590,24783,22807
2016/2/1,彰化縣,秀水鄉,10533,39343,20335,19008
2016/2/1,彰化縣,花壇鄉,13856,46092,23689,22403
2016/2/1,彰化縣,芬園鄉,6869,23996,12631,11365
2016/2/1,彰化縣,大村鄉,10895,36577,18963,17614
2016/2/1,彰化縣,埔鹽鄉,8995,32860,17257,15603
2016/2/1,彰化縣,埔心鄉,10402,34764,17910,16854
2016/2/1,彰化縣,永靖鄉,10848,37965,19745,18220
2016/2/1,彰化縣,社頭鄉,12795,43494,22349,21145
2016/2/1,彰化縣,二水鄉,5330,15611,8174,7437
2016/2/1,彰化縣,田尾鄉,7891,27578,14250,13328
2016/2/1,彰化縣,埤頭鄉,8943,30868,16026,14842
2016/2/1,彰化縣,芳苑鄉,10125,34252,18124,16128
2016/2/1,彰化縣,大城鄉,5316,17498,9494,8004
2016/2/1,彰化縣,竹塘鄉,4622,15605,8236,7369
2016/2/1,彰化縣,溪州鄉,8924,30546,16004,14542
2016/2/1,南投縣,南投市,34472,101507,50915,50592
2016/2/1,南投縣,埔里鎮,28922,82095,41160,40935
2016/2/1,南投縣,草屯鎮,32798,98745,49889,48856
2016/2/1,南投縣,竹山鎮,20017,55934,28726,27208
2016/2/1,南投縣,集集鎮,4338,11212,5829,5383
2016/2/1,南投縣,名間鄉,12589,39533,20775,18758
2016/2/1,南投縣,鹿谷鄉,7711,18159,9663,8496
2016/2/1,南投縣,中寮鄉,5654,15316,8326,6990
2016/2/1,南投縣,魚池鄉,5760,16287,8531,7756
2016/2/1,南投縣,國姓鄉,7303,19305,10465,8840
2016/2/1,南投縣,水里鄉,7198,18293,9598,8695
2016/2/1,南投縣,信義鄉,5229,16452,8837,7615
2016/2/1,南投縣,仁愛鄉,4938,15748,8144,7604
2016/2/1,雲林縣,斗六市,37560,108431,54086,54345
2016/2/1,雲林縣,斗南鎮,15763,45540,23134,22406
2016/2/1,雲林縣,虎尾鎮,24435,70647,35864,34783
2016/2/1,雲林縣,西螺鎮,14484,46791,23758,23033
2016/2/1,雲林縣,土庫鎮,9232,29418,15374,14044
2016/2/1,雲林縣,北港鎮,15880,40961,21270,19691
2016/2/1,雲林縣,古坑鄉,10949,32243,17006,15237
2016/2/1,雲林縣,大埤鄉,6740,19690,10596,9094
2016/2/1,雲林縣,莿桐鄉,9248,29209,15345,13864
2016/2/1,雲林縣,林內鄉,5926,18618,9739,8879
2016/2/1,雲林縣,二崙鄉,8912,27866,14923,12943
2016/2/1,雲林縣,崙背鄉,8499,25402,13440,11962
2016/2/1,雲林縣,麥寮鄉,14015,44525,22496,22029
2016/2/1,雲林縣,東勢鄉,5728,15362,8450,6912
2016/2/1,雲林縣,褒忠鄉,4412,13327,7158,6169
2016/2/1,雲林縣,臺西鄉,8729,24502,13128,11374
2016/2/1,雲林縣,元長鄉,9327,26733,14602,12131
2016/2/1,雲林縣,四湖鄉,8888,24621,13382,11239
2016/2/1,雲林縣,口湖鄉,9578,28418,15089,13329
2016/2/1,雲林縣,水林鄉,10113,26449,14501,11948
2016/2/1,嘉義縣,太保市,12403,37223,19135,18088
2016/2/1,嘉義縣,朴子市,15559,42918,21750,21168
2016/2/1,嘉義縣,布袋鎮,10019,27864,14239,13625
2016/2/1,嘉義縣,大林鎮,11371,31638,16203,15435
2016/2/1,嘉義縣,民雄鄉,24444,71890,36830,35060
2016/2/1,嘉義縣,溪口鄉,5384,15083,8067,7016
2016/2/1,嘉義縣,新港鄉,10633,32746,17287,15459
2016/2/1,嘉義縣,六腳鄉,8969,24137,12820,11317
2016/2/1,嘉義縣,東石鄉,9356,25669,13612,12057
2016/2/1,嘉義縣,義竹鄉,7499,19195,9980,9215
2016/2/1,嘉義縣,鹿草鄉,5781,16062,8626,7436
2016/2/1,嘉義縣,水上鄉,17922,50322,26000,24322
2016/2/1,嘉義縣,中埔鄉,15952,45701,23764,21937
2016/2/1,嘉義縣,竹崎鄉,11701,36482,19491,16991
2016/2/1,嘉義縣,梅山鄉,6767,19969,10620,9349
2016/2/1,嘉義縣,番路鄉,4303,11838,6404,5434
2016/2/1,嘉義縣,大埔鄉,1939,4610,2406,2204
2016/2/1,嘉義縣,阿里山鄉,1962,5698,3014,2684
2016/2/1,屏東縣,屏東市,73719,202405,100445,101960
2016/2/1,屏東縣,潮州鎮,19209,54691,27390,27301
2016/2/1,屏東縣,東港鎮,16441,48188,24364,23824
2016/2/1,屏東縣,恆春鎮,11368,30853,15809,15044
2016/2/1,屏東縣,萬丹鄉,14822,51578,26708,24870
2016/2/1,屏東縣,長治鄉,10032,30303,15788,14515
2016/2/1,屏東縣,麟洛鄉,3763,11249,5846,5403
2016/2/1,屏東縣,九如鄉,6850,22081,11441,10640
2016/2/1,屏東縣,里港鄉,8147,27049,13760,13289
2016/2/1,屏東縣,鹽埔鄉,7842,26374,13716,12658
2016/2/1,屏東縣,高樹鄉,9364,25096,13339,11757
2016/2/1,屏東縣,萬巒鄉,6490,20762,10873,9889
2016/2/1,屏東縣,內埔鄉,18508,55581,28783,26798
2016/2/1,屏東縣,竹田鄉,5658,17518,9286,8232
2016/2/1,屏東縣,新埤鄉,3423,10046,5350,4696
2016/2/1,屏東縣,枋寮鄉,8535,25067,13147,11920
2016/2/1,屏東縣,新園鄉,11752,36071,18678,17393
2016/2/1,屏東縣,崁頂鄉,4466,16130,8183,7947
2016/2/1,屏東縣,林邊鄉,6887,18765,9638,9127
2016/2/1,屏東縣,南州鄉,3686,10857,5574,5283
2016/2/1,屏東縣,佳冬鄉,6977,19855,10322,9533
2016/2/1,屏東縣,琉球鄉,4351,12466,6850,5616
2016/2/1,屏東縣,車城鄉,3479,8880,4793,4087
2016/2/1,屏東縣,滿州鄉,3004,7975,4375,3600
2016/2/1,屏東縣,枋山鄉,2134,5626,2991,2635
2016/2/1,屏東縣,三地門鄉,2291,7698,3888,3810
2016/2/1,屏東縣,霧臺鄉,1056,3329,1707,1622
2016/2/1,屏東縣,瑪家鄉,2023,6775,3460,3315
2016/2/1,屏東縣,泰武鄉,1316,5218,2743,2475
2016/2/1,屏東縣,來義鄉,2233,7564,3854,3710
2016/2/1,屏東縣,春日鄉,1356,4807,2467,2340
2016/2/1,屏東縣,獅子鄉,1531,4795,2483,2312
2016/2/1,屏東縣,牡丹鄉,1868,4756,2439,2317
2016/2/1,臺東縣,臺東市,39320,106756,53633,53123
2016/2/1,臺東縣,成功鎮,5427,14589,7712,6877
2016/2/1,臺東縣,關山鎮,3199,8903,4673,4230
2016/2/1,臺東縣,卑南鄉,6655,17491,9270,8221
2016/2/1,臺東縣,大武鄉,2516,6288,3284,3004
2016/2/1,臺東縣,太麻里鄉,4621,11316,6016,5300
2016/2/1,臺東縣,東河鄉,3765,8812,4852,3960
2016/2/1,臺東縣,長濱鄉,2922,7547,4280,3267
2016/2/1,臺東縣,鹿野鄉,3075,8084,4327,3757
2016/2/1,臺東縣,池上鄉,3234,8496,4437,4059
2016/2/1,臺東縣,綠島鄉,1085,3759,1960,1799
2016/2/1,臺東縣,延平鄉,1073,3560,1909,1651
2016/2/1,臺東縣,海端鄉,1089,4305,2299,2006
2016/2/1,臺東縣,達仁鄉,1448,3589,1953,1636
2016/2/1,臺東縣,金峰鄉,1105,3579,1849,1730
2016/2/1,臺東縣,蘭嶼鄉,1786,5044,2546,2498
2016/2/1,花蓮縣,花蓮市,41397,105671,51172,54499
2016/2/1,花蓮縣,鳳林鎮,4409,11090,5802,5288
2016/2/1,花蓮縣,玉里鎮,8915,24939,13328,11611
2016/2/1,花蓮縣,新城鄉,7616,20185,10428,9757
2016/2/1,花蓮縣,吉安鄉,31489,83310,42156,41154
2016/2/1,花蓮縣,壽豐鄉,7065,18153,9693,8460
2016/2/1,花蓮縣,光復鄉,5030,13180,7007,6173
2016/2/1,花蓮縣,豐濱鄉,1723,4541,2527,2014
2016/2/1,花蓮縣,瑞穗鄉,4710,11910,6412,5498
2016/2/1,花蓮縣,富里鄉,4008,10639,5807,4832
2016/2/1,花蓮縣,秀林鄉,4760,15702,8118,7584
2016/2/1,花蓮縣,萬榮鄉,2077,6432,3395,3037
2016/2/1,花蓮縣,卓溪鄉,1681,6049,3321,2728
2016/2/1,澎湖縣,馬公市,23587,61032,31076,29956
2016/2/1,澎湖縣,湖西鄉,5447,14384,7619,6765
2016/2/1,澎湖縣,白沙鄉,3341,9693,5087,4606
2016/2/1,澎湖縣,西嶼鄉,2944,8405,4324,4081
2016/2/1,澎湖縣,望安鄉,1978,5094,2735,2359
2016/2/1,澎湖縣,七美鄉,1326,3728,1934,1794
2016/2/1,基隆市,中正區,22483,52709,26956,25753
2016/2/1,基隆市,七堵區,21123,54053,27290,26763
2016/2/1,基隆市,暖暖區,15411,38397,19333,19064
2016/2/1,基隆市,仁愛區,19333,45500,22469,23031
2016/2/1,基隆市,中山區,19236,48332,24579,23753
2016/2/1,基隆市,安樂區,32317,81289,40455,40834
2016/2/1,基隆市,信義區,20981,51634,25720,25914
2016/2/1,新竹市,東區,76441,208100,102557,105543
2016/2/1,新竹市,北區,54993,149279,73105,76174
2016/2/1,新竹市,香山區,26247,76900,39181,37719
2016/2/1,嘉義市,東區,45258,122837,59423,63414
2016/2/1,嘉義市,西區,53364,147460,72383,75077
2016/2/1,金門縣,金城鎮,12689,42379,21268,21111
2016/2/1,金門縣,金湖鎮,8599,28430,14317,14113
2016/2/1,金門縣,金沙鎮,6167,20091,9951,10140
2016/2/1,金門縣,金寧鄉,8009,28946,14608,14338
2016/2/1,金門縣,烈嶼鄉,3076,12454,6185,6269
2016/2/1,金門縣,烏坵鄉,133,660,330,330
2016/2/1,連江縣,南竿鄉,1477,7379,4187,3192
2016/2/1,連江縣,北竿鄉,502,2332,1298,1034
2016/2/1,連江縣,莒光鄉,282,1546,921,625
2016/2/1,連江縣,東引鄉,321,1266,763,503
2016/3/1,總計,新北市,1512390,3970790,1950602,2020188
2016/3/1,總計,臺北市,1044184,2704495,1294885,1409610
2016/3/1,總計,桃園市,753275,2114172,1056502,1057670
2016/3/1,總計,臺中市,930242,2748799,1358693,1390106
2016/3/1,總計,臺南市,672858,1885157,943377,941780
2016/3/1,總計,高雄市,1074044,2778240,1380105,1398135
2016/3/1,總計,臺灣省,2451343,7149632,3652095,3497537
2016/3/1,總計,宜蘭縣,165138,457854,232049,225805
2016/3/1,總計,新竹縣,183969,543183,277939,265244
2016/3/1,總計,苗栗縣,184453,562473,290017,272456
2016/3/1,總計,彰化縣,382330,1288945,658206,630739
2016/3/1,總計,南投縣,177009,508146,260615,247531
2016/3/1,總計,雲林縣,238453,698187,363058,335129
2016/3/1,總計,嘉義縣,181964,518507,269986,248521
2016/3/1,總計,屏東縣,284627,839760,430116,409644
2016/3/1,總計,臺東縣,82374,221974,114902,107072
2016/3/1,總計,花蓮縣,124900,331633,169013,162620
2016/3/1,總計,澎湖縣,38693,102332,52773,49559
2016/3/1,總計,基隆市,150916,371882,186732,185150
2016/3/1,總計,新竹市,157877,434492,214940,219552
2016/3/1,總計,嘉義市,98640,270264,131749,138515
2016/3/1,總計,福建省,41297,145528,73823,71705
2016/3/1,總計,金門縣,38690,132998,66653,66345
2016/3/1,總計,連江縣,2607,12530,7170,5360
2016/3/1,新北市,板橋區,205682,553781,270865,282916
2016/3/1,新北市,三重區,148596,388091,191512,196579
2016/3/1,新北市,中和區,163060,413909,201985,211924
2016/3/1,新北市,永和區,90700,225366,107172,118194
2016/3/1,新北市,新莊區,149360,413550,202486,211064
2016/3/1,新北市,新店區,123953,300162,144931,155231
2016/3/1,新北市,樹林區,65481,184274,92060,92214
2016/3/1,新北市,鶯歌區,29447,87745,44014,43731
2016/3/1,新北市,三峽區,41273,112998,56809,56189
2016/3/1,新北市,淡水區,70653,162851,78365,84486
2016/3/1,新北市,汐止區,85048,196137,95928,100209
2016/3/1,新北市,瑞芳區,16148,40869,20648,20221
2016/3/1,新北市,土城區,85954,238628,118074,120554
2016/3/1,新北市,蘆洲區,69590,200111,98519,101592
2016/3/1,新北市,五股區,30077,83064,41905,41159
2016/3/1,新北市,泰山區,28023,78791,39159,39632
2016/3/1,新北市,林口區,39421,101015,49411,51604
2016/3/1,新北市,深坑區,9483,23616,11808,11808
2016/3/1,新北市,石碇區,3375,7836,4321,3515
2016/3/1,新北市,坪林區,2496,6505,3617,2888
2016/3/1,新北市,三芝區,9357,23420,12062,11358
2016/3/1,新北市,石門區,4308,12598,6530,6068
2016/3/1,新北市,八里區,14033,37648,18785,18863
2016/3/1,新北市,平溪區,2355,4851,2676,2175
2016/3/1,新北市,雙溪區,3831,9191,4962,4229
2016/3/1,新北市,貢寮區,4405,12793,6535,6258
2016/3/1,新北市,金山區,7036,22249,11010,11239
2016/3/1,新北市,萬里區,7406,22556,11372,11184
2016/3/1,新北市,烏來區,1839,6185,3081,3104
2016/3/1,臺北市,松山區,80289,209740,98795,110945
2016/3/1,臺北市,信義區,89482,228784,109602,119182
2016/3/1,臺北市,大安區,120369,312958,146339,166619
2016/3/1,臺北市,中山區,99122,231197,107922,123275
2016/3/1,臺北市,中正區,65173,162323,77526,84797
2016/3/1,臺北市,大同區,51536,130958,63950,67008
2016/3/1,臺北市,萬華區,78336,194235,95794,98441
2016/3/1,臺北市,文山區,104571,275701,132560,143141
2016/3/1,臺北市,南港區,46462,122237,59740,62497
2016/3/1,臺北市,內湖區,106649,287758,137708,150050
2016/3/1,臺北市,士林區,106431,290751,140476,150275
2016/3/1,臺北市,北投區,95764,257853,124473,133380
2016/3/1,桃園市,桃園區,160326,429123,208890,220233
2016/3/1,桃園市,中壢區,141942,391063,193224,197839
2016/3/1,桃園市,大溪區,31520,93562,47908,45654
2016/3/1,桃園市,楊梅區,55220,161602,81709,79893
2016/3/1,桃園市,蘆竹區,55573,156076,77757,78319
2016/3/1,桃園市,大園區,30616,85745,44008,41737
2016/3/1,桃園市,龜山區,55685,146008,73218,72790
2016/3/1,桃園市,八德區,66281,188658,94955,93703
2016/3/1,桃園市,龍潭區,40306,118921,59818,59103
2016/3/1,桃園市,平鎮區,74481,218756,109046,109710
2016/3/1,桃園市,新屋區,15815,48631,25986,22645
2016/3/1,桃園市,觀音區,21779,65027,33972,31055
2016/3/1,桃園市,復興區,3731,11000,6011,4989
2016/3/1,臺中市,中區,7902,18994,9475,9519
2016/3/1,臺中市,東區,27371,75150,37497,37653
2016/3/1,臺中市,南區,46824,122146,58825,63321
2016/3/1,臺中市,西區,45113,115769,55121,60648
2016/3/1,臺中市,北區,58581,147559,70764,76795
2016/3/1,臺中市,西屯區,82673,222306,107095,115211
2016/3/1,臺中市,南屯區,59887,164955,79026,85929
2016/3/1,臺中市,北屯區,95252,266063,127996,138067
2016/3/1,臺中市,豐原區,52707,166679,82510,84169
2016/3/1,臺中市,東勢區,17275,51190,26363,24827
2016/3/1,臺中市,大甲區,22762,77854,39235,38619
2016/3/1,臺中市,清水區,26488,86142,44295,41847
2016/3/1,臺中市,沙鹿區,28201,90028,45592,44436
2016/3/1,臺中市,梧棲區,17215,57235,28791,28444
2016/3/1,臺中市,后里區,15702,54247,27595,26652
2016/3/1,臺中市,神岡區,18947,65231,33338,31893
2016/3/1,臺中市,潭子區,35517,106708,52879,53829
2016/3/1,臺中市,大雅區,28491,93742,46866,46876
2016/3/1,臺中市,新社區,7509,25032,13013,12019
2016/3/1,臺中市,石岡區,4897,15287,7938,7349
2016/3/1,臺中市,外埔區,9434,31838,16332,15506
2016/3/1,臺中市,大安區,5409,19479,10281,9198
2016/3/1,臺中市,烏日區,23312,72792,36650,36142
2016/3/1,臺中市,大肚區,17073,56752,29028,27724
2016/3/1,臺中市,龍井區,22375,76713,38821,37892
2016/3/1,臺中市,霧峰區,19771,64711,32925,31786
2016/3/1,臺中市,太平區,61300,184473,91758,92715
2016/3/1,臺中市,大里區,67815,209032,102953,106079
2016/3/1,臺中市,和平區,4439,10692,5731,4961
2016/3/1,臺南市,新營區,28719,78237,38751,39486
2016/3/1,臺南市,鹽水區,10082,26035,13609,12426
2016/3/1,臺南市,白河區,10906,29178,15268,13910
2016/3/1,臺南市,柳營區,7841,21560,11252,10308
2016/3/1,臺南市,後壁區,8884,24221,12568,11653
2016/3/1,臺南市,東山區,8259,21523,11415,10108
2016/3/1,臺南市,麻豆區,15618,44946,22815,22131
2016/3/1,臺南市,下營區,9092,24686,12717,11969
2016/3/1,臺南市,六甲區,7722,22552,11640,10912
2016/3/1,臺南市,官田區,7828,21589,11042,10547
2016/3/1,臺南市,大內區,3908,10022,5366,4656
2016/3/1,臺南市,佳里區,20422,59524,29515,30009
2016/3/1,臺南市,學甲區,9645,26567,13599,12968
2016/3/1,臺南市,西港區,8116,24874,12600,12274
2016/3/1,臺南市,七股區,8056,23357,12103,11254
2016/3/1,臺南市,將軍區,7301,20237,10312,9925
2016/3/1,臺南市,北門區,4309,11468,5812,5656
2016/3/1,臺南市,新化區,14284,43825,22368,21457
2016/3/1,臺南市,善化區,16899,47089,23781,23308
2016/3/1,臺南市,新市區,11779,35937,18059,17878
2016/3/1,臺南市,安定區,9876,30360,15569,14791
2016/3/1,臺南市,山上區,2686,7398,3874,3524
2016/3/1,臺南市,玉井區,5118,14360,7448,6912
2016/3/1,臺南市,楠西區,3536,9987,5297,4690
2016/3/1,臺南市,南化區,2862,8863,4788,4075
2016/3/1,臺南市,左鎮區,1991,5056,2829,2227
2016/3/1,臺南市,仁德區,26915,74038,37646,36392
2016/3/1,臺南市,歸仁區,22290,67972,34559,33413
2016/3/1,臺南市,關廟區,10975,34675,17895,16780
2016/3/1,臺南市,龍崎區,1565,4186,2267,1919
2016/3/1,臺南市,永康區,81930,231047,114046,117001
2016/3/1,臺南市,東區,71704,188590,90618,97972
2016/3/1,臺南市,南區,44965,125700,62459,63241
2016/3/1,臺南市,北區,49989,132692,64748,67944
2016/3/1,臺南市,安南區,61201,189881,95970,93911
2016/3/1,臺南市,安平區,24881,65515,31145,34370
2016/3/1,臺南市,中西區,30704,77410,37627,39783
2016/3/1,高雄市,鹽埕區,10802,24903,12371,12532
2016/3/1,高雄市,鼓山區,56292,136795,66348,70447
2016/3/1,高雄市,左營區,77777,196594,94963,101631
2016/3/1,高雄市,楠梓區,67704,180456,88856,91600
2016/3/1,高雄市,三民區,135219,345796,167799,177997
2016/3/1,高雄市,新興區,22648,51853,25003,26850
2016/3/1,高雄市,前金區,12495,27351,13142,14209
2016/3/1,高雄市,苓雅區,72237,174078,84060,90018
2016/3/1,高雄市,前鎮區,78330,192153,94666,97487
2016/3/1,高雄市,旗津區,11070,28895,14970,13925
2016/3/1,高雄市,小港區,66612,156317,77854,78463
2016/3/1,高雄市,鳳山區,137507,356811,175332,181479
2016/3/1,高雄市,林園區,25585,70361,35683,34678
2016/3/1,高雄市,大寮區,41436,111709,57395,54314
2016/3/1,高雄市,大樹區,13443,43148,22170,20978
2016/3/1,高雄市,大社區,12741,34613,17606,17007
2016/3/1,高雄市,仁武區,31351,82885,42216,40669
2016/3/1,高雄市,鳥松區,17773,43978,22363,21615
2016/3/1,高雄市,岡山區,34653,97804,48619,49185
2016/3/1,高雄市,橋頭區,13284,37356,19028,18328
2016/3/1,高雄市,燕巢區,10395,30027,15903,14124
2016/3/1,高雄市,田寮區,3349,7416,4120,3296
2016/3/1,高雄市,阿蓮區,9361,29246,14743,14503
2016/3/1,高雄市,路竹區,16843,53094,27117,25977
2016/3/1,高雄市,湖內區,10597,29584,15098,14486
2016/3/1,高雄市,茄萣區,10454,30418,15718,14700
2016/3/1,高雄市,永安區,5731,14086,7081,7005
2016/3/1,高雄市,彌陀區,6750,19634,10122,9512
2016/3/1,高雄市,梓官區,12553,36336,18769,17567
2016/3/1,高雄市,旗山區,13828,37665,19517,18148
2016/3/1,高雄市,美濃區,14593,40720,21344,19376
2016/3/1,高雄市,六龜區,5618,13398,7214,6184
2016/3/1,高雄市,甲仙區,2353,6244,3325,2919
2016/3/1,高雄市,杉林區,4815,12364,6753,5611
2016/3/1,高雄市,內門區,5077,14886,8061,6825
2016/3/1,高雄市,茂林區,583,1897,933,964
2016/3/1,高雄市,桃源區,1329,4221,2219,2002
2016/3/1,高雄市,那瑪夏區,856,3148,1624,1524
2016/3/1,宜蘭縣,宜蘭市,35671,96063,46941,49122
2016/3/1,宜蘭縣,羅東鎮,26088,72443,34425,38018
2016/3/1,宜蘭縣,蘇澳鎮,14083,40624,20704,19920
2016/3/1,宜蘭縣,頭城鎮,10133,29751,15336,14415
2016/3/1,宜蘭縣,礁溪鄉,13578,35809,18685,17124
2016/3/1,宜蘭縣,壯圍鄉,8553,24230,12828,11402
2016/3/1,宜蘭縣,員山鄉,11517,32254,17108,15146
2016/3/1,宜蘭縣,冬山鄉,18908,53572,27528,26044
2016/3/1,宜蘭縣,五結鄉,14463,39599,20510,19089
2016/3/1,宜蘭縣,三星鄉,8333,21420,11542,9878
2016/3/1,宜蘭縣,大同鄉,1888,6068,3293,2775
2016/3/1,宜蘭縣,南澳鄉,1923,6021,3149,2872
2016/3/1,新竹縣,竹北市,61110,171998,85694,86304
2016/3/1,新竹縣,關西鎮,9517,29775,15923,13852
2016/3/1,新竹縣,新埔鎮,10657,34048,18130,15918
2016/3/1,新竹縣,竹東鎮,33080,96630,48551,48079
2016/3/1,新竹縣,湖口鄉,25789,77326,39277,38049
2016/3/1,新竹縣,橫山鄉,4488,13466,7302,6164
2016/3/1,新竹縣,新豐鄉,17850,56229,28836,27393
2016/3/1,新竹縣,芎林鄉,6479,20245,10734,9511
2016/3/1,新竹縣,寶山鄉,5208,14281,7725,6556
2016/3/1,新竹縣,北埔鄉,3124,9646,5219,4427
2016/3/1,新竹縣,峨眉鄉,2083,5632,3113,2519
2016/3/1,新竹縣,尖石鄉,2846,9325,4943,4382
2016/3/1,新竹縣,五峰鄉,1738,4582,2492,2090
2016/3/1,苗栗縣,苗栗市,30727,90315,45134,45181
2016/3/1,苗栗縣,頭份市,33588,103198,52073,51125
2016/3/1,苗栗縣,苑裡鎮,14461,47555,24706,22849
2016/3/1,苗栗縣,通霄鎮,11537,35955,18981,16974
2016/3/1,苗栗縣,竹南鎮,27974,84658,42712,41946
2016/3/1,苗栗縣,後龍鎮,11862,37683,19881,17802
2016/3/1,苗栗縣,卓蘭鎮,6107,17918,9365,8553
2016/3/1,苗栗縣,大湖鄉,5419,15198,8073,7125
2016/3/1,苗栗縣,公館鄉,10622,34477,17939,16538
2016/3/1,苗栗縣,銅鑼鄉,6147,18626,9863,8763
2016/3/1,苗栗縣,南庄鄉,3972,10516,5796,4720
2016/3/1,苗栗縣,頭屋鄉,3647,11167,5896,5271
2016/3/1,苗栗縣,三義鄉,5489,16970,8909,8061
2016/3/1,苗栗縣,西湖鄉,2676,7409,4124,3285
2016/3/1,苗栗縣,造橋鄉,4122,13282,6976,6306
2016/3/1,苗栗縣,三灣鄉,2412,6970,3814,3156
2016/3/1,苗栗縣,獅潭鄉,1727,4576,2560,2016
2016/3/1,苗栗縣,泰安鄉,1964,6000,3215,2785
2016/3/1,彰化縣,彰化市,75591,235124,116366,118758
2016/3/1,彰化縣,員林市,38738,125068,62282,62786
2016/3/1,彰化縣,鹿港鎮,24104,86492,44044,42448
2016/3/1,彰化縣,和美鎮,26344,91158,46510,44648
2016/3/1,彰化縣,北斗鎮,10538,33229,16753,16476
2016/3/1,彰化縣,溪湖鎮,16108,55753,28359,27394
2016/3/1,彰化縣,田中鎮,13039,42384,21921,20463
2016/3/1,彰化縣,二林鎮,14886,51820,26688,25132
2016/3/1,彰化縣,線西鄉,4330,17004,8797,8207
2016/3/1,彰化縣,伸港鄉,9670,36546,18671,17875
2016/3/1,彰化縣,福興鄉,12589,47589,24782,22807
2016/3/1,彰化縣,秀水鄉,10549,39351,20320,19031
2016/3/1,彰化縣,花壇鄉,13839,46025,23656,22369
2016/3/1,彰化縣,芬園鄉,6867,23977,12615,11362
2016/3/1,彰化縣,大村鄉,10910,36597,18972,17625
2016/3/1,彰化縣,埔鹽鄉,8995,32892,17268,15624
2016/3/1,彰化縣,埔心鄉,10409,34740,17912,16828
2016/3/1,彰化縣,永靖鄉,10844,37928,19720,18208
2016/3/1,彰化縣,社頭鄉,12805,43483,22325,21158
2016/3/1,彰化縣,二水鄉,5336,15604,8181,7423
2016/3/1,彰化縣,田尾鄉,7898,27591,14265,13326
2016/3/1,彰化縣,埤頭鄉,8947,30844,16022,14822
2016/3/1,彰化縣,芳苑鄉,10129,34198,18103,16095
2016/3/1,彰化縣,大城鄉,5311,17460,9470,7990
2016/3/1,彰化縣,竹塘鄉,4623,15576,8213,7363
2016/3/1,彰化縣,溪州鄉,8931,30512,15991,14521
2016/3/1,南投縣,南投市,34489,101481,50902,50579
2016/3/1,南投縣,埔里鎮,28933,82049,41127,40922
2016/3/1,南投縣,草屯鎮,32822,98677,49866,48811
2016/3/1,南投縣,竹山鎮,20021,55878,28685,27193
2016/3/1,南投縣,集集鎮,4337,11190,5819,5371
2016/3/1,南投縣,名間鄉,12582,39443,20732,18711
2016/3/1,南投縣,鹿谷鄉,7752,18146,9668,8478
2016/3/1,南投縣,中寮鄉,5655,15285,8307,6978
2016/3/1,南投縣,魚池鄉,5761,16284,8532,7752
2016/3/1,南投縣,國姓鄉,7301,19275,10437,8838
2016/3/1,南投縣,水里鄉,7191,18242,9568,8674
2016/3/1,南投縣,信義鄉,5228,16458,8831,7627
2016/3/1,南投縣,仁愛鄉,4937,15738,8141,7597
2016/3/1,雲林縣,斗六市,37597,108472,54113,54359
2016/3/1,雲林縣,斗南鎮,15763,45535,23147,22388
2016/3/1,雲林縣,虎尾鎮,24437,70625,35844,34781
2016/3/1,雲林縣,西螺鎮,14496,46770,23735,23035
2016/3/1,雲林縣,土庫鎮,9241,29404,15370,14034
2016/3/1,雲林縣,北港鎮,15882,40925,21250,19675
2016/3/1,雲林縣,古坑鄉,10954,32184,16980,15204
2016/3/1,雲林縣,大埤鄉,6723,19642,10572,9070
2016/3/1,雲林縣,莿桐鄉,9244,29187,15330,13857
2016/3/1,雲林縣,林內鄉,5926,18607,9726,8881
2016/3/1,雲林縣,二崙鄉,8907,27820,14901,12919
2016/3/1,雲林縣,崙背鄉,8502,25384,13432,11952
2016/3/1,雲林縣,麥寮鄉,14026,44503,22486,22017
2016/3/1,雲林縣,東勢鄉,5724,15346,8445,6901
2016/3/1,雲林縣,褒忠鄉,4421,13330,7152,6178
2016/3/1,雲林縣,臺西鄉,8719,24443,13102,11341
2016/3/1,雲林縣,元長鄉,9325,26686,14575,12111
2016/3/1,雲林縣,四湖鄉,8882,24562,13345,11217
2016/3/1,雲林縣,口湖鄉,9581,28361,15071,13290
2016/3/1,雲林縣,水林鄉,10103,26401,14482,11919
2016/3/1,嘉義縣,太保市,12409,37243,19148,18095
2016/3/1,嘉義縣,朴子市,15555,42907,21738,21169
2016/3/1,嘉義縣,布袋鎮,10006,27819,14217,13602
2016/3/1,嘉義縣,大林鎮,11375,31610,16198,15412
2016/3/1,嘉義縣,民雄鄉,24465,71926,36839,35087
2016/3/1,嘉義縣,溪口鄉,5383,15057,8057,7000
2016/3/1,嘉義縣,新港鄉,10637,32698,17254,15444
2016/3/1,嘉義縣,六腳鄉,8963,24096,12801,11295
2016/3/1,嘉義縣,東石鄉,9352,25608,13594,12014
2016/3/1,嘉義縣,義竹鄉,7495,19142,9959,9183
2016/3/1,嘉義縣,鹿草鄉,5777,16010,8594,7416
2016/3/1,嘉義縣,水上鄉,17938,50298,25984,24314
2016/3/1,嘉義縣,中埔鄉,15949,45596,23726,21870
2016/3/1,嘉義縣,竹崎鄉,11699,36439,19469,16970
2016/3/1,嘉義縣,梅山鄉,6762,19943,10605,9338
2016/3/1,嘉義縣,番路鄉,4297,11806,6387,5419
2016/3/1,嘉義縣,大埔鄉,1938,4610,2404,2206
2016/3/1,嘉義縣,阿里山鄉,1964,5699,3012,2687
2016/3/1,屏東縣,屏東市,73681,202382,100404,101978
2016/3/1,屏東縣,潮州鎮,19227,54729,27414,27315
2016/3/1,屏東縣,東港鎮,16471,48238,24389,23849
2016/3/1,屏東縣,恆春鎮,11396,30846,15797,15049
2016/3/1,屏東縣,萬丹鄉,14825,51522,26671,24851
2016/3/1,屏東縣,長治鄉,10032,30255,15762,14493
2016/3/1,屏東縣,麟洛鄉,3763,11214,5824,5390
2016/3/1,屏東縣,九如鄉,6862,22069,11427,10642
2016/3/1,屏東縣,里港鄉,8159,27067,13772,13295
2016/3/1,屏東縣,鹽埔鄉,7835,26320,13689,12631
2016/3/1,屏東縣,高樹鄉,9357,25059,13331,11728
2016/3/1,屏東縣,萬巒鄉,6495,20751,10868,9883
2016/3/1,屏東縣,內埔鄉,18521,55521,28757,26764
2016/3/1,屏東縣,竹田鄉,5653,17495,9283,8212
2016/3/1,屏東縣,新埤鄉,3423,10039,5352,4687
2016/3/1,屏東縣,枋寮鄉,8531,25039,13134,11905
2016/3/1,屏東縣,新園鄉,11753,35989,18629,17360
2016/3/1,屏東縣,崁頂鄉,4466,16057,8141,7916
2016/3/1,屏東縣,林邊鄉,6848,18671,9586,9085
2016/3/1,屏東縣,南州鄉,3690,10857,5572,5285
2016/3/1,屏東縣,佳冬鄉,6975,19820,10308,9512
2016/3/1,屏東縣,琉球鄉,4357,12436,6842,5594
2016/3/1,屏東縣,車城鄉,3474,8858,4774,4084
2016/3/1,屏東縣,滿州鄉,3002,7953,4361,3592
2016/3/1,屏東縣,枋山鄉,2133,5611,2980,2631
2016/3/1,屏東縣,三地門鄉,2299,7696,3890,3806
2016/3/1,屏東縣,霧臺鄉,1057,3313,1701,1612
2016/3/1,屏東縣,瑪家鄉,2023,6773,3451,3322
2016/3/1,屏東縣,泰武鄉,1319,5221,2742,2479
2016/3/1,屏東縣,來義鄉,2233,7560,3854,3706
2016/3/1,屏東縣,春日鄉,1356,4807,2471,2336
2016/3/1,屏東縣,獅子鄉,1533,4810,2486,2324
2016/3/1,屏東縣,牡丹鄉,1878,4782,2454,2328
2016/3/1,臺東縣,臺東市,39355,106760,53611,53149
2016/3/1,臺東縣,成功鎮,5427,14580,7709,6871
2016/3/1,臺東縣,關山鎮,3205,8902,4676,4226
2016/3/1,臺東縣,卑南鄉,6663,17498,9272,8226
2016/3/1,臺東縣,大武鄉,2515,6263,3269,2994
2016/3/1,臺東縣,太麻里鄉,4618,11324,6027,5297
2016/3/1,臺東縣,東河鄉,3782,8816,4860,3956
2016/3/1,臺東縣,長濱鄉,2921,7513,4263,3250
2016/3/1,臺東縣,鹿野鄉,3068,8056,4310,3746
2016/3/1,臺東縣,池上鄉,3228,8472,4425,4047
2016/3/1,臺東縣,綠島鄉,1091,3757,1959,1798
2016/3/1,臺東縣,延平鄉,1064,3547,1902,1645
2016/3/1,臺東縣,海端鄉,1086,4292,2288,2004
2016/3/1,臺東縣,達仁鄉,1448,3579,1947,1632
2016/3/1,臺東縣,金峰鄉,1108,3577,1848,1729
2016/3/1,臺東縣,蘭嶼鄉,1795,5038,2536,2502
2016/3/1,花蓮縣,花蓮市,41399,105620,51131,54489
2016/3/1,花蓮縣,鳳林鎮,4408,11097,5802,5295
2016/3/1,花蓮縣,玉里鎮,8918,24906,13306,11600
2016/3/1,花蓮縣,新城鄉,7612,20180,10404,9776
2016/3/1,花蓮縣,吉安鄉,31495,83282,42109,41173
2016/3/1,花蓮縣,壽豐鄉,7067,18113,9666,8447
2016/3/1,花蓮縣,光復鄉,5025,13174,7003,6171
2016/3/1,花蓮縣,豐濱鄉,1727,4533,2526,2007
2016/3/1,花蓮縣,瑞穗鄉,4716,11893,6406,5487
2016/3/1,花蓮縣,富里鄉,4014,10636,5804,4832
2016/3/1,花蓮縣,秀林鄉,4763,15709,8130,7579
2016/3/1,花蓮縣,萬榮鄉,2076,6436,3405,3031
2016/3/1,花蓮縣,卓溪鄉,1680,6054,3321,2733
2016/3/1,澎湖縣,馬公市,23628,61061,31091,29970
2016/3/1,澎湖縣,湖西鄉,5448,14368,7611,6757
2016/3/1,澎湖縣,白沙鄉,3350,9697,5078,4619
2016/3/1,澎湖縣,西嶼鄉,2946,8389,4324,4065
2016/3/1,澎湖縣,望安鄉,1987,5093,2734,2359
2016/3/1,澎湖縣,七美鄉,1334,3724,1935,1789
2016/3/1,基隆市,中正區,22503,52744,26980,25764
2016/3/1,基隆市,七堵區,21142,54075,27305,26770
2016/3/1,基隆市,暖暖區,15421,38415,19338,19077
2016/3/1,基隆市,仁愛區,19322,45504,22444,23060
2016/3/1,基隆市,中山區,19226,48293,24540,23753
2016/3/1,基隆市,安樂區,32327,81255,40438,40817
2016/3/1,基隆市,信義區,20975,51596,25687,25909
2016/3/1,新竹市,東區,76520,208200,102590,105610
2016/3/1,新竹市,北區,55075,149300,73146,76154
2016/3/1,新竹市,香山區,26282,76992,39204,37788
2016/3/1,嘉義市,東區,45292,122875,59441,63434
2016/3/1,嘉義市,西區,53348,147389,72308,75081
2016/3/1,金門縣,金城鎮,12684,42379,21235,21144
2016/3/1,金門縣,金湖鎮,8597,28400,14315,14085
2016/3/1,金門縣,金沙鎮,6176,20103,9961,10142
2016/3/1,金門縣,金寧鄉,8023,28988,14629,14359
2016/3/1,金門縣,烈嶼鄉,3077,12466,6184,6282
2016/3/1,金門縣,烏坵鄉,133,662,329,333
2016/3/1,連江縣,南竿鄉,1489,7376,4185,3191
2016/3/1,連江縣,北竿鄉,509,2334,1299,1035
2016/3/1,連江縣,莒光鄉,285,1543,917,626
2016/3/1,連江縣,東引鄉,324,1277,769,508
2016/4/1,總計,新北市,1513013,3971000,1950343,2020657
2016/4/1,總計,臺北市,1044441,2703829,1294385,1409444
2016/4/1,總計,桃園市,754504,2116988,1057689,1059299
2016/4/1,總計,臺中市,931077,2750322,1359218,1391104
2016/4/1,總計,臺南市,673174,1885252,943384,941868
2016/4/1,總計,高雄市,1074436,2778107,1379945,1398162
2016/4/1,總計,臺灣省,2452634,7148298,3651094,3497204
2016/4/1,總計,宜蘭縣,165359,457815,232010,225805
2016/4/1,總計,新竹縣,184271,543600,278146,265454
2016/4/1,總計,苗栗縣,184508,562133,289823,272310
2016/4/1,總計,彰化縣,382521,1288923,658126,630797
2016/4/1,總計,南投縣,176999,507852,260459,247393
2016/4/1,總計,雲林縣,238531,697752,362758,334994
2016/4/1,總計,嘉義縣,181977,518026,269686,248340
2016/4/1,總計,屏東縣,284724,839339,429885,409454
2016/4/1,總計,臺東縣,82435,221817,114827,106990
2016/4/1,總計,花蓮縣,124946,331498,168902,162596
2016/4/1,總計,澎湖縣,38723,102369,52793,49576
2016/4/1,總計,基隆市,150981,372037,186805,185232
2016/4/1,總計,新竹市,158041,434674,215046,219628
2016/4/1,總計,嘉義市,98618,270463,131828,138635
2016/4/1,總計,福建省,41347,145608,73840,71768
2016/4/1,總計,金門縣,38734,133086,66681,66405
2016/4/1,總計,連江縣,2613,12522,7159,5363
2016/4/1,新北市,板橋區,205653,553595,270713,282882
2016/4/1,新北市,三重區,148757,388153,191510,196643
2016/4/1,新北市,中和區,163082,413876,201956,211920
2016/4/1,新北市,永和區,90648,225256,107114,118142
2016/4/1,新北市,新莊區,149463,413592,202438,211154
2016/4/1,新北市,新店區,123952,300007,144798,155209
2016/4/1,新北市,樹林區,65493,184245,92068,92177
2016/4/1,新北市,鶯歌區,29455,87669,43969,43700
2016/4/1,新北市,三峽區,41334,113146,56862,56284
2016/4/1,新北市,淡水區,70773,163141,78508,84633
2016/4/1,新北市,汐止區,85080,196208,95923,100285
2016/4/1,新北市,瑞芳區,16152,40820,20624,20196
2016/4/1,新北市,土城區,85966,238606,118026,120580
2016/4/1,新北市,蘆洲區,69616,200109,98526,101583
2016/4/1,新北市,五股區,30125,83157,41961,41196
2016/4/1,新北市,泰山區,28042,78861,39188,39673
2016/4/1,新北市,林口區,39505,101280,49532,51748
2016/4/1,新北市,深坑區,9471,23589,11789,11800
2016/4/1,新北市,石碇區,3372,7808,4305,3503
2016/4/1,新北市,坪林區,2501,6502,3608,2894
2016/4/1,新北市,三芝區,9349,23395,12039,11356
2016/4/1,新北市,石門區,4306,12590,6521,6069
2016/4/1,新北市,八里區,14059,37686,18796,18890
2016/4/1,新北市,平溪區,2348,4824,2669,2155
2016/4/1,新北市,雙溪區,3825,9186,4963,4223
2016/4/1,新北市,貢寮區,4402,12790,6529,6261
2016/4/1,新北市,金山區,7036,22221,10991,11230
2016/4/1,新北市,萬里區,7407,22512,11342,11170
2016/4/1,新北市,烏來區,1841,6176,3075,3101
2016/4/1,臺北市,松山區,80295,209638,98710,110928
2016/4/1,臺北市,信義區,89460,228608,109475,119133
2016/4/1,臺北市,大安區,120431,312993,146344,166649
2016/4/1,臺北市,中山區,99134,231116,107861,123255
2016/4/1,臺北市,中正區,65178,162334,77570,84764
2016/4/1,臺北市,大同區,51523,130833,63905,66928
2016/4/1,臺北市,萬華區,78338,194100,95699,98401
2016/4/1,臺北市,文山區,104617,275631,132464,143167
2016/4/1,臺北市,南港區,46495,122223,59746,62477
2016/4/1,臺北市,內湖區,106718,287753,137677,150076
2016/4/1,臺北市,士林區,106443,290757,140481,150276
2016/4/1,臺北市,北投區,95809,257843,124453,133390
2016/4/1,桃園市,桃園區,160568,429816,209196,220620
2016/4/1,桃園市,中壢區,142194,391541,193424,198117
2016/4/1,桃園市,大溪區,31543,93635,47935,45700
2016/4/1,桃園市,楊梅區,55315,161816,81811,80005
2016/4/1,桃園市,蘆竹區,55661,156193,77805,78388
2016/4/1,桃園市,大園區,30646,85870,44053,41817
2016/4/1,桃園市,龜山區,55796,146292,73330,72962
2016/4/1,桃園市,八德區,66429,189057,95129,93928
2016/4/1,桃園市,龍潭區,40372,119054,59878,59176
2016/4/1,桃園市,平鎮區,74594,219029,109127,109902
2016/4/1,桃園市,新屋區,15837,48642,25988,22654
2016/4/1,桃園市,觀音區,21813,65048,34003,31045
2016/4/1,桃園市,復興區,3736,10995,6010,4985
2016/4/1,臺中市,中區,7911,18945,9452,9493
2016/4/1,臺中市,東區,27386,75149,37491,37658
2016/4/1,臺中市,南區,46846,122270,58872,63398
2016/4/1,臺中市,西區,45118,115765,55135,60630
2016/4/1,臺中市,北區,58608,147616,70775,76841
2016/4/1,臺中市,西屯區,82736,222516,107178,115338
2016/4/1,臺中市,南屯區,59968,165082,79070,86012
2016/4/1,臺中市,北屯區,95408,266451,128170,138281
2016/4/1,臺中市,豐原區,52751,166768,82540,84228
2016/4/1,臺中市,東勢區,17281,51191,26357,24834
2016/4/1,臺中市,大甲區,22757,77822,39212,38610
2016/4/1,臺中市,清水區,26527,86206,44315,41891
2016/4/1,臺中市,沙鹿區,28253,90209,45682,44527
2016/4/1,臺中市,梧棲區,17240,57266,28804,28462
2016/4/1,臺中市,后里區,15699,54226,27572,26654
2016/4/1,臺中市,神岡區,18945,65180,33316,31864
2016/4/1,臺中市,潭子區,35532,106702,52860,53842
2016/4/1,臺中市,大雅區,28518,93785,46879,46906
2016/4/1,臺中市,新社區,7506,25036,13015,12021
2016/4/1,臺中市,石岡區,4897,15278,7926,7352
2016/4/1,臺中市,外埔區,9448,31854,16335,15519
2016/4/1,臺中市,大安區,5407,19469,10280,9189
2016/4/1,臺中市,烏日區,23360,72863,36662,36201
2016/4/1,臺中市,大肚區,17100,56837,29062,27775
2016/4/1,臺中市,龍井區,22384,76696,38803,37893
2016/4/1,臺中市,霧峰區,19775,64696,32915,31781
2016/4/1,臺中市,太平區,61387,184649,91820,92829
2016/4/1,臺中市,大里區,67873,209092,102987,106105
2016/4/1,臺中市,和平區,4456,10703,5733,4970
2016/4/1,臺南市,新營區,28733,78245,38738,39507
2016/4/1,臺南市,鹽水區,10071,26010,13600,12410
2016/4/1,臺南市,白河區,10898,29129,15237,13892
2016/4/1,臺南市,柳營區,7837,21544,11250,10294
2016/4/1,臺南市,後壁區,8888,24234,12580,11654
2016/4/1,臺南市,東山區,8263,21517,11421,10096
2016/4/1,臺南市,麻豆區,15627,44924,22814,22110
2016/4/1,臺南市,下營區,9101,24666,12704,11962
2016/4/1,臺南市,六甲區,7720,22543,11636,10907
2016/4/1,臺南市,官田區,7835,21570,11032,10538
2016/4/1,臺南市,大內區,3901,9991,5349,4642
2016/4/1,臺南市,佳里區,20435,59579,29529,30050
2016/4/1,臺南市,學甲區,9648,26538,13577,12961
2016/4/1,臺南市,西港區,8113,24868,12605,12263
2016/4/1,臺南市,七股區,8054,23313,12080,11233
2016/4/1,臺南市,將軍區,7293,20201,10296,9905
2016/4/1,臺南市,北門區,4306,11445,5802,5643
2016/4/1,臺南市,新化區,14294,43846,22371,21475
2016/4/1,臺南市,善化區,16931,47150,23794,23356
2016/4/1,臺南市,新市區,11793,35978,18086,17892
2016/4/1,臺南市,安定區,9883,30385,15584,14801
2016/4/1,臺南市,山上區,2690,7391,3872,3519
2016/4/1,臺南市,玉井區,5113,14355,7446,6909
2016/4/1,臺南市,楠西區,3540,9973,5292,4681
2016/4/1,臺南市,南化區,2863,8859,4788,4071
2016/4/1,臺南市,左鎮區,1991,5048,2821,2227
2016/4/1,臺南市,仁德區,26950,74126,37697,36429
2016/4/1,臺南市,歸仁區,22309,67986,34554,33432
2016/4/1,臺南市,關廟區,10991,34669,17900,16769
2016/4/1,臺南市,龍崎區,1565,4165,2256,1909
2016/4/1,臺南市,永康區,81963,231191,114107,117084
2016/4/1,臺南市,東區,71699,188470,90555,97915
2016/4/1,臺南市,南區,44989,125661,62427,63234
2016/4/1,臺南市,北區,50039,132799,64787,68012
2016/4/1,臺南市,安南區,61251,190024,96029,93995
2016/4/1,臺南市,安平區,24896,65508,31154,34354
2016/4/1,臺南市,中西區,30701,77351,37614,39737
2016/4/1,高雄市,鹽埕區,10802,24877,12360,12517
2016/4/1,高雄市,鼓山區,56337,136888,66386,70502
2016/4/1,高雄市,左營區,77800,196610,94953,101657
2016/4/1,高雄市,楠梓區,67795,180508,88885,91623
2016/4/1,高雄市,三民區,135203,345644,167701,177943
2016/4/1,高雄市,新興區,22656,51815,24986,26829
2016/4/1,高雄市,前金區,12495,27356,13142,14214
2016/4/1,高雄市,苓雅區,72217,174012,84014,89998
2016/4/1,高雄市,前鎮區,78322,192071,94630,97441
2016/4/1,高雄市,旗津區,11077,28891,14968,13923
2016/4/1,高雄市,小港區,66637,156285,77831,78454
2016/4/1,高雄市,鳳山區,137558,356940,175391,181549
2016/4/1,高雄市,林園區,25587,70335,35666,34669
2016/4/1,高雄市,大寮區,41458,111767,57389,54378
2016/4/1,高雄市,大樹區,13455,43153,22163,20990
2016/4/1,高雄市,大社區,12745,34613,17608,17005
2016/4/1,高雄市,仁武區,31431,83004,42260,40744
2016/4/1,高雄市,鳥松區,17784,43958,22361,21597
2016/4/1,高雄市,岡山區,34679,97822,48616,49206
2016/4/1,高雄市,橋頭區,13289,37330,19023,18307
2016/4/1,高雄市,燕巢區,10412,30012,15893,14119
2016/4/1,高雄市,田寮區,3343,7406,4113,3293
2016/4/1,高雄市,阿蓮區,9374,29255,14757,14498
2016/4/1,高雄市,路竹區,16846,53088,27115,25973
2016/4/1,高雄市,湖內區,10604,29618,15118,14500
2016/4/1,高雄市,茄萣區,10457,30396,15709,14687
2016/4/1,高雄市,永安區,5727,14074,7079,6995
2016/4/1,高雄市,彌陀區,6754,19642,10124,9518
2016/4/1,高雄市,梓官區,12559,36336,18772,17564
2016/4/1,高雄市,旗山區,13820,37651,19523,18128
2016/4/1,高雄市,美濃區,14596,40672,21322,19350
2016/4/1,高雄市,六龜區,5608,13369,7199,6170
2016/4/1,高雄市,甲仙區,2358,6251,3324,2927
2016/4/1,高雄市,杉林區,4811,12345,6735,5610
2016/4/1,高雄市,內門區,5077,14857,8052,6805
2016/4/1,高雄市,茂林區,581,1896,934,962
2016/4/1,高雄市,桃源區,1328,4218,2218,2000
2016/4/1,高雄市,那瑪夏區,854,3142,1625,1517
2016/4/1,宜蘭縣,宜蘭市,35686,96079,46966,49113
2016/4/1,宜蘭縣,羅東鎮,26127,72501,34458,38043
2016/4/1,宜蘭縣,蘇澳鎮,14096,40603,20674,19929
2016/4/1,宜蘭縣,頭城鎮,10152,29752,15329,14423
2016/4/1,宜蘭縣,礁溪鄉,13612,35841,18679,17162
2016/4/1,宜蘭縣,壯圍鄉,8566,24252,12833,11419
2016/4/1,宜蘭縣,員山鄉,11519,32246,17096,15150
2016/4/1,宜蘭縣,冬山鄉,18927,53430,27469,25961
2016/4/1,宜蘭縣,五結鄉,14504,39606,20516,19090
2016/4/1,宜蘭縣,三星鄉,8354,21428,11547,9881
2016/4/1,宜蘭縣,大同鄉,1889,6063,3296,2767
2016/4/1,宜蘭縣,南澳鄉,1927,6014,3147,2867
2016/4/1,新竹縣,竹北市,61302,172490,85939,86551
2016/4/1,新竹縣,關西鎮,9513,29723,15904,13819
2016/4/1,新竹縣,新埔鎮,10658,34020,18123,15897
2016/4/1,新竹縣,竹東鎮,33135,96696,48576,48120
2016/4/1,新竹縣,湖口鄉,25822,77336,39264,38072
2016/4/1,新竹縣,橫山鄉,4493,13452,7293,6159
2016/4/1,新竹縣,新豐鄉,17863,56251,28864,27387
2016/4/1,新竹縣,芎林鄉,6478,20216,10710,9506
2016/4/1,新竹縣,寶山鄉,5213,14281,7722,6559
2016/4/1,新竹縣,北埔鄉,3122,9624,5214,4410
2016/4/1,新竹縣,峨眉鄉,2086,5630,3111,2519
2016/4/1,新竹縣,尖石鄉,2846,9311,4946,4365
2016/4/1,新竹縣,五峰鄉,1740,4570,2480,2090
2016/4/1,苗栗縣,苗栗市,30748,90273,45113,45160
2016/4/1,苗栗縣,頭份市,33595,103134,52022,51112
2016/4/1,苗栗縣,苑裡鎮,14459,47501,24678,22823
2016/4/1,苗栗縣,通霄鎮,11544,35940,18973,16967
2016/4/1,苗栗縣,竹南鎮,28008,84698,42724,41974
2016/4/1,苗栗縣,後龍鎮,11865,37639,19853,17786
2016/4/1,苗栗縣,卓蘭鎮,6103,17870,9348,8522
2016/4/1,苗栗縣,大湖鄉,5413,15212,8072,7140
2016/4/1,苗栗縣,公館鄉,10620,34454,17934,16520
2016/4/1,苗栗縣,銅鑼鄉,6143,18608,9857,8751
2016/4/1,苗栗縣,南庄鄉,3968,10501,5787,4714
2016/4/1,苗栗縣,頭屋鄉,3643,11147,5890,5257
2016/4/1,苗栗縣,三義鄉,5494,16966,8913,8053
2016/4/1,苗栗縣,西湖鄉,2675,7405,4119,3286
2016/4/1,苗栗縣,造橋鄉,4120,13278,6971,6307
2016/4/1,苗栗縣,三灣鄉,2416,6957,3804,3153
2016/4/1,苗栗縣,獅潭鄉,1727,4561,2553,2008
2016/4/1,苗栗縣,泰安鄉,1967,5989,3212,2777
2016/4/1,彰化縣,彰化市,75636,235157,116368,118789
2016/4/1,彰化縣,員林市,38733,125099,62281,62818
2016/4/1,彰化縣,鹿港鎮,24133,86543,44070,42473
2016/4/1,彰化縣,和美鎮,26358,91169,46516,44653
2016/4/1,彰化縣,北斗鎮,10542,33245,16765,16480
2016/4/1,彰化縣,溪湖鎮,16123,55756,28349,27407
2016/4/1,彰化縣,田中鎮,13051,42359,21901,20458
2016/4/1,彰化縣,二林鎮,14905,51814,26687,25127
2016/4/1,彰化縣,線西鄉,4330,17003,8794,8209
2016/4/1,彰化縣,伸港鄉,9679,36547,18662,17885
2016/4/1,彰化縣,福興鄉,12597,47559,24764,22795
2016/4/1,彰化縣,秀水鄉,10551,39362,20330,19032
2016/4/1,彰化縣,花壇鄉,13845,46028,23670,22358
2016/4/1,彰化縣,芬園鄉,6862,23962,12608,11354
2016/4/1,彰化縣,大村鄉,10924,36610,18970,17640
2016/4/1,彰化縣,埔鹽鄉,9005,32881,17265,15616
2016/4/1,彰化縣,埔心鄉,10412,34721,17898,16823
2016/4/1,彰化縣,永靖鄉,10856,37952,19721,18231
2016/4/1,彰化縣,社頭鄉,12805,43457,22305,21152
2016/4/1,彰化縣,二水鄉,5332,15592,8177,7415
2016/4/1,彰化縣,田尾鄉,7895,27587,14257,13330
2016/4/1,彰化縣,埤頭鄉,8949,30843,16029,14814
2016/4/1,彰化縣,芳苑鄉,10127,34166,18085,16081
2016/4/1,彰化縣,大城鄉,5308,17439,9462,7977
2016/4/1,彰化縣,竹塘鄉,4625,15570,8208,7362
2016/4/1,彰化縣,溪州鄉,8938,30502,15984,14518
2016/4/1,南投縣,南投市,34498,101456,50900,50556
2016/4/1,南投縣,埔里鎮,28930,82036,41113,40923
2016/4/1,南投縣,草屯鎮,32824,98682,49855,48827
2016/4/1,南投縣,竹山鎮,20018,55845,28672,27173
2016/4/1,南投縣,集集鎮,4330,11153,5800,5353
2016/4/1,南投縣,名間鄉,12578,39416,20721,18695
2016/4/1,南投縣,鹿谷鄉,7763,18116,9655,8461
2016/4/1,南投縣,中寮鄉,5652,15248,8291,6957
2016/4/1,南投縣,魚池鄉,5757,16280,8532,7748
2016/4/1,南投縣,國姓鄉,7299,19229,10402,8827
2016/4/1,南投縣,水里鄉,7189,18209,9546,8663
2016/4/1,南投縣,信義鄉,5228,16457,8830,7627
2016/4/1,南投縣,仁愛鄉,4933,15725,8142,7583
2016/4/1,雲林縣,斗六市,37620,108482,54125,54357
2016/4/1,雲林縣,斗南鎮,15790,45528,23134,22394
2016/4/1,雲林縣,虎尾鎮,24444,70580,35801,34779
2016/4/1,雲林縣,西螺鎮,14517,46764,23711,23053
2016/4/1,雲林縣,土庫鎮,9261,29413,15376,14037
2016/4/1,雲林縣,北港鎮,15868,40893,21225,19668
2016/4/1,雲林縣,古坑鄉,10946,32153,16965,15188
2016/4/1,雲林縣,大埤鄉,6722,19595,10549,9046
2016/4/1,雲林縣,莿桐鄉,9247,29139,15299,13840
2016/4/1,雲林縣,林內鄉,5937,18665,9756,8909
2016/4/1,雲林縣,二崙鄉,8905,27808,14902,12906
2016/4/1,雲林縣,崙背鄉,8495,25355,13415,11940
2016/4/1,雲林縣,麥寮鄉,14036,44507,22470,22037
2016/4/1,雲林縣,東勢鄉,5724,15343,8442,6901
2016/4/1,雲林縣,褒忠鄉,4417,13297,7138,6159
2016/4/1,雲林縣,臺西鄉,8719,24400,13077,11323
2016/4/1,雲林縣,元長鄉,9329,26634,14549,12085
2016/4/1,雲林縣,四湖鄉,8880,24518,13319,11199
2016/4/1,雲林縣,口湖鄉,9578,28313,15042,13271
2016/4/1,雲林縣,水林鄉,10096,26365,14463,11902
2016/4/1,嘉義縣,太保市,12435,37269,19158,18111
2016/4/1,嘉義縣,朴子市,15570,42870,21731,21139
2016/4/1,嘉義縣,布袋鎮,10000,27769,14196,13573
2016/4/1,嘉義縣,大林鎮,11371,31596,16187,15409
2016/4/1,嘉義縣,民雄鄉,24482,71918,36831,35087
2016/4/1,嘉義縣,溪口鄉,5379,15026,8033,6993
2016/4/1,嘉義縣,新港鄉,10634,32667,17228,15439
2016/4/1,嘉義縣,六腳鄉,8961,24063,12790,11273
2016/4/1,嘉義縣,東石鄉,9339,25567,13571,11996
2016/4/1,嘉義縣,義竹鄉,7489,19095,9928,9167
2016/4/1,嘉義縣,鹿草鄉,5780,15978,8578,7400
2016/4/1,嘉義縣,水上鄉,17928,50228,25926,24302
2016/4/1,嘉義縣,中埔鄉,15952,45544,23689,21855
2016/4/1,嘉義縣,竹崎鄉,11703,36432,19469,16963
2016/4/1,嘉義縣,梅山鄉,6769,19922,10596,9326
2016/4/1,嘉義縣,番路鄉,4292,11802,6379,5423
2016/4/1,嘉義縣,大埔鄉,1934,4596,2394,2202
2016/4/1,嘉義縣,阿里山鄉,1959,5684,3002,2682
2016/4/1,屏東縣,屏東市,73701,202347,100389,101958
2016/4/1,屏東縣,潮州鎮,19251,54754,27413,27341
2016/4/1,屏東縣,東港鎮,16480,48233,24399,23834
2016/4/1,屏東縣,恆春鎮,11400,30812,15770,15042
2016/4/1,屏東縣,萬丹鄉,14833,51471,26648,24823
2016/4/1,屏東縣,長治鄉,10032,30232,15754,14478
2016/4/1,屏東縣,麟洛鄉,3765,11212,5824,5388
2016/4/1,屏東縣,九如鄉,6880,22087,11429,10658
2016/4/1,屏東縣,里港鄉,8164,27093,13788,13305
2016/4/1,屏東縣,鹽埔鄉,7840,26312,13679,12633
2016/4/1,屏東縣,高樹鄉,9348,25022,13316,11706
2016/4/1,屏東縣,萬巒鄉,6493,20726,10852,9874
2016/4/1,屏東縣,內埔鄉,18530,55481,28738,26743
2016/4/1,屏東縣,竹田鄉,5655,17483,9274,8209
2016/4/1,屏東縣,新埤鄉,3424,10015,5335,4680
2016/4/1,屏東縣,枋寮鄉,8524,25020,13117,11903
2016/4/1,屏東縣,新園鄉,11757,35998,18638,17360
2016/4/1,屏東縣,崁頂鄉,4465,16026,8130,7896
2016/4/1,屏東縣,林邊鄉,6820,18601,9552,9049
2016/4/1,屏東縣,南州鄉,3693,10862,5571,5291
2016/4/1,屏東縣,佳冬鄉,6970,19793,10293,9500
2016/4/1,屏東縣,琉球鄉,4370,12423,6832,5591
2016/4/1,屏東縣,車城鄉,3477,8848,4772,4076
2016/4/1,屏東縣,滿州鄉,3007,7948,4358,3590
2016/4/1,屏東縣,枋山鄉,2135,5600,2969,2631
2016/4/1,屏東縣,三地門鄉,2296,7698,3889,3809
2016/4/1,屏東縣,霧臺鄉,1058,3313,1703,1610
2016/4/1,屏東縣,瑪家鄉,2029,6757,3444,3313
2016/4/1,屏東縣,泰武鄉,1321,5204,2740,2464
2016/4/1,屏東縣,來義鄉,2230,7556,3850,3706
2016/4/1,屏東縣,春日鄉,1357,4802,2476,2326
2016/4/1,屏東縣,獅子鄉,1536,4816,2490,2326
2016/4/1,屏東縣,牡丹鄉,1883,4794,2453,2341
2016/4/1,臺東縣,臺東市,39409,106697,53580,53117
2016/4/1,臺東縣,成功鎮,5415,14555,7696,6859
2016/4/1,臺東縣,關山鎮,3207,8920,4685,4235
2016/4/1,臺東縣,卑南鄉,6668,17489,9262,8227
2016/4/1,臺東縣,大武鄉,2515,6249,3265,2984
2016/4/1,臺東縣,太麻里鄉,4621,11323,6020,5303
2016/4/1,臺東縣,東河鄉,3784,8807,4853,3954
2016/4/1,臺東縣,長濱鄉,2922,7504,4261,3243
2016/4/1,臺東縣,鹿野鄉,3068,8047,4316,3731
2016/4/1,臺東縣,池上鄉,3226,8463,4418,4045
2016/4/1,臺東縣,綠島鄉,1093,3752,1955,1797
2016/4/1,臺東縣,延平鄉,1062,3535,1895,1640
2016/4/1,臺東縣,海端鄉,1090,4278,2284,1994
2016/4/1,臺東縣,達仁鄉,1448,3581,1949,1632
2016/4/1,臺東縣,金峰鄉,1109,3582,1850,1732
2016/4/1,臺東縣,蘭嶼鄉,1798,5035,2538,2497
2016/4/1,花蓮縣,花蓮市,41433,105597,51135,54462
2016/4/1,花蓮縣,鳳林鎮,4406,11089,5791,5298
2016/4/1,花蓮縣,玉里鎮,8909,24879,13279,11600
2016/4/1,花蓮縣,新城鄉,7621,20192,10402,9790
2016/4/1,花蓮縣,吉安鄉,31524,83302,42101,41201
2016/4/1,花蓮縣,壽豐鄉,7059,18088,9657,8431
2016/4/1,花蓮縣,光復鄉,5016,13161,6993,6168
2016/4/1,花蓮縣,豐濱鄉,1727,4507,2512,1995
2016/4/1,花蓮縣,瑞穗鄉,4723,11881,6405,5476
2016/4/1,花蓮縣,富里鄉,4020,10634,5790,4844
2016/4/1,花蓮縣,秀林鄉,4756,15690,8115,7575
2016/4/1,花蓮縣,萬榮鄉,2070,6438,3407,3031
2016/4/1,花蓮縣,卓溪鄉,1682,6040,3315,2725
2016/4/1,澎湖縣,馬公市,23638,61111,31120,29991
2016/4/1,澎湖縣,湖西鄉,5456,14379,7611,6768
2016/4/1,澎湖縣,白沙鄉,3342,9680,5075,4605
2016/4/1,澎湖縣,西嶼鄉,2954,8372,4311,4061
2016/4/1,澎湖縣,望安鄉,1992,5095,2737,2358
2016/4/1,澎湖縣,七美鄉,1341,3732,1939,1793
2016/4/1,基隆市,中正區,22483,52693,26940,25753
2016/4/1,基隆市,七堵區,21163,54134,27326,26808
2016/4/1,基隆市,暖暖區,15445,38466,19376,19090
2016/4/1,基隆市,仁愛區,19332,45504,22457,23047
2016/4/1,基隆市,中山區,19224,48251,24519,23732
2016/4/1,基隆市,安樂區,32338,81336,40461,40875
2016/4/1,基隆市,信義區,20996,51653,25726,25927
2016/4/1,新竹市,東區,76599,208315,102673,105642
2016/4/1,新竹市,北區,55117,149343,73152,76191
2016/4/1,新竹市,香山區,26325,77016,39221,37795
2016/4/1,嘉義市,東區,45274,122950,59466,63484
2016/4/1,嘉義市,西區,53344,147513,72362,75151
2016/4/1,金門縣,金城鎮,12690,42393,21240,21153
2016/4/1,金門縣,金湖鎮,8609,28427,14321,14106
2016/4/1,金門縣,金沙鎮,6178,20114,9961,10153
2016/4/1,金門縣,金寧鄉,8047,29036,14656,14380
2016/4/1,金門縣,烈嶼鄉,3077,12455,6175,6280
2016/4/1,金門縣,烏坵鄉,133,661,328,333
2016/4/1,連江縣,南竿鄉,1491,7372,4176,3196
2016/4/1,連江縣,北竿鄉,511,2329,1296,1033
2016/4/1,連江縣,莒光鄉,287,1545,920,625
2016/4/1,連江縣,東引鄉,324,1276,767,509
2016/5/1,總計,新北市,1514464,3972003,1950653,2021350
2016/5/1,總計,臺北市,1044858,2702930,1293702,1409228
2016/5/1,總計,桃園市,756319,2120838,1059448,1061390
2016/5/1,總計,臺中市,932542,2752413,1360072,1392341
2016/5/1,總計,臺南市,673650,1885199,943267,941932
2016/5/1,總計,高雄市,1075353,2777784,1379620,1398164
2016/5/1,總計,臺灣省,2454394,7146514,3649853,3496661
2016/5/1,總計,宜蘭縣,165523,457811,232017,225794
2016/5/1,總計,新竹縣,184776,544198,278497,265701
2016/5/1,總計,苗栗縣,184637,561755,289647,272108
2016/5/1,總計,彰化縣,382754,1288776,657875,630901
2016/5/1,總計,南投縣,177020,507421,260234,247187
2016/5/1,總計,雲林縣,238649,697318,362508,334810
2016/5/1,總計,嘉義縣,182077,517698,269461,248237
2016/5/1,總計,屏東縣,284914,839001,429674,409327
2016/5/1,總計,臺東縣,82436,221633,114722,106911
2016/5/1,總計,花蓮縣,125005,331379,168829,162550
2016/5/1,總計,澎湖縣,38722,102396,52802,49594
2016/5/1,總計,基隆市,151001,371878,186667,185211
2016/5/1,總計,新竹市,158284,434955,215156,219799
2016/5/1,總計,嘉義市,98596,270295,131764,138531
2016/5/1,總計,福建省,41427,145668,73879,71789
2016/5/1,總計,金門縣,38798,133150,66713,66437
2016/5/1,總計,連江縣,2629,12518,7166,5352
2016/5/1,新北市,板橋區,205737,553482,270674,282808
2016/5/1,新北市,三重區,148842,388060,191453,196607
2016/5/1,新北市,中和區,163131,413858,201910,211948
2016/5/1,新北市,永和區,90686,225249,107121,118128
2016/5/1,新北市,新莊區,149650,413805,202486,211319
2016/5/1,新北市,新店區,124084,300036,144811,155225
2016/5/1,新北市,樹林區,65503,184205,91977,92228
2016/5/1,新北市,鶯歌區,29465,87644,43965,43679
2016/5/1,新北市,三峽區,41412,113280,56909,56371
2016/5/1,新北市,淡水區,70957,163442,78655,84787
2016/5/1,新北市,汐止區,85178,196432,96015,100417
2016/5/1,新北市,瑞芳區,16147,40774,20610,20164
2016/5/1,新北市,土城區,86039,238559,118015,120544
2016/5/1,新北市,蘆洲區,69681,200146,98539,101607
2016/5/1,新北市,五股區,30203,83286,42029,41257
2016/5/1,新北市,泰山區,28089,78912,39207,39705
2016/5/1,新北市,林口區,39677,101534,49642,51892
2016/5/1,新北市,深坑區,9481,23603,11794,11809
2016/5/1,新北市,石碇區,3370,7766,4288,3478
2016/5/1,新北市,坪林區,2501,6510,3612,2898
2016/5/1,新北市,三芝區,9355,23367,12035,11332
2016/5/1,新北市,石門區,4302,12574,6508,6066
2016/5/1,新北市,八里區,14104,37754,18825,18929
2016/5/1,新北市,平溪區,2340,4807,2662,2145
2016/5/1,新北市,雙溪區,3825,9181,4961,4220
2016/5/1,新北市,貢寮區,4402,12788,6529,6259
2016/5/1,新北市,金山區,7041,22228,10990,11238
2016/5/1,新北市,萬里區,7421,22551,11354,11197
2016/5/1,新北市,烏來區,1841,6170,3077,3093
2016/5/1,臺北市,松山區,80318,209595,98682,110913
2016/5/1,臺北市,信義區,89476,228506,109369,119137
2016/5/1,臺北市,大安區,120452,312950,146308,166642
2016/5/1,臺北市,中山區,99182,231108,107833,123275
2016/5/1,臺北市,中正區,65171,162235,77481,84754
2016/5/1,臺北市,大同區,51522,130697,63846,66851
2016/5/1,臺北市,萬華區,78309,193885,95584,98301
2016/5/1,臺北市,文山區,104704,275669,132427,143242
2016/5/1,臺北市,南港區,46562,122263,59759,62504
2016/5/1,臺北市,內湖區,106797,287734,137658,150076
2016/5/1,臺北市,士林區,106448,290501,140334,150167
2016/5/1,臺北市,北投區,95917,257787,124421,133366
2016/5/1,桃園市,桃園區,160828,430456,209439,221017
2016/5/1,桃園市,中壢區,142497,392178,193741,198437
2016/5/1,桃園市,大溪區,31572,93712,47953,45759
2016/5/1,桃園市,楊梅區,55445,162089,81973,80116
2016/5/1,桃園市,蘆竹區,55813,156609,77989,78620
2016/5/1,桃園市,大園區,30727,85974,44108,41866
2016/5/1,桃園市,龜山區,56116,146938,73670,73268
2016/5/1,桃園市,八德區,66655,189538,95327,94211
2016/5/1,桃園市,龍潭區,40459,119197,59936,59261
2016/5/1,桃園市,平鎮區,74772,219337,109279,110058
2016/5/1,桃園市,新屋區,15859,48664,25978,22686
2016/5/1,桃園市,觀音區,21832,65098,34029,31069
2016/5/1,桃園市,復興區,3744,11048,6026,5022
2016/5/1,臺中市,中區,7915,18918,9430,9488
2016/5/1,臺中市,東區,27412,75171,37502,37669
2016/5/1,臺中市,南區,46914,122415,58910,63505
2016/5/1,臺中市,西區,45120,115739,55100,60639
2016/5/1,臺中市,北區,58609,147583,70747,76836
2016/5/1,臺中市,西屯區,82919,222783,107326,115457
2016/5/1,臺中市,南屯區,60062,165275,79156,86119
2016/5/1,臺中市,北屯區,95668,266978,128436,138542
2016/5/1,臺中市,豐原區,52786,166766,82550,84216
2016/5/1,臺中市,東勢區,17290,51171,26343,24828
2016/5/1,臺中市,大甲區,22751,77759,39165,38594
2016/5/1,臺中市,清水區,26567,86243,44321,41922
2016/5/1,臺中市,沙鹿區,28319,90312,45724,44588
2016/5/1,臺中市,梧棲區,17299,57295,28819,28476
2016/5/1,臺中市,后里區,15726,54240,27578,26662
2016/5/1,臺中市,神岡區,18994,65280,33357,31923
2016/5/1,臺中市,潭子區,35579,106792,52887,53905
2016/5/1,臺中市,大雅區,28570,93886,46910,46976
2016/5/1,臺中市,新社區,7515,25017,13015,12002
2016/5/1,臺中市,石岡區,4895,15262,7913,7349
2016/5/1,臺中市,外埔區,9460,31878,16335,15543
2016/5/1,臺中市,大安區,5420,19483,10293,9190
2016/5/1,臺中市,烏日區,23435,72981,36722,36259
2016/5/1,臺中市,大肚區,17156,56908,29096,27812
2016/5/1,臺中市,龍井區,22422,76704,38806,37898
2016/5/1,臺中市,霧峰區,19804,64716,32929,31787
2016/5/1,臺中市,太平區,61493,184897,91896,93001
2016/5/1,臺中市,大里區,67976,209239,103067,106172
2016/5/1,臺中市,和平區,4466,10722,5739,4983
2016/5/1,臺南市,新營區,28767,78241,38741,39500
2016/5/1,臺南市,鹽水區,10073,25998,13589,12409
2016/5/1,臺南市,白河區,10899,29072,15206,13866
2016/5/1,臺南市,柳營區,7828,21514,11244,10270
2016/5/1,臺南市,後壁區,8889,24219,12580,11639
2016/5/1,臺南市,東山區,8283,21481,11404,10077
2016/5/1,臺南市,麻豆區,15647,44897,22802,22095
2016/5/1,臺南市,下營區,9097,24632,12682,11950
2016/5/1,臺南市,六甲區,7719,22521,11620,10901
2016/5/1,臺南市,官田區,7840,21557,11025,10532
2016/5/1,臺南市,大內區,3905,9989,5346,4643
2016/5/1,臺南市,佳里區,20460,59554,29521,30033
2016/5/1,臺南市,學甲區,9650,26537,13569,12968
2016/5/1,臺南市,西港區,8114,24879,12606,12273
2016/5/1,臺南市,七股區,8057,23271,12055,11216
2016/5/1,臺南市,將軍區,7293,20177,10279,9898
2016/5/1,臺南市,北門區,4299,11421,5791,5630
2016/5/1,臺南市,新化區,14299,43822,22348,21474
2016/5/1,臺南市,善化區,16974,47219,23828,23391
2016/5/1,臺南市,新市區,11815,36021,18114,17907
2016/5/1,臺南市,安定區,9905,30415,15602,14813
2016/5/1,臺南市,山上區,2694,7399,3878,3521
2016/5/1,臺南市,玉井區,5113,14357,7446,6911
2016/5/1,臺南市,楠西區,3535,9962,5284,4678
2016/5/1,臺南市,南化區,2861,8843,4784,4059
2016/5/1,臺南市,左鎮區,1989,5038,2817,2221
2016/5/1,臺南市,仁德區,27017,74269,37770,36499
2016/5/1,臺南市,歸仁區,22347,68011,34548,33463
2016/5/1,臺南市,關廟區,11009,34681,17906,16775
2016/5/1,臺南市,龍崎區,1562,4152,2250,1902
2016/5/1,臺南市,永康區,82004,231224,114120,117104
2016/5/1,臺南市,東區,71668,188321,90496,97825
2016/5/1,臺南市,南區,45013,125693,62443,63250
2016/5/1,臺南市,北區,50085,132888,64806,68082
2016/5/1,臺南市,安南區,61334,190174,96075,94099
2016/5/1,臺南市,安平區,24925,65532,31138,34394
2016/5/1,臺南市,中西區,30681,77218,37554,39664
2016/5/1,高雄市,鹽埕區,10803,24866,12339,12527
2016/5/1,高雄市,鼓山區,56424,136995,66415,70580
2016/5/1,高雄市,左營區,77895,196663,94964,101699
2016/5/1,高雄市,楠梓區,67951,180692,88959,91733
2016/5/1,高雄市,三民區,135257,345429,167538,177891
2016/5/1,高雄市,新興區,22651,51784,24971,26813
2016/5/1,高雄市,前金區,12481,27281,13102,14179
2016/5/1,高雄市,苓雅區,72225,173789,83911,89878
2016/5/1,高雄市,前鎮區,78293,191954,94557,97397
2016/5/1,高雄市,旗津區,11079,28870,14962,13908
2016/5/1,高雄市,小港區,66709,156340,77838,78502
2016/5/1,高雄市,鳳山區,137718,357020,175421,181599
2016/5/1,高雄市,林園區,25621,70320,35652,34668
2016/5/1,高雄市,大寮區,41495,111760,57397,54363
2016/5/1,高雄市,大樹區,13463,43100,22149,20951
2016/5/1,高雄市,大社區,12740,34599,17595,17004
2016/5/1,高雄市,仁武區,31502,83146,42336,40810
2016/5/1,高雄市,鳥松區,17845,44024,22405,21619
2016/5/1,高雄市,岡山區,34709,97782,48609,49173
2016/5/1,高雄市,橋頭區,13299,37333,19014,18319
2016/5/1,高雄市,燕巢區,10413,30001,15888,14113
2016/5/1,高雄市,田寮區,3341,7397,4110,3287
2016/5/1,高雄市,阿蓮區,9385,29227,14750,14477
2016/5/1,高雄市,路竹區,16879,53072,27099,25973
2016/5/1,高雄市,湖內區,10622,29656,15137,14519
2016/5/1,高雄市,茄萣區,10462,30423,15716,14707
2016/5/1,高雄市,永安區,5734,14077,7085,6992
2016/5/1,高雄市,彌陀區,6758,19627,10117,9510
2016/5/1,高雄市,梓官區,12567,36321,18749,17572
2016/5/1,高雄市,旗山區,13816,37586,19476,18110
2016/5/1,高雄市,美濃區,14606,40643,21307,19336
2016/5/1,高雄市,六龜區,5599,13356,7191,6165
2016/5/1,高雄市,甲仙區,2361,6244,3320,2924
2016/5/1,高雄市,杉林區,4805,12315,6731,5584
2016/5/1,高雄市,內門區,5085,14837,8042,6795
2016/5/1,高雄市,茂林區,581,1896,932,964
2016/5/1,高雄市,桃源區,1326,4217,2213,2004
2016/5/1,高雄市,那瑪夏區,853,3142,1623,1519
2016/5/1,宜蘭縣,宜蘭市,35688,96056,46968,49088
2016/5/1,宜蘭縣,羅東鎮,26144,72541,34466,38075
2016/5/1,宜蘭縣,蘇澳鎮,14098,40576,20677,19899
2016/5/1,宜蘭縣,頭城鎮,10167,29764,15333,14431
2016/5/1,宜蘭縣,礁溪鄉,13645,35853,18682,17171
2016/5/1,宜蘭縣,壯圍鄉,8592,24274,12844,11430
2016/5/1,宜蘭縣,員山鄉,11540,32265,17101,15164
2016/5/1,宜蘭縣,冬山鄉,18929,53408,27443,25965
2016/5/1,宜蘭縣,五結鄉,14539,39656,20552,19104
2016/5/1,宜蘭縣,三星鄉,8367,21401,11540,9861
2016/5/1,宜蘭縣,大同鄉,1890,6052,3289,2763
2016/5/1,宜蘭縣,南澳鄉,1924,5965,3122,2843
2016/5/1,新竹縣,竹北市,61595,173066,86242,86824
2016/5/1,新竹縣,關西鎮,9511,29663,15886,13777
2016/5/1,新竹縣,新埔鎮,10664,34002,18117,15885
2016/5/1,新竹縣,竹東鎮,33201,96830,48680,48150
2016/5/1,新竹縣,湖口鄉,25901,77361,39277,38084
2016/5/1,新竹縣,橫山鄉,4493,13433,7276,6157
2016/5/1,新竹縣,新豐鄉,17904,56300,28887,27413
2016/5/1,新竹縣,芎林鄉,6477,20177,10689,9488
2016/5/1,新竹縣,寶山鄉,5244,14288,7725,6563
2016/5/1,新竹縣,北埔鄉,3122,9611,5201,4410
2016/5/1,新竹縣,峨眉鄉,2085,5620,3106,2514
2016/5/1,新竹縣,尖石鄉,2844,9297,4941,4356
2016/5/1,新竹縣,五峰鄉,1735,4550,2470,2080
2016/5/1,苗栗縣,苗栗市,30779,90248,45097,45151
2016/5/1,苗栗縣,頭份市,33638,103122,52052,51070
2016/5/1,苗栗縣,苑裡鎮,14463,47464,24680,22784
2016/5/1,苗栗縣,通霄鎮,11536,35874,18932,16942
2016/5/1,苗栗縣,竹南鎮,28098,84734,42738,41996
2016/5/1,苗栗縣,後龍鎮,11849,37546,19803,17743
2016/5/1,苗栗縣,卓蘭鎮,6095,17827,9307,8520
2016/5/1,苗栗縣,大湖鄉,5413,15214,8072,7142
2016/5/1,苗栗縣,公館鄉,10624,34446,17937,16509
2016/5/1,苗栗縣,銅鑼鄉,6139,18584,9843,8741
2016/5/1,苗栗縣,南庄鄉,3964,10490,5776,4714
2016/5/1,苗栗縣,頭屋鄉,3645,11145,5894,5251
2016/5/1,苗栗縣,三義鄉,5497,16951,8901,8050
2016/5/1,苗栗縣,西湖鄉,2671,7379,4100,3279
2016/5/1,苗栗縣,造橋鄉,4118,13261,6968,6293
2016/5/1,苗栗縣,三灣鄉,2419,6947,3803,3144
2016/5/1,苗栗縣,獅潭鄉,1726,4553,2549,2004
2016/5/1,苗栗縣,泰安鄉,1963,5970,3195,2775
2016/5/1,彰化縣,彰化市,75675,235095,116305,118790
2016/5/1,彰化縣,員林市,38772,125078,62246,62832
2016/5/1,彰化縣,鹿港鎮,24166,86643,44095,42548
2016/5/1,彰化縣,和美鎮,26378,91223,46525,44698
2016/5/1,彰化縣,北斗鎮,10550,33258,16762,16496
2016/5/1,彰化縣,溪湖鎮,16133,55739,28327,27412
2016/5/1,彰化縣,田中鎮,13049,42324,21882,20442
2016/5/1,彰化縣,二林鎮,14918,51746,26652,25094
2016/5/1,彰化縣,線西鄉,4337,16996,8785,8211
2016/5/1,彰化縣,伸港鄉,9696,36569,18663,17906
2016/5/1,彰化縣,福興鄉,12604,47523,24746,22777
2016/5/1,彰化縣,秀水鄉,10565,39358,20325,19033
2016/5/1,彰化縣,花壇鄉,13861,46032,23675,22357
2016/5/1,彰化縣,芬園鄉,6857,23946,12598,11348
2016/5/1,彰化縣,大村鄉,10927,36623,18974,17649
2016/5/1,彰化縣,埔鹽鄉,9004,32881,17270,15611
2016/5/1,彰化縣,埔心鄉,10423,34745,17902,16843
2016/5/1,彰化縣,永靖鄉,10860,37927,19697,18230
2016/5/1,彰化縣,社頭鄉,12804,43440,22293,21147
2016/5/1,彰化縣,二水鄉,5330,15595,8176,7419
2016/5/1,彰化縣,田尾鄉,7899,27595,14259,13336
2016/5/1,彰化縣,埤頭鄉,8957,30846,16031,14815
2016/5/1,彰化縣,芳苑鄉,10123,34123,18049,16074
2016/5/1,彰化縣,大城鄉,5306,17416,9446,7970
2016/5/1,彰化縣,竹塘鄉,4622,15564,8202,7362
2016/5/1,彰化縣,溪州鄉,8938,30491,15990,14501
2016/5/1,南投縣,南投市,34519,101406,50876,50530
2016/5/1,南投縣,埔里鎮,28957,82012,41093,40919
2016/5/1,南投縣,草屯鎮,32831,98636,49826,48810
2016/5/1,南投縣,竹山鎮,20010,55793,28642,27151
2016/5/1,南投縣,集集鎮,4323,11128,5785,5343
2016/5/1,南投縣,名間鄉,12572,39356,20687,18669
2016/5/1,南投縣,鹿谷鄉,7765,18090,9641,8449
2016/5/1,南投縣,中寮鄉,5648,15227,8278,6949
2016/5/1,南投縣,魚池鄉,5754,16264,8533,7731
2016/5/1,南投縣,國姓鄉,7297,19204,10393,8811
2016/5/1,南投縣,水里鄉,7179,18166,9524,8642
2016/5/1,南投縣,信義鄉,5234,16456,8833,7623
2016/5/1,南投縣,仁愛鄉,4931,15683,8123,7560
2016/5/1,雲林縣,斗六市,37664,108493,54126,54367
2016/5/1,雲林縣,斗南鎮,15800,45478,23102,22376
2016/5/1,雲林縣,虎尾鎮,24464,70596,35828,34768
2016/5/1,雲林縣,西螺鎮,14523,46748,23679,23069
2016/5/1,雲林縣,土庫鎮,9263,29408,15370,14038
2016/5/1,雲林縣,北港鎮,15871,40867,21225,19642
2016/5/1,雲林縣,古坑鄉,10950,32114,16947,15167
2016/5/1,雲林縣,大埤鄉,6716,19557,10526,9031
2016/5/1,雲林縣,莿桐鄉,9265,29130,15299,13831
2016/5/1,雲林縣,林內鄉,5955,18666,9759,8907
2016/5/1,雲林縣,二崙鄉,8903,27771,14883,12888
2016/5/1,雲林縣,崙背鄉,8493,25319,13388,11931
2016/5/1,雲林縣,麥寮鄉,14061,44552,22484,22068
2016/5/1,雲林縣,東勢鄉,5725,15309,8422,6887
2016/5/1,雲林縣,褒忠鄉,4421,13277,7132,6145
2016/5/1,雲林縣,臺西鄉,8710,24354,13050,11304
2016/5/1,雲林縣,元長鄉,9329,26590,14530,12060
2016/5/1,雲林縣,四湖鄉,8874,24475,13290,11185
2016/5/1,雲林縣,口湖鄉,9571,28276,15018,13258
2016/5/1,雲林縣,水林鄉,10091,26338,14450,11888
2016/5/1,嘉義縣,太保市,12479,37325,19176,18149
2016/5/1,嘉義縣,朴子市,15566,42869,21731,21138
2016/5/1,嘉義縣,布袋鎮,9998,27702,14162,13540
2016/5/1,嘉義縣,大林鎮,11382,31584,16170,15414
2016/5/1,嘉義縣,民雄鄉,24511,71906,36817,35089
2016/5/1,嘉義縣,溪口鄉,5378,15034,8038,6996
2016/5/1,嘉義縣,新港鄉,10636,32636,17203,15433
2016/5/1,嘉義縣,六腳鄉,8960,24013,12764,11249
2016/5/1,嘉義縣,東石鄉,9339,25529,13547,11982
2016/5/1,嘉義縣,義竹鄉,7489,19044,9908,9136
2016/5/1,嘉義縣,鹿草鄉,5790,15974,8569,7405
2016/5/1,嘉義縣,水上鄉,17923,50185,25892,24293
2016/5/1,嘉義縣,中埔鄉,15953,45508,23662,21846
2016/5/1,嘉義縣,竹崎鄉,11719,36438,19472,16966
2016/5/1,嘉義縣,梅山鄉,6767,19893,10582,9311
2016/5/1,嘉義縣,番路鄉,4295,11784,6372,5412
2016/5/1,嘉義縣,大埔鄉,1937,4597,2396,2201
2016/5/1,嘉義縣,阿里山鄉,1955,5677,3000,2677
2016/5/1,屏東縣,屏東市,73730,202354,100378,101976
2016/5/1,屏東縣,潮州鎮,19279,54786,27436,27350
2016/5/1,屏東縣,東港鎮,16519,48248,24402,23846
2016/5/1,屏東縣,恆春鎮,11410,30784,15751,15033
2016/5/1,屏東縣,萬丹鄉,14836,51464,26635,24829
2016/5/1,屏東縣,長治鄉,10044,30212,15743,14469
2016/5/1,屏東縣,麟洛鄉,3766,11189,5808,5381
2016/5/1,屏東縣,九如鄉,6895,22086,11433,10653
2016/5/1,屏東縣,里港鄉,8160,27116,13787,13329
2016/5/1,屏東縣,鹽埔鄉,7837,26271,13665,12606
2016/5/1,屏東縣,高樹鄉,9342,25005,13311,11694
2016/5/1,屏東縣,萬巒鄉,6500,20722,10854,9868
2016/5/1,屏東縣,內埔鄉,18555,55461,28720,26741
2016/5/1,屏東縣,竹田鄉,5660,17478,9269,8209
2016/5/1,屏東縣,新埤鄉,3422,9996,5330,4666
2016/5/1,屏東縣,枋寮鄉,8525,24984,13096,11888
2016/5/1,屏東縣,新園鄉,11758,35946,18621,17325
2016/5/1,屏東縣,崁頂鄉,4463,15996,8115,7881
2016/5/1,屏東縣,林邊鄉,6802,18526,9504,9022
2016/5/1,屏東縣,南州鄉,3692,10852,5565,5287
2016/5/1,屏東縣,佳冬鄉,6972,19778,10285,9493
2016/5/1,屏東縣,琉球鄉,4385,12432,6842,5590
2016/5/1,屏東縣,車城鄉,3474,8855,4779,4076
2016/5/1,屏東縣,滿州鄉,3011,7942,4362,3580
2016/5/1,屏東縣,枋山鄉,2135,5584,2962,2622
2016/5/1,屏東縣,三地門鄉,2305,7698,3883,3815
2016/5/1,屏東縣,霧臺鄉,1058,3315,1699,1616
2016/5/1,屏東縣,瑪家鄉,2039,6757,3440,3317
2016/5/1,屏東縣,泰武鄉,1324,5202,2736,2466
2016/5/1,屏東縣,來義鄉,2232,7540,3839,3701
2016/5/1,屏東縣,春日鄉,1357,4807,2479,2328
2016/5/1,屏東縣,獅子鄉,1537,4813,2485,2328
2016/5/1,屏東縣,牡丹鄉,1890,4802,2460,2342
2016/5/1,臺東縣,臺東市,39404,106663,53568,53095
2016/5/1,臺東縣,成功鎮,5419,14520,7676,6844
2016/5/1,臺東縣,關山鎮,3206,8906,4675,4231
2016/5/1,臺東縣,卑南鄉,6673,17474,9252,8222
2016/5/1,臺東縣,大武鄉,2515,6243,3261,2982
2016/5/1,臺東縣,太麻里鄉,4619,11307,6006,5301
2016/5/1,臺東縣,東河鄉,3783,8799,4855,3944
2016/5/1,臺東縣,長濱鄉,2919,7470,4241,3229
2016/5/1,臺東縣,鹿野鄉,3072,8059,4311,3748
2016/5/1,臺東縣,池上鄉,3228,8454,4419,4035
2016/5/1,臺東縣,綠島鄉,1096,3742,1951,1791
2016/5/1,臺東縣,延平鄉,1063,3528,1894,1634
2016/5/1,臺東縣,海端鄉,1087,4275,2280,1995
2016/5/1,臺東縣,達仁鄉,1446,3576,1946,1630
2016/5/1,臺東縣,金峰鄉,1107,3586,1848,1738
2016/5/1,臺東縣,蘭嶼鄉,1799,5031,2539,2492
2016/5/1,花蓮縣,花蓮市,41435,105517,51088,54429
2016/5/1,花蓮縣,鳳林鎮,4401,11073,5782,5291
2016/5/1,花蓮縣,玉里鎮,8900,24867,13275,11592
2016/5/1,花蓮縣,新城鄉,7643,20199,10399,9800
2016/5/1,花蓮縣,吉安鄉,31555,83360,42125,41235
2016/5/1,花蓮縣,壽豐鄉,7069,18089,9657,8432
2016/5/1,花蓮縣,光復鄉,5025,13140,6983,6157
2016/5/1,花蓮縣,豐濱鄉,1726,4495,2507,1988
2016/5/1,花蓮縣,瑞穗鄉,4731,11871,6398,5473
2016/5/1,花蓮縣,富里鄉,4011,10612,5784,4828
2016/5/1,花蓮縣,秀林鄉,4758,15709,8127,7582
2016/5/1,花蓮縣,萬榮鄉,2071,6441,3406,3035
2016/5/1,花蓮縣,卓溪鄉,1680,6006,3298,2708
2016/5/1,澎湖縣,馬公市,23625,61128,31129,29999
2016/5/1,澎湖縣,湖西鄉,5469,14380,7604,6776
2016/5/1,澎湖縣,白沙鄉,3345,9673,5074,4599
2016/5/1,澎湖縣,西嶼鄉,2952,8375,4313,4062
2016/5/1,澎湖縣,望安鄉,1991,5109,2743,2366
2016/5/1,澎湖縣,七美鄉,1340,3731,1939,1792
2016/5/1,基隆市,中正區,22480,52616,26897,25719
2016/5/1,基隆市,七堵區,21147,54072,27286,26786
2016/5/1,基隆市,暖暖區,15443,38425,19358,19067
2016/5/1,基隆市,仁愛區,19350,45514,22465,23049
2016/5/1,基隆市,中山區,19221,48241,24514,23727
2016/5/1,基隆市,安樂區,32345,81351,40454,40897
2016/5/1,基隆市,信義區,21015,51659,25693,25966
2016/5/1,新竹市,東區,76719,208485,102757,105728
2016/5/1,新竹市,北區,55187,149424,73159,76265
2016/5/1,新竹市,香山區,26378,77046,39240,37806
2016/5/1,嘉義市,東區,45257,122800,59400,63400
2016/5/1,嘉義市,西區,53339,147495,72364,75131
2016/5/1,金門縣,金城鎮,12693,42430,21252,21178
2016/5/1,金門縣,金湖鎮,8626,28411,14308,14103
2016/5/1,金門縣,金沙鎮,6190,20120,9968,10152
2016/5/1,金門縣,金寧鄉,8070,29070,14684,14386
2016/5/1,金門縣,烈嶼鄉,3086,12456,6172,6284
2016/5/1,金門縣,烏坵鄉,133,663,329,334
2016/5/1,連江縣,南竿鄉,1501,7359,4171,3188
2016/5/1,連江縣,北竿鄉,517,2325,1296,1029
2016/5/1,連江縣,莒光鄉,287,1554,927,627
2016/5/1,連江縣,東引鄉,324,1280,772,508
2016/6/1,總計,新北市,1515318,3972204,1950470,2021734
2016/6/1,總計,臺北市,1045175,2702925,1293639,1409286
2016/6/1,總計,桃園市,757890,2124339,1061023,1063316
2016/6/1,總計,臺中市,933760,2754191,1360893,1393298
2016/6/1,總計,臺南市,674233,1885388,943349,942039
2016/6/1,總計,高雄市,1076120,2778092,1379503,1398589
2016/6/1,總計,臺灣省,2455727,7145502,3648769,3496733
2016/6/1,總計,宜蘭縣,165698,457808,231992,225816
2016/6/1,總計,新竹縣,185128,544624,278667,265957
2016/6/1,總計,苗栗縣,184739,561495,289526,271969
2016/6/1,總計,彰化縣,383007,1288803,657777,631026
2016/6/1,總計,南投縣,177089,507210,260101,247109
2016/6/1,總計,雲林縣,238767,697105,362343,334762
2016/6/1,總計,嘉義縣,182132,517339,269265,248074
2016/6/1,總計,屏東縣,285022,838584,429362,409222
2016/6/1,總計,臺東縣,82460,221504,114637,106867
2016/6/1,總計,花蓮縣,125005,331372,168800,162572
2016/6/1,總計,澎湖縣,38571,102329,52744,49585
2016/6/1,總計,基隆市,151064,371837,186587,185250
2016/6/1,總計,新竹市,158443,435238,215235,220003
2016/6/1,總計,嘉義市,98602,270254,131733,138521
2016/6/1,總計,福建省,41535,145721,73895,71826
2016/6/1,總計,金門縣,38898,133185,66724,66461
2016/6/1,總計,連江縣,2637,12536,7171,5365
2016/6/1,新北市,板橋區,205839,553430,270635,282795
2016/6/1,新北市,三重區,148911,388014,191361,196653
2016/6/1,新北市,中和區,163164,413709,201774,211935
2016/6/1,新北市,永和區,90659,225060,107020,118040
2016/6/1,新北市,新莊區,149753,413805,202457,211348
2016/6/1,新北市,新店區,124133,300074,144817,155257
2016/6/1,新北市,樹林區,65579,184284,91994,92290
2016/6/1,新北市,鶯歌區,29462,87592,43938,43654
2016/6/1,新北市,三峽區,41471,113442,57005,56437
2016/6/1,新北市,淡水區,71060,163704,78771,84933
2016/6/1,新北市,汐止區,85202,196408,95962,100446
2016/6/1,新北市,瑞芳區,16149,40742,20601,20141
2016/6/1,新北市,土城區,86033,238389,117885,120504
2016/6/1,新北市,蘆洲區,69722,200150,98547,101603
2016/6/1,新北市,五股區,30278,83380,42074,41306
2016/6/1,新北市,泰山區,28110,78912,39229,39683
2016/6/1,新北市,林口區,39736,101731,49733,51998
2016/6/1,新北市,深坑區,9493,23624,11806,11818
2016/6/1,新北市,石碇區,3369,7770,4284,3486
2016/6/1,新北市,坪林區,2499,6515,3618,2897
2016/6/1,新北市,三芝區,9366,23369,12029,11340
2016/6/1,新北市,石門區,4303,12560,6507,6053
2016/6/1,新北市,八里區,14140,37835,18855,18980
2016/6/1,新北市,平溪區,2339,4803,2661,2142
2016/6/1,新北市,雙溪區,3821,9158,4948,4210
2016/6/1,新北市,貢寮區,4400,12791,6529,6262
2016/6/1,新北市,金山區,7050,22225,10990,11235
2016/6/1,新北市,萬里區,7432,22561,11369,11192
2016/6/1,新北市,烏來區,1845,6167,3071,3096
2016/6/1,臺北市,松山區,80338,209574,98621,110953
2016/6/1,臺北市,信義區,89470,228462,109328,119134
2016/6/1,臺北市,大安區,120471,312896,146296,166600
2016/6/1,臺北市,中山區,99233,231190,107873,123317
2016/6/1,臺北市,中正區,65178,162080,77370,84710
2016/6/1,臺北市,大同區,51548,130640,63787,66853
2016/6/1,臺北市,萬華區,78302,193819,95542,98277
2016/6/1,臺北市,文山區,104733,275673,132445,143228
2016/6/1,臺北市,南港區,46585,122329,59790,62539
2016/6/1,臺北市,內湖區,106873,287871,137751,150120
2016/6/1,臺北市,士林區,106462,290622,140414,150208
2016/6/1,臺北市,北投區,95982,257769,124422,133347
2016/6/1,桃園市,桃園區,161053,430992,209699,221293
2016/6/1,桃園市,中壢區,142730,392651,193981,198670
2016/6/1,桃園市,大溪區,31597,93724,47943,45781
2016/6/1,桃園市,楊梅區,55554,162419,82134,80285
2016/6/1,桃園市,蘆竹區,55914,156921,78141,78780
2016/6/1,桃園市,大園區,30801,86153,44169,41984
2016/6/1,桃園市,龜山區,56512,147651,73984,73667
2016/6/1,桃園市,八德區,66865,189982,95528,94454
2016/6/1,桃園市,龍潭區,40501,119318,59983,59335
2016/6/1,桃園市,平鎮區,74896,219629,109378,110251
2016/6/1,桃園市,新屋區,15881,48683,25992,22691
2016/6/1,桃園市,觀音區,21835,65139,34047,31092
2016/6/1,桃園市,復興區,3751,11077,6044,5033
2016/6/1,臺中市,中區,7932,18912,9432,9480
2016/6/1,臺中市,東區,27436,75209,37528,37681
2016/6/1,臺中市,南區,47007,122541,58961,63580
2016/6/1,臺中市,西區,45165,115727,55064,60663
2016/6/1,臺中市,北區,58618,147577,70709,76868
2016/6/1,臺中市,西屯區,83044,222946,107428,115518
2016/6/1,臺中市,南屯區,60116,165510,79255,86255
2016/6/1,臺中市,北屯區,95888,267487,128682,138805
2016/6/1,臺中市,豐原區,52826,166737,82516,84221
2016/6/1,臺中市,東勢區,17283,51152,26332,24820
2016/6/1,臺中市,大甲區,22752,77729,39160,38569
2016/6/1,臺中市,清水區,26600,86216,44276,41940
2016/6/1,臺中市,沙鹿區,28366,90432,45783,44649
2016/6/1,臺中市,梧棲區,17322,57361,28849,28512
2016/6/1,臺中市,后里區,15747,54238,27589,26649
2016/6/1,臺中市,神岡區,19029,65264,33348,31916
2016/6/1,臺中市,潭子區,35599,106859,52921,53938
2016/6/1,臺中市,大雅區,28624,93929,46947,46982
2016/6/1,臺中市,新社區,7516,24999,13005,11994
2016/6/1,臺中市,石岡區,4901,15252,7912,7340
2016/6/1,臺中市,外埔區,9476,31891,16342,15549
2016/6/1,臺中市,大安區,5420,19496,10304,9192
2016/6/1,臺中市,烏日區,23491,73066,36759,36307
2016/6/1,臺中市,大肚區,17195,56937,29114,27823
2016/6/1,臺中市,龍井區,22450,76741,38814,37927
2016/6/1,臺中市,霧峰區,19834,64739,32946,31793
2016/6/1,臺中市,太平區,61604,185188,92039,93149
2016/6/1,臺中市,大里區,68047,209311,103123,106188
2016/6/1,臺中市,和平區,4472,10745,5755,4990
2016/6/1,臺南市,新營區,28782,78202,38719,39483
2016/6/1,臺南市,鹽水區,10084,25979,13580,12399
2016/6/1,臺南市,白河區,10884,29023,15177,13846
2016/6/1,臺南市,柳營區,7827,21497,11233,10264
2016/6/1,臺南市,後壁區,8889,24208,12576,11632
2016/6/1,臺南市,東山區,8304,21466,11398,10068
2016/6/1,臺南市,麻豆區,15658,44887,22778,22109
2016/6/1,臺南市,下營區,9105,24607,12674,11933
2016/6/1,臺南市,六甲區,7719,22520,11625,10895
2016/6/1,臺南市,官田區,7827,21532,11001,10531
2016/6/1,臺南市,大內區,3896,9966,5334,4632
2016/6/1,臺南市,佳里區,20496,59556,29540,30016
2016/6/1,臺南市,學甲區,9652,26527,13560,12967
2016/6/1,臺南市,西港區,8121,24919,12621,12298
2016/6/1,臺南市,七股區,8057,23259,12033,11226
2016/6/1,臺南市,將軍區,7297,20171,10280,9891
2016/6/1,臺南市,北門區,4298,11418,5787,5631
2016/6/1,臺南市,新化區,14296,43797,22336,21461
2016/6/1,臺南市,善化區,17033,47314,23874,23440
2016/6/1,臺南市,新市區,11833,36021,18116,17905
2016/6/1,臺南市,安定區,9917,30443,15621,14822
2016/6/1,臺南市,山上區,2692,7390,3875,3515
2016/6/1,臺南市,玉井區,5119,14341,7445,6896
2016/6/1,臺南市,楠西區,3534,9950,5273,4677
2016/6/1,臺南市,南化區,2860,8837,4786,4051
2016/6/1,臺南市,左鎮區,1988,5029,2809,2220
2016/6/1,臺南市,仁德區,27058,74348,37808,36540
2016/6/1,臺南市,歸仁區,22381,68054,34580,33474
2016/6/1,臺南市,關廟區,11020,34699,17920,16779
2016/6/1,臺南市,龍崎區,1559,4138,2240,1898
2016/6/1,臺南市,永康區,82113,231384,114208,117176
2016/6/1,臺南市,東區,71725,188295,90491,97804
2016/6/1,臺南市,南區,45059,125691,62428,63263
2016/6/1,臺南市,北區,50109,132916,64802,68114
2016/6/1,臺南市,安南區,61450,190329,96152,94177
2016/6/1,臺南市,安平區,24939,65554,31165,34389
2016/6/1,臺南市,中西區,30652,77121,37504,39617
2016/6/1,高雄市,鹽埕區,10801,24829,12313,12516
2016/6/1,高雄市,鼓山區,56505,137110,66471,70639
2016/6/1,高雄市,左營區,77951,196713,94934,101779
2016/6/1,高雄市,楠梓區,68110,180893,89051,91842
2016/6/1,高雄市,三民區,135336,345404,167525,177879
2016/6/1,高雄市,新興區,22649,51753,24949,26804
2016/6/1,高雄市,前金區,12475,27240,13079,14161
2016/6/1,高雄市,苓雅區,72254,173803,83906,89897
2016/6/1,高雄市,前鎮區,78322,191884,94506,97378
2016/6/1,高雄市,旗津區,11093,28902,14977,13925
2016/6/1,高雄市,小港區,66788,156396,77836,78560
2016/6/1,高雄市,鳳山區,137809,357040,175441,181599
2016/6/1,高雄市,林園區,25639,70261,35611,34650
2016/6/1,高雄市,大寮區,41549,111816,57405,54411
2016/6/1,高雄市,大樹區,13466,43095,22146,20949
2016/6/1,高雄市,大社區,12751,34610,17581,17029
2016/6/1,高雄市,仁武區,31561,83262,42379,40883
2016/6/1,高雄市,鳥松區,17863,44068,22423,21645
2016/6/1,高雄市,岡山區,34706,97787,48593,49194
2016/6/1,高雄市,橋頭區,13313,37332,19009,18323
2016/6/1,高雄市,燕巢區,10416,30019,15894,14125
2016/6/1,高雄市,田寮區,3336,7395,4102,3293
2016/6/1,高雄市,阿蓮區,9381,29201,14734,14467
2016/6/1,高雄市,路竹區,16884,53069,27095,25974
2016/6/1,高雄市,湖內區,10637,29664,15128,14536
2016/6/1,高雄市,茄萣區,10463,30419,15692,14727
2016/6/1,高雄市,永安區,5729,14053,7073,6980
2016/6/1,高雄市,彌陀區,6764,19640,10128,9512
2016/6/1,高雄市,梓官區,12565,36251,18724,17527
2016/6/1,高雄市,旗山區,13805,37574,19461,18113
2016/6/1,高雄市,美濃區,14603,40614,21292,19322
2016/6/1,高雄市,六龜區,5594,13346,7182,6164
2016/6/1,高雄市,甲仙區,2362,6242,3322,2920
2016/6/1,高雄市,杉林區,4798,12310,6731,5579
2016/6/1,高雄市,內門區,5083,14832,8038,6794
2016/6/1,高雄市,茂林區,582,1899,933,966
2016/6/1,高雄市,桃源區,1325,4224,2216,2008
2016/6/1,高雄市,那瑪夏區,852,3142,1623,1519
2016/6/1,宜蘭縣,宜蘭市,35725,96077,46961,49116
2016/6/1,宜蘭縣,羅東鎮,26159,72560,34483,38077
2016/6/1,宜蘭縣,蘇澳鎮,14105,40581,20672,19909
2016/6/1,宜蘭縣,頭城鎮,10190,29776,15344,14432
2016/6/1,宜蘭縣,礁溪鄉,13681,35846,18672,17174
2016/6/1,宜蘭縣,壯圍鄉,8597,24266,12848,11418
2016/6/1,宜蘭縣,員山鄉,11550,32250,17101,15149
2016/6/1,宜蘭縣,冬山鄉,18947,53408,27440,25968
2016/6/1,宜蘭縣,五結鄉,14550,39624,20523,19101
2016/6/1,宜蘭縣,三星鄉,8380,21421,11553,9868
2016/6/1,宜蘭縣,大同鄉,1890,6059,3286,2773
2016/6/1,宜蘭縣,南澳鄉,1924,5940,3109,2831
2016/6/1,新竹縣,竹北市,61816,173539,86458,87081
2016/6/1,新竹縣,關西鎮,9514,29636,15864,13772
2016/6/1,新竹縣,新埔鎮,10669,33984,18115,15869
2016/6/1,新竹縣,竹東鎮,33219,96812,48675,48137
2016/6/1,新竹縣,湖口鄉,25955,77406,39276,38130
2016/6/1,新竹縣,橫山鄉,4492,13425,7272,6153
2016/6/1,新竹縣,新豐鄉,17937,56293,28879,27414
2016/6/1,新竹縣,芎林鄉,6482,20163,10685,9478
2016/6/1,新竹縣,寶山鄉,5267,14294,7727,6567
2016/6/1,新竹縣,北埔鄉,3121,9602,5199,4403
2016/6/1,新竹縣,峨眉鄉,2079,5618,3104,2514
2016/6/1,新竹縣,尖石鄉,2841,9300,4941,4359
2016/6/1,新竹縣,五峰鄉,1736,4552,2472,2080
2016/6/1,苗栗縣,苗栗市,30793,90211,45073,45138
2016/6/1,苗栗縣,頭份市,33660,103116,52061,51055
2016/6/1,苗栗縣,苑裡鎮,14482,47436,24661,22775
2016/6/1,苗栗縣,通霄鎮,11534,35804,18894,16910
2016/6/1,苗栗縣,竹南鎮,28153,84823,42788,42035
2016/6/1,苗栗縣,後龍鎮,11845,37515,19793,17722
2016/6/1,苗栗縣,卓蘭鎮,6098,17800,9296,8504
2016/6/1,苗栗縣,大湖鄉,5406,15186,8056,7130
2016/6/1,苗栗縣,公館鄉,10629,34422,17929,16493
2016/6/1,苗栗縣,銅鑼鄉,6133,18562,9837,8725
2016/6/1,苗栗縣,南庄鄉,3953,10457,5761,4696
2016/6/1,苗栗縣,頭屋鄉,3650,11164,5899,5265
2016/6/1,苗栗縣,三義鄉,5514,16946,8901,8045
2016/6/1,苗栗縣,西湖鄉,2669,7361,4087,3274
2016/6/1,苗栗縣,造橋鄉,4119,13247,6963,6284
2016/6/1,苗栗縣,三灣鄉,2417,6939,3796,3143
2016/6/1,苗栗縣,獅潭鄉,1724,4543,2545,1998
2016/6/1,苗栗縣,泰安鄉,1960,5963,3186,2777
2016/6/1,彰化縣,彰化市,75716,235127,116302,118825
2016/6/1,彰化縣,員林市,38804,125120,62260,62860
2016/6/1,彰化縣,鹿港鎮,24189,86662,44097,42565
2016/6/1,彰化縣,和美鎮,26395,91250,46514,44736
2016/6/1,彰化縣,北斗鎮,10551,33267,16770,16497
2016/6/1,彰化縣,溪湖鎮,16143,55730,28333,27397
2016/6/1,彰化縣,田中鎮,13059,42317,21870,20447
2016/6/1,彰化縣,二林鎮,14927,51729,26656,25073
2016/6/1,彰化縣,線西鄉,4337,16992,8779,8213
2016/6/1,彰化縣,伸港鄉,9708,36555,18658,17897
2016/6/1,彰化縣,福興鄉,12609,47494,24739,22755
2016/6/1,彰化縣,秀水鄉,10572,39367,20320,19047
2016/6/1,彰化縣,花壇鄉,13881,46040,23670,22370
2016/6/1,彰化縣,芬園鄉,6850,23927,12588,11339
2016/6/1,彰化縣,大村鄉,10950,36640,18985,17655
2016/6/1,彰化縣,埔鹽鄉,9008,32900,17260,15640
2016/6/1,彰化縣,埔心鄉,10423,34755,17913,16842
2016/6/1,彰化縣,永靖鄉,10873,37933,19696,18237
2016/6/1,彰化縣,社頭鄉,12800,43378,22257,21121
2016/6/1,彰化縣,二水鄉,5333,15600,8175,7425
2016/6/1,彰化縣,田尾鄉,7903,27605,14262,13343
2016/6/1,彰化縣,埤頭鄉,8974,30859,16032,14827
2016/6/1,彰化縣,芳苑鄉,10125,34121,18046,16075
2016/6/1,彰化縣,大城鄉,5304,17390,9420,7970
2016/6/1,彰化縣,竹塘鄉,4626,15553,8193,7360
2016/6/1,彰化縣,溪州鄉,8947,30492,15982,14510
2016/6/1,南投縣,南投市,34530,101402,50859,50543
2016/6/1,南投縣,埔里鎮,28956,81939,41043,40896
2016/6/1,南投縣,草屯鎮,32877,98656,49844,48812
2016/6/1,南投縣,竹山鎮,20011,55780,28641,27139
2016/6/1,南投縣,集集鎮,4318,11103,5771,5332
2016/6/1,南投縣,名間鄉,12586,39328,20674,18654
2016/6/1,南投縣,鹿谷鄉,7767,18075,9633,8442
2016/6/1,南投縣,中寮鄉,5651,15224,8280,6944
2016/6/1,南投縣,魚池鄉,5748,16259,8534,7725
2016/6/1,南投縣,國姓鄉,7301,19195,10384,8811
2016/6/1,南投縣,水里鄉,7175,18139,9502,8637
2016/6/1,南投縣,信義鄉,5237,16452,8825,7627
2016/6/1,南投縣,仁愛鄉,4932,15658,8111,7547
2016/6/1,雲林縣,斗六市,37676,108481,54124,54357
2016/6/1,雲林縣,斗南鎮,15800,45436,23092,22344
2016/6/1,雲林縣,虎尾鎮,24491,70613,35811,34802
2016/6/1,雲林縣,西螺鎮,14539,46781,23695,23086
2016/6/1,雲林縣,土庫鎮,9281,29384,15353,14031
2016/6/1,雲林縣,北港鎮,15875,40864,21199,19665
2016/6/1,雲林縣,古坑鄉,10940,32103,16938,15165
2016/6/1,雲林縣,大埤鄉,6715,19559,10518,9041
2016/6/1,雲林縣,莿桐鄉,9266,29121,15286,13835
2016/6/1,雲林縣,林內鄉,5958,18663,9757,8906
2016/6/1,雲林縣,二崙鄉,8910,27748,14867,12881
2016/6/1,雲林縣,崙背鄉,8498,25284,13368,11916
2016/6/1,雲林縣,麥寮鄉,14076,44585,22517,22068
2016/6/1,雲林縣,東勢鄉,5723,15276,8403,6873
2016/6/1,雲林縣,褒忠鄉,4421,13267,7128,6139
2016/6/1,雲林縣,臺西鄉,8732,24339,13048,11291
2016/6/1,雲林縣,元長鄉,9335,26583,14522,12061
2016/6/1,雲林縣,四湖鄉,8869,24430,13270,11160
2016/6/1,雲林縣,口湖鄉,9566,28250,15003,13247
2016/6/1,雲林縣,水林鄉,10096,26338,14444,11894
2016/6/1,嘉義縣,太保市,12498,37323,19171,18152
2016/6/1,嘉義縣,朴子市,15576,42811,21690,21121
2016/6/1,嘉義縣,布袋鎮,9994,27662,14144,13518
2016/6/1,嘉義縣,大林鎮,11372,31572,16172,15400
2016/6/1,嘉義縣,民雄鄉,24542,71907,36818,35089
2016/6/1,嘉義縣,溪口鄉,5373,15020,8033,6987
2016/6/1,嘉義縣,新港鄉,10639,32644,17203,15441
2016/6/1,嘉義縣,六腳鄉,8961,23978,12760,11218
2016/6/1,嘉義縣,東石鄉,9332,25498,13526,11972
2016/6/1,嘉義縣,義竹鄉,7494,19030,9905,9125
2016/6/1,嘉義縣,鹿草鄉,5794,15963,8564,7399
2016/6/1,嘉義縣,水上鄉,17928,50132,25858,24274
2016/6/1,嘉義縣,中埔鄉,15967,45496,23646,21850
2016/6/1,嘉義縣,竹崎鄉,11714,36398,19447,16951
2016/6/1,嘉義縣,梅山鄉,6766,19879,10576,9303
2016/6/1,嘉義縣,番路鄉,4291,11758,6359,5399
2016/6/1,嘉義縣,大埔鄉,1935,4599,2392,2207
2016/6/1,嘉義縣,阿里山鄉,1956,5669,3001,2668
2016/6/1,屏東縣,屏東市,73766,202307,100323,101984
2016/6/1,屏東縣,潮州鎮,19291,54773,27428,27345
2016/6/1,屏東縣,東港鎮,16529,48241,24386,23855
2016/6/1,屏東縣,恆春鎮,11421,30778,15745,15033
2016/6/1,屏東縣,萬丹鄉,14832,51415,26620,24795
2016/6/1,屏東縣,長治鄉,10052,30185,15717,14468
2016/6/1,屏東縣,麟洛鄉,3774,11193,5815,5378
2016/6/1,屏東縣,九如鄉,6902,22084,11435,10649
2016/6/1,屏東縣,里港鄉,8175,27137,13795,13342
2016/6/1,屏東縣,鹽埔鄉,7841,26251,13659,12592
2016/6/1,屏東縣,高樹鄉,9338,24976,13274,11702
2016/6/1,屏東縣,萬巒鄉,6492,20703,10849,9854
2016/6/1,屏東縣,內埔鄉,18554,55422,28691,26731
2016/6/1,屏東縣,竹田鄉,5661,17464,9259,8205
2016/6/1,屏東縣,新埤鄉,3429,9979,5319,4660
2016/6/1,屏東縣,枋寮鄉,8531,24974,13099,11875
2016/6/1,屏東縣,新園鄉,11760,35904,18589,17315
2016/6/1,屏東縣,崁頂鄉,4458,15988,8114,7874
2016/6/1,屏東縣,林邊鄉,6797,18504,9489,9015
2016/6/1,屏東縣,南州鄉,3701,10845,5560,5285
2016/6/1,屏東縣,佳冬鄉,6976,19776,10282,9494
2016/6/1,屏東縣,琉球鄉,4400,12441,6843,5598
2016/6/1,屏東縣,車城鄉,3473,8860,4770,4090
2016/6/1,屏東縣,滿州鄉,3007,7943,4353,3590
2016/6/1,屏東縣,枋山鄉,2131,5558,2951,2607
2016/6/1,屏東縣,三地門鄉,2303,7683,3872,3811
2016/6/1,屏東縣,霧臺鄉,1056,3299,1692,1607
2016/6/1,屏東縣,瑪家鄉,2038,6736,3434,3302
2016/6/1,屏東縣,泰武鄉,1324,5210,2737,2473
2016/6/1,屏東縣,來義鄉,2233,7530,3830,3700
2016/6/1,屏東縣,春日鄉,1357,4804,2475,2329
2016/6/1,屏東縣,獅子鄉,1534,4806,2487,2319
2016/6/1,屏東縣,牡丹鄉,1886,4815,2470,2345
2016/6/1,臺東縣,臺東市,39427,106642,53533,53109
2016/6/1,臺東縣,成功鎮,5421,14503,7671,6832
2016/6/1,臺東縣,關山鎮,3206,8907,4675,4232
2016/6/1,臺東縣,卑南鄉,6671,17468,9264,8204
2016/6/1,臺東縣,大武鄉,2514,6232,3251,2981
2016/6/1,臺東縣,太麻里鄉,4615,11293,6010,5283
2016/6/1,臺東縣,東河鄉,3785,8773,4837,3936
2016/6/1,臺東縣,長濱鄉,2922,7462,4227,3235
2016/6/1,臺東縣,鹿野鄉,3071,8058,4304,3754
2016/6/1,臺東縣,池上鄉,3229,8447,4412,4035
2016/6/1,臺東縣,綠島鄉,1100,3739,1952,1787
2016/6/1,臺東縣,延平鄉,1063,3527,1894,1633
2016/6/1,臺東縣,海端鄉,1088,4265,2275,1990
2016/6/1,臺東縣,達仁鄉,1443,3568,1945,1623
2016/6/1,臺東縣,金峰鄉,1106,3579,1844,1735
2016/6/1,臺東縣,蘭嶼鄉,1799,5041,2543,2498
2016/6/1,花蓮縣,花蓮市,41424,105507,51047,54460
2016/6/1,花蓮縣,鳳林鎮,4408,11064,5777,5287
2016/6/1,花蓮縣,玉里鎮,8890,24831,13260,11571
2016/6/1,花蓮縣,新城鄉,7636,20196,10401,9795
2016/6/1,花蓮縣,吉安鄉,31572,83421,42155,41266
2016/6/1,花蓮縣,壽豐鄉,7067,18084,9653,8431
2016/6/1,花蓮縣,光復鄉,5028,13132,6982,6150
2016/6/1,花蓮縣,豐濱鄉,1725,4495,2506,1989
2016/6/1,花蓮縣,瑞穗鄉,4727,11858,6397,5461
2016/6/1,花蓮縣,富里鄉,4008,10595,5775,4820
2016/6/1,花蓮縣,秀林鄉,4762,15738,8141,7597
2016/6/1,花蓮縣,萬榮鄉,2079,6447,3413,3034
2016/6/1,花蓮縣,卓溪鄉,1679,6004,3293,2711
2016/6/1,澎湖縣,馬公市,23458,61009,31040,29969
2016/6/1,澎湖縣,湖西鄉,5472,14386,7603,6783
2016/6/1,澎湖縣,白沙鄉,3354,9699,5086,4613
2016/6/1,澎湖縣,西嶼鄉,2947,8366,4313,4053
2016/6/1,澎湖縣,望安鄉,1994,5123,2752,2371
2016/6/1,澎湖縣,七美鄉,1346,3746,1950,1796
2016/6/1,基隆市,中正區,22476,52555,26864,25691
2016/6/1,基隆市,七堵區,21161,54085,27299,26786
2016/6/1,基隆市,暖暖區,15473,38436,19343,19093
2016/6/1,基隆市,仁愛區,19347,45473,22457,23016
2016/6/1,基隆市,中山區,19207,48204,24484,23720
2016/6/1,基隆市,安樂區,32400,81390,40451,40939
2016/6/1,基隆市,信義區,21000,51694,25689,26005
2016/6/1,新竹市,東區,76812,208734,102863,105871
2016/6/1,新竹市,北區,55219,149439,73152,76287
2016/6/1,新竹市,香山區,26412,77065,39220,37845
2016/6/1,嘉義市,東區,45257,122751,59394,63357
2016/6/1,嘉義市,西區,53345,147503,72339,75164
2016/6/1,金門縣,金城鎮,12708,42509,21283,21226
2016/6/1,金門縣,金湖鎮,8647,28493,14351,14142
2016/6/1,金門縣,金沙鎮,6204,20155,9990,10165
2016/6/1,金門縣,金寧鄉,8118,28911,14605,14306
2016/6/1,金門縣,烈嶼鄉,3088,12459,6167,6292
2016/6/1,金門縣,烏坵鄉,133,658,328,330
2016/6/1,連江縣,南竿鄉,1506,7359,4167,3192
2016/6/1,連江縣,北竿鄉,522,2340,1305,1035
2016/6/1,連江縣,莒光鄉,286,1557,931,626
2016/6/1,連江縣,東引鄉,323,1280,768,512
2016/7/1,總計,新北市,1516639,3973655,1950996,2022659
2016/7/1,總計,臺北市,1045117,2701645,1292896,1408749
2016/7/1,總計,桃園市,759902,2128594,1063029,1065565
2016/7/1,總計,臺中市,935002,2756256,1361675,1394581
2016/7/1,總計,臺南市,674804,1885629,943396,942233
2016/7/1,總計,高雄市,1077111,2778285,1379513,1398772
2016/7/1,總計,臺灣省,2457288,7144707,3648007,3496700
2016/7/1,總計,宜蘭縣,165864,457746,231940,225806
2016/7/1,總計,新竹縣,185502,545204,278954,266250
2016/7/1,總計,苗栗縣,184894,561138,289301,271837
2016/7/1,總計,彰化縣,383238,1288970,657814,631156
2016/7/1,總計,南投縣,177155,506966,259961,247005
2016/7/1,總計,雲林縣,238871,696691,362117,334574
2016/7/1,總計,嘉義縣,182240,517224,269149,248075
2016/7/1,總計,屏東縣,285140,838166,429077,409089
2016/7/1,總計,臺東縣,82507,221408,114553,106855
2016/7/1,總計,花蓮縣,125034,331323,168775,162548
2016/7/1,總計,澎湖縣,38553,102357,52716,49641
2016/7/1,總計,基隆市,151111,371901,186612,185289
2016/7/1,總計,新竹市,158618,435488,215390,220098
2016/7/1,總計,嘉義市,98561,270125,131648,138477
2016/7/1,總計,福建省,41612,145979,73948,72031
2016/7/1,總計,金門縣,38973,133448,66791,66657
2016/7/1,總計,連江縣,2639,12531,7157,5374
2016/7/1,新北市,板橋區,205852,553131,270446,282685
2016/7/1,新北市,三重區,149059,388122,191392,196730
2016/7/1,新北市,中和區,163322,413941,201876,212065
2016/7/1,新北市,永和區,90645,224896,106943,117953
2016/7/1,新北市,新莊區,149805,413614,202342,211272
2016/7/1,新北市,新店區,124279,300346,144894,155452
2016/7/1,新北市,樹林區,65621,184313,92021,92292
2016/7/1,新北市,鶯歌區,29463,87526,43901,43625
2016/7/1,新北市,三峽區,41564,113622,57093,56529
2016/7/1,新北市,淡水區,71305,164129,78967,85162
2016/7/1,新北市,汐止區,85301,196713,96117,100596
2016/7/1,新北市,瑞芳區,16167,40769,20614,20155
2016/7/1,新北市,土城區,86038,238348,117854,120494
2016/7/1,新北市,蘆洲區,69790,200313,98628,101685
2016/7/1,新北市,五股區,30342,83523,42154,41369
2016/7/1,新北市,泰山區,28120,78911,39222,39689
2016/7/1,新北市,林口區,39837,101970,49836,52134
2016/7/1,新北市,深坑區,9500,23638,11813,11825
2016/7/1,新北市,石碇區,3371,7773,4289,3484
2016/7/1,新北市,坪林區,2501,6522,3623,2899
2016/7/1,新北市,三芝區,9380,23383,12021,11362
2016/7/1,新北市,石門區,4301,12540,6501,6039
2016/7/1,新北市,八里區,14167,37900,18891,19009
2016/7/1,新北市,平溪區,2336,4797,2656,2141
2016/7/1,新北市,雙溪區,3820,9136,4933,4203
2016/7/1,新北市,貢寮區,4403,12787,6530,6257
2016/7/1,新北市,金山區,7055,22238,10990,11248
2016/7/1,新北市,萬里區,7445,22587,11376,11211
2016/7/1,新北市,烏來區,1850,6167,3073,3094
2016/7/1,臺北市,松山區,80274,209388,98551,110837
2016/7/1,臺北市,信義區,89459,228369,109265,119104
2016/7/1,臺北市,大安區,120400,312540,146070,166470
2016/7/1,臺北市,中山區,99285,231288,107946,123342
2016/7/1,臺北市,中正區,65119,161744,77238,84506
2016/7/1,臺北市,大同區,51532,130520,63720,66800
2016/7/1,臺北市,萬華區,78317,193790,95454,98336
2016/7/1,臺北市,文山區,104706,275589,132390,143199
2016/7/1,臺北市,南港區,46626,122475,59884,62591
2016/7/1,臺北市,內湖區,106896,287763,137649,150114
2016/7/1,臺北市,士林區,106471,290497,140352,150145
2016/7/1,臺北市,北投區,96032,257682,124377,133305
2016/7/1,桃園市,桃園區,161286,431504,209924,221580
2016/7/1,桃園市,中壢區,142978,393288,194296,198992
2016/7/1,桃園市,大溪區,31646,93841,48007,45834
2016/7/1,桃園市,楊梅區,55698,162720,82264,80456
2016/7/1,桃園市,蘆竹區,56068,157242,78282,78960
2016/7/1,桃園市,大園區,30902,86296,44242,42054
2016/7/1,桃園市,龜山區,57085,148803,74529,74274
2016/7/1,桃園市,八德區,67116,190526,95801,94725
2016/7/1,桃園市,龍潭區,40567,119391,60032,59359
2016/7/1,桃園市,平鎮區,75032,219965,109524,110441
2016/7/1,桃園市,新屋區,15899,48687,25990,22697
2016/7/1,桃園市,觀音區,21873,65246,34095,31151
2016/7/1,桃園市,復興區,3752,11085,6043,5042
2016/7/1,臺中市,中區,7938,18863,9396,9467
2016/7/1,臺中市,東區,27451,75211,37502,37709
2016/7/1,臺中市,南區,47051,122724,59043,63681
2016/7/1,臺中市,西區,45152,115611,55046,60565
2016/7/1,臺中市,北區,58590,147474,70642,76832
2016/7/1,臺中市,西屯區,83158,223173,107489,115684
2016/7/1,臺中市,南屯區,60229,165784,79393,86391
2016/7/1,臺中市,北屯區,96151,268094,128911,139183
2016/7/1,臺中市,豐原區,52878,166794,82548,84246
2016/7/1,臺中市,東勢區,17296,51108,26318,24790
2016/7/1,臺中市,大甲區,22778,77757,39164,38593
2016/7/1,臺中市,清水區,26641,86244,44279,41965
2016/7/1,臺中市,沙鹿區,28411,90498,45803,44695
2016/7/1,臺中市,梧棲區,17364,57439,28882,28557
2016/7/1,臺中市,后里區,15782,54250,27604,26646
2016/7/1,臺中市,神岡區,19068,65356,33402,31954
2016/7/1,臺中市,潭子區,35662,106982,52965,54017
2016/7/1,臺中市,大雅區,28659,93966,46961,47005
2016/7/1,臺中市,新社區,7525,24958,12983,11975
2016/7/1,臺中市,石岡區,4897,15241,7910,7331
2016/7/1,臺中市,外埔區,9490,31910,16346,15564
2016/7/1,臺中市,大安區,5431,19479,10291,9188
2016/7/1,臺中市,烏日區,23550,73129,36791,36338
2016/7/1,臺中市,大肚區,17224,56983,29116,27867
2016/7/1,臺中市,龍井區,22470,76837,38850,37987
2016/7/1,臺中市,霧峰區,19844,64767,32960,31807
2016/7/1,臺中市,太平區,61708,185429,92154,93275
2016/7/1,臺中市,大里區,68125,209447,103167,106280
2016/7/1,臺中市,和平區,4479,10748,5759,4989
2016/7/1,臺南市,新營區,28798,78220,38715,39505
2016/7/1,臺南市,鹽水區,10091,25998,13584,12414
2016/7/1,臺南市,白河區,10870,28977,15146,13831
2016/7/1,臺南市,柳營區,7837,21531,11252,10279
2016/7/1,臺南市,後壁區,8891,24199,12576,11623
2016/7/1,臺南市,東山區,8358,21449,11390,10059
2016/7/1,臺南市,麻豆區,15655,44861,22779,22082
2016/7/1,臺南市,下營區,9115,24594,12666,11928
2016/7/1,臺南市,六甲區,7724,22531,11626,10905
2016/7/1,臺南市,官田區,7845,21544,11002,10542
2016/7/1,臺南市,大內區,3898,9973,5334,4639
2016/7/1,臺南市,佳里區,20495,59540,29533,30007
2016/7/1,臺南市,學甲區,9662,26530,13559,12971
2016/7/1,臺南市,西港區,8133,24930,12626,12304
2016/7/1,臺南市,七股區,8055,23236,12029,11207
2016/7/1,臺南市,將軍區,7298,20144,10267,9877
2016/7/1,臺南市,北門區,4295,11404,5783,5621
2016/7/1,臺南市,新化區,14306,43798,22334,21464
2016/7/1,臺南市,善化區,17059,47346,23893,23453
2016/7/1,臺南市,新市區,11861,36055,18130,17925
2016/7/1,臺南市,安定區,9927,30429,15621,14808
2016/7/1,臺南市,山上區,2693,7384,3870,3514
2016/7/1,臺南市,玉井區,5115,14313,7431,6882
2016/7/1,臺南市,楠西區,3538,9952,5275,4677
2016/7/1,臺南市,南化區,2860,8829,4779,4050
2016/7/1,臺南市,左鎮區,1983,5020,2806,2214
2016/7/1,臺南市,仁德區,27115,74458,37862,36596
2016/7/1,臺南市,歸仁區,22391,68044,34575,33469
2016/7/1,臺南市,關廟區,11034,34708,17912,16796
2016/7/1,臺南市,龍崎區,1558,4138,2238,1900
2016/7/1,臺南市,永康區,82199,231552,114308,117244
2016/7/1,臺南市,東區,71722,188211,90436,97775
2016/7/1,臺南市,南區,45094,125704,62405,63299
2016/7/1,臺南市,北區,50176,132884,64781,68103
2016/7/1,臺南市,安南區,61572,190556,96253,94303
2016/7/1,臺南市,安平區,24961,65608,31182,34426
2016/7/1,臺南市,中西區,30620,76979,37438,39541
2016/7/1,高雄市,鹽埕區,10797,24771,12295,12476
2016/7/1,高雄市,鼓山區,56620,137314,66555,70759
2016/7/1,高雄市,左營區,78000,196744,94916,101828
2016/7/1,高雄市,楠梓區,68270,181072,89157,91915
2016/7/1,高雄市,三民區,135433,345251,167461,177790
2016/7/1,高雄市,新興區,22677,51707,24922,26785
2016/7/1,高雄市,前金區,12489,27196,13055,14141
2016/7/1,高雄市,苓雅區,72212,173605,83838,89767
2016/7/1,高雄市,前鎮區,78347,191701,94381,97320
2016/7/1,高雄市,旗津區,11095,28939,14972,13967
2016/7/1,高雄市,小港區,66854,156481,77880,78601
2016/7/1,高雄市,鳳山區,138002,357316,175560,181756
2016/7/1,高雄市,林園區,25653,70254,35622,34632
2016/7/1,高雄市,大寮區,41608,111918,57446,54472
2016/7/1,高雄市,大樹區,13470,43052,22115,20937
2016/7/1,高雄市,大社區,12755,34609,17570,17039
2016/7/1,高雄市,仁武區,31645,83452,42468,40984
2016/7/1,高雄市,鳥松區,17886,44065,22427,21638
2016/7/1,高雄市,岡山區,34732,97752,48551,49201
2016/7/1,高雄市,橋頭區,13335,37366,19022,18344
2016/7/1,高雄市,燕巢區,10435,30018,15899,14119
2016/7/1,高雄市,田寮區,3331,7390,4102,3288
2016/7/1,高雄市,阿蓮區,9378,29171,14722,14449
2016/7/1,高雄市,路竹區,16901,53088,27114,25974
2016/7/1,高雄市,湖內區,10652,29665,15123,14542
2016/7/1,高雄市,茄萣區,10466,30426,15696,14730
2016/7/1,高雄市,永安區,5728,14051,7072,6979
2016/7/1,高雄市,彌陀區,6777,19653,10132,9521
2016/7/1,高雄市,梓官區,12561,36251,18716,17535
2016/7/1,高雄市,旗山區,13804,37515,19437,18078
2016/7/1,高雄市,美濃區,14613,40574,21281,19293
2016/7/1,高雄市,六龜區,5579,13310,7164,6146
2016/7/1,高雄市,甲仙區,2357,6226,3315,2911
2016/7/1,高雄市,杉林區,4806,12305,6729,5576
2016/7/1,高雄市,內門區,5084,14826,8034,6792
2016/7/1,高雄市,茂林區,582,1903,935,968
2016/7/1,高雄市,桃源區,1324,4210,2208,2002
2016/7/1,高雄市,那瑪夏區,853,3138,1621,1517
2016/7/1,宜蘭縣,宜蘭市,35746,96023,46930,49093
2016/7/1,宜蘭縣,羅東鎮,26187,72514,34423,38091
2016/7/1,宜蘭縣,蘇澳鎮,14123,40584,20678,19906
2016/7/1,宜蘭縣,頭城鎮,10197,29764,15336,14428
2016/7/1,宜蘭縣,礁溪鄉,13704,35855,18684,17171
2016/7/1,宜蘭縣,壯圍鄉,8606,24264,12837,11427
2016/7/1,宜蘭縣,員山鄉,11560,32281,17119,15162
2016/7/1,宜蘭縣,冬山鄉,18963,53392,27442,25950
2016/7/1,宜蘭縣,五結鄉,14576,39652,20540,19112
2016/7/1,宜蘭縣,三星鄉,8383,21417,11553,9864
2016/7/1,宜蘭縣,大同鄉,1891,6068,3292,2776
2016/7/1,宜蘭縣,南澳鄉,1928,5932,3106,2826
2016/7/1,新竹縣,竹北市,62026,174057,86708,87349
2016/7/1,新竹縣,關西鎮,9510,29609,15850,13759
2016/7/1,新竹縣,新埔鎮,10667,33947,18089,15858
2016/7/1,新竹縣,竹東鎮,33270,96831,48701,48130
2016/7/1,新竹縣,湖口鄉,26004,77477,39300,38177
2016/7/1,新竹縣,橫山鄉,4484,13395,7257,6138
2016/7/1,新竹縣,新豐鄉,17981,56325,28894,27431
2016/7/1,新竹縣,芎林鄉,6488,20181,10693,9488
2016/7/1,新竹縣,寶山鄉,5300,14326,7749,6577
2016/7/1,新竹縣,北埔鄉,3119,9582,5191,4391
2016/7/1,新竹縣,峨眉鄉,2078,5611,3104,2507
2016/7/1,新竹縣,尖石鄉,2844,9312,4946,4366
2016/7/1,新竹縣,五峰鄉,1731,4551,2472,2079
2016/7/1,苗栗縣,苗栗市,30830,90184,45045,45139
2016/7/1,苗栗縣,頭份市,33677,103095,52029,51066
2016/7/1,苗栗縣,苑裡鎮,14492,47402,24640,22762
2016/7/1,苗栗縣,通霄鎮,11532,35739,18867,16872
2016/7/1,苗栗縣,竹南鎮,28203,84837,42784,42053
2016/7/1,苗栗縣,後龍鎮,11844,37468,19769,17699
2016/7/1,苗栗縣,卓蘭鎮,6094,17770,9282,8488
2016/7/1,苗栗縣,大湖鄉,5409,15176,8049,7127
2016/7/1,苗栗縣,公館鄉,10633,34373,17910,16463
2016/7/1,苗栗縣,銅鑼鄉,6140,18569,9836,8733
2016/7/1,苗栗縣,南庄鄉,3956,10444,5755,4689
2016/7/1,苗栗縣,頭屋鄉,3651,11153,5894,5259
2016/7/1,苗栗縣,三義鄉,5549,16932,8897,8035
2016/7/1,苗栗縣,西湖鄉,2666,7350,4081,3269
2016/7/1,苗栗縣,造橋鄉,4120,13231,6955,6276
2016/7/1,苗栗縣,三灣鄉,2414,6930,3793,3137
2016/7/1,苗栗縣,獅潭鄉,1722,4532,2537,1995
2016/7/1,苗栗縣,泰安鄉,1962,5953,3178,2775
2016/7/1,彰化縣,彰化市,75749,235089,116282,118807
2016/7/1,彰化縣,員林市,38826,125119,62259,62860
2016/7/1,彰化縣,鹿港鎮,24217,86707,44117,42590
2016/7/1,彰化縣,和美鎮,26428,91287,46526,44761
2016/7/1,彰化縣,北斗鎮,10557,33281,16773,16508
2016/7/1,彰化縣,溪湖鎮,16155,55745,28347,27398
2016/7/1,彰化縣,田中鎮,13064,42320,21872,20448
2016/7/1,彰化縣,二林鎮,14931,51722,26646,25076
2016/7/1,彰化縣,線西鄉,4346,17011,8793,8218
2016/7/1,彰化縣,伸港鄉,9725,36579,18668,17911
2016/7/1,彰化縣,福興鄉,12597,47445,24714,22731
2016/7/1,彰化縣,秀水鄉,10572,39379,20322,19057
2016/7/1,彰化縣,花壇鄉,13906,46101,23695,22406
2016/7/1,彰化縣,芬園鄉,6845,23932,12593,11339
2016/7/1,彰化縣,大村鄉,10965,36688,18995,17693
2016/7/1,彰化縣,埔鹽鄉,9029,32907,17268,15639
2016/7/1,彰化縣,埔心鄉,10424,34767,17917,16850
2016/7/1,彰化縣,永靖鄉,10888,37921,19678,18243
2016/7/1,彰化縣,社頭鄉,12810,43378,22257,21121
2016/7/1,彰化縣,二水鄉,5331,15592,8178,7414
2016/7/1,彰化縣,田尾鄉,7902,27625,14269,13356
2016/7/1,彰化縣,埤頭鄉,8972,30821,16022,14799
2016/7/1,彰化縣,芳苑鄉,10112,34134,18045,16089
2016/7/1,彰化縣,大城鄉,5307,17388,9416,7972
2016/7/1,彰化縣,竹塘鄉,4626,15544,8187,7357
2016/7/1,彰化縣,溪州鄉,8954,30488,15975,14513
2016/7/1,南投縣,南投市,34546,101314,50802,50512
2016/7/1,南投縣,埔里鎮,28956,81892,41003,40889
2016/7/1,南投縣,草屯鎮,32900,98652,49849,48803
2016/7/1,南投縣,竹山鎮,20020,55758,28632,27126
2016/7/1,南投縣,集集鎮,4318,11098,5771,5327
2016/7/1,南投縣,名間鄉,12594,39348,20685,18663
2016/7/1,南投縣,鹿谷鄉,7769,18056,9622,8434
2016/7/1,南投縣,中寮鄉,5650,15208,8270,6938
2016/7/1,南投縣,魚池鄉,5752,16244,8531,7713
2016/7/1,南投縣,國姓鄉,7308,19165,10364,8801
2016/7/1,南投縣,水里鄉,7178,18121,9509,8612
2016/7/1,南投縣,信義鄉,5238,16448,8808,7640
2016/7/1,南投縣,仁愛鄉,4926,15662,8115,7547
2016/7/1,雲林縣,斗六市,37693,108473,54129,54344
2016/7/1,雲林縣,斗南鎮,15792,45395,23063,22332
2016/7/1,雲林縣,虎尾鎮,24520,70671,35830,34841
2016/7/1,雲林縣,西螺鎮,14551,46716,23671,23045
2016/7/1,雲林縣,土庫鎮,9282,29348,15340,14008
2016/7/1,雲林縣,北港鎮,15891,40845,21185,19660
2016/7/1,雲林縣,古坑鄉,10940,32088,16923,15165
2016/7/1,雲林縣,大埤鄉,6710,19554,10511,9043
2016/7/1,雲林縣,莿桐鄉,9273,29122,15289,13833
2016/7/1,雲林縣,林內鄉,5968,18621,9738,8883
2016/7/1,雲林縣,二崙鄉,8915,27692,14837,12855
2016/7/1,雲林縣,崙背鄉,8506,25267,13363,11904
2016/7/1,雲林縣,麥寮鄉,14088,44622,22517,22105
2016/7/1,雲林縣,東勢鄉,5714,15234,8382,6852
2016/7/1,雲林縣,褒忠鄉,4444,13261,7123,6138
2016/7/1,雲林縣,臺西鄉,8734,24317,13034,11283
2016/7/1,雲林縣,元長鄉,9336,26557,14514,12043
2016/7/1,雲林縣,四湖鄉,8865,24380,13242,11138
2016/7/1,雲林縣,口湖鄉,9559,28212,14992,13220
2016/7/1,雲林縣,水林鄉,10090,26316,14434,11882
2016/7/1,嘉義縣,太保市,12526,37373,19198,18175
2016/7/1,嘉義縣,朴子市,15599,42787,21673,21114
2016/7/1,嘉義縣,布袋鎮,9980,27619,14122,13497
2016/7/1,嘉義縣,大林鎮,11374,31550,16154,15396
2016/7/1,嘉義縣,民雄鄉,24569,71925,36836,35089
2016/7/1,嘉義縣,溪口鄉,5374,15023,8025,6998
2016/7/1,嘉義縣,新港鄉,10657,32619,17183,15436
2016/7/1,嘉義縣,六腳鄉,8962,23969,12752,11217
2016/7/1,嘉義縣,東石鄉,9325,25482,13512,11970
2016/7/1,嘉義縣,義竹鄉,7489,18976,9875,9101
2016/7/1,嘉義縣,鹿草鄉,5794,15936,8553,7383
2016/7/1,嘉義縣,水上鄉,17940,50155,25864,24291
2016/7/1,嘉義縣,中埔鄉,15973,45521,23654,21867
2016/7/1,嘉義縣,竹崎鄉,11716,36380,19425,16955
2016/7/1,嘉義縣,梅山鄉,6773,19887,10577,9310
2016/7/1,嘉義縣,番路鄉,4294,11749,6350,5399
2016/7/1,嘉義縣,大埔鄉,1940,4602,2395,2207
2016/7/1,嘉義縣,阿里山鄉,1955,5671,3001,2670
2016/7/1,屏東縣,屏東市,73810,202214,100271,101943
2016/7/1,屏東縣,潮州鎮,19312,54794,27438,27356
2016/7/1,屏東縣,東港鎮,16553,48251,24386,23865
2016/7/1,屏東縣,恆春鎮,11431,30764,15740,15024
2016/7/1,屏東縣,萬丹鄉,14833,51403,26602,24801
2016/7/1,屏東縣,長治鄉,10053,30181,15711,14470
2016/7/1,屏東縣,麟洛鄉,3775,11196,5816,5380
2016/7/1,屏東縣,九如鄉,6906,22073,11433,10640
2016/7/1,屏東縣,里港鄉,8175,27117,13786,13331
2016/7/1,屏東縣,鹽埔鄉,7841,26255,13651,12604
2016/7/1,屏東縣,高樹鄉,9331,24950,13262,11688
2016/7/1,屏東縣,萬巒鄉,6500,20685,10823,9862
2016/7/1,屏東縣,內埔鄉,18548,55343,28650,26693
2016/7/1,屏東縣,竹田鄉,5663,17455,9249,8206
2016/7/1,屏東縣,新埤鄉,3429,9970,5313,4657
2016/7/1,屏東縣,枋寮鄉,8530,24944,13076,11868
2016/7/1,屏東縣,新園鄉,11761,35860,18566,17294
2016/7/1,屏東縣,崁頂鄉,4460,15949,8095,7854
2016/7/1,屏東縣,林邊鄉,6792,18484,9476,9008
2016/7/1,屏東縣,南州鄉,3708,10861,5563,5298
2016/7/1,屏東縣,佳冬鄉,6975,19742,10264,9478
2016/7/1,屏東縣,琉球鄉,4406,12452,6842,5610
2016/7/1,屏東縣,車城鄉,3474,8861,4767,4094
2016/7/1,屏東縣,滿州鄉,3014,7935,4346,3589
2016/7/1,屏東縣,枋山鄉,2130,5547,2949,2598
2016/7/1,屏東縣,三地門鄉,2304,7665,3861,3804
2016/7/1,屏東縣,霧臺鄉,1053,3292,1691,1601
2016/7/1,屏東縣,瑪家鄉,2038,6743,3441,3302
2016/7/1,屏東縣,泰武鄉,1324,5208,2737,2471
2016/7/1,屏東縣,來義鄉,2232,7527,3829,3698
2016/7/1,屏東縣,春日鄉,1360,4812,2480,2332
2016/7/1,屏東縣,獅子鄉,1535,4811,2489,2322
2016/7/1,屏東縣,牡丹鄉,1884,4822,2474,2348
2016/7/1,臺東縣,臺東市,39458,106586,53476,53110
2016/7/1,臺東縣,成功鎮,5423,14506,7670,6836
2016/7/1,臺東縣,關山鎮,3206,8894,4665,4229
2016/7/1,臺東縣,卑南鄉,6674,17454,9253,8201
2016/7/1,臺東縣,大武鄉,2509,6221,3251,2970
2016/7/1,臺東縣,太麻里鄉,4630,11304,6022,5282
2016/7/1,臺東縣,東河鄉,3784,8774,4838,3936
2016/7/1,臺東縣,長濱鄉,2924,7458,4221,3237
2016/7/1,臺東縣,鹿野鄉,3074,8058,4300,3758
2016/7/1,臺東縣,池上鄉,3229,8434,4403,4031
2016/7/1,臺東縣,綠島鄉,1095,3740,1951,1789
2016/7/1,臺東縣,延平鄉,1063,3523,1893,1630
2016/7/1,臺東縣,海端鄉,1089,4262,2279,1983
2016/7/1,臺東縣,達仁鄉,1446,3558,1939,1619
2016/7/1,臺東縣,金峰鄉,1109,3588,1844,1744
2016/7/1,臺東縣,蘭嶼鄉,1794,5048,2548,2500
2016/7/1,花蓮縣,花蓮市,41430,105443,51009,54434
2016/7/1,花蓮縣,鳳林鎮,4409,11056,5767,5289
2016/7/1,花蓮縣,玉里鎮,8887,24820,13254,11566
2016/7/1,花蓮縣,新城鄉,7650,20207,10410,9797
2016/7/1,花蓮縣,吉安鄉,31586,83457,42199,41258
2016/7/1,花蓮縣,壽豐鄉,7070,18081,9653,8428
2016/7/1,花蓮縣,光復鄉,5035,13128,6990,6138
2016/7/1,花蓮縣,豐濱鄉,1718,4486,2499,1987
2016/7/1,花蓮縣,瑞穗鄉,4718,11845,6384,5461
2016/7/1,花蓮縣,富里鄉,4006,10598,5773,4825
2016/7/1,花蓮縣,秀林鄉,4762,15761,8143,7618
2016/7/1,花蓮縣,萬榮鄉,2083,6443,3409,3034
2016/7/1,花蓮縣,卓溪鄉,1680,5998,3285,2713
2016/7/1,澎湖縣,馬公市,23421,60966,30991,29975
2016/7/1,澎湖縣,湖西鄉,5467,14393,7596,6797
2016/7/1,澎湖縣,白沙鄉,3358,9718,5091,4627
2016/7/1,澎湖縣,西嶼鄉,2954,8383,4320,4063
2016/7/1,澎湖縣,望安鄉,2007,5146,2763,2383
2016/7/1,澎湖縣,七美鄉,1346,3751,1955,1796
2016/7/1,基隆市,中正區,22475,52537,26867,25670
2016/7/1,基隆市,七堵區,21173,54092,27290,26802
2016/7/1,基隆市,暖暖區,15464,38413,19330,19083
2016/7/1,基隆市,仁愛區,19309,45372,22420,22952
2016/7/1,基隆市,中山區,19194,48199,24479,23720
2016/7/1,基隆市,安樂區,32479,81525,40485,41040
2016/7/1,基隆市,信義區,21017,51763,25741,26022
2016/7/1,新竹市,東區,76837,208724,102878,105846
2016/7/1,新竹市,北區,55296,149610,73245,76365
2016/7/1,新竹市,香山區,26485,77154,39267,37887
2016/7/1,嘉義市,東區,45243,122730,59375,63355
2016/7/1,嘉義市,西區,53318,147395,72273,75122
2016/7/1,金門縣,金城鎮,12709,42576,21289,21287
2016/7/1,金門縣,金湖鎮,8673,28606,14401,14205
2016/7/1,金門縣,金沙鎮,6214,20207,10004,10203
2016/7/1,金門縣,金寧鄉,8149,28924,14606,14318
2016/7/1,金門縣,烈嶼鄉,3095,12476,6164,6312
2016/7/1,金門縣,烏坵鄉,133,659,327,332
2016/7/1,連江縣,南竿鄉,1510,7360,4155,3205
2016/7/1,連江縣,北竿鄉,522,2326,1299,1027
2016/7/1,連江縣,莒光鄉,284,1556,931,625
2016/7/1,連江縣,東引鄉,323,1289,772,517
2016/8/1,總計,新北市,1518816,3974278,1950970,2023308
2016/8/1,總計,臺北市,1045651,2698591,1291456,1407135
2016/8/1,總計,桃園市,762740,2132854,1065043,1067811
2016/8/1,總計,臺中市,937024,2758136,1362405,1395731
2016/8/1,總計,臺南市,675666,1885601,943295,942306
2016/8/1,總計,高雄市,1078635,2778318,1379378,1398940
2016/8/1,總計,臺灣省,2459821,7142857,3646767,3496090
2016/8/1,總計,宜蘭縣,166172,457788,231938,225850
2016/8/1,總計,新竹縣,185980,545674,279174,266500
2016/8/1,總計,苗栗縣,185086,560745,289131,271614
2016/8/1,總計,彰化縣,383639,1288345,657540,630805
2016/8/1,總計,南投縣,177161,506530,259733,246797
2016/8/1,總計,雲林縣,239035,696315,361882,334433
2016/8/1,總計,嘉義縣,182356,516915,268961,247954
2016/8/1,總計,屏東縣,285328,837700,428804,408896
2016/8/1,總計,臺東縣,82545,221324,114520,106804
2016/8/1,總計,花蓮縣,125104,331332,168733,162599
2016/8/1,總計,澎湖縣,38547,102406,52693,49713
2016/8/1,總計,基隆市,151291,371986,186595,185391
2016/8/1,總計,新竹市,158924,435805,215509,220296
2016/8/1,總計,嘉義市,98653,269992,131554,138438
2016/8/1,總計,福建省,41703,146206,74050,72156
2016/8/1,總計,金門縣,39060,133656,66875,66781
2016/8/1,總計,連江縣,2643,12550,7175,5375
2016/8/1,新北市,板橋區,206036,552748,270217,282531
2016/8/1,新北市,三重區,149273,388230,191399,196831
2016/8/1,新北市,中和區,163578,414127,201923,212204
2016/8/1,新北市,永和區,90606,224563,106777,117786
2016/8/1,新北市,新莊區,149986,413718,202374,211344
2016/8/1,新北市,新店區,124532,300584,144979,155605
2016/8/1,新北市,樹林區,65730,184358,92064,92294
2016/8/1,新北市,鶯歌區,29481,87449,43847,43602
2016/8/1,新北市,三峽區,41653,113696,57110,56586
2016/8/1,新北市,淡水區,71545,164434,79091,85343
2016/8/1,新北市,汐止區,85433,196843,96186,100657
2016/8/1,新北市,瑞芳區,16169,40721,20577,20144
2016/8/1,新北市,土城區,86106,238350,117838,120512
2016/8/1,新北市,蘆洲區,69926,200365,98629,101736
2016/8/1,新北市,五股區,30436,83665,42232,41433
2016/8/1,新北市,泰山區,28133,78835,39164,39671
2016/8/1,新北市,林口區,39988,102212,49934,52278
2016/8/1,新北市,深坑區,9508,23642,11811,11831
2016/8/1,新北市,石碇區,3374,7769,4278,3491
2016/8/1,新北市,坪林區,2506,6513,3620,2893
2016/8/1,新北市,三芝區,9394,23350,12002,11348
2016/8/1,新北市,石門區,4297,12511,6484,6027
2016/8/1,新北市,八里區,14192,37944,18918,19026
2016/8/1,新北市,平溪區,2339,4791,2647,2144
2016/8/1,新北市,雙溪區,3820,9130,4929,4201
2016/8/1,新北市,貢寮區,4402,12773,6525,6248
2016/8/1,新北市,金山區,7062,22217,10973,11244
2016/8/1,新北市,萬里區,7461,22574,11374,11200
2016/8/1,新北市,烏來區,1850,6166,3068,3098
2016/8/1,臺北市,松山區,80269,208884,98306,110578
2016/8/1,臺北市,信義區,89491,228174,109185,118989
2016/8/1,臺北市,大安區,120380,311964,145839,166125
2016/8/1,臺北市,中山區,99358,231166,107879,123287
2016/8/1,臺北市,中正區,65087,161295,77003,84292
2016/8/1,臺北市,大同區,51485,130236,63571,66665
2016/8/1,臺北市,萬華區,78386,193706,95413,98293
2016/8/1,臺北市,文山區,104789,275356,132275,143081
2016/8/1,臺北市,南港區,46738,122510,59894,62616
2016/8/1,臺北市,內湖區,107010,287563,137546,150017
2016/8/1,臺北市,士林區,106521,290207,140231,149976
2016/8/1,臺北市,北投區,96137,257530,124314,133216
2016/8/1,桃園市,桃園區,161594,431857,210110,221747
2016/8/1,桃園市,中壢區,143418,393883,194571,199312
2016/8/1,桃園市,大溪區,31720,93872,48008,45864
2016/8/1,桃園市,楊梅區,55845,162881,82319,80562
2016/8/1,桃園市,蘆竹區,56233,157612,78450,79162
2016/8/1,桃園市,大園區,31010,86395,44292,42103
2016/8/1,桃園市,龜山區,57923,150289,75273,75016
2016/8/1,桃園市,八德區,67429,191032,96026,95006
2016/8/1,桃園市,龍潭區,40695,119523,60098,59425
2016/8/1,桃園市,平鎮區,75259,220354,109734,110620
2016/8/1,桃園市,新屋區,15924,48695,25982,22713
2016/8/1,桃園市,觀音區,21938,65350,34131,31219
2016/8/1,桃園市,復興區,3752,11111,6049,5062
2016/8/1,臺中市,中區,7953,18813,9364,9449
2016/8/1,臺中市,東區,27460,75208,37512,37696
2016/8/1,臺中市,南區,47160,122848,59089,63759
2016/8/1,臺中市,西區,45285,115637,55034,60603
2016/8/1,臺中市,北區,58712,147440,70624,76816
2016/8/1,臺中市,西屯區,83331,223323,107556,115767
2016/8/1,臺中市,南屯區,60313,165906,79440,86466
2016/8/1,臺中市,北屯區,96485,268640,129134,139506
2016/8/1,臺中市,豐原區,52950,166794,82534,84260
2016/8/1,臺中市,東勢區,17303,51039,26287,24752
2016/8/1,臺中市,大甲區,22834,77740,39152,38588
2016/8/1,臺中市,清水區,26695,86266,44279,41987
2016/8/1,臺中市,沙鹿區,28489,90682,45885,44797
2016/8/1,臺中市,梧棲區,17397,57469,28897,28572
2016/8/1,臺中市,后里區,15833,54240,27588,26652
2016/8/1,臺中市,神岡區,19128,65468,33447,32021
2016/8/1,臺中市,潭子區,35731,107074,53006,54068
2016/8/1,臺中市,大雅區,28754,94117,47044,47073
2016/8/1,臺中市,新社區,7543,24979,12977,12002
2016/8/1,臺中市,石岡區,4903,15220,7909,7311
2016/8/1,臺中市,外埔區,9560,32006,16418,15588
2016/8/1,臺中市,大安區,5438,19475,10289,9186
2016/8/1,臺中市,烏日區,23608,73194,36816,36378
2016/8/1,臺中市,大肚區,17268,56997,29122,27875
2016/8/1,臺中市,龍井區,22497,76843,38834,38009
2016/8/1,臺中市,霧峰區,19860,64801,32984,31817
2016/8/1,臺中市,太平區,61804,185623,92220,93403
2016/8/1,臺中市,大里區,68233,209518,103188,106330
2016/8/1,臺中市,和平區,4497,10776,5776,5000
2016/8/1,臺南市,新營區,28828,78170,38676,39494
2016/8/1,臺南市,鹽水區,10091,25974,13571,12403
2016/8/1,臺南市,白河區,10863,28934,15121,13813
2016/8/1,臺南市,柳營區,7857,21543,11257,10286
2016/8/1,臺南市,後壁區,8887,24165,12557,11608
2016/8/1,臺南市,東山區,8439,21445,11385,10060
2016/8/1,臺南市,麻豆區,15667,44842,22782,22060
2016/8/1,臺南市,下營區,9108,24587,12666,11921
2016/8/1,臺南市,六甲區,7716,22503,11615,10888
2016/8/1,臺南市,官田區,7853,21548,11003,10545
2016/8/1,臺南市,大內區,3899,9978,5342,4636
2016/8/1,臺南市,佳里區,20498,59519,29514,30005
2016/8/1,臺南市,學甲區,9657,26474,13528,12946
2016/8/1,臺南市,西港區,8151,24924,12624,12300
2016/8/1,臺南市,七股區,8056,23206,12021,11185
2016/8/1,臺南市,將軍區,7301,20120,10253,9867
2016/8/1,臺南市,北門區,4291,11404,5785,5619
2016/8/1,臺南市,新化區,14330,43804,22333,21471
2016/8/1,臺南市,善化區,17097,47423,23928,23495
2016/8/1,臺南市,新市區,11903,36109,18159,17950
2016/8/1,臺南市,安定區,9949,30458,15631,14827
2016/8/1,臺南市,山上區,2695,7385,3874,3511
2016/8/1,臺南市,玉井區,5112,14302,7416,6886
2016/8/1,臺南市,楠西區,3532,9939,5267,4672
2016/8/1,臺南市,南化區,2860,8816,4773,4043
2016/8/1,臺南市,左鎮區,1983,5010,2803,2207
2016/8/1,臺南市,仁德區,27162,74530,37877,36653
2016/8/1,臺南市,歸仁區,22423,68067,34597,33470
2016/8/1,臺南市,關廟區,11047,34703,17908,16795
2016/8/1,臺南市,龍崎區,1559,4132,2229,1903
2016/8/1,臺南市,永康區,82318,231680,114413,117267
2016/8/1,臺南市,東區,71732,187983,90312,97671
2016/8/1,臺南市,南區,45172,125723,62401,63322
2016/8/1,臺南市,北區,50262,132872,64738,68134
2016/8/1,臺南市,安南區,61707,190725,96318,94407
2016/8/1,臺南市,安平區,25031,65661,31173,34488
2016/8/1,臺南市,中西區,30630,76943,37445,39498
2016/8/1,高雄市,鹽埕區,10797,24728,12271,12457
2016/8/1,高雄市,鼓山區,56825,137557,66661,70896
2016/8/1,高雄市,左營區,78118,196828,94939,101889
2016/8/1,高雄市,楠梓區,68473,181202,89241,91961
2016/8/1,高雄市,三民區,135575,345014,167331,177683
2016/8/1,高雄市,新興區,22672,51562,24836,26726
2016/8/1,高雄市,前金區,12504,27163,13048,14115
2016/8/1,高雄市,苓雅區,72236,173437,83743,89694
2016/8/1,高雄市,前鎮區,78420,191627,94312,97315
2016/8/1,高雄市,旗津區,11098,28925,14952,13973
2016/8/1,高雄市,小港區,66943,156502,77884,78618
2016/8/1,高雄市,鳳山區,138173,357398,175626,181772
2016/8/1,高雄市,林園區,25681,70274,35651,34623
2016/8/1,高雄市,大寮區,41675,111947,57452,54495
2016/8/1,高雄市,大樹區,13496,43073,22119,20954
2016/8/1,高雄市,大社區,12791,34621,17568,17053
2016/8/1,高雄市,仁武區,31776,83714,42586,41128
2016/8/1,高雄市,鳥松區,17944,44142,22470,21672
2016/8/1,高雄市,岡山區,34787,97687,48514,49173
2016/8/1,高雄市,橋頭區,13372,37411,19029,18382
2016/8/1,高雄市,燕巢區,10435,30009,15886,14123
2016/8/1,高雄市,田寮區,3331,7381,4096,3285
2016/8/1,高雄市,阿蓮區,9381,29154,14713,14441
2016/8/1,高雄市,路竹區,16905,53068,27101,25967
2016/8/1,高雄市,湖內區,10677,29714,15135,14579
2016/8/1,高雄市,茄萣區,10476,30433,15701,14732
2016/8/1,高雄市,永安區,5731,14045,7071,6974
2016/8/1,高雄市,彌陀區,6772,19632,10116,9516
2016/8/1,高雄市,梓官區,12556,36250,18709,17541
2016/8/1,高雄市,旗山區,13816,37466,19406,18060
2016/8/1,高雄市,美濃區,14632,40531,21258,19273
2016/8/1,高雄市,六龜區,5567,13278,7141,6137
2016/8/1,高雄市,甲仙區,2351,6207,3305,2902
2016/8/1,高雄市,杉林區,4808,12292,6728,5564
2016/8/1,高雄市,內門區,5082,14802,8019,6783
2016/8/1,高雄市,茂林區,582,1897,934,963
2016/8/1,高雄市,桃源區,1325,4214,2208,2006
2016/8/1,高雄市,那瑪夏區,852,3133,1618,1515
2016/8/1,宜蘭縣,宜蘭市,35821,95983,46915,49068
2016/8/1,宜蘭縣,羅東鎮,26240,72530,34423,38107
2016/8/1,宜蘭縣,蘇澳鎮,14133,40575,20671,19904
2016/8/1,宜蘭縣,頭城鎮,10206,29787,15354,14433
2016/8/1,宜蘭縣,礁溪鄉,13753,35924,18725,17199
2016/8/1,宜蘭縣,壯圍鄉,8626,24283,12837,11446
2016/8/1,宜蘭縣,員山鄉,11579,32298,17124,15174
2016/8/1,宜蘭縣,冬山鄉,18986,53333,27417,25916
2016/8/1,宜蘭縣,五結鄉,14609,39641,20522,19119
2016/8/1,宜蘭縣,三星鄉,8399,21412,11544,9868
2016/8/1,宜蘭縣,大同鄉,1891,6081,3298,2783
2016/8/1,宜蘭縣,南澳鄉,1929,5941,3108,2833
2016/8/1,新竹縣,竹北市,62296,174542,86933,87609
2016/8/1,新竹縣,關西鎮,9524,29577,15837,13740
2016/8/1,新竹縣,新埔鎮,10682,33894,18077,15817
2016/8/1,新竹縣,竹東鎮,33327,96815,48661,48154
2016/8/1,新竹縣,湖口鄉,26038,77512,39296,38216
2016/8/1,新竹縣,橫山鄉,4487,13366,7241,6125
2016/8/1,新竹縣,新豐鄉,18017,56352,28925,27427
2016/8/1,新竹縣,芎林鄉,6498,20198,10708,9490
2016/8/1,新竹縣,寶山鄉,5330,14336,7764,6572
2016/8/1,新竹縣,北埔鄉,3128,9593,5198,4395
2016/8/1,新竹縣,峨眉鄉,2076,5602,3100,2502
2016/8/1,新竹縣,尖石鄉,2845,9332,4964,4368
2016/8/1,新竹縣,五峰鄉,1732,4555,2470,2085
2016/8/1,苗栗縣,苗栗市,30871,90092,44992,45100
2016/8/1,苗栗縣,頭份市,33721,103096,52030,51066
2016/8/1,苗栗縣,苑裡鎮,14509,47346,24610,22736
2016/8/1,苗栗縣,通霄鎮,11538,35665,18831,16834
2016/8/1,苗栗縣,竹南鎮,28258,84890,42821,42069
2016/8/1,苗栗縣,後龍鎮,11846,37428,19748,17680
2016/8/1,苗栗縣,卓蘭鎮,6092,17746,9273,8473
2016/8/1,苗栗縣,大湖鄉,5410,15157,8042,7115
2016/8/1,苗栗縣,公館鄉,10651,34346,17914,16432
2016/8/1,苗栗縣,銅鑼鄉,6146,18563,9833,8730
2016/8/1,苗栗縣,南庄鄉,3955,10419,5742,4677
2016/8/1,苗栗縣,頭屋鄉,3647,11134,5883,5251
2016/8/1,苗栗縣,三義鄉,5563,16890,8881,8009
2016/8/1,苗栗縣,西湖鄉,2667,7346,4074,3272
2016/8/1,苗栗縣,造橋鄉,4116,13211,6948,6263
2016/8/1,苗栗縣,三灣鄉,2413,6938,3795,3143
2016/8/1,苗栗縣,獅潭鄉,1722,4519,2530,1989
2016/8/1,苗栗縣,泰安鄉,1961,5959,3184,2775
2016/8/1,彰化縣,彰化市,75814,234884,116163,118721
2016/8/1,彰化縣,員林市,38870,125057,62222,62835
2016/8/1,彰化縣,鹿港鎮,24250,86672,44098,42574
2016/8/1,彰化縣,和美鎮,26430,91250,46523,44727
2016/8/1,彰化縣,北斗鎮,10568,33291,16789,16502
2016/8/1,彰化縣,溪湖鎮,16174,55711,28327,27384
2016/8/1,彰化縣,田中鎮,13068,42265,21841,20424
2016/8/1,彰化縣,二林鎮,14960,51645,26610,25035
2016/8/1,彰化縣,線西鄉,4354,16992,8781,8211
2016/8/1,彰化縣,伸港鄉,9765,36623,18702,17921
2016/8/1,彰化縣,福興鄉,12596,47434,24719,22715
2016/8/1,彰化縣,秀水鄉,10594,39369,20319,19050
2016/8/1,彰化縣,花壇鄉,13945,46130,23728,22402
2016/8/1,彰化縣,芬園鄉,6848,23947,12602,11345
2016/8/1,彰化縣,大村鄉,10986,36702,19006,17696
2016/8/1,彰化縣,埔鹽鄉,9031,32875,17253,15622
2016/8/1,彰化縣,埔心鄉,10439,34787,17927,16860
2016/8/1,彰化縣,永靖鄉,10896,37862,19640,18222
2016/8/1,彰化縣,社頭鄉,12828,43349,22252,21097
2016/8/1,彰化縣,二水鄉,5333,15572,8163,7409
2016/8/1,彰化縣,田尾鄉,7907,27611,14267,13344
2016/8/1,彰化縣,埤頭鄉,8981,30836,16026,14810
2016/8/1,彰化縣,芳苑鄉,10122,34137,18049,16088
2016/8/1,彰化縣,大城鄉,5302,17361,9404,7957
2016/8/1,彰化縣,竹塘鄉,4626,15539,8183,7356
2016/8/1,彰化縣,溪州鄉,8952,30444,15946,14498
2016/8/1,南投縣,南投市,34569,101211,50748,50463
2016/8/1,南投縣,埔里鎮,28956,81832,40965,40867
2016/8/1,南投縣,草屯鎮,32899,98582,49823,48759
2016/8/1,南投縣,竹山鎮,20013,55719,28606,27113
2016/8/1,南投縣,集集鎮,4316,11087,5769,5318
2016/8/1,南投縣,名間鄉,12602,39295,20658,18637
2016/8/1,南投縣,鹿谷鄉,7779,18045,9619,8426
2016/8/1,南投縣,中寮鄉,5644,15186,8248,6938
2016/8/1,南投縣,魚池鄉,5747,16220,8533,7687
2016/8/1,南投縣,國姓鄉,7302,19152,10353,8799
2016/8/1,南投縣,水里鄉,7174,18102,9496,8606
2016/8/1,南投縣,信義鄉,5233,16424,8791,7633
2016/8/1,南投縣,仁愛鄉,4927,15675,8124,7551
2016/8/1,雲林縣,斗六市,37732,108429,54102,54327
2016/8/1,雲林縣,斗南鎮,15798,45383,23073,22310
2016/8/1,雲林縣,虎尾鎮,24584,70733,35860,34873
2016/8/1,雲林縣,西螺鎮,14561,46678,23647,23031
2016/8/1,雲林縣,土庫鎮,9288,29336,15340,13996
2016/8/1,雲林縣,北港鎮,15913,40840,21183,19657
2016/8/1,雲林縣,古坑鄉,10951,32084,16919,15165
2016/8/1,雲林縣,大埤鄉,6706,19510,10480,9030
2016/8/1,雲林縣,莿桐鄉,9282,29109,15295,13814
2016/8/1,雲林縣,林內鄉,5967,18589,9721,8868
2016/8/1,雲林縣,二崙鄉,8921,27679,14826,12853
2016/8/1,雲林縣,崙背鄉,8508,25211,13335,11876
2016/8/1,雲林縣,麥寮鄉,14111,44717,22552,22165
2016/8/1,雲林縣,東勢鄉,5717,15215,8369,6846
2016/8/1,雲林縣,褒忠鄉,4449,13244,7113,6131
2016/8/1,雲林縣,臺西鄉,8722,24289,13021,11268
2016/8/1,雲林縣,元長鄉,9323,26489,14466,12023
2016/8/1,雲林縣,四湖鄉,8867,24322,13207,11115
2016/8/1,雲林縣,口湖鄉,9557,28196,14990,13206
2016/8/1,雲林縣,水林鄉,10078,26262,14383,11879
2016/8/1,嘉義縣,太保市,12567,37431,19223,18208
2016/8/1,嘉義縣,朴子市,15614,42738,21647,21091
2016/8/1,嘉義縣,布袋鎮,9987,27597,14108,13489
2016/8/1,嘉義縣,大林鎮,11374,31502,16120,15382
2016/8/1,嘉義縣,民雄鄉,24596,71892,36816,35076
2016/8/1,嘉義縣,溪口鄉,5370,15019,8020,6999
2016/8/1,嘉義縣,新港鄉,10662,32573,17158,15415
2016/8/1,嘉義縣,六腳鄉,8955,23921,12725,11196
2016/8/1,嘉義縣,東石鄉,9318,25453,13496,11957
2016/8/1,嘉義縣,義竹鄉,7491,18922,9839,9083
2016/8/1,嘉義縣,鹿草鄉,5800,15924,8548,7376
2016/8/1,嘉義縣,水上鄉,17959,50197,25899,24298
2016/8/1,嘉義縣,中埔鄉,15968,45499,23636,21863
2016/8/1,嘉義縣,竹崎鄉,11732,36361,19414,16947
2016/8/1,嘉義縣,梅山鄉,6773,19861,10570,9291
2016/8/1,嘉義縣,番路鄉,4296,11756,6349,5407
2016/8/1,嘉義縣,大埔鄉,1939,4597,2387,2210
2016/8/1,嘉義縣,阿里山鄉,1955,5672,3006,2666
2016/8/1,屏東縣,屏東市,73834,202045,100168,101877
2016/8/1,屏東縣,潮州鎮,19340,54840,27453,27387
2016/8/1,屏東縣,東港鎮,16577,48230,24388,23842
2016/8/1,屏東縣,恆春鎮,11439,30765,15747,15018
2016/8/1,屏東縣,萬丹鄉,14849,51362,26584,24778
2016/8/1,屏東縣,長治鄉,10061,30171,15699,14472
2016/8/1,屏東縣,麟洛鄉,3781,11173,5808,5365
2016/8/1,屏東縣,九如鄉,6913,22064,11421,10643
2016/8/1,屏東縣,里港鄉,8183,27110,13788,13322
2016/8/1,屏東縣,鹽埔鄉,7845,26233,13633,12600
2016/8/1,屏東縣,高樹鄉,9333,24945,13270,11675
2016/8/1,屏東縣,萬巒鄉,6497,20667,10810,9857
2016/8/1,屏東縣,內埔鄉,18558,55299,28616,26683
2016/8/1,屏東縣,竹田鄉,5661,17438,9239,8199
2016/8/1,屏東縣,新埤鄉,3426,9963,5304,4659
2016/8/1,屏東縣,枋寮鄉,8528,24925,13072,11853
2016/8/1,屏東縣,新園鄉,11773,35841,18562,17279
2016/8/1,屏東縣,崁頂鄉,4465,15944,8092,7852
2016/8/1,屏東縣,林邊鄉,6792,18452,9458,8994
2016/8/1,屏東縣,南州鄉,3708,10858,5561,5297
2016/8/1,屏東縣,佳冬鄉,6978,19742,10253,9489
2016/8/1,屏東縣,琉球鄉,4418,12444,6846,5598
2016/8/1,屏東縣,車城鄉,3479,8845,4755,4090
2016/8/1,屏東縣,滿州鄉,3019,7905,4330,3575
2016/8/1,屏東縣,枋山鄉,2122,5522,2936,2586
2016/8/1,屏東縣,三地門鄉,2305,7675,3867,3808
2016/8/1,屏東縣,霧臺鄉,1055,3286,1687,1599
2016/8/1,屏東縣,瑪家鄉,2040,6742,3441,3301
2016/8/1,屏東縣,泰武鄉,1327,5228,2744,2484
2016/8/1,屏東縣,來義鄉,2231,7516,3825,3691
2016/8/1,屏東縣,春日鄉,1363,4812,2479,2333
2016/8/1,屏東縣,獅子鄉,1537,4814,2489,2325
2016/8/1,屏東縣,牡丹鄉,1891,4844,2479,2365
2016/8/1,臺東縣,臺東市,39463,106535,53474,53061
2016/8/1,臺東縣,成功鎮,5420,14499,7663,6836
2016/8/1,臺東縣,關山鎮,3207,8866,4646,4220
2016/8/1,臺東縣,卑南鄉,6684,17448,9235,8213
2016/8/1,臺東縣,大武鄉,2516,6223,3249,2974
2016/8/1,臺東縣,太麻里鄉,4644,11329,6035,5294
2016/8/1,臺東縣,東河鄉,3783,8756,4829,3927
2016/8/1,臺東縣,長濱鄉,2919,7433,4206,3227
2016/8/1,臺東縣,鹿野鄉,3063,8052,4297,3755
2016/8/1,臺東縣,池上鄉,3235,8416,4394,4022
2016/8/1,臺東縣,綠島鄉,1098,3738,1949,1789
2016/8/1,臺東縣,延平鄉,1061,3527,1900,1627
2016/8/1,臺東縣,海端鄉,1090,4281,2289,1992
2016/8/1,臺東縣,達仁鄉,1444,3555,1940,1615
2016/8/1,臺東縣,金峰鄉,1109,3586,1846,1740
2016/8/1,臺東縣,蘭嶼鄉,1809,5080,2568,2512
2016/8/1,花蓮縣,花蓮市,41449,105367,50972,54395
2016/8/1,花蓮縣,鳳林鎮,4405,11029,5751,5278
2016/8/1,花蓮縣,玉里鎮,8886,24814,13241,11573
2016/8/1,花蓮縣,新城鄉,7669,20237,10430,9807
2016/8/1,花蓮縣,吉安鄉,31601,83523,42240,41283
2016/8/1,花蓮縣,壽豐鄉,7082,18120,9660,8460
2016/8/1,花蓮縣,光復鄉,5036,13112,6974,6138
2016/8/1,花蓮縣,豐濱鄉,1720,4472,2490,1982
2016/8/1,花蓮縣,瑞穗鄉,4719,11830,6377,5453
2016/8/1,花蓮縣,富里鄉,4004,10591,5761,4830
2016/8/1,花蓮縣,秀林鄉,4768,15750,8127,7623
2016/8/1,花蓮縣,萬榮鄉,2082,6442,3402,3040
2016/8/1,花蓮縣,卓溪鄉,1683,6045,3308,2737
2016/8/1,澎湖縣,馬公市,23393,60988,30970,30018
2016/8/1,澎湖縣,湖西鄉,5467,14392,7595,6797
2016/8/1,澎湖縣,白沙鄉,3368,9748,5102,4646
2016/8/1,澎湖縣,西嶼鄉,2958,8391,4327,4064
2016/8/1,澎湖縣,望安鄉,2008,5150,2756,2394
2016/8/1,澎湖縣,七美鄉,1353,3737,1943,1794
2016/8/1,基隆市,中正區,22489,52488,26836,25652
2016/8/1,基隆市,七堵區,21186,54100,27286,26814
2016/8/1,基隆市,暖暖區,15471,38418,19328,19090
2016/8/1,基隆市,仁愛區,19291,45256,22359,22897
2016/8/1,基隆市,中山區,19201,48191,24468,23723
2016/8/1,基隆市,安樂區,32626,81696,40541,41155
2016/8/1,基隆市,信義區,21027,51837,25777,26060
2016/8/1,新竹市,東區,77010,208890,102942,105948
2016/8/1,新竹市,北區,55367,149674,73246,76428
2016/8/1,新竹市,香山區,26547,77241,39321,37920
2016/8/1,嘉義市,東區,45289,122640,59320,63320
2016/8/1,嘉義市,西區,53364,147352,72234,75118
2016/8/1,金門縣,金城鎮,12723,42637,21311,21326
2016/8/1,金門縣,金湖鎮,8697,28692,14452,14240
2016/8/1,金門縣,金沙鎮,6215,20187,9987,10200
2016/8/1,金門縣,金寧鄉,8192,28982,14628,14354
2016/8/1,金門縣,烈嶼鄉,3100,12499,6170,6329
2016/8/1,金門縣,烏坵鄉,133,659,327,332
2016/8/1,連江縣,南竿鄉,1514,7368,4164,3204
2016/8/1,連江縣,北竿鄉,522,2338,1308,1030
2016/8/1,連江縣,莒光鄉,285,1554,931,623
2016/8/1,連江縣,東引鄉,322,1290,772,518
2016/9/1,總計,新北市,1521700,3974911,1951006,2023905
2016/9/1,總計,臺北市,1046849,2696316,1290311,1406005
2016/9/1,總計,桃園市,765688,2136702,1066819,1069883
2016/9/1,總計,臺中市,939545,2759887,1363129,1396758
2016/9/1,總計,臺南市,676638,1885499,943148,942351
2016/9/1,總計,高雄市,1080508,2778332,1379143,1399189
2016/9/1,總計,臺灣省,2464206,7140866,3645590,3495276
2016/9/1,總計,宜蘭縣,166457,457671,231855,225816
2016/9/1,總計,新竹縣,186738,546272,279514,266758
2016/9/1,總計,苗栗縣,185450,560271,288890,271381
2016/9/1,總計,彰化縣,384130,1287665,657156,630509
2016/9/1,總計,南投縣,177274,506052,259449,246603
2016/9/1,總計,雲林縣,239262,695925,361645,334280
2016/9/1,總計,嘉義縣,182500,516531,268761,247770
2016/9/1,總計,屏東縣,285583,837048,428461,408587
2016/9/1,總計,臺東縣,82531,221199,114445,106754
2016/9/1,總計,花蓮縣,125167,331223,168636,162587
2016/9/1,總計,澎湖縣,39040,102880,52960,49920
2016/9/1,總計,基隆市,151636,372019,186560,185459
2016/9/1,總計,新竹市,159587,436220,215770,220450
2016/9/1,總計,嘉義市,98851,269890,131488,138402
2016/9/1,總計,福建省,41749,147005,74416,72589
2016/9/1,總計,金門縣,39106,134419,67225,67194
2016/9/1,總計,連江縣,2643,12586,7191,5395
2016/9/1,新北市,板橋區,206289,552317,269925,282392
2016/9/1,新北市,三重區,149519,388216,191376,196840
2016/9/1,新北市,中和區,163888,414220,201950,212270
2016/9/1,新北市,永和區,90694,224269,106648,117621
2016/9/1,新北市,新莊區,150191,413762,202399,211363
2016/9/1,新北市,新店區,124810,300731,145048,155683
2016/9/1,新北市,樹林區,65789,184243,92003,92240
2016/9/1,新北市,鶯歌區,29505,87362,43785,43577
2016/9/1,新北市,三峽區,41808,113941,57225,56716
2016/9/1,新北市,淡水區,71873,164838,79273,85565
2016/9/1,新北市,汐止區,85655,197110,96310,100800
2016/9/1,新北市,瑞芳區,16165,40677,20569,20108
2016/9/1,新北市,土城區,86270,238331,117799,120532
2016/9/1,新北市,蘆洲區,70019,200393,98608,101785
2016/9/1,新北市,五股區,30586,83839,42320,41519
2016/9/1,新北市,泰山區,28168,78763,39121,39642
2016/9/1,新北市,林口區,40196,102545,50061,52484
2016/9/1,新北市,深坑區,9512,23644,11806,11838
2016/9/1,新北市,石碇區,3371,7761,4271,3490
2016/9/1,新北市,坪林區,2504,6511,3615,2896
2016/9/1,新北市,三芝區,9414,23356,12010,11346
2016/9/1,新北市,石門區,4294,12491,6473,6018
2016/9/1,新北市,八里區,14239,38008,18945,19063
2016/9/1,新北市,平溪區,2338,4791,2648,2143
2016/9/1,新北市,雙溪區,3821,9111,4916,4195
2016/9/1,新北市,貢寮區,4405,12760,6518,6242
2016/9/1,新北市,金山區,7071,22216,10968,11248
2016/9/1,新北市,萬里區,7454,22535,11344,11191
2016/9/1,新北市,烏來區,1852,6170,3072,3098
2016/9/1,臺北市,松山區,80281,208387,98086,110301
2016/9/1,臺北市,信義區,89610,228059,109103,118956
2016/9/1,臺北市,大安區,120446,311479,145638,165841
2016/9/1,臺北市,中山區,99536,231106,107839,123267
2016/9/1,臺北市,中正區,65062,160790,76761,84029
2016/9/1,臺北市,大同區,51556,130167,63543,66624
2016/9/1,臺北市,萬華區,78536,193741,95395,98346
2016/9/1,臺北市,文山區,104902,275214,132220,142994
2016/9/1,臺北市,南港區,46809,122523,59898,62625
2016/9/1,臺北市,內湖區,107164,287453,137490,149963
2016/9/1,臺北市,士林區,106629,290001,140124,149877
2016/9/1,臺北市,北投區,96318,257396,124214,133182
2016/9/1,桃園市,桃園區,162027,432316,210368,221948
2016/9/1,桃園市,中壢區,143939,394421,194813,199608
2016/9/1,桃園市,大溪區,31751,93871,47986,45885
2016/9/1,桃園市,楊梅區,56006,163107,82435,80672
2016/9/1,桃園市,蘆竹區,56422,157891,78598,79293
2016/9/1,桃園市,大園區,31164,86609,44386,42223
2016/9/1,桃園市,龜山區,58668,151453,75790,75663
2016/9/1,桃園市,八德區,67802,191536,96246,95290
2016/9/1,桃園市,龍潭區,40750,119626,60148,59478
2016/9/1,桃園市,平鎮區,75466,220665,109875,110790
2016/9/1,桃園市,新屋區,15951,48697,25970,22727
2016/9/1,桃園市,觀音區,21988,65390,34146,31244
2016/9/1,桃園市,復興區,3754,11120,6058,5062
2016/9/1,臺中市,中區,7979,18764,9327,9437
2016/9/1,臺中市,東區,27556,75288,37545,37743
2016/9/1,臺中市,南區,47277,122991,59166,63825
2016/9/1,臺中市,西區,45358,115522,54973,60549
2016/9/1,臺中市,北區,58892,147503,70661,76842
2016/9/1,臺中市,西屯區,83659,223636,107719,115917
2016/9/1,臺中市,南屯區,60540,166135,79525,86610
2016/9/1,臺中市,北屯區,96874,269077,129332,139745
2016/9/1,臺中市,豐原區,53038,166718,82520,84198
2016/9/1,臺中市,東勢區,17337,51004,26265,24739
2016/9/1,臺中市,大甲區,22854,77684,39122,38562
2016/9/1,臺中市,清水區,26725,86256,44273,41983
2016/9/1,臺中市,沙鹿區,28588,90840,45945,44895
2016/9/1,臺中市,梧棲區,17432,57492,28915,28577
2016/9/1,臺中市,后里區,15885,54244,27591,26653
2016/9/1,臺中市,神岡區,19171,65477,33441,32036
2016/9/1,臺中市,潭子區,35795,107190,53054,54136
2016/9/1,臺中市,大雅區,28864,94195,47051,47144
2016/9/1,臺中市,新社區,7537,24950,12960,11990
2016/9/1,臺中市,石岡區,4909,15225,7907,7318
2016/9/1,臺中市,外埔區,9581,32007,16410,15597
2016/9/1,臺中市,大安區,5448,19476,10282,9194
2016/9/1,臺中市,烏日區,23678,73235,36854,36381
2016/9/1,臺中市,大肚區,17352,57106,29178,27928
2016/9/1,臺中市,龍井區,22565,76886,38843,38043
2016/9/1,臺中市,霧峰區,19883,64867,33006,31861
2016/9/1,臺中市,太平區,61899,185721,92269,93452
2016/9/1,臺中市,大里區,68369,209613,103203,106410
2016/9/1,臺中市,和平區,4500,10785,5792,4993
2016/9/1,臺南市,新營區,28862,78147,38649,39498
2016/9/1,臺南市,鹽水區,10085,25941,13547,12394
2016/9/1,臺南市,白河區,10857,28924,15116,13808
2016/9/1,臺南市,柳營區,7869,21552,11265,10287
2016/9/1,臺南市,後壁區,8880,24135,12538,11597
2016/9/1,臺南市,東山區,8425,21401,11357,10044
2016/9/1,臺南市,麻豆區,15683,44808,22765,22043
2016/9/1,臺南市,下營區,9114,24585,12665,11920
2016/9/1,臺南市,六甲區,7715,22464,11600,10864
2016/9/1,臺南市,官田區,7868,21537,10998,10539
2016/9/1,臺南市,大內區,3899,9978,5341,4637
2016/9/1,臺南市,佳里區,20517,59514,29523,29991
2016/9/1,臺南市,學甲區,9674,26457,13525,12932
2016/9/1,臺南市,西港區,8154,24914,12622,12292
2016/9/1,臺南市,七股區,8058,23165,11990,11175
2016/9/1,臺南市,將軍區,7300,20103,10236,9867
2016/9/1,臺南市,北門區,4286,11373,5773,5600
2016/9/1,臺南市,新化區,14327,43762,22312,21450
2016/9/1,臺南市,善化區,17163,47476,23947,23529
2016/9/1,臺南市,新市區,11932,36133,18169,17964
2016/9/1,臺南市,安定區,9965,30462,15625,14837
2016/9/1,臺南市,山上區,2697,7390,3876,3514
2016/9/1,臺南市,玉井區,5123,14287,7410,6877
2016/9/1,臺南市,楠西區,3537,9947,5274,4673
2016/9/1,臺南市,南化區,2863,8822,4773,4049
2016/9/1,臺南市,左鎮區,1982,5005,2801,2204
2016/9/1,臺南市,仁德區,27215,74589,37900,36689
2016/9/1,臺南市,歸仁區,22454,68098,34617,33481
2016/9/1,臺南市,關廟區,11061,34679,17895,16784
2016/9/1,臺南市,龍崎區,1559,4136,2231,1905
2016/9/1,臺南市,永康區,82480,231785,114450,117335
2016/9/1,臺南市,東區,71799,187872,90238,97634
2016/9/1,臺南市,南區,45278,125752,62405,63347
2016/9/1,臺南市,北區,50396,132951,64781,68170
2016/9/1,臺南市,安南區,61846,190851,96362,94489
2016/9/1,臺南市,安平區,25084,65677,31173,34504
2016/9/1,臺南市,中西區,30631,76827,37399,39428
2016/9/1,高雄市,鹽埕區,10800,24680,12237,12443
2016/9/1,高雄市,鼓山區,57059,137710,66695,71015
2016/9/1,高雄市,左營區,78261,196765,94914,101851
2016/9/1,高雄市,楠梓區,68743,181426,89348,92078
2016/9/1,高雄市,三民區,135798,344963,167289,177674
2016/9/1,高雄市,新興區,22709,51501,24794,26707
2016/9/1,高雄市,前金區,12513,27138,13037,14101
2016/9/1,高雄市,苓雅區,72253,173184,83631,89553
2016/9/1,高雄市,前鎮區,78486,191526,94239,97287
2016/9/1,高雄市,旗津區,11105,28924,14951,13973
2016/9/1,高雄市,小港區,67089,156626,77916,78710
2016/9/1,高雄市,鳳山區,138380,357504,175605,181899
2016/9/1,高雄市,林園區,25702,70219,35628,34591
2016/9/1,高雄市,大寮區,41738,112029,57472,54557
2016/9/1,高雄市,大樹區,13517,43082,22125,20957
2016/9/1,高雄市,大社區,12802,34609,17558,17051
2016/9/1,高雄市,仁武區,31909,83879,42654,41225
2016/9/1,高雄市,鳥松區,18014,44225,22516,21709
2016/9/1,高雄市,岡山區,34836,97608,48490,49118
2016/9/1,高雄市,橋頭區,13420,37432,19042,18390
2016/9/1,高雄市,燕巢區,10440,30006,15877,14129
2016/9/1,高雄市,田寮區,3324,7364,4083,3281
2016/9/1,高雄市,阿蓮區,9398,29145,14702,14443
2016/9/1,高雄市,路竹區,16912,53037,27075,25962
2016/9/1,高雄市,湖內區,10701,29737,15140,14597
2016/9/1,高雄市,茄萣區,10481,30447,15720,14727
2016/9/1,高雄市,永安區,5728,14032,7062,6970
2016/9/1,高雄市,彌陀區,6770,19600,10101,9499
2016/9/1,高雄市,梓官區,12572,36237,18700,17537
2016/9/1,高雄市,旗山區,13821,37444,19390,18054
2016/9/1,高雄市,美濃區,14649,40469,21229,19240
2016/9/1,高雄市,六龜區,5567,13266,7130,6136
2016/9/1,高雄市,甲仙區,2350,6225,3313,2912
2016/9/1,高雄市,杉林區,4812,12274,6717,5557
2016/9/1,高雄市,內門區,5091,14776,8002,6774
2016/9/1,高雄市,茂林區,582,1897,936,961
2016/9/1,高雄市,桃源區,1323,4218,2208,2010
2016/9/1,高雄市,那瑪夏區,853,3128,1617,1511
2016/9/1,宜蘭縣,宜蘭市,35906,95975,46902,49073
2016/9/1,宜蘭縣,羅東鎮,26256,72479,34388,38091
2016/9/1,宜蘭縣,蘇澳鎮,14135,40516,20655,19861
2016/9/1,宜蘭縣,頭城鎮,10201,29744,15332,14412
2016/9/1,宜蘭縣,礁溪鄉,13802,35934,18725,17209
2016/9/1,宜蘭縣,壯圍鄉,8657,24286,12846,11440
2016/9/1,宜蘭縣,員山鄉,11595,32314,17136,15178
2016/9/1,宜蘭縣,冬山鄉,19020,53319,27403,25916
2016/9/1,宜蘭縣,五結鄉,14660,39672,20531,19141
2016/9/1,宜蘭縣,三星鄉,8409,21411,11538,9873
2016/9/1,宜蘭縣,大同鄉,1890,6079,3292,2787
2016/9/1,宜蘭縣,南澳鄉,1926,5942,3107,2835
2016/9/1,新竹縣,竹北市,62767,175242,87303,87939
2016/9/1,新竹縣,關西鎮,9529,29527,15807,13720
2016/9/1,新竹縣,新埔鎮,10697,33833,18048,15785
2016/9/1,新竹縣,竹東鎮,33433,96831,48686,48145
2016/9/1,新竹縣,湖口鄉,26099,77511,39304,38207
2016/9/1,新竹縣,橫山鄉,4489,13357,7242,6115
2016/9/1,新竹縣,新豐鄉,18098,56383,28944,27439
2016/9/1,新竹縣,芎林鄉,6504,20180,10696,9484
2016/9/1,新竹縣,寶山鄉,5336,14322,7753,6569
2016/9/1,新竹縣,北埔鄉,3129,9569,5190,4379
2016/9/1,新竹縣,峨眉鄉,2078,5592,3098,2494
2016/9/1,新竹縣,尖石鄉,2844,9367,4973,4394
2016/9/1,新竹縣,五峰鄉,1735,4558,2470,2088
2016/9/1,苗栗縣,苗栗市,30952,90013,44967,45046
2016/9/1,苗栗縣,頭份市,33804,103121,52028,51093
2016/9/1,苗栗縣,苑裡鎮,14530,47252,24574,22678
2016/9/1,苗栗縣,通霄鎮,11548,35578,18778,16800
2016/9/1,苗栗縣,竹南鎮,28387,84953,42870,42083
2016/9/1,苗栗縣,後龍鎮,11867,37372,19713,17659
2016/9/1,苗栗縣,卓蘭鎮,6089,17715,9243,8472
2016/9/1,苗栗縣,大湖鄉,5409,15135,8029,7106
2016/9/1,苗栗縣,公館鄉,10661,34289,17880,16409
2016/9/1,苗栗縣,銅鑼鄉,6159,18541,9819,8722
2016/9/1,苗栗縣,南庄鄉,3954,10407,5737,4670
2016/9/1,苗栗縣,頭屋鄉,3653,11118,5879,5239
2016/9/1,苗栗縣,三義鄉,5570,16875,8874,8001
2016/9/1,苗栗縣,西湖鄉,2664,7322,4062,3260
2016/9/1,苗栗縣,造橋鄉,4116,13205,6949,6256
2016/9/1,苗栗縣,三灣鄉,2409,6921,3788,3133
2016/9/1,苗栗縣,獅潭鄉,1718,4499,2518,1981
2016/9/1,苗栗縣,泰安鄉,1960,5955,3182,2773
2016/9/1,彰化縣,彰化市,75893,234721,116095,118626
2016/9/1,彰化縣,員林市,38922,124923,62149,62774
2016/9/1,彰化縣,鹿港鎮,24300,86697,44107,42590
2016/9/1,彰化縣,和美鎮,26495,91229,46504,44725
2016/9/1,彰化縣,北斗鎮,10566,33274,16781,16493
2016/9/1,彰化縣,溪湖鎮,16191,55683,28307,27376
2016/9/1,彰化縣,田中鎮,13080,42250,21822,20428
2016/9/1,彰化縣,二林鎮,14974,51598,26588,25010
2016/9/1,彰化縣,線西鄉,4372,16990,8782,8208
2016/9/1,彰化縣,伸港鄉,9799,36632,18704,17928
2016/9/1,彰化縣,福興鄉,12611,47413,24691,22722
2016/9/1,彰化縣,秀水鄉,10603,39352,20310,19042
2016/9/1,彰化縣,花壇鄉,13980,46163,23738,22425
2016/9/1,彰化縣,芬園鄉,6852,23911,12576,11335
2016/9/1,彰化縣,大村鄉,11015,36723,19021,17702
2016/9/1,彰化縣,埔鹽鄉,9033,32829,17239,15590
2016/9/1,彰化縣,埔心鄉,10451,34786,17938,16848
2016/9/1,彰化縣,永靖鄉,10908,37800,19590,18210
2016/9/1,彰化縣,社頭鄉,12839,43349,22257,21092
2016/9/1,彰化縣,二水鄉,5326,15550,8155,7395
2016/9/1,彰化縣,田尾鄉,7914,27611,14270,13341
2016/9/1,彰化縣,埤頭鄉,8988,30783,16006,14777
2016/9/1,彰化縣,芳苑鄉,10129,34100,18023,16077
2016/9/1,彰化縣,大城鄉,5297,17335,9392,7943
2016/9/1,彰化縣,竹塘鄉,4630,15520,8175,7345
2016/9/1,彰化縣,溪州鄉,8962,30443,15936,14507
2016/9/1,南投縣,南投市,34585,101091,50670,50421
2016/9/1,南投縣,埔里鎮,28962,81709,40897,40812
2016/9/1,南投縣,草屯鎮,32947,98519,49795,48724
2016/9/1,南投縣,竹山鎮,20026,55656,28577,27079
2016/9/1,南投縣,集集鎮,4317,11079,5758,5321
2016/9/1,南投縣,名間鄉,12607,39287,20652,18635
2016/9/1,南投縣,鹿谷鄉,7788,18035,9612,8423
2016/9/1,南投縣,中寮鄉,5651,15164,8236,6928
2016/9/1,南投縣,魚池鄉,5747,16179,8507,7672
2016/9/1,南投縣,國姓鄉,7306,19154,10352,8802
2016/9/1,南投縣,水里鄉,7177,18081,9486,8595
2016/9/1,南投縣,信義鄉,5229,16406,8782,7624
2016/9/1,南投縣,仁愛鄉,4932,15692,8125,7567
2016/9/1,雲林縣,斗六市,37805,108415,54090,54325
2016/9/1,雲林縣,斗南鎮,15821,45345,23057,22288
2016/9/1,雲林縣,虎尾鎮,24656,70760,35862,34898
2016/9/1,雲林縣,西螺鎮,14571,46639,23620,23019
2016/9/1,雲林縣,土庫鎮,9296,29321,15325,13996
2016/9/1,雲林縣,北港鎮,15931,40805,21152,19653
2016/9/1,雲林縣,古坑鄉,10949,32044,16895,15149
2016/9/1,雲林縣,大埤鄉,6706,19495,10464,9031
2016/9/1,雲林縣,莿桐鄉,9296,29092,15292,13800
2016/9/1,雲林縣,林內鄉,5979,18568,9710,8858
2016/9/1,雲林縣,二崙鄉,8916,27617,14790,12827
2016/9/1,雲林縣,崙背鄉,8510,25183,13327,11856
2016/9/1,雲林縣,麥寮鄉,14137,44833,22610,22223
2016/9/1,雲林縣,東勢鄉,5712,15182,8357,6825
2016/9/1,雲林縣,褒忠鄉,4453,13231,7109,6122
2016/9/1,雲林縣,臺西鄉,8723,24273,13010,11263
2016/9/1,雲林縣,元長鄉,9324,26461,14456,12005
2016/9/1,雲林縣,四湖鄉,8858,24275,13178,11097
2016/9/1,雲林縣,口湖鄉,9546,28152,14974,13178
2016/9/1,雲林縣,水林鄉,10073,26234,14367,11867
2016/9/1,嘉義縣,太保市,12604,37474,19252,18222
2016/9/1,嘉義縣,朴子市,15624,42688,21614,21074
2016/9/1,嘉義縣,布袋鎮,9999,27575,14097,13478
2016/9/1,嘉義縣,大林鎮,11372,31469,16106,15363
2016/9/1,嘉義縣,民雄鄉,24640,71859,36791,35068
2016/9/1,嘉義縣,溪口鄉,5372,14997,8004,6993
2016/9/1,嘉義縣,新港鄉,10663,32536,17133,15403
2016/9/1,嘉義縣,六腳鄉,8953,23888,12710,11178
2016/9/1,嘉義縣,東石鄉,9308,25412,13477,11935
2016/9/1,嘉義縣,義竹鄉,7492,18917,9835,9082
2016/9/1,嘉義縣,鹿草鄉,5802,15904,8540,7364
2016/9/1,嘉義縣,水上鄉,18000,50197,25885,24312
2016/9/1,嘉義縣,中埔鄉,15969,45472,23633,21839
2016/9/1,嘉義縣,竹崎鄉,11736,36313,19391,16922
2016/9/1,嘉義縣,梅山鄉,6774,19824,10552,9272
2016/9/1,嘉義縣,番路鄉,4297,11741,6346,5395
2016/9/1,嘉義縣,大埔鄉,1939,4590,2386,2204
2016/9/1,嘉義縣,阿里山鄉,1956,5675,3009,2666
2016/9/1,屏東縣,屏東市,73912,201830,100050,101780
2016/9/1,屏東縣,潮州鎮,19368,54841,27441,27400
2016/9/1,屏東縣,東港鎮,16596,48193,24366,23827
2016/9/1,屏東縣,恆春鎮,11461,30761,15748,15013
2016/9/1,屏東縣,萬丹鄉,14875,51325,26564,24761
2016/9/1,屏東縣,長治鄉,10075,30186,15721,14465
2016/9/1,屏東縣,麟洛鄉,3780,11163,5797,5366
2016/9/1,屏東縣,九如鄉,6928,22067,11413,10654
2016/9/1,屏東縣,里港鄉,8188,27087,13771,13316
2016/9/1,屏東縣,鹽埔鄉,7854,26225,13631,12594
2016/9/1,屏東縣,高樹鄉,9327,24898,13246,11652
2016/9/1,屏東縣,萬巒鄉,6500,20649,10797,9852
2016/9/1,屏東縣,內埔鄉,18558,55261,28582,26679
2016/9/1,屏東縣,竹田鄉,5656,17423,9228,8195
2016/9/1,屏東縣,新埤鄉,3431,9966,5299,4667
2016/9/1,屏東縣,枋寮鄉,8526,24880,13052,11828
2016/9/1,屏東縣,新園鄉,11772,35785,18540,17245
2016/9/1,屏東縣,崁頂鄉,4469,15898,8072,7826
2016/9/1,屏東縣,林邊鄉,6800,18431,9449,8982
2016/9/1,屏東縣,南州鄉,3716,10847,5558,5289
2016/9/1,屏東縣,佳冬鄉,6982,19721,10250,9471
2016/9/1,屏東縣,琉球鄉,4427,12427,6843,5584
2016/9/1,屏東縣,車城鄉,3482,8820,4747,4073
2016/9/1,屏東縣,滿州鄉,3022,7884,4313,3571
2016/9/1,屏東縣,枋山鄉,2119,5528,2940,2588
2016/9/1,屏東縣,三地門鄉,2304,7664,3862,3802
2016/9/1,屏東縣,霧臺鄉,1054,3283,1686,1597
2016/9/1,屏東縣,瑪家鄉,2044,6762,3453,3309
2016/9/1,屏東縣,泰武鄉,1328,5247,2755,2492
2016/9/1,屏東縣,來義鄉,2235,7499,3818,3681
2016/9/1,屏東縣,春日鄉,1365,4828,2490,2338
2016/9/1,屏東縣,獅子鄉,1538,4820,2493,2327
2016/9/1,屏東縣,牡丹鄉,1891,4849,2486,2363
2016/9/1,臺東縣,臺東市,39458,106468,53424,53044
2016/9/1,臺東縣,成功鎮,5414,14484,7660,6824
2016/9/1,臺東縣,關山鎮,3207,8847,4636,4211
2016/9/1,臺東縣,卑南鄉,6681,17457,9236,8221
2016/9/1,臺東縣,大武鄉,2511,6225,3249,2976
2016/9/1,臺東縣,太麻里鄉,4659,11328,6033,5295
2016/9/1,臺東縣,東河鄉,3776,8734,4816,3918
2016/9/1,臺東縣,長濱鄉,2916,7431,4210,3221
2016/9/1,臺東縣,鹿野鄉,3061,8044,4297,3747
2016/9/1,臺東縣,池上鄉,3228,8403,4390,4013
2016/9/1,臺東縣,綠島鄉,1104,3733,1948,1785
2016/9/1,臺東縣,延平鄉,1060,3523,1896,1627
2016/9/1,臺東縣,海端鄉,1091,4286,2288,1998
2016/9/1,臺東縣,達仁鄉,1447,3560,1940,1620
2016/9/1,臺東縣,金峰鄉,1113,3596,1853,1743
2016/9/1,臺東縣,蘭嶼鄉,1805,5080,2569,2511
2016/9/1,花蓮縣,花蓮市,41452,105235,50905,54330
2016/9/1,花蓮縣,鳳林鎮,4403,11036,5753,5283
2016/9/1,花蓮縣,玉里鎮,8891,24789,13232,11557
2016/9/1,花蓮縣,新城鄉,7666,20252,10432,9820
2016/9/1,花蓮縣,吉安鄉,31664,83572,42253,41319
2016/9/1,花蓮縣,壽豐鄉,7077,18118,9651,8467
2016/9/1,花蓮縣,光復鄉,5028,13086,6961,6125
2016/9/1,花蓮縣,豐濱鄉,1721,4461,2485,1976
2016/9/1,花蓮縣,瑞穗鄉,4717,11799,6369,5430
2016/9/1,花蓮縣,富里鄉,4005,10583,5754,4829
2016/9/1,花蓮縣,秀林鄉,4773,15806,8143,7663
2016/9/1,花蓮縣,萬榮鄉,2086,6444,3397,3047
2016/9/1,花蓮縣,卓溪鄉,1684,6042,3301,2741
2016/9/1,澎湖縣,馬公市,23856,61446,31232,30214
2016/9/1,澎湖縣,湖西鄉,5475,14404,7595,6809
2016/9/1,澎湖縣,白沙鄉,3375,9757,5106,4651
2016/9/1,澎湖縣,西嶼鄉,2963,8396,4330,4066
2016/9/1,澎湖縣,望安鄉,2014,5142,2753,2389
2016/9/1,澎湖縣,七美鄉,1357,3735,1944,1791
2016/9/1,基隆市,中正區,22530,52526,26844,25682
2016/9/1,基隆市,七堵區,21205,54058,27251,26807
2016/9/1,基隆市,暖暖區,15494,38382,19314,19068
2016/9/1,基隆市,仁愛區,19290,45142,22302,22840
2016/9/1,基隆市,中山區,19224,48194,24475,23719
2016/9/1,基隆市,安樂區,32829,81824,40571,41253
2016/9/1,基隆市,信義區,21064,51893,25803,26090
2016/9/1,新竹市,東區,77352,209123,103079,106044
2016/9/1,新竹市,北區,55577,149761,73320,76441
2016/9/1,新竹市,香山區,26658,77336,39371,37965
2016/9/1,嘉義市,東區,45379,122571,59251,63320
2016/9/1,嘉義市,西區,53472,147319,72237,75082
2016/9/1,金門縣,金城鎮,12728,42607,21292,21315
2016/9/1,金門縣,金湖鎮,8696,28681,14453,14228
2016/9/1,金門縣,金沙鎮,6226,20226,10000,10226
2016/9/1,金門縣,金寧鄉,8218,29723,14980,14743
2016/9/1,金門縣,烈嶼鄉,3105,12521,6172,6349
2016/9/1,金門縣,烏坵鄉,133,661,328,333
2016/9/1,連江縣,南竿鄉,1514,7395,4178,3217
2016/9/1,連江縣,北竿鄉,524,2340,1308,1032
2016/9/1,連江縣,莒光鄉,285,1562,934,628
2016/9/1,連江縣,東引鄉,320,1289,771,518
2016/10/1,總計,新北市,1522405,3976313,1951464,2024849
2016/10/1,總計,臺北市,1046417,2696319,1290248,1406071
2016/10/1,總計,桃園市,766901,2140392,1068403,1071989
2016/10/1,總計,臺中市,940831,2762699,1364335,1398364
2016/10/1,總計,臺南市,676758,1885603,943086,942517
2016/10/1,總計,高雄市,1080598,2778375,1378994,1399381
2016/10/1,總計,臺灣省,2464628,7139309,3644493,3494816
2016/10/1,總計,宜蘭縣,166467,457599,231786,225813
2016/10/1,總計,新竹縣,186941,546672,279710,266962
2016/10/1,總計,苗栗縣,185518,559886,288701,271185
2016/10/1,總計,彰化縣,384236,1287450,656974,630476
2016/10/1,總計,南投縣,177227,505660,259303,246357
2016/10/1,總計,雲林縣,239303,695628,361488,334140
2016/10/1,總計,嘉義縣,182406,516218,268567,247651
2016/10/1,總計,屏東縣,285596,836699,428234,408465
2016/10/1,總計,臺東縣,82517,221098,114393,106705
2016/10/1,總計,花蓮縣,125157,331065,168517,162548
2016/10/1,總計,澎湖縣,39086,102992,53005,49987
2016/10/1,總計,基隆市,151612,372048,186573,185475
2016/10/1,總計,新竹市,159742,436490,215826,220664
2016/10/1,總計,嘉義市,98820,269804,131416,138388
2016/10/1,總計,福建省,41802,147285,74555,72730
2016/10/1,總計,金門縣,39152,134687,67363,67324
2016/10/1,總計,連江縣,2650,12598,7192,5406
2016/10/1,新北市,板橋區,206315,552341,269922,282419
2016/10/1,新北市,三重區,149616,388299,191414,196885
2016/10/1,新北市,中和區,163905,414232,201936,212296
2016/10/1,新北市,永和區,90674,224176,106588,117588
2016/10/1,新北市,新莊區,150234,413867,202427,211440
2016/10/1,新北市,新店區,124839,300981,145136,155845
2016/10/1,新北市,樹林區,65836,184320,92035,92285
2016/10/1,新北市,鶯歌區,29498,87295,43754,43541
2016/10/1,新北市,三峽區,41854,114017,57244,56773
2016/10/1,新北市,淡水區,71988,165148,79438,85710
2016/10/1,新北市,汐止區,85725,197273,96390,100883
2016/10/1,新北市,瑞芳區,16168,40656,20555,20101
2016/10/1,新北市,土城區,86312,238385,117793,120592
2016/10/1,新北市,蘆洲區,70034,200436,98589,101847
2016/10/1,新北市,五股區,30624,83994,42405,41589
2016/10/1,新北市,泰山區,28181,78735,39107,39628
2016/10/1,新北市,林口區,40272,102754,50129,52625
2016/10/1,新北市,深坑區,9527,23671,11828,11843
2016/10/1,新北市,石碇區,3375,7771,4274,3497
2016/10/1,新北市,坪林區,2510,6524,3619,2905
2016/10/1,新北市,三芝區,9417,23339,11999,11340
2016/10/1,新北市,石門區,4299,12505,6474,6031
2016/10/1,新北市,八里區,14256,38064,18977,19087
2016/10/1,新北市,平溪區,2331,4787,2645,2142
2016/10/1,新北市,雙溪區,3826,9106,4919,4187
2016/10/1,新北市,貢寮區,4402,12758,6514,6244
2016/10/1,新北市,金山區,7070,22196,10957,11239
2016/10/1,新北市,萬里區,7466,22506,11328,11178
2016/10/1,新北市,烏來區,1851,6177,3068,3109
2016/10/1,臺北市,松山區,80220,208287,98019,110268
2016/10/1,臺北市,信義區,89526,228001,109054,118947
2016/10/1,臺北市,大安區,120431,311506,145645,165861
2016/10/1,臺北市,中山區,99509,231169,107898,123271
2016/10/1,臺北市,中正區,65038,160775,76768,84007
2016/10/1,臺北市,大同區,51551,130162,63527,66635
2016/10/1,臺北市,萬華區,78499,193619,95313,98306
2016/10/1,臺北市,文山區,104842,275279,132242,143037
2016/10/1,臺北市,南港區,46784,122577,59934,62643
2016/10/1,臺北市,內湖區,107141,287633,137584,150049
2016/10/1,臺北市,士林區,106598,289905,140049,149856
2016/10/1,臺北市,北投區,96278,257406,124215,133191
2016/10/1,桃園市,桃園區,162208,432943,210593,222350
2016/10/1,桃園市,中壢區,144159,395067,195125,199942
2016/10/1,桃園市,大溪區,31774,93917,47990,45927
2016/10/1,桃園市,楊梅區,56086,163366,82540,80826
2016/10/1,桃園市,蘆竹區,56521,158180,78718,79462
2016/10/1,桃園市,大園區,31279,86812,44487,42325
2016/10/1,桃園市,龜山區,58832,151920,76030,75890
2016/10/1,桃園市,八德區,67933,192025,96470,95555
2016/10/1,桃園市,龍潭區,40796,119779,60180,59599
2016/10/1,桃園市,平鎮區,75583,221038,110034,111004
2016/10/1,桃園市,新屋區,15955,48707,25978,22729
2016/10/1,桃園市,觀音區,22024,65479,34182,31297
2016/10/1,桃園市,復興區,3751,11159,6076,5083
2016/10/1,臺中市,中區,7986,18793,9325,9468
2016/10/1,臺中市,東區,27562,75337,37561,37776
2016/10/1,臺中市,南區,47328,123156,59244,63912
2016/10/1,臺中市,西區,45355,115649,55020,60629
2016/10/1,臺中市,北區,58917,147577,70705,76872
2016/10/1,臺中市,西屯區,83782,223933,107822,116111
2016/10/1,臺中市,南屯區,60619,166269,79586,86683
2016/10/1,臺中市,北屯區,97161,269668,129614,140054
2016/10/1,臺中市,豐原區,53064,166818,82562,84256
2016/10/1,臺中市,東勢區,17343,50960,26231,24729
2016/10/1,臺中市,大甲區,22873,77676,39117,38559
2016/10/1,臺中市,清水區,26763,86265,44286,41979
2016/10/1,臺中市,沙鹿區,28657,91026,46023,45003
2016/10/1,臺中市,梧棲區,17448,57537,28925,28612
2016/10/1,臺中市,后里區,15912,54272,27595,26677
2016/10/1,臺中市,神岡區,19195,65485,33445,32040
2016/10/1,臺中市,潭子區,35843,107301,53090,54211
2016/10/1,臺中市,大雅區,28940,94301,47101,47200
2016/10/1,臺中市,新社區,7545,24959,12950,12009
2016/10/1,臺中市,石岡區,4906,15216,7906,7310
2016/10/1,臺中市,外埔區,9587,32018,16419,15599
2016/10/1,臺中市,大安區,5450,19460,10271,9189
2016/10/1,臺中市,烏日區,23744,73347,36911,36436
2016/10/1,臺中市,大肚區,17402,57163,29215,27948
2016/10/1,臺中市,龍井區,22638,77135,38946,38189
2016/10/1,臺中市,霧峰區,19898,64877,33000,31877
2016/10/1,臺中市,太平區,61978,185889,92342,93547
2016/10/1,臺中市,大里區,68429,209830,103321,106509
2016/10/1,臺中市,和平區,4506,10782,5802,4980
2016/10/1,臺南市,新營區,28846,78143,38632,39511
2016/10/1,臺南市,鹽水區,10090,25901,13529,12372
2016/10/1,臺南市,白河區,10848,28892,15095,13797
2016/10/1,臺南市,柳營區,7875,21547,11266,10281
2016/10/1,臺南市,後壁區,8884,24122,12540,11582
2016/10/1,臺南市,東山區,8424,21392,11347,10045
2016/10/1,臺南市,麻豆區,15682,44798,22756,22042
2016/10/1,臺南市,下營區,9114,24584,12678,11906
2016/10/1,臺南市,六甲區,7713,22462,11598,10864
2016/10/1,臺南市,官田區,7872,21540,10998,10542
2016/10/1,臺南市,大內區,3900,9971,5333,4638
2016/10/1,臺南市,佳里區,20515,59468,29494,29974
2016/10/1,臺南市,學甲區,9663,26435,13519,12916
2016/10/1,臺南市,西港區,8143,24891,12612,12279
2016/10/1,臺南市,七股區,8058,23161,11981,11180
2016/10/1,臺南市,將軍區,7304,20093,10227,9866
2016/10/1,臺南市,北門區,4285,11365,5767,5598
2016/10/1,臺南市,新化區,14333,43771,22313,21458
2016/10/1,臺南市,善化區,17194,47548,23980,23568
2016/10/1,臺南市,新市區,11947,36173,18172,18001
2016/10/1,臺南市,安定區,9965,30473,15633,14840
2016/10/1,臺南市,山上區,2698,7377,3864,3513
2016/10/1,臺南市,玉井區,5121,14282,7405,6877
2016/10/1,臺南市,楠西區,3532,9923,5258,4665
2016/10/1,臺南市,南化區,2860,8818,4773,4045
2016/10/1,臺南市,左鎮區,1981,4993,2794,2199
2016/10/1,臺南市,仁德區,27220,74611,37897,36714
2016/10/1,臺南市,歸仁區,22463,68088,34626,33462
2016/10/1,臺南市,關廟區,11064,34668,17882,16786
2016/10/1,臺南市,龍崎區,1556,4114,2211,1903
2016/10/1,臺南市,永康區,82533,231872,114486,117386
2016/10/1,臺南市,東區,71766,187864,90220,97644
2016/10/1,臺南市,南區,45289,125784,62391,63393
2016/10/1,臺南市,北區,50428,133042,64836,68206
2016/10/1,臺南市,安南區,61902,190999,96425,94574
2016/10/1,臺南市,安平區,25090,65701,31189,34512
2016/10/1,臺南市,中西區,30600,76737,37359,39378
2016/10/1,高雄市,鹽埕區,10819,24688,12239,12449
2016/10/1,高雄市,鼓山區,57107,137864,66750,71114
2016/10/1,高雄市,左營區,78257,196813,94916,101897
2016/10/1,高雄市,楠梓區,68804,181541,89415,92126
2016/10/1,高雄市,三民區,135758,344867,167189,177678
2016/10/1,高雄市,新興區,22688,51437,24764,26673
2016/10/1,高雄市,前金區,12516,27137,13020,14117
2016/10/1,高雄市,苓雅區,72204,173117,83607,89510
2016/10/1,高雄市,前鎮區,78433,191361,94144,97217
2016/10/1,高雄市,旗津區,11106,28941,14966,13975
2016/10/1,高雄市,小港區,67150,156738,77956,78782
2016/10/1,高雄市,鳳山區,138400,357470,175576,181894
2016/10/1,高雄市,林園區,25701,70220,35633,34587
2016/10/1,高雄市,大寮區,41776,112091,57500,54591
2016/10/1,高雄市,大樹區,13518,43090,22115,20975
2016/10/1,高雄市,大社區,12807,34599,17553,17046
2016/10/1,高雄市,仁武區,31960,83985,42701,41284
2016/10/1,高雄市,鳥松區,18016,44229,22514,21715
2016/10/1,高雄市,岡山區,34812,97570,48471,49099
2016/10/1,高雄市,橋頭區,13427,37450,19053,18397
2016/10/1,高雄市,燕巢區,10446,29991,15857,14134
2016/10/1,高雄市,田寮區,3315,7359,4078,3281
2016/10/1,高雄市,阿蓮區,9385,29125,14693,14432
2016/10/1,高雄市,路竹區,16902,53024,27079,25945
2016/10/1,高雄市,湖內區,10704,29772,15166,14606
2016/10/1,高雄市,茄萣區,10466,30422,15700,14722
2016/10/1,高雄市,永安區,5730,14033,7064,6969
2016/10/1,高雄市,彌陀區,6763,19565,10089,9476
2016/10/1,高雄市,梓官區,12580,36278,18718,17560
2016/10/1,高雄市,旗山區,13809,37407,19362,18045
2016/10/1,高雄市,美濃區,14661,40466,21225,19241
2016/10/1,高雄市,六龜區,5570,13240,7107,6133
2016/10/1,高雄市,甲仙區,2347,6215,3309,2906
2016/10/1,高雄市,杉林區,4808,12254,6709,5545
2016/10/1,高雄市,內門區,5090,14766,7995,6771
2016/10/1,高雄市,茂林區,584,1900,939,961
2016/10/1,高雄市,桃源區,1324,4218,2202,2016
2016/10/1,高雄市,那瑪夏區,855,3132,1620,1512
2016/10/1,宜蘭縣,宜蘭市,35901,95964,46866,49098
2016/10/1,宜蘭縣,羅東鎮,26250,72506,34401,38105
2016/10/1,宜蘭縣,蘇澳鎮,14127,40530,20651,19879
2016/10/1,宜蘭縣,頭城鎮,10194,29737,15332,14405
2016/10/1,宜蘭縣,礁溪鄉,13812,35942,18723,17219
2016/10/1,宜蘭縣,壯圍鄉,8678,24265,12836,11429
2016/10/1,宜蘭縣,員山鄉,11603,32303,17135,15168
2016/10/1,宜蘭縣,冬山鄉,19028,53305,27384,25921
2016/10/1,宜蘭縣,五結鄉,14657,39637,20524,19113
2016/10/1,宜蘭縣,三星鄉,8401,21387,11527,9860
2016/10/1,宜蘭縣,大同鄉,1886,6084,3298,2786
2016/10/1,宜蘭縣,南澳鄉,1930,5939,3109,2830
2016/10/1,新竹縣,竹北市,62886,175664,87518,88146
2016/10/1,新竹縣,關西鎮,9520,29504,15795,13709
2016/10/1,新竹縣,新埔鎮,10707,33824,18045,15779
2016/10/1,新竹縣,竹東鎮,33437,96781,48658,48123
2016/10/1,新竹縣,湖口鄉,26133,77477,39293,38184
2016/10/1,新竹縣,橫山鄉,4488,13340,7239,6101
2016/10/1,新竹縣,新豐鄉,18124,56434,28969,27465
2016/10/1,新竹縣,芎林鄉,6503,20166,10694,9472
2016/10/1,新竹縣,寶山鄉,5340,14353,7755,6598
2016/10/1,新竹縣,北埔鄉,3131,9571,5190,4381
2016/10/1,新竹縣,峨眉鄉,2086,5593,3098,2495
2016/10/1,新竹縣,尖石鄉,2843,9392,4981,4411
2016/10/1,新竹縣,五峰鄉,1743,4573,2475,2098
2016/10/1,苗栗縣,苗栗市,30941,89948,44943,45005
2016/10/1,苗栗縣,頭份市,33857,103118,52016,51102
2016/10/1,苗栗縣,苑裡鎮,14532,47175,24543,22632
2016/10/1,苗栗縣,通霄鎮,11546,35533,18758,16775
2016/10/1,苗栗縣,竹南鎮,28392,84941,42856,42085
2016/10/1,苗栗縣,後龍鎮,11879,37334,19685,17649
2016/10/1,苗栗縣,卓蘭鎮,6090,17686,9228,8458
2016/10/1,苗栗縣,大湖鄉,5406,15124,8018,7106
2016/10/1,苗栗縣,公館鄉,10666,34279,17879,16400
2016/10/1,苗栗縣,銅鑼鄉,6160,18527,9815,8712
2016/10/1,苗栗縣,南庄鄉,3955,10398,5734,4664
2016/10/1,苗栗縣,頭屋鄉,3657,11127,5886,5241
2016/10/1,苗栗縣,三義鄉,5577,16856,8865,7991
2016/10/1,苗栗縣,西湖鄉,2664,7312,4060,3252
2016/10/1,苗栗縣,造橋鄉,4113,13188,6943,6245
2016/10/1,苗栗縣,三灣鄉,2407,6900,3775,3125
2016/10/1,苗栗縣,獅潭鄉,1717,4485,2515,1970
2016/10/1,苗栗縣,泰安鄉,1959,5955,3182,2773
2016/10/1,彰化縣,彰化市,75905,234731,116094,118637
2016/10/1,彰化縣,員林市,38937,124930,62141,62789
2016/10/1,彰化縣,鹿港鎮,24320,86714,44100,42614
2016/10/1,彰化縣,和美鎮,26498,91211,46495,44716
2016/10/1,彰化縣,北斗鎮,10567,33262,16779,16483
2016/10/1,彰化縣,溪湖鎮,16207,55653,28293,27360
2016/10/1,彰化縣,田中鎮,13082,42207,21803,20404
2016/10/1,彰化縣,二林鎮,14969,51548,26557,24991
2016/10/1,彰化縣,線西鄉,4376,16968,8775,8193
2016/10/1,彰化縣,伸港鄉,9808,36684,18724,17960
2016/10/1,彰化縣,福興鄉,12633,47420,24694,22726
2016/10/1,彰化縣,秀水鄉,10599,39331,20304,19027
2016/10/1,彰化縣,花壇鄉,13988,46177,23723,22454
2016/10/1,彰化縣,芬園鄉,6837,23897,12557,11340
2016/10/1,彰化縣,大村鄉,11016,36721,19016,17705
2016/10/1,彰化縣,埔鹽鄉,9037,32805,17221,15584
2016/10/1,彰化縣,埔心鄉,10468,34792,17936,16856
2016/10/1,彰化縣,永靖鄉,10918,37776,19594,18182
2016/10/1,彰化縣,社頭鄉,12836,43325,22247,21078
2016/10/1,彰化縣,二水鄉,5324,15535,8149,7386
2016/10/1,彰化縣,田尾鄉,7909,27619,14264,13355
2016/10/1,彰化縣,埤頭鄉,8991,30805,16014,14791
2016/10/1,彰化縣,芳苑鄉,10131,34087,18017,16070
2016/10/1,彰化縣,大城鄉,5294,17326,9382,7944
2016/10/1,彰化縣,竹塘鄉,4630,15505,8172,7333
2016/10/1,彰化縣,溪州鄉,8956,30421,15923,14498
2016/10/1,南投縣,南投市,34597,101011,50656,50355
2016/10/1,南投縣,埔里鎮,28951,81660,40864,40796
2016/10/1,南投縣,草屯鎮,32935,98442,49766,48676
2016/10/1,南投縣,竹山鎮,20014,55582,28548,27034
2016/10/1,南投縣,集集鎮,4310,11053,5747,5306
2016/10/1,南投縣,名間鄉,12607,39265,20655,18610
2016/10/1,南投縣,鹿谷鄉,7791,18034,9607,8427
2016/10/1,南投縣,中寮鄉,5649,15143,8232,6911
2016/10/1,南投縣,魚池鄉,5741,16168,8509,7659
2016/10/1,南投縣,國姓鄉,7301,19129,10331,8798
2016/10/1,南投縣,水里鄉,7167,18077,9478,8599
2016/10/1,南投縣,信義鄉,5228,16387,8775,7612
2016/10/1,南投縣,仁愛鄉,4936,15709,8135,7574
2016/10/1,雲林縣,斗六市,37822,108416,54084,54332
2016/10/1,雲林縣,斗南鎮,15826,45312,23046,22266
2016/10/1,雲林縣,虎尾鎮,24677,70765,35874,34891
2016/10/1,雲林縣,西螺鎮,14567,46619,23605,23014
2016/10/1,雲林縣,土庫鎮,9306,29322,15321,14001
2016/10/1,雲林縣,北港鎮,15929,40756,21139,19617
2016/10/1,雲林縣,古坑鄉,10954,32020,16878,15142
2016/10/1,雲林縣,大埤鄉,6706,19495,10465,9030
2016/10/1,雲林縣,莿桐鄉,9290,29093,15290,13803
2016/10/1,雲林縣,林內鄉,5977,18506,9675,8831
2016/10/1,雲林縣,二崙鄉,8923,27601,14776,12825
2016/10/1,雲林縣,崙背鄉,8515,25153,13314,11839
2016/10/1,雲林縣,麥寮鄉,14152,44973,22676,22297
2016/10/1,雲林縣,東勢鄉,5717,15160,8347,6813
2016/10/1,雲林縣,褒忠鄉,4450,13217,7107,6110
2016/10/1,雲林縣,臺西鄉,8723,24256,13001,11255
2016/10/1,雲林縣,元長鄉,9315,26415,14431,11984
2016/10/1,雲林縣,四湖鄉,8849,24246,13163,11083
2016/10/1,雲林縣,口湖鄉,9541,28120,14954,13166
2016/10/1,雲林縣,水林鄉,10064,26183,14342,11841
2016/10/1,嘉義縣,太保市,12621,37485,19258,18227
2016/10/1,嘉義縣,朴子市,15627,42666,21605,21061
2016/10/1,嘉義縣,布袋鎮,9993,27554,14076,13478
2016/10/1,嘉義縣,大林鎮,11361,31447,16085,15362
2016/10/1,嘉義縣,民雄鄉,24629,71854,36789,35065
2016/10/1,嘉義縣,溪口鄉,5372,14994,8008,6986
2016/10/1,嘉義縣,新港鄉,10654,32499,17114,15385
2016/10/1,嘉義縣,六腳鄉,8936,23853,12690,11163
2016/10/1,嘉義縣,東石鄉,9296,25368,13457,11911
2016/10/1,嘉義縣,義竹鄉,7482,18898,9817,9081
2016/10/1,嘉義縣,鹿草鄉,5790,15869,8522,7347
2016/10/1,嘉義縣,水上鄉,17991,50156,25868,24288
2016/10/1,嘉義縣,中埔鄉,15964,45472,23630,21842
2016/10/1,嘉義縣,竹崎鄉,11736,36300,19379,16921
2016/10/1,嘉義縣,梅山鄉,6772,19799,10536,9263
2016/10/1,嘉義縣,番路鄉,4289,11734,6336,5398
2016/10/1,嘉義縣,大埔鄉,1938,4597,2390,2207
2016/10/1,嘉義縣,阿里山鄉,1955,5673,3007,2666
2016/10/1,屏東縣,屏東市,73872,201706,99954,101752
2016/10/1,屏東縣,潮州鎮,19365,54778,27412,27366
2016/10/1,屏東縣,東港鎮,16617,48148,24349,23799
2016/10/1,屏東縣,恆春鎮,11486,30775,15759,15016
2016/10/1,屏東縣,萬丹鄉,14865,51324,26568,24756
2016/10/1,屏東縣,長治鄉,10083,30179,15726,14453
2016/10/1,屏東縣,麟洛鄉,3775,11161,5799,5362
2016/10/1,屏東縣,九如鄉,6933,22074,11420,10654
2016/10/1,屏東縣,里港鄉,8185,27068,13765,13303
2016/10/1,屏東縣,鹽埔鄉,7850,26228,13634,12594
2016/10/1,屏東縣,高樹鄉,9330,24903,13248,11655
2016/10/1,屏東縣,萬巒鄉,6494,20636,10786,9850
2016/10/1,屏東縣,內埔鄉,18566,55235,28550,26685
2016/10/1,屏東縣,竹田鄉,5661,17402,9213,8189
2016/10/1,屏東縣,新埤鄉,3430,9953,5290,4663
2016/10/1,屏東縣,枋寮鄉,8516,24851,13038,11813
2016/10/1,屏東縣,新園鄉,11780,35758,18530,17228
2016/10/1,屏東縣,崁頂鄉,4476,15916,8073,7843
2016/10/1,屏東縣,林邊鄉,6790,18401,9430,8971
2016/10/1,屏東縣,南州鄉,3713,10833,5552,5281
2016/10/1,屏東縣,佳冬鄉,6990,19725,10250,9475
2016/10/1,屏東縣,琉球鄉,4433,12426,6841,5585
2016/10/1,屏東縣,車城鄉,3483,8797,4735,4062
2016/10/1,屏東縣,滿州鄉,3018,7871,4305,3566
2016/10/1,屏東縣,枋山鄉,2120,5540,2946,2594
2016/10/1,屏東縣,三地門鄉,2305,7665,3859,3806
2016/10/1,屏東縣,霧臺鄉,1055,3298,1694,1604
2016/10/1,屏東縣,瑪家鄉,2042,6772,3454,3318
2016/10/1,屏東縣,泰武鄉,1329,5251,2758,2493
2016/10/1,屏東縣,來義鄉,2234,7493,3813,3680
2016/10/1,屏東縣,春日鄉,1363,4851,2499,2352
2016/10/1,屏東縣,獅子鄉,1544,4823,2496,2327
2016/10/1,屏東縣,牡丹鄉,1893,4858,2488,2370
2016/10/1,臺東縣,臺東市,39453,106426,53388,53038
2016/10/1,臺東縣,成功鎮,5409,14463,7652,6811
2016/10/1,臺東縣,關山鎮,3200,8845,4632,4213
2016/10/1,臺東縣,卑南鄉,6685,17464,9246,8218
2016/10/1,臺東縣,大武鄉,2507,6239,3259,2980
2016/10/1,臺東縣,太麻里鄉,4664,11328,6035,5293
2016/10/1,臺東縣,東河鄉,3775,8709,4808,3901
2016/10/1,臺東縣,長濱鄉,2918,7421,4204,3217
2016/10/1,臺東縣,鹿野鄉,3059,8032,4292,3740
2016/10/1,臺東縣,池上鄉,3224,8398,4384,4014
2016/10/1,臺東縣,綠島鄉,1103,3728,1951,1777
2016/10/1,臺東縣,延平鄉,1064,3529,1897,1632
2016/10/1,臺東縣,海端鄉,1089,4283,2286,1997
2016/10/1,臺東縣,達仁鄉,1447,3550,1934,1616
2016/10/1,臺東縣,金峰鄉,1115,3604,1858,1746
2016/10/1,臺東縣,蘭嶼鄉,1805,5079,2567,2512
2016/10/1,花蓮縣,花蓮市,41419,105118,50851,54267
2016/10/1,花蓮縣,鳳林鎮,4405,11024,5739,5285
2016/10/1,花蓮縣,玉里鎮,8892,24764,13217,11547
2016/10/1,花蓮縣,新城鄉,7668,20263,10442,9821
2016/10/1,花蓮縣,吉安鄉,31658,83591,42229,41362
2016/10/1,花蓮縣,壽豐鄉,7075,18110,9646,8464
2016/10/1,花蓮縣,光復鄉,5039,13080,6962,6118
2016/10/1,花蓮縣,豐濱鄉,1721,4460,2479,1981
2016/10/1,花蓮縣,瑞穗鄉,4724,11792,6364,5428
2016/10/1,花蓮縣,富里鄉,4000,10572,5750,4822
2016/10/1,花蓮縣,秀林鄉,4782,15804,8138,7666
2016/10/1,花蓮縣,萬榮鄉,2087,6445,3402,3043
2016/10/1,花蓮縣,卓溪鄉,1687,6042,3298,2744
2016/10/1,澎湖縣,馬公市,23893,61513,31270,30243
2016/10/1,澎湖縣,湖西鄉,5486,14442,7606,6836
2016/10/1,澎湖縣,白沙鄉,3367,9767,5112,4655
2016/10/1,澎湖縣,西嶼鄉,2962,8394,4321,4073
2016/10/1,澎湖縣,望安鄉,2018,5134,2750,2384
2016/10/1,澎湖縣,七美鄉,1360,3742,1946,1796
2016/10/1,基隆市,中正區,22526,52553,26861,25692
2016/10/1,基隆市,七堵區,21222,54080,27258,26822
2016/10/1,基隆市,暖暖區,15495,38380,19315,19065
2016/10/1,基隆市,仁愛區,19271,45119,22295,22824
2016/10/1,基隆市,中山區,19220,48150,24446,23704
2016/10/1,基隆市,安樂區,32837,81878,40603,41275
2016/10/1,基隆市,信義區,21041,51888,25795,26093
2016/10/1,新竹市,東區,77444,209356,103165,106191
2016/10/1,新竹市,北區,55631,149758,73298,76460
2016/10/1,新竹市,香山區,26667,77376,39363,38013
2016/10/1,嘉義市,東區,45359,122468,59203,63265
2016/10/1,嘉義市,西區,53461,147336,72213,75123
2016/10/1,金門縣,金城鎮,12742,42637,21300,21337
2016/10/1,金門縣,金湖鎮,8716,28762,14497,14265
2016/10/1,金門縣,金沙鎮,6228,20250,10014,10236
2016/10/1,金門縣,金寧鄉,8231,29844,15049,14795
2016/10/1,金門縣,烈嶼鄉,3102,12533,6175,6358
2016/10/1,金門縣,烏坵鄉,133,661,328,333
2016/10/1,連江縣,南竿鄉,1523,7393,4168,3225
2016/10/1,連江縣,北竿鄉,524,2342,1312,1030
2016/10/1,連江縣,莒光鄉,284,1568,939,629
2016/10/1,連江縣,東引鄉,319,1295,773,522
2016/11/1,總計,新北市,1525385,3977905,1952036,2025869
2016/11/1,總計,臺北市,1047103,2695652,1289721,1405931
2016/11/1,總計,桃園市,769198,2144044,1069986,1074058
2016/11/1,總計,臺中市,943408,2764958,1365288,1399670
2016/11/1,總計,臺南市,677690,1885653,943016,942637
2016/11/1,總計,高雄市,1082096,2778770,1378987,1399783
2016/11/1,總計,臺灣省,2467254,7137617,3643280,3494337
2016/11/1,總計,宜蘭縣,166794,457587,231752,225835
2016/11/1,總計,新竹縣,187215,546934,279780,267154
2016/11/1,總計,苗栗縣,185779,559557,288610,270947
2016/11/1,總計,彰化縣,384528,1287165,656779,630386
2016/11/1,總計,南投縣,177384,505371,259151,246220
2016/11/1,總計,雲林縣,239426,695195,361178,334017
2016/11/1,總計,嘉義縣,182482,515835,268363,247472
2016/11/1,總計,屏東縣,285727,836243,427989,408254
2016/11/1,總計,臺東縣,82569,220942,114294,106648
2016/11/1,總計,花蓮縣,125289,330930,168386,162544
2016/11/1,總計,澎湖縣,39141,103104,53079,50025
2016/11/1,總計,基隆市,151812,372062,186509,185553
2016/11/1,總計,新竹市,160192,436877,215998,220879
2016/11/1,總計,嘉義市,98916,269815,131412,138403
2016/11/1,總計,福建省,41860,147466,74638,72828
2016/11/1,總計,金門縣,39208,134858,67454,67404
2016/11/1,總計,連江縣,2652,12608,7184,5424
2016/11/1,新北市,板橋區,206652,552178,269815,282363
2016/11/1,新北市,三重區,149950,388419,191457,196962
2016/11/1,新北市,中和區,164177,414343,201948,212395
2016/11/1,新北市,永和區,90768,224110,106529,117581
2016/11/1,新北市,新莊區,150567,413961,202425,211536
2016/11/1,新北市,新店區,125078,301089,145192,155897
2016/11/1,新北市,樹林區,65961,184351,92060,92291
2016/11/1,新北市,鶯歌區,29548,87265,43739,43526
2016/11/1,新北市,三峽區,41931,114164,57311,56853
2016/11/1,新北市,淡水區,72234,165486,79557,85929
2016/11/1,新北市,汐止區,85939,197573,96535,101038
2016/11/1,新北市,瑞芳區,16176,40637,20544,20093
2016/11/1,新北市,土城區,86446,238468,117815,120653
2016/11/1,新北市,蘆洲區,70195,200596,98667,101929
2016/11/1,新北市,五股區,30710,84066,42429,41637
2016/11/1,新北市,泰山區,28219,78785,39155,39630
2016/11/1,新北市,林口區,40429,102957,50234,52723
2016/11/1,新北市,深坑區,9547,23692,11847,11845
2016/11/1,新北市,石碇區,3369,7752,4257,3495
2016/11/1,新北市,坪林區,2514,6540,3632,2908
2016/11/1,新北市,三芝區,9423,23366,12009,11357
2016/11/1,新北市,石門區,4302,12487,6467,6020
2016/11/1,新北市,八里區,14292,38129,19005,19124
2016/11/1,新北市,平溪區,2330,4789,2648,2141
2016/11/1,新北市,雙溪區,3826,9092,4913,4179
2016/11/1,新北市,貢寮區,4408,12730,6499,6231
2016/11/1,新北市,金山區,7079,22207,10963,11244
2016/11/1,新北市,萬里區,7462,22495,11321,11174
2016/11/1,新北市,烏來區,1853,6178,3063,3115
2016/11/1,臺北市,松山區,80284,208237,97966,110271
2016/11/1,臺北市,信義區,89566,227955,108996,118959
2016/11/1,臺北市,大安區,120482,311421,145568,165853
2016/11/1,臺北市,中山區,99600,231164,107858,123306
2016/11/1,臺北市,中正區,65033,160513,76664,83849
2016/11/1,臺北市,大同區,51590,130104,63484,66620
2016/11/1,臺北市,萬華區,78563,193551,95227,98324
2016/11/1,臺北市,文山區,104879,275220,132181,143039
2016/11/1,臺北市,南港區,46827,122563,59946,62617
2016/11/1,臺北市,內湖區,107189,287620,137574,150046
2016/11/1,臺北市,士林區,106718,289873,140024,149849
2016/11/1,臺北市,北投區,96372,257431,124233,133198
2016/11/1,桃園市,桃園區,162593,433534,210868,222666
2016/11/1,桃園市,中壢區,144670,395690,195392,200298
2016/11/1,桃園市,大溪區,31830,93981,48004,45977
2016/11/1,桃園市,楊梅區,56254,163654,82642,81012
2016/11/1,桃園市,蘆竹區,56678,158476,78853,79623
2016/11/1,桃園市,大園區,31390,86980,44579,42401
2016/11/1,桃園市,龜山區,59102,152432,76231,76201
2016/11/1,桃園市,八德區,68166,192542,96714,95828
2016/11/1,桃園市,龍潭區,40930,120009,60279,59730
2016/11/1,桃園市,平鎮區,75759,221310,110152,111158
2016/11/1,桃園市,新屋區,15987,48744,25974,22770
2016/11/1,桃園市,觀音區,22089,65524,34212,31312
2016/11/1,桃園市,復興區,3750,11168,6086,5082
2016/11/1,臺中市,中區,7991,18748,9301,9447
2016/11/1,臺中市,東區,27601,75357,37576,37781
2016/11/1,臺中市,南區,47424,123284,59279,64005
2016/11/1,臺中市,西區,45431,115658,54989,60669
2016/11/1,臺中市,北區,58980,147527,70687,76840
2016/11/1,臺中市,西屯區,84219,224313,107987,116326
2016/11/1,臺中市,南屯區,60834,166560,79746,86814
2016/11/1,臺中市,北屯區,97636,270191,129836,140355
2016/11/1,臺中市,豐原區,53162,166777,82518,84259
2016/11/1,臺中市,東勢區,17354,50949,26227,24722
2016/11/1,臺中市,大甲區,22906,77649,39104,38545
2016/11/1,臺中市,清水區,26823,86294,44301,41993
2016/11/1,臺中市,沙鹿區,28791,91222,46125,45097
2016/11/1,臺中市,梧棲區,17491,57571,28953,28618
2016/11/1,臺中市,后里區,15941,54298,27607,26691
2016/11/1,臺中市,神岡區,19246,65500,33452,32048
2016/11/1,臺中市,潭子區,35924,107405,53129,54276
2016/11/1,臺中市,大雅區,29016,94371,47154,47217
2016/11/1,臺中市,新社區,7543,24950,12947,12003
2016/11/1,臺中市,石岡區,4896,15192,7887,7305
2016/11/1,臺中市,外埔區,9604,32033,16430,15603
2016/11/1,臺中市,大安區,5454,19445,10262,9183
2016/11/1,臺中市,烏日區,23857,73500,36983,36517
2016/11/1,臺中市,大肚區,17431,57194,29219,27975
2016/11/1,臺中市,龍井區,22662,77150,38952,38198
2016/11/1,臺中市,霧峰區,19943,64885,33003,31882
2016/11/1,臺中市,太平區,62122,186109,92415,93694
2016/11/1,臺中市,大里區,68614,210025,103396,106629
2016/11/1,臺中市,和平區,4512,10801,5823,4978
2016/11/1,臺南市,新營區,28887,78109,38622,39487
2016/11/1,臺南市,鹽水區,10094,25895,13531,12364
2016/11/1,臺南市,白河區,10851,28856,15076,13780
2016/11/1,臺南市,柳營區,7879,21539,11255,10284
2016/11/1,臺南市,後壁區,8883,24101,12535,11566
2016/11/1,臺南市,東山區,8424,21354,11325,10029
2016/11/1,臺南市,麻豆區,15709,44804,22749,22055
2016/11/1,臺南市,下營區,9114,24541,12654,11887
2016/11/1,臺南市,六甲區,7718,22436,11588,10848
2016/11/1,臺南市,官田區,7870,21525,10991,10534
2016/11/1,臺南市,大內區,3899,9974,5336,4638
2016/11/1,臺南市,佳里區,20529,59452,29481,29971
2016/11/1,臺南市,學甲區,9664,26411,13509,12902
2016/11/1,臺南市,西港區,8143,24874,12606,12268
2016/11/1,臺南市,七股區,8057,23172,11984,11188
2016/11/1,臺南市,將軍區,7312,20077,10221,9856
2016/11/1,臺南市,北門區,4279,11339,5757,5582
2016/11/1,臺南市,新化區,14349,43754,22302,21452
2016/11/1,臺南市,善化區,17238,47585,23982,23603
2016/11/1,臺南市,新市區,12002,36246,18203,18043
2016/11/1,臺南市,安定區,9978,30465,15633,14832
2016/11/1,臺南市,山上區,2693,7363,3861,3502
2016/11/1,臺南市,玉井區,5129,14282,7400,6882
2016/11/1,臺南市,楠西區,3536,9922,5256,4666
2016/11/1,臺南市,南化區,2859,8829,4776,4053
2016/11/1,臺南市,左鎮區,1983,4988,2793,2195
2016/11/1,臺南市,仁德區,27248,74629,37889,36740
2016/11/1,臺南市,歸仁區,22498,68107,34624,33483
2016/11/1,臺南市,關廟區,11075,34650,17869,16781
2016/11/1,臺南市,龍崎區,1555,4109,2205,1904
2016/11/1,臺南市,永康區,82755,232040,114547,117493
2016/11/1,臺南市,東區,71791,187681,90121,97560
2016/11/1,臺南市,南區,45349,125768,62398,63370
2016/11/1,臺南市,北區,50523,133051,64838,68213
2016/11/1,臺南市,安南區,62005,191134,96473,94661
2016/11/1,臺南市,安平區,25144,65738,31217,34521
2016/11/1,臺南市,中西區,30668,76853,37409,39444
2016/11/1,高雄市,鹽埕區,10829,24663,12232,12431
2016/11/1,高雄市,鼓山區,57211,137974,66794,71180
2016/11/1,高雄市,左營區,78351,196835,94917,101918
2016/11/1,高雄市,楠梓區,68920,181632,89421,92211
2016/11/1,高雄市,三民區,135983,344857,167138,177719
2016/11/1,高雄市,新興區,22718,51439,24763,26676
2016/11/1,高雄市,前金區,12549,27162,13036,14126
2016/11/1,高雄市,苓雅區,72237,172995,83513,89482
2016/11/1,高雄市,前鎮區,78532,191320,94120,97200
2016/11/1,高雄市,旗津區,11110,28936,14968,13968
2016/11/1,高雄市,小港區,67257,156910,78033,78877
2016/11/1,高雄市,鳳山區,138649,357653,175594,182059
2016/11/1,高雄市,林園區,25707,70188,35610,34578
2016/11/1,高雄市,大寮區,41855,112149,57538,54611
2016/11/1,高雄市,大樹區,13534,43101,22122,20979
2016/11/1,高雄市,大社區,12837,34618,17561,17057
2016/11/1,高雄市,仁武區,32049,84081,42759,41322
2016/11/1,高雄市,鳥松區,18065,44250,22521,21729
2016/11/1,高雄市,岡山區,34835,97549,48461,49088
2016/11/1,高雄市,橋頭區,13435,37455,19059,18396
2016/11/1,高雄市,燕巢區,10458,29975,15852,14123
2016/11/1,高雄市,田寮區,3309,7342,4074,3268
2016/11/1,高雄市,阿蓮區,9399,29110,14695,14415
2016/11/1,高雄市,路竹區,16918,52997,27062,25935
2016/11/1,高雄市,湖內區,10736,29848,15202,14646
2016/11/1,高雄市,茄萣區,10471,30411,15696,14715
2016/11/1,高雄市,永安區,5738,14043,7064,6979
2016/11/1,高雄市,彌陀區,6778,19568,10082,9486
2016/11/1,高雄市,梓官區,12588,36267,18691,17576
2016/11/1,高雄市,旗山區,13803,37351,19343,18008
2016/11/1,高雄市,美濃區,14670,40429,21212,19217
2016/11/1,高雄市,六龜區,5565,13234,7108,6126
2016/11/1,高雄市,甲仙區,2343,6214,3311,2903
2016/11/1,高雄市,杉林區,4801,12219,6688,5531
2016/11/1,高雄市,內門區,5095,14754,7986,6768
2016/11/1,高雄市,茂林區,584,1895,941,954
2016/11/1,高雄市,桃源區,1325,4214,2201,2013
2016/11/1,高雄市,那瑪夏區,852,3132,1619,1513
2016/11/1,宜蘭縣,宜蘭市,35954,95957,46834,49123
2016/11/1,宜蘭縣,羅東鎮,26264,72478,34387,38091
2016/11/1,宜蘭縣,蘇澳鎮,14140,40520,20637,19883
2016/11/1,宜蘭縣,頭城鎮,10214,29708,15318,14390
2016/11/1,宜蘭縣,礁溪鄉,13849,35930,18723,17207
2016/11/1,宜蘭縣,壯圍鄉,8702,24259,12836,11423
2016/11/1,宜蘭縣,員山鄉,11639,32318,17140,15178
2016/11/1,宜蘭縣,冬山鄉,19088,53342,27407,25935
2016/11/1,宜蘭縣,五結鄉,14701,39639,20526,19113
2016/11/1,宜蘭縣,三星鄉,8426,21415,11535,9880
2016/11/1,宜蘭縣,大同鄉,1885,6080,3295,2785
2016/11/1,宜蘭縣,南澳鄉,1932,5941,3114,2827
2016/11/1,新竹縣,竹北市,63064,176057,87733,88324
2016/11/1,新竹縣,關西鎮,9509,29461,15771,13690
2016/11/1,新竹縣,新埔鎮,10713,33752,17988,15764
2016/11/1,新竹縣,竹東鎮,33482,96756,48636,48120
2016/11/1,新竹縣,湖口鄉,26168,77526,39290,38236
2016/11/1,新竹縣,橫山鄉,4487,13325,7225,6100
2016/11/1,新竹縣,新豐鄉,18147,56426,28969,27457
2016/11/1,新竹縣,芎林鄉,6503,20167,10688,9479
2016/11/1,新竹縣,寶山鄉,5344,14367,7756,6611
2016/11/1,新竹縣,北埔鄉,3125,9540,5174,4366
2016/11/1,新竹縣,峨眉鄉,2088,5590,3097,2493
2016/11/1,新竹縣,尖石鄉,2840,9396,4984,4412
2016/11/1,新竹縣,五峰鄉,1745,4571,2469,2102
2016/11/1,苗栗縣,苗栗市,31002,89910,44952,44958
2016/11/1,苗栗縣,頭份市,33929,103131,52038,51093
2016/11/1,苗栗縣,苑裡鎮,14549,47139,24525,22614
2016/11/1,苗栗縣,通霄鎮,11560,35488,18739,16749
2016/11/1,苗栗縣,竹南鎮,28466,84980,42870,42110
2016/11/1,苗栗縣,後龍鎮,11878,37289,19666,17623
2016/11/1,苗栗縣,卓蘭鎮,6082,17647,9210,8437
2016/11/1,苗栗縣,大湖鄉,5401,15086,7999,7087
2016/11/1,苗栗縣,公館鄉,10676,34247,17879,16368
2016/11/1,苗栗縣,銅鑼鄉,6170,18495,9802,8693
2016/11/1,苗栗縣,南庄鄉,3955,10398,5734,4664
2016/11/1,苗栗縣,頭屋鄉,3663,11112,5886,5226
2016/11/1,苗栗縣,三義鄉,5581,16836,8859,7977
2016/11/1,苗栗縣,西湖鄉,2665,7305,4058,3247
2016/11/1,苗栗縣,造橋鄉,4121,13179,6940,6239
2016/11/1,苗栗縣,三灣鄉,2404,6891,3765,3126
2016/11/1,苗栗縣,獅潭鄉,1720,4486,2510,1976
2016/11/1,苗栗縣,泰安鄉,1957,5938,3178,2760
2016/11/1,彰化縣,彰化市,75975,234689,116074,118615
2016/11/1,彰化縣,員林市,38969,124883,62096,62787
2016/11/1,彰化縣,鹿港鎮,24325,86713,44099,42614
2016/11/1,彰化縣,和美鎮,26523,91203,46496,44707
2016/11/1,彰化縣,北斗鎮,10576,33270,16777,16493
2016/11/1,彰化縣,溪湖鎮,16232,55659,28301,27358
2016/11/1,彰化縣,田中鎮,13091,42161,21775,20386
2016/11/1,彰化縣,二林鎮,14968,51519,26541,24978
2016/11/1,彰化縣,線西鄉,4382,16950,8760,8190
2016/11/1,彰化縣,伸港鄉,9829,36708,18734,17974
2016/11/1,彰化縣,福興鄉,12653,47446,24708,22738
2016/11/1,彰化縣,秀水鄉,10598,39309,20298,19011
2016/11/1,彰化縣,花壇鄉,14002,46155,23692,22463
2016/11/1,彰化縣,芬園鄉,6842,23880,12546,11334
2016/11/1,彰化縣,大村鄉,11021,36748,19035,17713
2016/11/1,彰化縣,埔鹽鄉,9036,32799,17234,15565
2016/11/1,彰化縣,埔心鄉,10484,34809,17939,16870
2016/11/1,彰化縣,永靖鄉,10933,37781,19594,18187
2016/11/1,彰化縣,社頭鄉,12843,43336,22258,21078
2016/11/1,彰化縣,二水鄉,5323,15522,8143,7379
2016/11/1,彰化縣,田尾鄉,7913,27579,14247,13332
2016/11/1,彰化縣,埤頭鄉,9000,30794,16006,14788
2016/11/1,彰化縣,芳苑鄉,10130,34076,18015,16061
2016/11/1,彰化縣,大城鄉,5296,17300,9363,7937
2016/11/1,彰化縣,竹塘鄉,4629,15482,8153,7329
2016/11/1,彰化縣,溪州鄉,8955,30394,15895,14499
2016/11/1,南投縣,南投市,34633,100958,50628,50330
2016/11/1,南投縣,埔里鎮,28983,81615,40832,40783
2016/11/1,南投縣,草屯鎮,32979,98431,49761,48670
2016/11/1,南投縣,竹山鎮,20038,55544,28540,27004
2016/11/1,南投縣,集集鎮,4307,11042,5748,5294
2016/11/1,南投縣,名間鄉,12615,39231,20639,18592
2016/11/1,南投縣,鹿谷鄉,7803,18020,9607,8413
2016/11/1,南投縣,中寮鄉,5650,15105,8216,6889
2016/11/1,南投縣,魚池鄉,5744,16168,8505,7663
2016/11/1,南投縣,國姓鄉,7302,19120,10318,8802
2016/11/1,南投縣,水里鄉,7168,18053,9459,8594
2016/11/1,南投縣,信義鄉,5234,16387,8775,7612
2016/11/1,南投縣,仁愛鄉,4928,15697,8123,7574
2016/11/1,雲林縣,斗六市,37878,108415,54082,54333
2016/11/1,雲林縣,斗南鎮,15819,45289,23031,22258
2016/11/1,雲林縣,虎尾鎮,24723,70762,35876,34886
2016/11/1,雲林縣,西螺鎮,14581,46595,23585,23010
2016/11/1,雲林縣,土庫鎮,9311,29303,15294,14009
2016/11/1,雲林縣,北港鎮,15920,40707,21100,19607
2016/11/1,雲林縣,古坑鄉,10957,32013,16877,15136
2016/11/1,雲林縣,大埤鄉,6707,19476,10452,9024
2016/11/1,雲林縣,莿桐鄉,9304,29091,15286,13805
2016/11/1,雲林縣,林內鄉,5979,18478,9647,8831
2016/11/1,雲林縣,二崙鄉,8920,27555,14751,12804
2016/11/1,雲林縣,崙背鄉,8513,25111,13292,11819
2016/11/1,雲林縣,麥寮鄉,14164,45025,22678,22347
2016/11/1,雲林縣,東勢鄉,5713,15146,8341,6805
2016/11/1,雲林縣,褒忠鄉,4453,13188,7099,6089
2016/11/1,雲林縣,臺西鄉,8731,24231,12984,11247
2016/11/1,雲林縣,元長鄉,9310,26402,14417,11985
2016/11/1,雲林縣,四湖鄉,8855,24190,13139,11051
2016/11/1,雲林縣,口湖鄉,9537,28088,14934,13154
2016/11/1,雲林縣,水林鄉,10051,26130,14313,11817
2016/11/1,嘉義縣,太保市,12644,37523,19261,18262
2016/11/1,嘉義縣,朴子市,15646,42619,21576,21043
2016/11/1,嘉義縣,布袋鎮,9997,27530,14071,13459
2016/11/1,嘉義縣,大林鎮,11363,31420,16073,15347
2016/11/1,嘉義縣,民雄鄉,24669,71853,36788,35065
2016/11/1,嘉義縣,溪口鄉,5373,14975,8000,6975
2016/11/1,嘉義縣,新港鄉,10658,32441,17080,15361
2016/11/1,嘉義縣,六腳鄉,8938,23836,12678,11158
2016/11/1,嘉義縣,東石鄉,9295,25338,13446,11892
2016/11/1,嘉義縣,義竹鄉,7475,18869,9802,9067
2016/11/1,嘉義縣,鹿草鄉,5784,15841,8512,7329
2016/11/1,嘉義縣,水上鄉,17989,50078,25835,24243
2016/11/1,嘉義縣,中埔鄉,15956,45451,23625,21826
2016/11/1,嘉義縣,竹崎鄉,11739,36262,19348,16914
2016/11/1,嘉義縣,梅山鄉,6774,19811,10543,9268
2016/11/1,嘉義縣,番路鄉,4283,11710,6333,5377
2016/11/1,嘉義縣,大埔鄉,1944,4605,2390,2215
2016/11/1,嘉義縣,阿里山鄉,1955,5673,3002,2671
2016/11/1,屏東縣,屏東市,73931,201681,99917,101764
2016/11/1,屏東縣,潮州鎮,19393,54753,27386,27367
2016/11/1,屏東縣,東港鎮,16634,48140,24368,23772
2016/11/1,屏東縣,恆春鎮,11508,30798,15770,15028
2016/11/1,屏東縣,萬丹鄉,14876,51296,26567,24729
2016/11/1,屏東縣,長治鄉,10091,30172,15719,14453
2016/11/1,屏東縣,麟洛鄉,3781,11136,5789,5347
2016/11/1,屏東縣,九如鄉,6941,22090,11428,10662
2016/11/1,屏東縣,里港鄉,8180,27045,13755,13290
2016/11/1,屏東縣,鹽埔鄉,7845,26193,13611,12582
2016/11/1,屏東縣,高樹鄉,9327,24895,13246,11649
2016/11/1,屏東縣,萬巒鄉,6495,20604,10763,9841
2016/11/1,屏東縣,內埔鄉,18564,55199,28537,26662
2016/11/1,屏東縣,竹田鄉,5647,17378,9204,8174
2016/11/1,屏東縣,新埤鄉,3436,9958,5290,4668
2016/11/1,屏東縣,枋寮鄉,8522,24836,13037,11799
2016/11/1,屏東縣,新園鄉,11780,35716,18509,17207
2016/11/1,屏東縣,崁頂鄉,4471,15902,8058,7844
2016/11/1,屏東縣,林邊鄉,6782,18336,9400,8936
2016/11/1,屏東縣,南州鄉,3717,10831,5548,5283
2016/11/1,屏東縣,佳冬鄉,6991,19709,10241,9468
2016/11/1,屏東縣,琉球鄉,4433,12421,6834,5587
2016/11/1,屏東縣,車城鄉,3482,8766,4721,4045
2016/11/1,屏東縣,滿州鄉,3018,7852,4286,3566
2016/11/1,屏東縣,枋山鄉,2119,5541,2948,2593
2016/11/1,屏東縣,三地門鄉,2304,7659,3859,3800
2016/11/1,屏東縣,霧臺鄉,1054,3295,1692,1603
2016/11/1,屏東縣,瑪家鄉,2042,6771,3450,3321
2016/11/1,屏東縣,泰武鄉,1330,5256,2764,2492
2016/11/1,屏東縣,來義鄉,2235,7496,3813,3683
2016/11/1,屏東縣,春日鄉,1364,4847,2495,2352
2016/11/1,屏東縣,獅子鄉,1546,4817,2495,2322
2016/11/1,屏東縣,牡丹鄉,1888,4854,2489,2365
2016/11/1,臺東縣,臺東市,39497,106395,53369,53026
2016/11/1,臺東縣,成功鎮,5406,14434,7635,6799
2016/11/1,臺東縣,關山鎮,3196,8827,4625,4202
2016/11/1,臺東縣,卑南鄉,6681,17451,9239,8212
2016/11/1,臺東縣,大武鄉,2504,6252,3265,2987
2016/11/1,臺東縣,太麻里鄉,4673,11297,6020,5277
2016/11/1,臺東縣,東河鄉,3777,8695,4800,3895
2016/11/1,臺東縣,長濱鄉,2923,7412,4195,3217
2016/11/1,臺東縣,鹿野鄉,3059,8026,4284,3742
2016/11/1,臺東縣,池上鄉,3219,8392,4383,4009
2016/11/1,臺東縣,綠島鄉,1101,3728,1949,1779
2016/11/1,臺東縣,延平鄉,1064,3520,1888,1632
2016/11/1,臺東縣,海端鄉,1092,4290,2287,2003
2016/11/1,臺東縣,達仁鄉,1452,3538,1931,1607
2016/11/1,臺東縣,金峰鄉,1118,3610,1856,1754
2016/11/1,臺東縣,蘭嶼鄉,1807,5075,2568,2507
2016/11/1,花蓮縣,花蓮市,41462,105083,50815,54268
2016/11/1,花蓮縣,鳳林鎮,4401,11006,5726,5280
2016/11/1,花蓮縣,玉里鎮,8896,24725,13186,11539
2016/11/1,花蓮縣,新城鄉,7670,20261,10438,9823
2016/11/1,花蓮縣,吉安鄉,31726,83631,42215,41416
2016/11/1,花蓮縣,壽豐鄉,7089,18123,9660,8463
2016/11/1,花蓮縣,光復鄉,5039,13039,6941,6098
2016/11/1,花蓮縣,豐濱鄉,1721,4446,2476,1970
2016/11/1,花蓮縣,瑞穗鄉,4730,11777,6352,5425
2016/11/1,花蓮縣,富里鄉,4002,10566,5736,4830
2016/11/1,花蓮縣,秀林鄉,4779,15791,8138,7653
2016/11/1,花蓮縣,萬榮鄉,2086,6454,3409,3045
2016/11/1,花蓮縣,卓溪鄉,1688,6028,3294,2734
2016/11/1,澎湖縣,馬公市,23929,61583,31311,30272
2016/11/1,澎湖縣,湖西鄉,5491,14435,7613,6822
2016/11/1,澎湖縣,白沙鄉,3368,9781,5119,4662
2016/11/1,澎湖縣,西嶼鄉,2969,8408,4329,4079
2016/11/1,澎湖縣,望安鄉,2023,5145,2759,2386
2016/11/1,澎湖縣,七美鄉,1361,3752,1948,1804
2016/11/1,基隆市,中正區,22551,52572,26869,25703
2016/11/1,基隆市,七堵區,21253,54082,27243,26839
2016/11/1,基隆市,暖暖區,15505,38387,19310,19077
2016/11/1,基隆市,仁愛區,19281,45084,22261,22823
2016/11/1,基隆市,中山區,19238,48125,24426,23699
2016/11/1,基隆市,安樂區,32928,81946,40628,41318
2016/11/1,基隆市,信義區,21056,51866,25772,26094
2016/11/1,新竹市,東區,77682,209562,103258,106304
2016/11/1,新竹市,北區,55775,149887,73367,76520
2016/11/1,新竹市,香山區,26735,77428,39373,38055
2016/11/1,嘉義市,東區,45395,122469,59194,63275
2016/11/1,嘉義市,西區,53521,147346,72218,75128
2016/11/1,金門縣,金城鎮,12748,42664,21318,21346
2016/11/1,金門縣,金湖鎮,8725,28774,14500,14274
2016/11/1,金門縣,金沙鎮,6239,20279,10036,10243
2016/11/1,金門縣,金寧鄉,8258,29918,15090,14828
2016/11/1,金門縣,烈嶼鄉,3105,12556,6180,6376
2016/11/1,金門縣,烏坵鄉,133,667,330,337
2016/11/1,連江縣,南竿鄉,1526,7397,4165,3232
2016/11/1,連江縣,北竿鄉,522,2343,1310,1033
2016/11/1,連江縣,莒光鄉,283,1567,935,632
2016/11/1,連江縣,東引鄉,321,1301,774,527
2016/12/1,總計,新北市,1526812,3979208,1952341,2026867
2016/12/1,總計,臺北市,1047284,2695704,1289510,1406194
2016/12/1,總計,桃園市,770894,2147763,1071564,1076199
2016/12/1,總計,臺中市,944624,2767239,1366312,1400927
2016/12/1,總計,臺南市,678158,1886033,943082,942951
2016/12/1,總計,高雄市,1083002,2779371,1379043,1400328
2016/12/1,總計,臺灣省,2468676,7136789,3642668,3494121
2016/12/1,總計,宜蘭縣,166916,457538,231722,225816
2016/12/1,總計,新竹縣,187439,547481,280030,267451
2016/12/1,總計,苗栗縣,185915,559189,288469,270720
2016/12/1,總計,彰化縣,384700,1287146,656749,630397
2016/12/1,總計,南投縣,177466,505163,258990,246173
2016/12/1,總計,雲林縣,239481,694873,360980,333893
2016/12/1,總計,嘉義縣,182488,515320,268109,247211
2016/12/1,總計,屏東縣,285804,835792,427747,408045
2016/12/1,總計,臺東縣,82574,220802,114205,106597
2016/12/1,總計,花蓮縣,125361,330911,168375,162536
2016/12/1,總計,澎湖縣,39244,103263,53152,50111
2016/12/1,總計,基隆市,151881,372100,186524,185576
2016/12/1,總計,新竹市,160460,437337,216206,221131
2016/12/1,總計,嘉義市,98947,269874,131410,138464
2016/12/1,總計,福建省,41933,147709,74750,72959
2016/12/1,總計,金門縣,39276,135114,67572,67542
2016/12/1,總計,連江縣,2657,12595,7178,5417
2016/12/1,新北市,板橋區,206794,552285,269874,282411
2016/12/1,新北市,三重區,150133,388581,191481,197100
2016/12/1,新北市,中和區,164248,414266,201832,212434
2016/12/1,新北市,永和區,90779,223999,106465,117534
2016/12/1,新北市,新莊區,150767,414156,202461,211695
2016/12/1,新北市,新店區,125213,301168,145218,155950
2016/12/1,新北市,樹林區,66035,184400,92064,92336
2016/12/1,新北市,鶯歌區,29565,87231,43731,43500
2016/12/1,新北市,三峽區,41992,114180,57307,56873
2016/12/1,新北市,淡水區,72432,165765,79687,86078
2016/12/1,新北市,汐止區,85998,197749,96598,101151
2016/12/1,新北市,瑞芳區,16168,40600,20518,20082
2016/12/1,新北市,土城區,86503,238500,117779,120721
2016/12/1,新北市,蘆洲區,70235,200702,98768,101934
2016/12/1,新北市,五股區,30747,84134,42449,41685
2016/12/1,新北市,泰山區,28230,78817,39178,39639
2016/12/1,新北市,林口區,40537,103219,50335,52884
2016/12/1,新北市,深坑區,9548,23683,11850,11833
2016/12/1,新北市,石碇區,3364,7736,4253,3483
2016/12/1,新北市,坪林區,2520,6538,3633,2905
2016/12/1,新北市,三芝區,9431,23369,11999,11370
2016/12/1,新北市,石門區,4305,12496,6469,6027
2016/12/1,新北市,八里區,14309,38167,19014,19153
2016/12/1,新北市,平溪區,2328,4778,2638,2140
2016/12/1,新北市,雙溪區,3819,9074,4901,4173
2016/12/1,新北市,貢寮區,4412,12706,6491,6215
2016/12/1,新北市,金山區,7078,22207,10969,11238
2016/12/1,新北市,萬里區,7465,22490,11309,11181
2016/12/1,新北市,烏來區,1857,6212,3070,3142
2016/12/1,臺北市,松山區,80313,208326,97953,110373
2016/12/1,臺北市,信義區,89544,227823,108923,118900
2016/12/1,臺北市,大安區,120518,311506,145617,165889
2016/12/1,臺北市,中山區,99610,231247,107850,123397
2016/12/1,臺北市,中正區,64984,160403,76610,83793
2016/12/1,臺北市,大同區,51597,130071,63469,66602
2016/12/1,臺北市,萬華區,78551,193539,95212,98327
2016/12/1,臺北市,文山區,104939,275231,132153,143078
2016/12/1,臺北市,南港區,46809,122516,59907,62609
2016/12/1,臺北市,內湖區,107193,287733,137619,150114
2016/12/1,臺北市,士林區,106807,289939,140011,149928
2016/12/1,臺北市,北投區,96419,257370,124186,133184
2016/12/1,桃園市,桃園區,162843,434243,211161,223082
2016/12/1,桃園市,中壢區,145057,396453,195719,200734
2016/12/1,桃園市,大溪區,31872,94102,48060,46042
2016/12/1,桃園市,楊梅區,56367,163959,82792,81167
2016/12/1,桃園市,蘆竹區,56821,158802,78988,79814
2016/12/1,桃園市,大園區,31533,87158,44653,42505
2016/12/1,桃園市,龜山區,59258,152817,76353,76464
2016/12/1,桃園市,八德區,68293,192922,96889,96033
2016/12/1,桃園市,龍潭區,41032,120201,60363,59838
2016/12/1,桃園市,平鎮區,75900,221587,110264,111323
2016/12/1,桃園市,新屋區,16006,48772,25990,22782
2016/12/1,桃園市,觀音區,22156,65555,34231,31324
2016/12/1,桃園市,復興區,3756,11192,6101,5091
2016/12/1,臺中市,中區,7978,18708,9295,9413
2016/12/1,臺中市,東區,27613,75396,37587,37809
2016/12/1,臺中市,南區,47493,123502,59357,64145
2016/12/1,臺中市,西區,45505,115747,55010,60737
2016/12/1,臺中市,北區,59011,147585,70725,76860
2016/12/1,臺中市,西屯區,84391,224601,108130,116471
2016/12/1,臺中市,南屯區,60928,166685,79808,86877
2016/12/1,臺中市,北屯區,97807,270547,129992,140555
2016/12/1,臺中市,豐原區,53191,166778,82510,84268
2016/12/1,臺中市,東勢區,17363,50952,26224,24728
2016/12/1,臺中市,大甲區,22924,77656,39105,38551
2016/12/1,臺中市,清水區,26851,86350,44343,42007
2016/12/1,臺中市,沙鹿區,28835,91338,46180,45158
2016/12/1,臺中市,梧棲區,17506,57645,28980,28665
2016/12/1,臺中市,后里區,15977,54332,27620,26712
2016/12/1,臺中市,神岡區,19259,65496,33452,32044
2016/12/1,臺中市,潭子區,35955,107530,53177,54353
2016/12/1,臺中市,大雅區,29107,94488,47204,47284
2016/12/1,臺中市,新社區,7542,24947,12944,12003
2016/12/1,臺中市,石岡區,4899,15174,7883,7291
2016/12/1,臺中市,外埔區,9616,32034,16448,15586
2016/12/1,臺中市,大安區,5451,19409,10251,9158
2016/12/1,臺中市,烏日區,23916,73647,37057,36590
2016/12/1,臺中市,大肚區,17450,57207,29216,27991
2016/12/1,臺中市,龍井區,22690,77236,38964,38272
2016/12/1,臺中市,霧峰區,19974,64898,33000,31898
2016/12/1,臺中市,太平區,62179,186271,92492,93779
2016/12/1,臺中市,大里區,68703,210285,103543,106742
2016/12/1,臺中市,和平區,4510,10795,5815,4980
2016/12/1,臺南市,新營區,28879,78101,38611,39490
2016/12/1,臺南市,鹽水區,10086,25871,13515,12356
2016/12/1,臺南市,白河區,10836,28819,15047,13772
2016/12/1,臺南市,柳營區,7873,21520,11245,10275
2016/12/1,臺南市,後壁區,8881,24066,12516,11550
2016/12/1,臺南市,東山區,8453,21320,11310,10010
2016/12/1,臺南市,麻豆區,15716,44812,22741,22071
2016/12/1,臺南市,下營區,9115,24508,12639,11869
2016/12/1,臺南市,六甲區,7711,22406,11577,10829
2016/12/1,臺南市,官田區,7880,21535,10995,10540
2016/12/1,臺南市,大內區,3895,9962,5329,4633
2016/12/1,臺南市,佳里區,20546,59458,29497,29961
2016/12/1,臺南市,學甲區,9662,26377,13495,12882
2016/12/1,臺南市,西港區,8155,24870,12601,12269
2016/12/1,臺南市,七股區,8053,23172,11981,11191
2016/12/1,臺南市,將軍區,7315,20051,10210,9841
2016/12/1,臺南市,北門區,4279,11333,5754,5579
2016/12/1,臺南市,新化區,14354,43727,22291,21436
2016/12/1,臺南市,善化區,17254,47660,24016,23644
2016/12/1,臺南市,新市區,12034,36268,18212,18056
2016/12/1,臺南市,安定區,9979,30447,15634,14813
2016/12/1,臺南市,山上區,2690,7359,3862,3497
2016/12/1,臺南市,玉井區,5134,14281,7397,6884
2016/12/1,臺南市,楠西區,3533,9898,5241,4657
2016/12/1,臺南市,南化區,2872,8838,4779,4059
2016/12/1,臺南市,左鎮區,1982,4980,2794,2186
2016/12/1,臺南市,仁德區,27270,74637,37875,36762
2016/12/1,臺南市,歸仁區,22518,68170,34658,33512
2016/12/1,臺南市,關廟區,11064,34601,17846,16755
2016/12/1,臺南市,龍崎區,1551,4107,2199,1908
2016/12/1,臺南市,永康區,82867,232210,114638,117572
2016/12/1,臺南市,東區,71835,187834,90167,97667
2016/12/1,臺南市,南區,45345,125768,62396,63372
2016/12/1,臺南市,北區,50561,133091,64838,68253
2016/12/1,臺南市,安南區,62086,191196,96479,94717
2016/12/1,臺南市,安平區,25179,65813,31264,34549
2016/12/1,臺南市,中西區,30715,76967,37433,39534
2016/12/1,高雄市,鹽埕區,10833,24659,12215,12444
2016/12/1,高雄市,鼓山區,57286,138099,66812,71287
2016/12/1,高雄市,左營區,78421,196936,94958,101978
2016/12/1,高雄市,楠梓區,69012,181845,89509,92336
2016/12/1,高雄市,三民區,136056,344888,167151,177737
2016/12/1,高雄市,新興區,22715,51431,24755,26676
2016/12/1,高雄市,前金區,12554,27151,13023,14128
2016/12/1,高雄市,苓雅區,72227,172895,83431,89464
2016/12/1,高雄市,前鎮區,78566,191262,94083,97179
2016/12/1,高雄市,旗津區,11112,28898,14954,13944
2016/12/1,高雄市,小港區,67351,157023,78087,78936
2016/12/1,高雄市,鳳山區,138800,357768,175649,182119
2016/12/1,高雄市,林園區,25738,70201,35604,34597
2016/12/1,高雄市,大寮區,41897,112258,57577,54681
2016/12/1,高雄市,大樹區,13548,43067,22111,20956
2016/12/1,高雄市,大社區,12842,34615,17567,17048
2016/12/1,高雄市,仁武區,32122,84122,42763,41359
2016/12/1,高雄市,鳥松區,18091,44265,22505,21760
2016/12/1,高雄市,岡山區,34866,97643,48477,49166
2016/12/1,高雄市,橋頭區,13444,37448,19041,18407
2016/12/1,高雄市,燕巢區,10453,29960,15846,14114
2016/12/1,高雄市,田寮區,3307,7340,4065,3275
2016/12/1,高雄市,阿蓮區,9407,29093,14686,14407
2016/12/1,高雄市,路竹區,16946,53007,27066,25941
2016/12/1,高雄市,湖內區,10751,29876,15219,14657
2016/12/1,高雄市,茄萣區,10491,30412,15706,14706
2016/12/1,高雄市,永安區,5745,14039,7060,6979
2016/12/1,高雄市,彌陀區,6784,19555,10070,9485
2016/12/1,高雄市,梓官區,12594,36252,18675,17577
2016/12/1,高雄市,旗山區,13804,37342,19336,18006
2016/12/1,高雄市,美濃區,14667,40399,21202,19197
2016/12/1,高雄市,六龜區,5563,13217,7107,6110
2016/12/1,高雄市,甲仙區,2342,6214,3314,2900
2016/12/1,高雄市,杉林區,4806,12201,6679,5522
2016/12/1,高雄市,內門區,5101,14743,7982,6761
2016/12/1,高雄市,茂林區,585,1896,943,953
2016/12/1,高雄市,桃源區,1324,4220,2198,2022
2016/12/1,高雄市,那瑪夏區,851,3131,1617,1514
2016/12/1,宜蘭縣,宜蘭市,35961,95907,46836,49071
2016/12/1,宜蘭縣,羅東鎮,26278,72485,34379,38106
2016/12/1,宜蘭縣,蘇澳鎮,14149,40493,20616,19877
2016/12/1,宜蘭縣,頭城鎮,10208,29666,15293,14373
2016/12/1,宜蘭縣,礁溪鄉,13871,35948,18730,17218
2016/12/1,宜蘭縣,壯圍鄉,8713,24236,12831,11405
2016/12/1,宜蘭縣,員山鄉,11656,32376,17159,15217
2016/12/1,宜蘭縣,冬山鄉,19099,53327,27395,25932
2016/12/1,宜蘭縣,五結鄉,14719,39657,20533,19124
2016/12/1,宜蘭縣,三星鄉,8448,21422,11540,9882
2016/12/1,宜蘭縣,大同鄉,1886,6083,3297,2786
2016/12/1,宜蘭縣,南澳鄉,1928,5938,3113,2825
2016/12/1,新竹縣,竹北市,63240,176604,87972,88632
2016/12/1,新竹縣,關西鎮,9499,29408,15741,13667
2016/12/1,新竹縣,新埔鎮,10702,33737,17989,15748
2016/12/1,新竹縣,竹東鎮,33494,96817,48661,48156
2016/12/1,新竹縣,湖口鄉,26187,77524,39292,38232
2016/12/1,新竹縣,橫山鄉,4487,13298,7211,6087
2016/12/1,新竹縣,新豐鄉,18170,56452,28980,27472
2016/12/1,新竹縣,芎林鄉,6506,20165,10698,9467
2016/12/1,新竹縣,寶山鄉,5355,14378,7763,6615
2016/12/1,新竹縣,北埔鄉,3127,9531,5172,4359
2016/12/1,新竹縣,峨眉鄉,2089,5593,3099,2494
2016/12/1,新竹縣,尖石鄉,2839,9412,4987,4425
2016/12/1,新竹縣,五峰鄉,1744,4562,2465,2097
2016/12/1,苗栗縣,苗栗市,31013,89892,44938,44954
2016/12/1,苗栗縣,頭份市,33985,103157,52071,51086
2016/12/1,苗栗縣,苑裡鎮,14567,47040,24478,22562
2016/12/1,苗栗縣,通霄鎮,11559,35433,18716,16717
2016/12/1,苗栗縣,竹南鎮,28507,85010,42889,42121
2016/12/1,苗栗縣,後龍鎮,11892,37251,19646,17605
2016/12/1,苗栗縣,卓蘭鎮,6082,17612,9193,8419
2016/12/1,苗栗縣,大湖鄉,5403,15070,7999,7071
2016/12/1,苗栗縣,公館鄉,10673,34210,17855,16355
2016/12/1,苗栗縣,銅鑼鄉,6165,18465,9794,8671
2016/12/1,苗栗縣,南庄鄉,3958,10391,5730,4661
2016/12/1,苗栗縣,頭屋鄉,3666,11102,5887,5215
2016/12/1,苗栗縣,三義鄉,5584,16813,8850,7963
2016/12/1,苗栗縣,西湖鄉,2662,7288,4047,3241
2016/12/1,苗栗縣,造橋鄉,4122,13166,6930,6236
2016/12/1,苗栗縣,三灣鄉,2401,6884,3761,3123
2016/12/1,苗栗縣,獅潭鄉,1721,4475,2508,1967
2016/12/1,苗栗縣,泰安鄉,1955,5930,3177,2753
2016/12/1,彰化縣,彰化市,75982,234690,116079,118611
2016/12/1,彰化縣,員林市,38982,124932,62103,62829
2016/12/1,彰化縣,鹿港鎮,24339,86709,44096,42613
2016/12/1,彰化縣,和美鎮,26551,91162,46483,44679
2016/12/1,彰化縣,北斗鎮,10577,33253,16768,16485
2016/12/1,彰化縣,溪湖鎮,16247,55675,28304,27371
2016/12/1,彰化縣,田中鎮,13095,42152,21764,20388
2016/12/1,彰化縣,二林鎮,14974,51516,26533,24983
2016/12/1,彰化縣,線西鄉,4378,16939,8749,8190
2016/12/1,彰化縣,伸港鄉,9845,36756,18767,17989
2016/12/1,彰化縣,福興鄉,12664,47479,24727,22752
2016/12/1,彰化縣,秀水鄉,10617,39344,20297,19047
2016/12/1,彰化縣,花壇鄉,14006,46142,23688,22454
2016/12/1,彰化縣,芬園鄉,6834,23881,12551,11330
2016/12/1,彰化縣,大村鄉,11039,36762,19047,17715
2016/12/1,彰化縣,埔鹽鄉,9036,32782,17220,15562
2016/12/1,彰化縣,埔心鄉,10488,34788,17945,16843
2016/12/1,彰化縣,永靖鄉,10933,37773,19588,18185
2016/12/1,彰化縣,社頭鄉,12856,43342,22262,21080
2016/12/1,彰化縣,二水鄉,5317,15500,8129,7371
2016/12/1,彰化縣,田尾鄉,7914,27567,14236,13331
2016/12/1,彰化縣,埤頭鄉,9008,30797,16019,14778
2016/12/1,彰化縣,芳苑鄉,10136,34039,17998,16041
2016/12/1,彰化縣,大城鄉,5294,17284,9351,7933
2016/12/1,彰化縣,竹塘鄉,4626,15491,8152,7339
2016/12/1,彰化縣,溪州鄉,8962,30391,15893,14498
2016/12/1,南投縣,南投市,34639,100960,50613,50347
2016/12/1,南投縣,埔里鎮,28993,81574,40785,40789
2016/12/1,南投縣,草屯鎮,33011,98431,49773,48658
2016/12/1,南投縣,竹山鎮,20048,55493,28509,26984
2016/12/1,南投縣,集集鎮,4308,11035,5745,5290
2016/12/1,南投縣,名間鄉,12618,39220,20618,18602
2016/12/1,南投縣,鹿谷鄉,7818,18010,9598,8412
2016/12/1,南投縣,中寮鄉,5649,15083,8197,6886
2016/12/1,南投縣,魚池鄉,5749,16154,8494,7660
2016/12/1,南投縣,國姓鄉,7303,19098,10320,8778
2016/12/1,南投縣,水里鄉,7162,18015,9443,8572
2016/12/1,南投縣,信義鄉,5236,16381,8773,7608
2016/12/1,南投縣,仁愛鄉,4932,15709,8122,7587
2016/12/1,雲林縣,斗六市,37868,108401,54053,54348
2016/12/1,雲林縣,斗南鎮,15821,45227,22997,22230
2016/12/1,雲林縣,虎尾鎮,24755,70815,35891,34924
2016/12/1,雲林縣,西螺鎮,14598,46597,23584,23013
2016/12/1,雲林縣,土庫鎮,9315,29275,15282,13993
2016/12/1,雲林縣,北港鎮,15922,40658,21067,19591
2016/12/1,雲林縣,古坑鄉,10961,31995,16860,15135
2016/12/1,雲林縣,大埤鄉,6708,19480,10458,9022
2016/12/1,雲林縣,莿桐鄉,9314,29089,15292,13797
2016/12/1,雲林縣,林內鄉,5978,18453,9635,8818
2016/12/1,雲林縣,二崙鄉,8920,27518,14743,12775
2016/12/1,雲林縣,崙背鄉,8519,25083,13282,11801
2016/12/1,雲林縣,麥寮鄉,14178,45126,22716,22410
2016/12/1,雲林縣,東勢鄉,5714,15120,8338,6782
2016/12/1,雲林縣,褒忠鄉,4450,13167,7093,6074
2016/12/1,雲林縣,臺西鄉,8727,24212,12968,11244
2016/12/1,雲林縣,元長鄉,9308,26361,14390,11971
2016/12/1,雲林縣,四湖鄉,8856,24151,13124,11027
2016/12/1,雲林縣,口湖鄉,9534,28074,14933,13141
2016/12/1,雲林縣,水林鄉,10035,26071,14274,11797
2016/12/1,嘉義縣,太保市,12664,37497,19255,18242
2016/12/1,嘉義縣,朴子市,15635,42585,21542,21043
2016/12/1,嘉義縣,布袋鎮,9996,27509,14058,13451
2016/12/1,嘉義縣,大林鎮,11359,31379,16058,15321
2016/12/1,嘉義縣,民雄鄉,24683,71834,36802,35032
2016/12/1,嘉義縣,溪口鄉,5372,14933,7992,6941
2016/12/1,嘉義縣,新港鄉,10658,32385,17049,15336
2016/12/1,嘉義縣,六腳鄉,8928,23787,12656,11131
2016/12/1,嘉義縣,東石鄉,9290,25307,13423,11884
2016/12/1,嘉義縣,義竹鄉,7464,18822,9776,9046
2016/12/1,嘉義縣,鹿草鄉,5784,15808,8497,7311
2016/12/1,嘉義縣,水上鄉,18020,50084,25835,24249
2016/12/1,嘉義縣,中埔鄉,15954,45395,23595,21800
2016/12/1,嘉義縣,竹崎鄉,11733,36226,19327,16899
2016/12/1,嘉義縣,梅山鄉,6776,19800,10535,9265
2016/12/1,嘉義縣,番路鄉,4279,11695,6320,5375
2016/12/1,嘉義縣,大埔鄉,1940,4610,2390,2220
2016/12/1,嘉義縣,阿里山鄉,1953,5664,2999,2665
2016/12/1,屏東縣,屏東市,73990,201644,99882,101762
2016/12/1,屏東縣,潮州鎮,19401,54703,27366,27337
2016/12/1,屏東縣,東港鎮,16636,48097,24338,23759
2016/12/1,屏東縣,恆春鎮,11514,30783,15770,15013
2016/12/1,屏東縣,萬丹鄉,14880,51261,26551,24710
2016/12/1,屏東縣,長治鄉,10098,30159,15702,14457
2016/12/1,屏東縣,麟洛鄉,3781,11125,5787,5338
2016/12/1,屏東縣,九如鄉,6940,22083,11431,10652
2016/12/1,屏東縣,里港鄉,8182,26995,13721,13274
2016/12/1,屏東縣,鹽埔鄉,7844,26199,13616,12583
2016/12/1,屏東縣,高樹鄉,9320,24882,13245,11637
2016/12/1,屏東縣,萬巒鄉,6501,20609,10767,9842
2016/12/1,屏東縣,內埔鄉,18564,55181,28530,26651
2016/12/1,屏東縣,竹田鄉,5640,17351,9190,8161
2016/12/1,屏東縣,新埤鄉,3424,9927,5275,4652
2016/12/1,屏東縣,枋寮鄉,8527,24826,13023,11803
2016/12/1,屏東縣,新園鄉,11781,35680,18492,17188
2016/12/1,屏東縣,崁頂鄉,4477,15916,8070,7846
2016/12/1,屏東縣,林邊鄉,6782,18317,9395,8922
2016/12/1,屏東縣,南州鄉,3720,10808,5533,5275
2016/12/1,屏東縣,佳冬鄉,6988,19689,10228,9461
2016/12/1,屏東縣,琉球鄉,4432,12423,6834,5589
2016/12/1,屏東縣,車城鄉,3480,8741,4707,4034
2016/12/1,屏東縣,滿州鄉,3017,7847,4284,3563
2016/12/1,屏東縣,枋山鄉,2117,5535,2950,2585
2016/12/1,屏東縣,三地門鄉,2306,7662,3863,3799
2016/12/1,屏東縣,霧臺鄉,1053,3285,1688,1597
2016/12/1,屏東縣,瑪家鄉,2045,6773,3451,3322
2016/12/1,屏東縣,泰武鄉,1331,5262,2763,2499
2016/12/1,屏東縣,來義鄉,2233,7494,3808,3686
2016/12/1,屏東縣,春日鄉,1367,4855,2499,2356
2016/12/1,屏東縣,獅子鄉,1545,4827,2499,2328
2016/12/1,屏東縣,牡丹鄉,1888,4853,2489,2364
2016/12/1,臺東縣,臺東市,39531,106368,53362,53006
2016/12/1,臺東縣,成功鎮,5408,14411,7625,6786
2016/12/1,臺東縣,關山鎮,3188,8811,4605,4206
2016/12/1,臺東縣,卑南鄉,6670,17443,9225,8218
2016/12/1,臺東縣,大武鄉,2504,6238,3257,2981
2016/12/1,臺東縣,太麻里鄉,4672,11304,6027,5277
2016/12/1,臺東縣,東河鄉,3771,8686,4799,3887
2016/12/1,臺東縣,長濱鄉,2920,7399,4185,3214
2016/12/1,臺東縣,鹿野鄉,3053,8018,4280,3738
2016/12/1,臺東縣,池上鄉,3214,8375,4370,4005
2016/12/1,臺東縣,綠島鄉,1106,3724,1949,1775
2016/12/1,臺東縣,延平鄉,1065,3523,1890,1633
2016/12/1,臺東縣,海端鄉,1090,4283,2284,1999
2016/12/1,臺東縣,達仁鄉,1451,3524,1921,1603
2016/12/1,臺東縣,金峰鄉,1121,3612,1855,1757
2016/12/1,臺東縣,蘭嶼鄉,1810,5083,2571,2512
2016/12/1,花蓮縣,花蓮市,41465,105034,50778,54256
2016/12/1,花蓮縣,鳳林鎮,4395,11004,5729,5275
2016/12/1,花蓮縣,玉里鎮,8891,24740,13176,11564
2016/12/1,花蓮縣,新城鄉,7678,20274,10443,9831
2016/12/1,花蓮縣,吉安鄉,31766,83656,42249,41407
2016/12/1,花蓮縣,壽豐鄉,7114,18146,9675,8471
2016/12/1,花蓮縣,光復鄉,5041,13032,6933,6099
2016/12/1,花蓮縣,豐濱鄉,1717,4439,2474,1965
2016/12/1,花蓮縣,瑞穗鄉,4730,11757,6343,5414
2016/12/1,花蓮縣,富里鄉,4007,10557,5737,4820
2016/12/1,花蓮縣,秀林鄉,4779,15796,8142,7654
2016/12/1,花蓮縣,萬榮鄉,2090,6440,3399,3041
2016/12/1,花蓮縣,卓溪鄉,1688,6036,3297,2739
2016/12/1,澎湖縣,馬公市,24023,61740,31376,30364
2016/12/1,澎湖縣,湖西鄉,5489,14435,7606,6829
2016/12/1,澎湖縣,白沙鄉,3373,9799,5135,4664
2016/12/1,澎湖縣,西嶼鄉,2979,8403,4331,4072
2016/12/1,澎湖縣,望安鄉,2016,5131,2751,2380
2016/12/1,澎湖縣,七美鄉,1364,3755,1953,1802
2016/12/1,基隆市,中正區,22545,52572,26876,25696
2016/12/1,基隆市,七堵區,21258,54103,27235,26868
2016/12/1,基隆市,暖暖區,15530,38407,19320,19087
2016/12/1,基隆市,仁愛區,19272,45021,22232,22789
2016/12/1,基隆市,中山區,19244,48115,24434,23681
2016/12/1,基隆市,安樂區,32972,82014,40666,41348
2016/12/1,基隆市,信義區,21060,51868,25761,26107
2016/12/1,新竹市,東區,77856,209826,103357,106469
2016/12/1,新竹市,北區,55828,149993,73444,76549
2016/12/1,新竹市,香山區,26776,77518,39405,38113
2016/12/1,嘉義市,東區,45383,122462,59172,63290
2016/12/1,嘉義市,西區,53564,147412,72238,75174
2016/12/1,金門縣,金城鎮,12764,42726,21345,21381
2016/12/1,金門縣,金湖鎮,8732,28833,14528,14305
2016/12/1,金門縣,金沙鎮,6243,20312,10051,10261
2016/12/1,金門縣,金寧鄉,8302,30006,15135,14871
2016/12/1,金門縣,烈嶼鄉,3102,12568,6183,6385
2016/12/1,金門縣,烏坵鄉,133,669,330,339
2016/12/1,連江縣,南竿鄉,1528,7382,4156,3226
2016/12/1,連江縣,北竿鄉,522,2344,1309,1035
2016/12/1,連江縣,莒光鄉,283,1562,934,628
2016/12/1,連江縣,東引鄉,324,1307,779,528
2017/1/1,總計,新北市,1527589,3979963,1952427,2027536
2017/1/1,總計,臺北市,1047393,2695371,1289308,1406063
2017/1/1,總計,桃園市,771961,2150685,1072883,1077802
2017/1/1,總計,臺中市,945386,2769005,1367013,1401992
2017/1/1,總計,臺南市,678421,1886075,942956,943119
2017/1/1,總計,高雄市,1083425,2779332,1378847,1400485
2017/1/1,總計,臺灣省,2469431,7135043,3641397,3493646
2017/1/1,總計,宜蘭縣,167004,457349,231604,225745
2017/1/1,總計,新竹縣,187644,547794,280195,267599
2017/1/1,總計,苗栗縣,185957,558779,288249,270530
2017/1/1,總計,彰化縣,384768,1286842,656523,630319
2017/1/1,總計,南投縣,177428,504838,258774,246064
2017/1/1,總計,雲林縣,239496,694519,360733,333786
2017/1/1,總計,嘉義縣,182469,515012,267927,247085
2017/1/1,總計,屏東縣,285873,835409,427496,407913
2017/1/1,總計,臺東縣,82589,220712,114127,106585
2017/1/1,總計,花蓮縣,125385,330810,168296,162514
2017/1/1,總計,澎湖縣,39284,103303,53186,50117
2017/1/1,總計,基隆市,151917,372044,186476,185568
2017/1/1,總計,新竹市,160630,437753,216412,221341
2017/1/1,總計,嘉義市,98987,269879,131399,138480
2017/1/1,總計,福建省,41982,147872,74815,73057
2017/1/1,總計,金門縣,39305,135223,67601,67622
2017/1/1,總計,連江縣,2677,12649,7214,5435
2017/1/1,新北市,板橋區,206836,552220,269787,282433
2017/1/1,新北市,三重區,150147,388544,191455,197089
2017/1/1,新北市,中和區,164283,414190,201765,212425
2017/1/1,新北市,永和區,90826,224086,106486,117600
2017/1/1,新北市,新莊區,150819,414227,202454,211773
2017/1/1,新北市,新店區,125299,301305,145239,156066
2017/1/1,新北市,樹林區,66078,184409,92068,92341
2017/1/1,新北市,鶯歌區,29594,87163,43693,43470
2017/1/1,新北市,三峽區,42004,114215,57328,56887
2017/1/1,新北市,淡水區,72613,166063,79827,86236
2017/1/1,新北市,汐止區,86040,197877,96631,101246
2017/1/1,新北市,瑞芳區,16157,40581,20511,20070
2017/1/1,新北市,土城區,86539,238491,117768,120723
2017/1/1,新北市,蘆洲區,70279,200760,98773,101987
2017/1/1,新北市,五股區,30771,84171,42472,41699
2017/1/1,新北市,泰山區,28238,78839,39197,39642
2017/1/1,新北市,林口區,40638,103458,50412,53046
2017/1/1,新北市,深坑區,9537,23667,11846,11821
2017/1/1,新北市,石碇區,3364,7735,4255,3480
2017/1/1,新北市,坪林區,2519,6530,3627,2903
2017/1/1,新北市,三芝區,9435,23349,11993,11356
2017/1/1,新北市,石門區,4301,12481,6458,6023
2017/1/1,新北市,八里區,14323,38177,19023,19154
2017/1/1,新北市,平溪區,2328,4776,2636,2140
2017/1/1,新北市,雙溪區,3817,9076,4905,4171
2017/1/1,新北市,貢寮區,4413,12689,6478,6211
2017/1/1,新北市,金山區,7070,22188,10964,11224
2017/1/1,新北市,萬里區,7461,22471,11302,11169
2017/1/1,新北市,烏來區,1860,6225,3074,3151
2017/1/1,臺北市,松山區,80325,208289,97938,110351
2017/1/1,臺北市,信義區,89502,227666,108864,118802
2017/1/1,臺北市,大安區,120529,311404,145556,165848
2017/1/1,臺北市,中山區,99650,231332,107864,123468
2017/1/1,臺北市,中正區,65013,160484,76628,83856
2017/1/1,臺北市,大同區,51564,129943,63417,66526
2017/1/1,臺北市,萬華區,78519,193415,95146,98269
2017/1/1,臺北市,文山區,105011,275233,132156,143077
2017/1/1,臺北市,南港區,46800,122444,59881,62563
2017/1/1,臺北市,內湖區,107228,287861,137697,150164
2017/1/1,臺北市,士林區,106819,289916,139972,149944
2017/1/1,臺北市,北投區,96433,257384,124189,133195
2017/1/1,桃園市,桃園區,162979,434653,211332,223321
2017/1/1,桃園市,中壢區,145313,397083,196000,201083
2017/1/1,桃園市,大溪區,31896,94166,48090,46076
2017/1/1,桃園市,楊梅區,56464,164189,82888,81301
2017/1/1,桃園市,蘆竹區,56891,159075,79113,79962
2017/1/1,桃園市,大園區,31600,87277,44724,42553
2017/1/1,桃園市,龜山區,59377,153256,76578,76678
2017/1/1,桃園市,八德區,68414,193236,97014,96222
2017/1/1,桃園市,龍潭區,41129,120409,60471,59938
2017/1/1,桃園市,平鎮區,75953,221751,110325,111426
2017/1/1,桃園市,新屋區,16014,48747,25973,22774
2017/1/1,桃園市,觀音區,22172,65608,34259,31349
2017/1/1,桃園市,復興區,3759,11235,6116,5119
2017/1/1,臺中市,中區,7987,18749,9316,9433
2017/1/1,臺中市,東區,27619,75421,37600,37821
2017/1/1,臺中市,南區,47540,123600,59408,64192
2017/1/1,臺中市,西區,45515,115745,55016,60729
2017/1/1,臺中市,北區,59013,147661,70730,76931
2017/1/1,臺中市,西屯區,84485,224831,108199,116632
2017/1/1,臺中市,南屯區,60970,166792,79832,86960
2017/1/1,臺中市,北屯區,97936,270847,130145,140702
2017/1/1,臺中市,豐原區,53185,166800,82519,84281
2017/1/1,臺中市,東勢區,17366,50930,26216,24714
2017/1/1,臺中市,大甲區,22932,77700,39125,38575
2017/1/1,臺中市,清水區,26881,86393,44346,42047
2017/1/1,臺中市,沙鹿區,28867,91404,46219,45185
2017/1/1,臺中市,梧棲區,17522,57668,28983,28685
2017/1/1,臺中市,后里區,15973,54324,27609,26715
2017/1/1,臺中市,神岡區,19267,65508,33461,32047
2017/1/1,臺中市,潭子區,35964,107632,53228,54404
2017/1/1,臺中市,大雅區,29142,94560,47236,47324
2017/1/1,臺中市,新社區,7533,24918,12923,11995
2017/1/1,臺中市,石岡區,4895,15168,7877,7291
2017/1/1,臺中市,外埔區,9616,32009,16423,15586
2017/1/1,臺中市,大安區,5454,19400,10245,9155
2017/1/1,臺中市,烏日區,23982,73771,37114,36657
2017/1/1,臺中市,大肚區,17456,57183,29199,27984
2017/1/1,臺中市,龍井區,22725,77299,38995,38304
2017/1/1,臺中市,霧峰區,19997,64964,33031,31933
2017/1/1,臺中市,太平區,62297,186480,92594,93886
2017/1/1,臺中市,大里區,68756,210431,103597,106834
2017/1/1,臺中市,和平區,4511,10817,5827,4990
2017/1/1,臺南市,新營區,28894,78165,38654,39511
2017/1/1,臺南市,鹽水區,10081,25827,13498,12329
2017/1/1,臺南市,白河區,10837,28778,15036,13742
2017/1/1,臺南市,柳營區,7874,21460,11207,10253
2017/1/1,臺南市,後壁區,8880,24030,12499,11531
2017/1/1,臺南市,東山區,8447,21291,11292,9999
2017/1/1,臺南市,麻豆區,15710,44782,22737,22045
2017/1/1,臺南市,下營區,9108,24481,12625,11856
2017/1/1,臺南市,六甲區,7717,22422,11587,10835
2017/1/1,臺南市,官田區,7892,21519,10983,10536
2017/1/1,臺南市,大內區,3896,9950,5320,4630
2017/1/1,臺南市,佳里區,20553,59469,29500,29969
2017/1/1,臺南市,學甲區,9660,26340,13475,12865
2017/1/1,臺南市,西港區,8161,24851,12590,12261
2017/1/1,臺南市,七股區,8047,23166,11976,11190
2017/1/1,臺南市,將軍區,7316,20042,10201,9841
2017/1/1,臺南市,北門區,4278,11305,5730,5575
2017/1/1,臺南市,新化區,14354,43706,22274,21432
2017/1/1,臺南市,善化區,17262,47687,24034,23653
2017/1/1,臺南市,新市區,12047,36269,18211,18058
2017/1/1,臺南市,安定區,9981,30427,15611,14816
2017/1/1,臺南市,山上區,2689,7354,3859,3495
2017/1/1,臺南市,玉井區,5132,14271,7388,6883
2017/1/1,臺南市,楠西區,3528,9885,5234,4651
2017/1/1,臺南市,南化區,2869,8825,4773,4052
2017/1/1,臺南市,左鎮區,1980,4975,2791,2184
2017/1/1,臺南市,仁德區,27297,74692,37886,36806
2017/1/1,臺南市,歸仁區,22535,68181,34666,33515
2017/1/1,臺南市,關廟區,11064,34584,17839,16745
2017/1/1,臺南市,龍崎區,1549,4101,2197,1904
2017/1/1,臺南市,永康區,82968,232385,114658,117727
2017/1/1,臺南市,東區,71874,187924,90212,97712
2017/1/1,臺南市,南區,45381,125830,62418,63412
2017/1/1,臺南市,北區,50534,132963,64765,68198
2017/1/1,臺南市,安南區,62116,191287,96526,94761
2017/1/1,臺南市,安平區,25197,65846,31270,34576
2017/1/1,臺南市,中西區,30713,77005,37434,39571
2017/1/1,高雄市,鹽埕區,10831,24638,12204,12434
2017/1/1,高雄市,鼓山區,57306,138122,66791,71331
2017/1/1,高雄市,左營區,78439,197008,94977,102031
2017/1/1,高雄市,楠梓區,69068,181936,89545,92391
2017/1/1,高雄市,三民區,136094,344904,167118,177786
2017/1/1,高雄市,新興區,22666,51336,24714,26622
2017/1/1,高雄市,前金區,12559,27164,13029,14135
2017/1/1,高雄市,苓雅區,72204,172768,83355,89413
2017/1/1,高雄市,前鎮區,78590,191157,94034,97123
2017/1/1,高雄市,旗津區,11107,28867,14938,13929
2017/1/1,高雄市,小港區,67416,157072,78100,78972
2017/1/1,高雄市,鳳山區,138962,357986,175761,182225
2017/1/1,高雄市,林園區,25735,70163,35579,34584
2017/1/1,高雄市,大寮區,41891,112213,57531,54682
2017/1/1,高雄市,大樹區,13553,43021,22076,20945
2017/1/1,高雄市,大社區,12844,34584,17562,17022
2017/1/1,高雄市,仁武區,32193,84317,42859,41458
2017/1/1,高雄市,鳥松區,18107,44243,22484,21759
2017/1/1,高雄市,岡山區,34879,97669,48498,49171
2017/1/1,高雄市,橋頭區,13470,37457,19045,18412
2017/1/1,高雄市,燕巢區,10458,29970,15839,14131
2017/1/1,高雄市,田寮區,3303,7328,4059,3269
2017/1/1,高雄市,阿蓮區,9404,29064,14672,14392
2017/1/1,高雄市,路竹區,16951,52993,27066,25927
2017/1/1,高雄市,湖內區,10751,29872,15220,14652
2017/1/1,高雄市,茄萣區,10497,30378,15684,14694
2017/1/1,高雄市,永安區,5748,14031,7058,6973
2017/1/1,高雄市,彌陀區,6784,19527,10046,9481
2017/1/1,高雄市,梓官區,12593,36262,18687,17575
2017/1/1,高雄市,旗山區,13794,37297,19301,17996
2017/1/1,高雄市,美濃區,14664,40419,21206,19213
2017/1/1,高雄市,六龜區,5558,13197,7110,6087
2017/1/1,高雄市,甲仙區,2343,6209,3305,2904
2017/1/1,高雄市,杉林區,4795,12184,6664,5520
2017/1/1,高雄市,內門區,5105,14717,7970,6747
2017/1/1,高雄市,茂林區,587,1902,946,956
2017/1/1,高雄市,桃源區,1325,4223,2199,2024
2017/1/1,高雄市,那瑪夏區,851,3134,1615,1519
2017/1/1,宜蘭縣,宜蘭市,35969,95902,46822,49080
2017/1/1,宜蘭縣,羅東鎮,26287,72447,34346,38101
2017/1/1,宜蘭縣,蘇澳鎮,14147,40475,20598,19877
2017/1/1,宜蘭縣,頭城鎮,10218,29670,15292,14378
2017/1/1,宜蘭縣,礁溪鄉,13879,35908,18705,17203
2017/1/1,宜蘭縣,壯圍鄉,8722,24229,12829,11400
2017/1/1,宜蘭縣,員山鄉,11672,32371,17166,15205
2017/1/1,宜蘭縣,冬山鄉,19107,53299,27382,25917
2017/1/1,宜蘭縣,五結鄉,14738,39648,20538,19110
2017/1/1,宜蘭縣,三星鄉,8450,21385,11515,9870
2017/1/1,宜蘭縣,大同鄉,1888,6092,3305,2787
2017/1/1,宜蘭縣,南澳鄉,1927,5923,3106,2817
2017/1/1,新竹縣,竹北市,63360,176966,88171,88795
2017/1/1,新竹縣,關西鎮,9498,29380,15726,13654
2017/1/1,新竹縣,新埔鎮,10708,33713,17972,15741
2017/1/1,新竹縣,竹東鎮,33524,96831,48676,48155
2017/1/1,新竹縣,湖口鄉,26207,77515,39278,38237
2017/1/1,新竹縣,橫山鄉,4486,13282,7204,6078
2017/1/1,新竹縣,新豐鄉,18193,56484,29000,27484
2017/1/1,新竹縣,芎林鄉,6508,20158,10695,9463
2017/1/1,新竹縣,寶山鄉,5362,14371,7758,6613
2017/1/1,新竹縣,北埔鄉,3127,9520,5168,4352
2017/1/1,新竹縣,峨眉鄉,2086,5591,3096,2495
2017/1/1,新竹縣,尖石鄉,2843,9420,4987,4433
2017/1/1,新竹縣,五峰鄉,1742,4563,2464,2099
2017/1/1,苗栗縣,苗栗市,31038,89850,44911,44939
2017/1/1,苗栗縣,頭份市,34007,103162,52055,51107
2017/1/1,苗栗縣,苑裡鎮,14568,46939,24432,22507
2017/1/1,苗栗縣,通霄鎮,11558,35389,18692,16697
2017/1/1,苗栗縣,竹南鎮,28518,85005,42890,42115
2017/1/1,苗栗縣,後龍鎮,11898,37228,19651,17577
2017/1/1,苗栗縣,卓蘭鎮,6071,17569,9166,8403
2017/1/1,苗栗縣,大湖鄉,5402,15071,7998,7073
2017/1/1,苗栗縣,公館鄉,10676,34179,17829,16350
2017/1/1,苗栗縣,銅鑼鄉,6163,18433,9777,8656
2017/1/1,苗栗縣,南庄鄉,3957,10381,5719,4662
2017/1/1,苗栗縣,頭屋鄉,3667,11097,5887,5210
2017/1/1,苗栗縣,三義鄉,5581,16788,8840,7948
2017/1/1,苗栗縣,西湖鄉,2662,7280,4042,3238
2017/1/1,苗栗縣,造橋鄉,4115,13153,6924,6229
2017/1/1,苗栗縣,三灣鄉,2402,6864,3755,3109
2017/1/1,苗栗縣,獅潭鄉,1721,4468,2508,1960
2017/1/1,苗栗縣,泰安鄉,1953,5923,3173,2750
2017/1/1,彰化縣,彰化市,75987,234567,116005,118562
2017/1/1,彰化縣,員林市,38985,124950,62105,62845
2017/1/1,彰化縣,鹿港鎮,24360,86779,44115,42664
2017/1/1,彰化縣,和美鎮,26562,91201,46511,44690
2017/1/1,彰化縣,北斗鎮,10591,33273,16784,16489
2017/1/1,彰化縣,溪湖鎮,16250,55694,28302,27392
2017/1/1,彰化縣,田中鎮,13086,42133,21752,20381
2017/1/1,彰化縣,二林鎮,14979,51487,26533,24954
2017/1/1,彰化縣,線西鄉,4381,16933,8741,8192
2017/1/1,彰化縣,伸港鄉,9849,36761,18766,17995
2017/1/1,彰化縣,福興鄉,12668,47487,24730,22757
2017/1/1,彰化縣,秀水鄉,10625,39335,20294,19041
2017/1/1,彰化縣,花壇鄉,14007,46142,23692,22450
2017/1/1,彰化縣,芬園鄉,6833,23843,12533,11310
2017/1/1,彰化縣,大村鄉,11041,36776,19044,17732
2017/1/1,彰化縣,埔鹽鄉,9038,32759,17205,15554
2017/1/1,彰化縣,埔心鄉,10482,34783,17932,16851
2017/1/1,彰化縣,永靖鄉,10933,37752,19573,18179
2017/1/1,彰化縣,社頭鄉,12859,43315,22253,21062
2017/1/1,彰化縣,二水鄉,5316,15489,8126,7363
2017/1/1,彰化縣,田尾鄉,7920,27557,14224,13333
2017/1/1,彰化縣,埤頭鄉,9007,30737,15988,14749
2017/1/1,彰化縣,芳苑鄉,10129,33991,17959,16032
2017/1/1,彰化縣,大城鄉,5296,17256,9335,7921
2017/1/1,彰化縣,竹塘鄉,4622,15476,8145,7331
2017/1/1,彰化縣,溪州鄉,8962,30366,15876,14490
2017/1/1,南投縣,南投市,34643,100913,50571,50342
2017/1/1,南投縣,埔里鎮,28991,81576,40771,40805
2017/1/1,南投縣,草屯鎮,32999,98366,49740,48626
2017/1/1,南投縣,竹山鎮,20040,55435,28461,26974
2017/1/1,南投縣,集集鎮,4301,11022,5740,5282
2017/1/1,南投縣,名間鄉,12615,39182,20595,18587
2017/1/1,南投縣,鹿谷鄉,7831,18007,9600,8407
2017/1/1,南投縣,中寮鄉,5636,15061,8182,6879
2017/1/1,南投縣,魚池鄉,5756,16155,8499,7656
2017/1/1,南投縣,國姓鄉,7295,19064,10298,8766
2017/1/1,南投縣,水里鄉,7157,17999,9439,8560
2017/1/1,南投縣,信義鄉,5241,16368,8766,7602
2017/1/1,南投縣,仁愛鄉,4923,15690,8112,7578
2017/1/1,雲林縣,斗六市,37899,108477,54078,54399
2017/1/1,雲林縣,斗南鎮,15814,45225,22999,22226
2017/1/1,雲林縣,虎尾鎮,24759,70790,35875,34915
2017/1/1,雲林縣,西螺鎮,14601,46567,23557,23010
2017/1/1,雲林縣,土庫鎮,9321,29252,15266,13986
2017/1/1,雲林縣,北港鎮,15913,40617,21045,19572
2017/1/1,雲林縣,古坑鄉,10962,31974,16855,15119
2017/1/1,雲林縣,大埤鄉,6706,19451,10452,8999
2017/1/1,雲林縣,莿桐鄉,9317,29103,15296,13807
2017/1/1,雲林縣,林內鄉,5984,18411,9596,8815
2017/1/1,雲林縣,二崙鄉,8916,27477,14724,12753
2017/1/1,雲林縣,崙背鄉,8518,25059,13268,11791
2017/1/1,雲林縣,麥寮鄉,14179,45107,22692,22415
2017/1/1,雲林縣,東勢鄉,5721,15118,8330,6788
2017/1/1,雲林縣,褒忠鄉,4449,13150,7089,6061
2017/1/1,雲林縣,臺西鄉,8719,24185,12951,11234
2017/1/1,雲林縣,元長鄉,9300,26340,14387,11953
2017/1/1,雲林縣,四湖鄉,8857,24122,13099,11023
2017/1/1,雲林縣,口湖鄉,9530,28065,14919,13146
2017/1/1,雲林縣,水林鄉,10031,26029,14255,11774
2017/1/1,嘉義縣,太保市,12685,37536,19269,18267
2017/1/1,嘉義縣,朴子市,15646,42597,21542,21055
2017/1/1,嘉義縣,布袋鎮,9990,27490,14053,13437
2017/1/1,嘉義縣,大林鎮,11361,31391,16049,15342
2017/1/1,嘉義縣,民雄鄉,24703,71835,36812,35023
2017/1/1,嘉義縣,溪口鄉,5368,14906,7976,6930
2017/1/1,嘉義縣,新港鄉,10642,32346,17034,15312
2017/1/1,嘉義縣,六腳鄉,8926,23737,12630,11107
2017/1/1,嘉義縣,東石鄉,9275,25247,13392,11855
2017/1/1,嘉義縣,義竹鄉,7455,18782,9757,9025
2017/1/1,嘉義縣,鹿草鄉,5781,15790,8476,7314
2017/1/1,嘉義縣,水上鄉,18018,50049,25817,24232
2017/1/1,嘉義縣,中埔鄉,15960,45353,23572,21781
2017/1/1,嘉義縣,竹崎鄉,11722,36225,19320,16905
2017/1/1,嘉義縣,梅山鄉,6768,19774,10521,9253
2017/1/1,嘉義縣,番路鄉,4277,11687,6318,5369
2017/1/1,嘉義縣,大埔鄉,1940,4604,2388,2216
2017/1/1,嘉義縣,阿里山鄉,1952,5663,3001,2662
2017/1/1,屏東縣,屏東市,73992,201497,99791,101706
2017/1/1,屏東縣,潮州鎮,19412,54706,27354,27352
2017/1/1,屏東縣,東港鎮,16643,48068,24323,23745
2017/1/1,屏東縣,恆春鎮,11520,30751,15752,14999
2017/1/1,屏東縣,萬丹鄉,14895,51227,26541,24686
2017/1/1,屏東縣,長治鄉,10100,30156,15686,14470
2017/1/1,屏東縣,麟洛鄉,3782,11122,5786,5336
2017/1/1,屏東縣,九如鄉,6945,22105,11438,10667
2017/1/1,屏東縣,里港鄉,8186,26991,13720,13271
2017/1/1,屏東縣,鹽埔鄉,7845,26196,13615,12581
2017/1/1,屏東縣,高樹鄉,9311,24858,13213,11645
2017/1/1,屏東縣,萬巒鄉,6505,20603,10765,9838
2017/1/1,屏東縣,內埔鄉,18565,55164,28519,26645
2017/1/1,屏東縣,竹田鄉,5636,17336,9185,8151
2017/1/1,屏東縣,新埤鄉,3423,9920,5273,4647
2017/1/1,屏東縣,枋寮鄉,8517,24802,12996,11806
2017/1/1,屏東縣,新園鄉,11793,35662,18481,17181
2017/1/1,屏東縣,崁頂鄉,4482,15934,8085,7849
2017/1/1,屏東縣,林邊鄉,6783,18302,9385,8917
2017/1/1,屏東縣,南州鄉,3714,10800,5527,5273
2017/1/1,屏東縣,佳冬鄉,6985,19676,10224,9452
2017/1/1,屏東縣,琉球鄉,4441,12438,6848,5590
2017/1/1,屏東縣,車城鄉,3479,8712,4698,4014
2017/1/1,屏東縣,滿州鄉,3016,7840,4281,3559
2017/1/1,屏東縣,枋山鄉,2121,5531,2948,2583
2017/1/1,屏東縣,三地門鄉,2306,7669,3865,3804
2017/1/1,屏東縣,霧臺鄉,1055,3287,1691,1596
2017/1/1,屏東縣,瑪家鄉,2047,6764,3446,3318
2017/1/1,屏東縣,泰武鄉,1331,5268,2767,2501
2017/1/1,屏東縣,來義鄉,2232,7488,3803,3685
2017/1/1,屏東縣,春日鄉,1368,4849,2499,2350
2017/1/1,屏東縣,獅子鄉,1546,4828,2499,2329
2017/1/1,屏東縣,牡丹鄉,1897,4859,2492,2367
2017/1/1,臺東縣,臺東市,39566,106364,53355,53009
2017/1/1,臺東縣,成功鎮,5406,14409,7619,6790
2017/1/1,臺東縣,關山鎮,3187,8798,4600,4198
2017/1/1,臺東縣,卑南鄉,6676,17440,9222,8218
2017/1/1,臺東縣,大武鄉,2504,6221,3241,2980
2017/1/1,臺東縣,太麻里鄉,4668,11287,6020,5267
2017/1/1,臺東縣,東河鄉,3765,8671,4787,3884
2017/1/1,臺東縣,長濱鄉,2918,7381,4177,3204
2017/1/1,臺東縣,鹿野鄉,3047,8023,4279,3744
2017/1/1,臺東縣,池上鄉,3213,8361,4357,4004
2017/1/1,臺東縣,綠島鄉,1101,3720,1946,1774
2017/1/1,臺東縣,延平鄉,1068,3522,1892,1630
2017/1/1,臺東縣,海端鄉,1089,4281,2285,1996
2017/1/1,臺東縣,達仁鄉,1450,3529,1921,1608
2017/1/1,臺東縣,金峰鄉,1120,3617,1856,1761
2017/1/1,臺東縣,蘭嶼鄉,1811,5088,2570,2518
2017/1/1,花蓮縣,花蓮市,41454,104972,50709,54263
2017/1/1,花蓮縣,鳳林鎮,4390,10993,5724,5269
2017/1/1,花蓮縣,玉里鎮,8897,24718,13156,11562
2017/1/1,花蓮縣,新城鄉,7683,20280,10447,9833
2017/1/1,花蓮縣,吉安鄉,31792,83729,42292,41437
2017/1/1,花蓮縣,壽豐鄉,7120,18127,9671,8456
2017/1/1,花蓮縣,光復鄉,5043,13012,6917,6095
2017/1/1,花蓮縣,豐濱鄉,1713,4430,2469,1961
2017/1/1,花蓮縣,瑞穗鄉,4727,11744,6342,5402
2017/1/1,花蓮縣,富里鄉,4003,10528,5720,4808
2017/1/1,花蓮縣,秀林鄉,4784,15803,8149,7654
2017/1/1,花蓮縣,萬榮鄉,2088,6418,3390,3028
2017/1/1,花蓮縣,卓溪鄉,1691,6056,3310,2746
2017/1/1,澎湖縣,馬公市,24060,61768,31406,30362
2017/1/1,澎湖縣,湖西鄉,5492,14450,7610,6840
2017/1/1,澎湖縣,白沙鄉,3375,9793,5134,4659
2017/1/1,澎湖縣,西嶼鄉,2978,8397,4324,4073
2017/1/1,澎湖縣,望安鄉,2020,5131,2754,2377
2017/1/1,澎湖縣,七美鄉,1359,3764,1958,1806
2017/1/1,基隆市,中正區,22556,52563,26873,25690
2017/1/1,基隆市,七堵區,21268,54062,27216,26846
2017/1/1,基隆市,暖暖區,15520,38415,19331,19084
2017/1/1,基隆市,仁愛區,19257,44972,22221,22751
2017/1/1,基隆市,中山區,19244,48092,24405,23687
2017/1/1,基隆市,安樂區,33018,82070,40676,41394
2017/1/1,基隆市,信義區,21054,51870,25754,26116
2017/1/1,新竹市,東區,77986,210123,103523,106600
2017/1/1,新竹市,北區,55864,150088,73484,76604
2017/1/1,新竹市,香山區,26780,77542,39405,38137
2017/1/1,嘉義市,東區,45387,122445,59160,63285
2017/1/1,嘉義市,西區,53600,147434,72239,75195
2017/1/1,金門縣,金城鎮,12772,42781,21361,21420
2017/1/1,金門縣,金湖鎮,8733,28852,14535,14317
2017/1/1,金門縣,金沙鎮,6248,20330,10058,10272
2017/1/1,金門縣,金寧鄉,8322,30022,15140,14882
2017/1/1,金門縣,烈嶼鄉,3097,12565,6173,6392
2017/1/1,金門縣,烏坵鄉,133,673,334,339
2017/1/1,連江縣,南竿鄉,1545,7411,4171,3240
2017/1/1,連江縣,北竿鄉,524,2356,1316,1040
2017/1/1,連江縣,莒光鄉,283,1569,943,626
2017/1/1,連江縣,東引鄉,325,1313,784,529
2017/2/1,總計,新北市,1528483,3980317,1952369,2027948
2017/2/1,總計,臺北市,1047528,2694195,1288568,1405627
2017/2/1,總計,桃園市,773252,2153521,1074120,1079401
2017/2/1,總計,臺中市,946370,2770356,1367504,1402852
2017/2/1,總計,臺南市,678824,1886160,942924,943236
2017/2/1,總計,高雄市,1083940,2779052,1378572,1400480
2017/2/1,總計,臺灣省,2470611,7132703,3639930,3492773
2017/2/1,總計,宜蘭縣,167154,457323,231595,225728
2017/2/1,總計,新竹縣,187910,548090,280355,267735
2017/2/1,總計,苗栗縣,186057,558373,288052,270321
2017/2/1,總計,彰化縣,384881,1286346,656228,630118
2017/2/1,總計,南投縣,177476,504561,258629,245932
2017/2/1,總計,雲林縣,239546,693987,360422,333565
2017/2/1,總計,嘉義縣,182463,514717,267801,246916
2017/2/1,總計,屏東縣,285950,834807,427143,407664
2017/2/1,總計,臺東縣,82616,220632,114070,106562
2017/2/1,總計,花蓮縣,125427,330691,168186,162505
2017/2/1,總計,澎湖縣,39323,103281,53172,50109
2017/2/1,總計,基隆市,152026,372049,186434,185615
2017/2/1,總計,新竹市,160796,438018,216490,221528
2017/2/1,總計,嘉義市,98986,269828,131353,138475
2017/2/1,總計,福建省,42044,147885,74808,73077
2017/2/1,總計,金門縣,39351,135235,67599,67636
2017/2/1,總計,連江縣,2693,12650,7209,5441
2017/2/1,新北市,板橋區,206904,552257,269811,282446
2017/2/1,新北市,三重區,150179,388361,191345,197016
2017/2/1,新北市,中和區,164269,413952,201603,212349
2017/2/1,新北市,永和區,90852,224120,106493,117627
2017/2/1,新北市,新莊區,150929,414330,202514,211816
2017/2/1,新北市,新店區,125393,301327,145232,156095
2017/2/1,新北市,樹林區,66078,184345,92028,92317
2017/2/1,新北市,鶯歌區,29637,87121,43667,43454
2017/2/1,新北市,三峽區,42058,114299,57348,56951
2017/2/1,新北市,淡水區,72778,166341,79960,86381
2017/2/1,新北市,汐止區,86050,198003,96670,101333
2017/2/1,新北市,瑞芳區,16176,40593,20515,20078
2017/2/1,新北市,土城區,86614,238529,117771,120758
2017/2/1,新北市,蘆洲區,70332,200833,98746,102087
2017/2/1,新北市,五股區,30814,84200,42485,41715
2017/2/1,新北市,泰山區,28245,78823,39204,39619
2017/2/1,新北市,林口區,40747,103684,50509,53175
2017/2/1,新北市,深坑區,9536,23663,11843,11820
2017/2/1,新北市,石碇區,3365,7719,4243,3476
2017/2/1,新北市,坪林區,2515,6541,3638,2903
2017/2/1,新北市,三芝區,9427,23335,11979,11356
2017/2/1,新北市,石門區,4300,12456,6452,6004
2017/2/1,新北市,八里區,14340,38170,19014,19156
2017/2/1,新北市,平溪區,2326,4764,2631,2133
2017/2/1,新北市,雙溪區,3815,9054,4895,4159
2017/2/1,新北市,貢寮區,4417,12690,6473,6217
2017/2/1,新北市,金山區,7067,22159,10948,11211
2017/2/1,新北市,萬里區,7456,22403,11268,11135
2017/2/1,新北市,烏來區,1864,6245,3084,3161
2017/2/1,臺北市,松山區,80322,208250,97892,110358
2017/2/1,臺北市,信義區,89462,227353,108696,118657
2017/2/1,臺北市,大安區,120506,311213,145496,165717
2017/2/1,臺北市,中山區,99661,231263,107826,123437
2017/2/1,臺北市,中正區,65078,160609,76678,83931
2017/2/1,臺北市,大同區,51601,129885,63381,66504
2017/2/1,臺北市,萬華區,78532,193207,94993,98214
2017/2/1,臺北市,文山區,105024,275143,132095,143048
2017/2/1,臺北市,南港區,46809,122415,59887,62528
2017/2/1,臺北市,內湖區,107226,287741,137599,150142
2017/2/1,臺北市,士林區,106849,289851,139903,149948
2017/2/1,臺北市,北投區,96458,257265,124122,133143
2017/2/1,桃園市,桃園區,163249,435260,211610,223650
2017/2/1,桃園市,中壢區,145593,397714,196279,201435
2017/2/1,桃園市,大溪區,31901,94115,48041,46074
2017/2/1,桃園市,楊梅區,56557,164473,83019,81454
2017/2/1,桃園市,蘆竹區,56968,159199,79179,80020
2017/2/1,桃園市,大園區,31704,87404,44749,42655
2017/2/1,桃園市,龜山區,59504,153545,76694,76851
2017/2/1,桃園市,八德區,68532,193576,97162,96414
2017/2/1,桃園市,龍潭區,41183,120468,60492,59976
2017/2/1,桃園市,平鎮區,76035,222032,110501,111531
2017/2/1,桃園市,新屋區,16054,48767,25979,22788
2017/2/1,桃園市,觀音區,22207,65680,34271,31409
2017/2/1,桃園市,復興區,3765,11288,6144,5144
2017/2/1,臺中市,中區,7989,18750,9320,9430
2017/2/1,臺中市,東區,27624,75394,37600,37794
2017/2/1,臺中市,南區,47585,123630,59448,64182
2017/2/1,臺中市,西區,45569,115835,55042,60793
2017/2/1,臺中市,北區,59051,147733,70761,76972
2017/2/1,臺中市,西屯區,84581,225037,108304,116733
2017/2/1,臺中市,南屯區,61024,166842,79824,87018
2017/2/1,臺中市,北屯區,98067,271221,130305,140916
2017/2/1,臺中市,豐原區,53227,166887,82558,84329
2017/2/1,臺中市,東勢區,17370,50893,26195,24698
2017/2/1,臺中市,大甲區,22926,77706,39139,38567
2017/2/1,臺中市,清水區,26924,86408,44339,42069
2017/2/1,臺中市,沙鹿區,28905,91514,46247,45267
2017/2/1,臺中市,梧棲區,17538,57712,29003,28709
2017/2/1,臺中市,后里區,15985,54291,27588,26703
2017/2/1,臺中市,神岡區,19284,65527,33466,32061
2017/2/1,臺中市,潭子區,35974,107581,53205,54376
2017/2/1,臺中市,大雅區,29174,94623,47259,47364
2017/2/1,臺中市,新社區,7542,24887,12908,11979
2017/2/1,臺中市,石岡區,4900,15163,7873,7290
2017/2/1,臺中市,外埔區,9617,31973,16409,15564
2017/2/1,臺中市,大安區,5455,19388,10244,9144
2017/2/1,臺中市,烏日區,24067,73873,37147,36726
2017/2/1,臺中市,大肚區,17467,57215,29214,28001
2017/2/1,臺中市,龍井區,22762,77261,38972,38289
2017/2/1,臺中市,霧峰區,20018,64961,33014,31947
2017/2/1,臺中市,太平區,62393,186632,92630,94002
2017/2/1,臺中市,大里區,68840,210595,103657,106938
2017/2/1,臺中市,和平區,4512,10824,5833,4991
2017/2/1,臺南市,新營區,28915,78195,38664,39531
2017/2/1,臺南市,鹽水區,10076,25803,13473,12330
2017/2/1,臺南市,白河區,10828,28747,15026,13721
2017/2/1,臺南市,柳營區,7880,21441,11192,10249
2017/2/1,臺南市,後壁區,8882,24001,12481,11520
2017/2/1,臺南市,東山區,8431,21254,11282,9972
2017/2/1,臺南市,麻豆區,15717,44788,22749,22039
2017/2/1,臺南市,下營區,9100,24448,12614,11834
2017/2/1,臺南市,六甲區,7709,22411,11596,10815
2017/2/1,臺南市,官田區,7906,21514,10971,10543
2017/2/1,臺南市,大內區,3895,9948,5314,4634
2017/2/1,臺南市,佳里區,20562,59484,29500,29984
2017/2/1,臺南市,學甲區,9660,26276,13440,12836
2017/2/1,臺南市,西港區,8166,24857,12590,12267
2017/2/1,臺南市,七股區,8047,23189,11995,11194
2017/2/1,臺南市,將軍區,7316,20000,10170,9830
2017/2/1,臺南市,北門區,4274,11304,5732,5572
2017/2/1,臺南市,新化區,14356,43676,22271,21405
2017/2/1,臺南市,善化區,17307,47759,24067,23692
2017/2/1,臺南市,新市區,12070,36285,18222,18063
2017/2/1,臺南市,安定區,9981,30422,15610,14812
2017/2/1,臺南市,山上區,2690,7346,3856,3490
2017/2/1,臺南市,玉井區,5130,14240,7372,6868
2017/2/1,臺南市,楠西區,3530,9868,5226,4642
2017/2/1,臺南市,南化區,2869,8823,4770,4053
2017/2/1,臺南市,左鎮區,1978,4949,2779,2170
2017/2/1,臺南市,仁德區,27339,74793,37938,36855
2017/2/1,臺南市,歸仁區,22559,68231,34689,33542
2017/2/1,臺南市,關廟區,11070,34546,17825,16721
2017/2/1,臺南市,龍崎區,1547,4091,2189,1902
2017/2/1,臺南市,永康區,83081,232540,114680,117860
2017/2/1,臺南市,東區,71884,187874,90191,97683
2017/2/1,臺南市,南區,45400,125826,62425,63401
2017/2/1,臺南市,北區,50538,132948,64754,68194
2017/2/1,臺南市,安南區,62177,191363,96552,94811
2017/2/1,臺南市,安平區,25211,65873,31286,34587
2017/2/1,臺南市,中西區,30743,77047,37433,39614
2017/2/1,高雄市,鹽埕區,10838,24618,12200,12418
2017/2/1,高雄市,鼓山區,57363,138214,66835,71379
2017/2/1,高雄市,左營區,78499,197034,94946,102088
2017/2/1,高雄市,楠梓區,69142,182104,89629,92475
2017/2/1,高雄市,三民區,136149,344882,167145,177737
2017/2/1,高雄市,新興區,22660,51253,24666,26587
2017/2/1,高雄市,前金區,12544,27128,13008,14120
2017/2/1,高雄市,苓雅區,72209,172613,83256,89357
2017/2/1,高雄市,前鎮區,78594,191083,93987,97096
2017/2/1,高雄市,旗津區,11109,28855,14922,13933
2017/2/1,高雄市,小港區,67445,157100,78095,79005
2017/2/1,高雄市,鳳山區,139085,358054,175766,182288
2017/2/1,高雄市,林園區,25749,70160,35563,34597
2017/2/1,高雄市,大寮區,41898,112184,57506,54678
2017/2/1,高雄市,大樹區,13558,43009,22062,20947
2017/2/1,高雄市,大社區,12840,34530,17537,16993
2017/2/1,高雄市,仁武區,32240,84422,42923,41499
2017/2/1,高雄市,鳥松區,18115,44237,22491,21746
2017/2/1,高雄市,岡山區,34891,97689,48508,49181
2017/2/1,高雄市,橋頭區,13482,37494,19061,18433
2017/2/1,高雄市,燕巢區,10458,29925,15811,14114
2017/2/1,高雄市,田寮區,3301,7317,4058,3259
2017/2/1,高雄市,阿蓮區,9410,29045,14669,14376
2017/2/1,高雄市,路竹區,16974,52963,27043,25920
2017/2/1,高雄市,湖內區,10755,29866,15219,14647
2017/2/1,高雄市,茄萣區,10494,30363,15669,14694
2017/2/1,高雄市,永安區,5752,14006,7047,6959
2017/2/1,高雄市,彌陀區,6782,19512,10037,9475
2017/2/1,高雄市,梓官區,12586,36231,18659,17572
2017/2/1,高雄市,旗山區,13787,37263,19275,17988
2017/2/1,高雄市,美濃區,14670,40382,21192,19190
2017/2/1,高雄市,六龜區,5557,13202,7108,6094
2017/2/1,高雄市,甲仙區,2340,6193,3303,2890
2017/2/1,高雄市,杉林區,4795,12157,6650,5507
2017/2/1,高雄市,內門區,5104,14694,7959,6735
2017/2/1,高雄市,茂林區,588,1906,946,960
2017/2/1,高雄市,桃源區,1326,4240,2208,2032
2017/2/1,高雄市,那瑪夏區,851,3124,1613,1511
2017/2/1,宜蘭縣,宜蘭市,36004,95944,46858,49086
2017/2/1,宜蘭縣,羅東鎮,26290,72456,34344,38112
2017/2/1,宜蘭縣,蘇澳鎮,14147,40445,20593,19852
2017/2/1,宜蘭縣,頭城鎮,10230,29644,15273,14371
2017/2/1,宜蘭縣,礁溪鄉,13902,35858,18687,17171
2017/2/1,宜蘭縣,壯圍鄉,8727,24209,12820,11389
2017/2/1,宜蘭縣,員山鄉,11681,32350,17143,15207
2017/2/1,宜蘭縣,冬山鄉,19132,53356,27412,25944
2017/2/1,宜蘭縣,五結鄉,14753,39674,20538,19136
2017/2/1,宜蘭縣,三星鄉,8468,21387,11520,9867
2017/2/1,宜蘭縣,大同鄉,1891,6100,3314,2786
2017/2/1,宜蘭縣,南澳鄉,1929,5900,3093,2807
2017/2/1,新竹縣,竹北市,63526,177353,88370,88983
2017/2/1,新竹縣,關西鎮,9504,29343,15713,13630
2017/2/1,新竹縣,新埔鎮,10704,33665,17941,15724
2017/2/1,新竹縣,竹東鎮,33578,96901,48709,48192
2017/2/1,新竹縣,湖口鄉,26246,77518,39288,38230
2017/2/1,新竹縣,橫山鄉,4480,13275,7197,6078
2017/2/1,新竹縣,新豐鄉,18195,56482,29005,27477
2017/2/1,新竹縣,芎林鄉,6503,20115,10667,9448
2017/2/1,新竹縣,寶山鄉,5369,14373,7762,6611
2017/2/1,新竹縣,北埔鄉,3129,9520,5166,4354
2017/2/1,新竹縣,峨眉鄉,2084,5576,3090,2486
2017/2/1,新竹縣,尖石鄉,2848,9404,4980,4424
2017/2/1,新竹縣,五峰鄉,1744,4565,2467,2098
2017/2/1,苗栗縣,苗栗市,31047,89754,44876,44878
2017/2/1,苗栗縣,頭份市,34043,103153,52057,51096
2017/2/1,苗栗縣,苑裡鎮,14571,46843,24381,22462
2017/2/1,苗栗縣,通霄鎮,11562,35352,18669,16683
2017/2/1,苗栗縣,竹南鎮,28576,85093,42935,42158
2017/2/1,苗栗縣,後龍鎮,11900,37206,19638,17568
2017/2/1,苗栗縣,卓蘭鎮,6070,17540,9163,8377
2017/2/1,苗栗縣,大湖鄉,5394,15034,7976,7058
2017/2/1,苗栗縣,公館鄉,10682,34168,17806,16362
2017/2/1,苗栗縣,銅鑼鄉,6163,18421,9781,8640
2017/2/1,苗栗縣,南庄鄉,3950,10350,5696,4654
2017/2/1,苗栗縣,頭屋鄉,3668,11067,5869,5198
2017/2/1,苗栗縣,三義鄉,5581,16778,8830,7948
2017/2/1,苗栗縣,西湖鄉,2662,7278,4040,3238
2017/2/1,苗栗縣,造橋鄉,4112,13117,6913,6204
2017/2/1,苗栗縣,三灣鄉,2404,6846,3747,3099
2017/2/1,苗栗縣,獅潭鄉,1719,4454,2501,1953
2017/2/1,苗栗縣,泰安鄉,1953,5919,3174,2745
2017/2/1,彰化縣,彰化市,76028,234489,115948,118541
2017/2/1,彰化縣,員林市,38992,124937,62071,62866
2017/2/1,彰化縣,鹿港鎮,24358,86762,44105,42657
2017/2/1,彰化縣,和美鎮,26585,91162,46491,44671
2017/2/1,彰化縣,北斗鎮,10615,33300,16807,16493
2017/2/1,彰化縣,溪湖鎮,16260,55724,28306,27418
2017/2/1,彰化縣,田中鎮,13091,42083,21723,20360
2017/2/1,彰化縣,二林鎮,14983,51464,26536,24928
2017/2/1,彰化縣,線西鄉,4372,16911,8725,8186
2017/2/1,彰化縣,伸港鄉,9861,36752,18771,17981
2017/2/1,彰化縣,福興鄉,12678,47458,24726,22732
2017/2/1,彰化縣,秀水鄉,10630,39371,20313,19058
2017/2/1,彰化縣,花壇鄉,14020,46130,23685,22445
2017/2/1,彰化縣,芬園鄉,6827,23810,12518,11292
2017/2/1,彰化縣,大村鄉,11049,36796,19059,17737
2017/2/1,彰化縣,埔鹽鄉,9028,32687,17172,15515
2017/2/1,彰化縣,埔心鄉,10480,34767,17930,16837
2017/2/1,彰化縣,永靖鄉,10930,37727,19552,18175
2017/2/1,彰化縣,社頭鄉,12852,43294,22246,21048
2017/2/1,彰化縣,二水鄉,5313,15462,8115,7347
2017/2/1,彰化縣,田尾鄉,7923,27547,14219,13328
2017/2/1,彰化縣,埤頭鄉,9013,30741,15979,14762
2017/2/1,彰化縣,芳苑鄉,10122,33970,17945,16025
2017/2/1,彰化縣,大城鄉,5292,17226,9312,7914
2017/2/1,彰化縣,竹塘鄉,4616,15438,8120,7318
2017/2/1,彰化縣,溪州鄉,8963,30338,15854,14484
2017/2/1,南投縣,南投市,34650,100868,50527,50341
2017/2/1,南投縣,埔里鎮,28984,81512,40720,40792
2017/2/1,南投縣,草屯鎮,33011,98351,49744,48607
2017/2/1,南投縣,竹山鎮,20058,55428,28458,26970
2017/2/1,南投縣,集集鎮,4302,11007,5729,5278
2017/2/1,南投縣,名間鄉,12616,39146,20596,18550
2017/2/1,南投縣,鹿谷鄉,7858,18001,9596,8405
2017/2/1,南投縣,中寮鄉,5633,15033,8173,6860
2017/2/1,南投縣,魚池鄉,5753,16138,8487,7651
2017/2/1,南投縣,國姓鄉,7290,19049,10295,8754
2017/2/1,南投縣,水里鄉,7156,17989,9435,8554
2017/2/1,南投縣,信義鄉,5245,16358,8766,7592
2017/2/1,南投縣,仁愛鄉,4920,15681,8103,7578
2017/2/1,雲林縣,斗六市,37904,108499,54061,54438
2017/2/1,雲林縣,斗南鎮,15825,45230,23002,22228
2017/2/1,雲林縣,虎尾鎮,24798,70860,35926,34934
2017/2/1,雲林縣,西螺鎮,14601,46527,23543,22984
2017/2/1,雲林縣,土庫鎮,9327,29200,15241,13959
2017/2/1,雲林縣,北港鎮,15910,40569,21003,19566
2017/2/1,雲林縣,古坑鄉,10969,31941,16853,15088
2017/2/1,雲林縣,大埤鄉,6706,19431,10442,8989
2017/2/1,雲林縣,莿桐鄉,9316,29091,15275,13816
2017/2/1,雲林縣,林內鄉,5979,18356,9579,8777
2017/2/1,雲林縣,二崙鄉,8929,27448,14705,12743
2017/2/1,雲林縣,崙背鄉,8517,25016,13245,11771
2017/2/1,雲林縣,麥寮鄉,14191,45096,22672,22424
2017/2/1,雲林縣,東勢鄉,5719,15072,8307,6765
2017/2/1,雲林縣,褒忠鄉,4450,13139,7084,6055
2017/2/1,雲林縣,臺西鄉,8717,24159,12939,11220
2017/2/1,雲林縣,元長鄉,9297,26313,14379,11934
2017/2/1,雲林縣,四湖鄉,8852,24068,13056,11012
2017/2/1,雲林縣,口湖鄉,9518,28002,14885,13117
2017/2/1,雲林縣,水林鄉,10021,25970,14225,11745
2017/2/1,嘉義縣,太保市,12704,37537,19275,18262
2017/2/1,嘉義縣,朴子市,15638,42608,21562,21046
2017/2/1,嘉義縣,布袋鎮,9988,27451,14036,13415
2017/2/1,嘉義縣,大林鎮,11361,31382,16059,15323
2017/2/1,嘉義縣,民雄鄉,24703,71836,36804,35032
2017/2/1,嘉義縣,溪口鄉,5370,14887,7960,6927
2017/2/1,嘉義縣,新港鄉,10635,32326,17021,15305
2017/2/1,嘉義縣,六腳鄉,8917,23690,12605,11085
2017/2/1,嘉義縣,東石鄉,9270,25219,13374,11845
2017/2/1,嘉義縣,義竹鄉,7448,18752,9744,9008
2017/2/1,嘉義縣,鹿草鄉,5773,15758,8461,7297
2017/2/1,嘉義縣,水上鄉,18032,50054,25831,24223
2017/2/1,嘉義縣,中埔鄉,15967,45334,23568,21766
2017/2/1,嘉義縣,竹崎鄉,11725,36197,19301,16896
2017/2/1,嘉義縣,梅山鄉,6765,19743,10506,9237
2017/2/1,嘉義縣,番路鄉,4273,11682,6315,5367
2017/2/1,嘉義縣,大埔鄉,1943,4595,2381,2214
2017/2/1,嘉義縣,阿里山鄉,1951,5666,2998,2668
2017/2/1,屏東縣,屏東市,74032,201372,99707,101665
2017/2/1,屏東縣,潮州鎮,19432,54695,27341,27354
2017/2/1,屏東縣,東港鎮,16649,48070,24314,23756
2017/2/1,屏東縣,恆春鎮,11517,30711,15732,14979
2017/2/1,屏東縣,萬丹鄉,14899,51182,26520,24662
2017/2/1,屏東縣,長治鄉,10104,30134,15670,14464
2017/2/1,屏東縣,麟洛鄉,3784,11139,5792,5347
2017/2/1,屏東縣,九如鄉,6952,22109,11443,10666
2017/2/1,屏東縣,里港鄉,8179,26940,13695,13245
2017/2/1,屏東縣,鹽埔鄉,7844,26164,13610,12554
2017/2/1,屏東縣,高樹鄉,9311,24826,13198,11628
2017/2/1,屏東縣,萬巒鄉,6500,20621,10783,9838
2017/2/1,屏東縣,內埔鄉,18564,55107,28487,26620
2017/2/1,屏東縣,竹田鄉,5631,17296,9157,8139
2017/2/1,屏東縣,新埤鄉,3425,9917,5267,4650
2017/2/1,屏東縣,枋寮鄉,8515,24769,12981,11788
2017/2/1,屏東縣,新園鄉,11809,35624,18465,17159
2017/2/1,屏東縣,崁頂鄉,4484,15931,8087,7844
2017/2/1,屏東縣,林邊鄉,6780,18297,9380,8917
2017/2/1,屏東縣,南州鄉,3715,10797,5524,5273
2017/2/1,屏東縣,佳冬鄉,6987,19650,10202,9448
2017/2/1,屏東縣,琉球鄉,4445,12431,6833,5598
2017/2/1,屏東縣,車城鄉,3472,8684,4689,3995
2017/2/1,屏東縣,滿州鄉,3010,7817,4264,3553
2017/2/1,屏東縣,枋山鄉,2118,5525,2948,2577
2017/2/1,屏東縣,三地門鄉,2306,7658,3859,3799
2017/2/1,屏東縣,霧臺鄉,1055,3282,1690,1592
2017/2/1,屏東縣,瑪家鄉,2048,6767,3449,3318
2017/2/1,屏東縣,泰武鄉,1332,5254,2761,2493
2017/2/1,屏東縣,來義鄉,2233,7498,3805,3693
2017/2/1,屏東縣,春日鄉,1373,4850,2498,2352
2017/2/1,屏東縣,獅子鄉,1549,4828,2500,2328
2017/2/1,屏東縣,牡丹鄉,1896,4862,2492,2370
2017/2/1,臺東縣,臺東市,39583,106357,53349,53008
2017/2/1,臺東縣,成功鎮,5405,14391,7602,6789
2017/2/1,臺東縣,關山鎮,3185,8788,4595,4193
2017/2/1,臺東縣,卑南鄉,6677,17452,9221,8231
2017/2/1,臺東縣,大武鄉,2500,6193,3230,2963
2017/2/1,臺東縣,太麻里鄉,4670,11271,6011,5260
2017/2/1,臺東縣,東河鄉,3772,8671,4793,3878
2017/2/1,臺東縣,長濱鄉,2923,7382,4178,3204
2017/2/1,臺東縣,鹿野鄉,3047,8008,4268,3740
2017/2/1,臺東縣,池上鄉,3217,8352,4353,3999
2017/2/1,臺東縣,綠島鄉,1104,3731,1953,1778
2017/2/1,臺東縣,延平鄉,1068,3527,1891,1636
2017/2/1,臺東縣,海端鄉,1089,4288,2287,2001
2017/2/1,臺東縣,達仁鄉,1448,3532,1921,1611
2017/2/1,臺東縣,金峰鄉,1119,3619,1855,1764
2017/2/1,臺東縣,蘭嶼鄉,1809,5070,2563,2507
2017/2/1,花蓮縣,花蓮市,41461,104987,50700,54287
2017/2/1,花蓮縣,鳳林鎮,4391,10983,5716,5267
2017/2/1,花蓮縣,玉里鎮,8899,24710,13147,11563
2017/2/1,花蓮縣,新城鄉,7680,20234,10415,9819
2017/2/1,花蓮縣,吉安鄉,31832,83777,42282,41495
2017/2/1,花蓮縣,壽豐鄉,7122,18102,9657,8445
2017/2/1,花蓮縣,光復鄉,5036,12998,6908,6090
2017/2/1,花蓮縣,豐濱鄉,1713,4426,2466,1960
2017/2/1,花蓮縣,瑞穗鄉,4726,11723,6332,5391
2017/2/1,花蓮縣,富里鄉,4003,10507,5711,4796
2017/2/1,花蓮縣,秀林鄉,4779,15773,8143,7630
2017/2/1,花蓮縣,萬榮鄉,2092,6409,3390,3019
2017/2/1,花蓮縣,卓溪鄉,1693,6062,3319,2743
2017/2/1,澎湖縣,馬公市,24080,61756,31397,30359
2017/2/1,澎湖縣,湖西鄉,5505,14452,7610,6842
2017/2/1,澎湖縣,白沙鄉,3380,9777,5128,4649
2017/2/1,澎湖縣,西嶼鄉,2977,8393,4321,4072
2017/2/1,澎湖縣,望安鄉,2021,5138,2755,2383
2017/2/1,澎湖縣,七美鄉,1360,3765,1961,1804
2017/2/1,基隆市,中正區,22563,52545,26848,25697
2017/2/1,基隆市,七堵區,21268,54031,27194,26837
2017/2/1,基隆市,暖暖區,15551,38470,19351,19119
2017/2/1,基隆市,仁愛區,19254,44906,22198,22708
2017/2/1,基隆市,中山區,19227,48029,24362,23667
2017/2/1,基隆市,安樂區,33091,82194,40743,41451
2017/2/1,基隆市,信義區,21072,51874,25738,26136
2017/2/1,新竹市,東區,78067,210350,103581,106769
2017/2/1,新竹市,北區,55945,150160,73519,76641
2017/2/1,新竹市,香山區,26784,77508,39390,38118
2017/2/1,嘉義市,東區,45371,122399,59114,63285
2017/2/1,嘉義市,西區,53615,147429,72239,75190
2017/2/1,金門縣,金城鎮,12779,42769,21363,21406
2017/2/1,金門縣,金湖鎮,8752,28840,14523,14317
2017/2/1,金門縣,金沙鎮,6256,20340,10062,10278
2017/2/1,金門縣,金寧鄉,8332,30055,15154,14901
2017/2/1,金門縣,烈嶼鄉,3099,12558,6161,6397
2017/2/1,金門縣,烏坵鄉,133,673,336,337
2017/2/1,連江縣,南竿鄉,1553,7396,4159,3237
2017/2/1,連江縣,北竿鄉,530,2358,1314,1044
2017/2/1,連江縣,莒光鄉,283,1579,950,629
2017/2/1,連江縣,東引鄉,327,1317,786,531
2017/3/1,總計,新北市,1529672,3980414,1952161,2028253
2017/3/1,總計,臺北市,1048003,2693313,1287959,1405354
2017/3/1,總計,桃園市,774809,2156999,1075714,1081285
2017/3/1,總計,臺中市,947726,2772118,1368268,1403850
2017/3/1,總計,臺南市,679301,1886368,942871,943497
2017/3/1,總計,高雄市,1084777,2778726,1378142,1400584
2017/3/1,總計,臺灣省,2472197,7129722,3638085,3491637
2017/3/1,總計,宜蘭縣,167232,457205,231495,225710
2017/3/1,總計,新竹縣,188212,548418,280483,267935
2017/3/1,總計,苗栗縣,186182,557741,287715,270026
2017/3/1,總計,彰化縣,385086,1285885,655930,629955
2017/3/1,總計,南投縣,177521,504098,258365,245733
2017/3/1,總計,雲林縣,239635,693525,360118,333407
2017/3/1,總計,嘉義縣,182517,514134,267511,246623
2017/3/1,總計,屏東縣,286056,834191,426839,407352
2017/3/1,總計,臺東縣,82657,220465,113979,106486
2017/3/1,總計,花蓮縣,125473,330484,168045,162439
2017/3/1,總計,澎湖縣,39385,103343,53217,50126
2017/3/1,總計,基隆市,152116,371973,186382,185591
2017/3/1,總計,新竹市,161044,438322,216616,221706
2017/3/1,總計,嘉義市,99081,269938,131390,138548
2017/3/1,總計,福建省,42124,148020,74868,73152
2017/3/1,總計,金門縣,39407,135342,67643,67699
2017/3/1,總計,連江縣,2717,12678,7225,5453
2017/3/1,新北市,板橋區,207047,552306,269813,282493
2017/3/1,新北市,三重區,150257,388267,191287,196980
2017/3/1,新北市,中和區,164263,413621,201413,212208
2017/3/1,新北市,永和區,90898,224081,106431,117650
2017/3/1,新北市,新莊區,151162,414585,202560,212025
2017/3/1,新北市,新店區,125440,301133,145107,156026
2017/3/1,新北市,樹林區,66126,184379,92011,92368
2017/3/1,新北市,鶯歌區,29637,87008,43627,43381
2017/3/1,新北市,三峽區,42078,114349,57365,56984
2017/3/1,新北市,淡水區,72933,166591,80061,86530
2017/3/1,新北市,汐止區,86117,198130,96720,101410
2017/3/1,新北市,瑞芳區,16170,40578,20501,20077
2017/3/1,新北市,土城區,86676,238495,117769,120726
2017/3/1,新北市,蘆洲區,70418,200959,98827,102132
2017/3/1,新北市,五股區,30840,84188,42502,41686
2017/3/1,新北市,泰山區,28282,78919,39231,39688
2017/3/1,新北市,林口區,40858,103866,50594,53272
2017/3/1,新北市,深坑區,9544,23673,11840,11833
2017/3/1,新北市,石碇區,3369,7713,4241,3472
2017/3/1,新北市,坪林區,2513,6551,3642,2909
2017/3/1,新北市,三芝區,9429,23309,11970,11339
2017/3/1,新北市,石門區,4302,12438,6437,6001
2017/3/1,新北市,八里區,14359,38153,19017,19136
2017/3/1,新北市,平溪區,2325,4744,2623,2121
2017/3/1,新北市,雙溪區,3813,9040,4876,4164
2017/3/1,新北市,貢寮區,4416,12648,6447,6201
2017/3/1,新北市,金山區,7072,22123,10930,11193
2017/3/1,新北市,萬里區,7467,22341,11237,11104
2017/3/1,新北市,烏來區,1861,6226,3082,3144
2017/3/1,臺北市,松山區,80369,208142,97829,110313
2017/3/1,臺北市,信義區,89429,227044,108526,118518
2017/3/1,臺北市,大安區,120550,311360,145578,165782
2017/3/1,臺北市,中山區,99711,231194,107832,123362
2017/3/1,臺北市,中正區,65142,160724,76741,83983
2017/3/1,臺北市,大同區,51672,129827,63317,66510
2017/3/1,臺北市,萬華區,78561,193036,94882,98154
2017/3/1,臺北市,文山區,105103,275058,132060,142998
2017/3/1,臺北市,南港區,46793,122322,59811,62511
2017/3/1,臺北市,內湖區,107336,287770,137576,150194
2017/3/1,臺北市,士林區,106859,289729,139794,149935
2017/3/1,臺北市,北投區,96478,257107,124013,133094
2017/3/1,桃園市,桃園區,163536,435979,211943,224036
2017/3/1,桃園市,中壢區,145921,398449,196619,201830
2017/3/1,桃園市,大溪區,31943,94144,48057,46087
2017/3/1,桃園市,楊梅區,56656,164683,83097,81586
2017/3/1,桃園市,蘆竹區,57106,159468,79314,80154
2017/3/1,桃園市,大園區,31899,87649,44866,42783
2017/3/1,桃園市,龜山區,59696,153991,76911,77080
2017/3/1,桃園市,八德區,68668,193920,97300,96620
2017/3/1,桃園市,龍潭區,41227,120589,60564,60025
2017/3/1,桃園市,平鎮區,76081,222377,110657,111720
2017/3/1,桃園市,新屋區,16066,48770,25983,22787
2017/3/1,桃園市,觀音區,22240,65714,34268,31446
2017/3/1,桃園市,復興區,3770,11266,6135,5131
2017/3/1,臺中市,中區,7985,18739,9315,9424
2017/3/1,臺中市,東區,27650,75464,37619,37845
2017/3/1,臺中市,南區,47694,123750,59522,64228
2017/3/1,臺中市,西區,45585,115882,55060,60822
2017/3/1,臺中市,北區,59074,147741,70778,76963
2017/3/1,臺中市,西屯區,84706,225324,108408,116916
2017/3/1,臺中市,南屯區,61086,166932,79849,87083
2017/3/1,臺中市,北屯區,98286,271569,130487,141082
2017/3/1,臺中市,豐原區,53258,166815,82518,84297
2017/3/1,臺中市,東勢區,17375,50884,26195,24689
2017/3/1,臺中市,大甲區,22942,77730,39124,38606
2017/3/1,臺中市,清水區,26956,86409,44345,42064
2017/3/1,臺中市,沙鹿區,28986,91708,46329,45379
2017/3/1,臺中市,梧棲區,17565,57751,29013,28738
2017/3/1,臺中市,后里區,16020,54321,27615,26706
2017/3/1,臺中市,神岡區,19335,65599,33507,32092
2017/3/1,臺中市,潭子區,36016,107624,53247,54377
2017/3/1,臺中市,大雅區,29239,94725,47312,47413
2017/3/1,臺中市,新社區,7549,24880,12888,11992
2017/3/1,臺中市,石岡區,4902,15140,7859,7281
2017/3/1,臺中市,外埔區,9628,31986,16425,15561
2017/3/1,臺中市,大安區,5457,19387,10239,9148
2017/3/1,臺中市,烏日區,24142,73954,37184,36770
2017/3/1,臺中市,大肚區,17491,57238,29215,28023
2017/3/1,臺中市,龍井區,22792,77214,38950,38264
2017/3/1,臺中市,霧峰區,20037,64985,33005,31980
2017/3/1,臺中市,太平區,62500,186769,92707,94062
2017/3/1,臺中市,大里區,68950,210769,103712,107057
2017/3/1,臺中市,和平區,4520,10829,5841,4988
2017/3/1,臺南市,新營區,28921,78185,38687,39498
2017/3/1,臺南市,鹽水區,10073,25777,13456,12321
2017/3/1,臺南市,白河區,10830,28717,15014,13703
2017/3/1,臺南市,柳營區,7878,21404,11178,10226
2017/3/1,臺南市,後壁區,8878,23980,12473,11507
2017/3/1,臺南市,東山區,8403,21228,11267,9961
2017/3/1,臺南市,麻豆區,15746,44794,22753,22041
2017/3/1,臺南市,下營區,9098,24426,12594,11832
2017/3/1,臺南市,六甲區,7718,22375,11582,10793
2017/3/1,臺南市,官田區,7907,21505,10957,10548
2017/3/1,臺南市,大內區,3900,9937,5311,4626
2017/3/1,臺南市,佳里區,20557,59477,29497,29980
2017/3/1,臺南市,學甲區,9661,26266,13428,12838
2017/3/1,臺南市,西港區,8171,24873,12598,12275
2017/3/1,臺南市,七股區,8045,23179,11988,11191
2017/3/1,臺南市,將軍區,7306,19972,10162,9810
2017/3/1,臺南市,北門區,4271,11277,5722,5555
2017/3/1,臺南市,新化區,14370,43692,22266,21426
2017/3/1,臺南市,善化區,17337,47836,24099,23737
2017/3/1,臺南市,新市區,12085,36291,18221,18070
2017/3/1,臺南市,安定區,10000,30446,15631,14815
2017/3/1,臺南市,山上區,2693,7343,3851,3492
2017/3/1,臺南市,玉井區,5128,14217,7360,6857
2017/3/1,臺南市,楠西區,3519,9836,5206,4630
2017/3/1,臺南市,南化區,2871,8819,4763,4056
2017/3/1,臺南市,左鎮區,1980,4940,2772,2168
2017/3/1,臺南市,仁德區,27410,74951,38020,36931
2017/3/1,臺南市,歸仁區,22587,68274,34703,33571
2017/3/1,臺南市,關廟區,11069,34530,17823,16707
2017/3/1,臺南市,龍崎區,1546,4087,2183,1904
2017/3/1,臺南市,永康區,83208,232685,114747,117938
2017/3/1,臺南市,東區,71890,187838,90124,97714
2017/3/1,臺南市,南區,45402,125781,62369,63412
2017/3/1,臺南市,北區,50553,132842,64694,68148
2017/3/1,臺南市,安南區,62243,191478,96574,94904
2017/3/1,臺南市,安平區,25255,65957,31326,34631
2017/3/1,臺南市,中西區,30792,77153,37472,39681
2017/3/1,高雄市,鹽埕區,10824,24571,12177,12394
2017/3/1,高雄市,鼓山區,57391,138284,66858,71426
2017/3/1,高雄市,左營區,78526,197037,94962,102075
2017/3/1,高雄市,楠梓區,69273,182363,89716,92647
2017/3/1,高雄市,三民區,136325,344918,167123,177795
2017/3/1,高雄市,新興區,22658,51204,24656,26548
2017/3/1,高雄市,前金區,12576,27158,13008,14150
2017/3/1,高雄市,苓雅區,72198,172458,83149,89309
2017/3/1,高雄市,前鎮區,78626,190963,93904,97059
2017/3/1,高雄市,旗津區,11120,28814,14912,13902
2017/3/1,高雄市,小港區,67503,157146,78089,79057
2017/3/1,高雄市,鳳山區,139214,358121,175774,182347
2017/3/1,高雄市,林園區,25758,70131,35541,34590
2017/3/1,高雄市,大寮區,41964,112205,57514,54691
2017/3/1,高雄市,大樹區,13573,42989,22046,20943
2017/3/1,高雄市,大社區,12848,34531,17545,16986
2017/3/1,高雄市,仁武區,32291,84454,42922,41532
2017/3/1,高雄市,鳥松區,18132,44271,22471,21800
2017/3/1,高雄市,岡山區,34889,97585,48474,49111
2017/3/1,高雄市,橋頭區,13508,37520,19058,18462
2017/3/1,高雄市,燕巢區,10470,29903,15805,14098
2017/3/1,高雄市,田寮區,3298,7294,4036,3258
2017/3/1,高雄市,阿蓮區,9422,29042,14669,14373
2017/3/1,高雄市,路竹區,17000,52965,27039,25926
2017/3/1,高雄市,湖內區,10741,29797,15190,14607
2017/3/1,高雄市,茄萣區,10489,30317,15643,14674
2017/3/1,高雄市,永安區,5750,13973,7027,6946
2017/3/1,高雄市,彌陀區,6788,19506,10038,9468
2017/3/1,高雄市,梓官區,12594,36187,18624,17563
2017/3/1,高雄市,旗山區,13783,37247,19276,17971
2017/3/1,高雄市,美濃區,14671,40335,21161,19174
2017/3/1,高雄市,六龜區,5568,13179,7088,6091
2017/3/1,高雄市,甲仙區,2342,6173,3293,2880
2017/3/1,高雄市,杉林區,4793,12156,6644,5512
2017/3/1,高雄市,內門區,5107,14673,7945,6728
2017/3/1,高雄市,茂林區,588,1906,947,959
2017/3/1,高雄市,桃源區,1324,4229,2208,2021
2017/3/1,高雄市,那瑪夏區,852,3121,1610,1511
2017/3/1,宜蘭縣,宜蘭市,36037,95977,46887,49090
2017/3/1,宜蘭縣,羅東鎮,26307,72469,34331,38138
2017/3/1,宜蘭縣,蘇澳鎮,14143,40416,20578,19838
2017/3/1,宜蘭縣,頭城鎮,10229,29613,15252,14361
2017/3/1,宜蘭縣,礁溪鄉,13901,35830,18670,17160
2017/3/1,宜蘭縣,壯圍鄉,8737,24207,12822,11385
2017/3/1,宜蘭縣,員山鄉,11673,32301,17115,15186
2017/3/1,宜蘭縣,冬山鄉,19146,53348,27390,25958
2017/3/1,宜蘭縣,五結鄉,14749,39643,20510,19133
2017/3/1,宜蘭縣,三星鄉,8494,21412,11541,9871
2017/3/1,宜蘭縣,大同鄉,1887,6098,3306,2792
2017/3/1,宜蘭縣,南澳鄉,1929,5891,3093,2798
2017/3/1,新竹縣,竹北市,63694,177751,88563,89188
2017/3/1,新竹縣,關西鎮,9512,29271,15679,13592
2017/3/1,新竹縣,新埔鎮,10715,33638,17917,15721
2017/3/1,新竹縣,竹東鎮,33600,96877,48681,48196
2017/3/1,新竹縣,湖口鄉,26289,77508,39286,38222
2017/3/1,新竹縣,橫山鄉,4474,13281,7195,6086
2017/3/1,新竹縣,新豐鄉,18227,56546,29045,27501
2017/3/1,新竹縣,芎林鄉,6501,20068,10654,9414
2017/3/1,新竹縣,寶山鄉,5389,14394,7767,6627
2017/3/1,新竹縣,北埔鄉,3131,9518,5165,4353
2017/3/1,新竹縣,峨眉鄉,2080,5569,3085,2484
2017/3/1,新竹縣,尖石鄉,2853,9428,4984,4444
2017/3/1,新竹縣,五峰鄉,1747,4569,2462,2107
2017/3/1,苗栗縣,苗栗市,31056,89664,44803,44861
2017/3/1,苗栗縣,頭份市,34109,103144,52056,51088
2017/3/1,苗栗縣,苑裡鎮,14577,46725,24335,22390
2017/3/1,苗栗縣,通霄鎮,11564,35269,18631,16638
2017/3/1,苗栗縣,竹南鎮,28631,85121,42936,42185
2017/3/1,苗栗縣,後龍鎮,11904,37165,19626,17539
2017/3/1,苗栗縣,卓蘭鎮,6066,17472,9137,8335
2017/3/1,苗栗縣,大湖鄉,5388,14999,7964,7035
2017/3/1,苗栗縣,公館鄉,10687,34121,17773,16348
2017/3/1,苗栗縣,銅鑼鄉,6160,18390,9768,8622
2017/3/1,苗栗縣,南庄鄉,3941,10337,5690,4647
2017/3/1,苗栗縣,頭屋鄉,3672,11040,5854,5186
2017/3/1,苗栗縣,三義鄉,5580,16753,8822,7931
2017/3/1,苗栗縣,西湖鄉,2661,7265,4034,3231
2017/3/1,苗栗縣,造橋鄉,4110,13099,6895,6204
2017/3/1,苗栗縣,三灣鄉,2403,6835,3735,3100
2017/3/1,苗栗縣,獅潭鄉,1720,4442,2494,1948
2017/3/1,苗栗縣,泰安鄉,1953,5900,3162,2738
2017/3/1,彰化縣,彰化市,76100,234442,115896,118546
2017/3/1,彰化縣,員林市,39026,124911,62063,62848
2017/3/1,彰化縣,鹿港鎮,24350,86751,44095,42656
2017/3/1,彰化縣,和美鎮,26589,91159,46507,44652
2017/3/1,彰化縣,北斗鎮,10620,33316,16826,16490
2017/3/1,彰化縣,溪湖鎮,16258,55704,28272,27432
2017/3/1,彰化縣,田中鎮,13100,42080,21702,20378
2017/3/1,彰化縣,二林鎮,14997,51422,26503,24919
2017/3/1,彰化縣,線西鄉,4377,16910,8717,8193
2017/3/1,彰化縣,伸港鄉,9866,36767,18779,17988
2017/3/1,彰化縣,福興鄉,12701,47421,24715,22706
2017/3/1,彰化縣,秀水鄉,10639,39365,20312,19053
2017/3/1,彰化縣,花壇鄉,14030,46103,23663,22440
2017/3/1,彰化縣,芬園鄉,6824,23809,12512,11297
2017/3/1,彰化縣,大村鄉,11054,36769,19026,17743
2017/3/1,彰化縣,埔鹽鄉,9027,32680,17176,15504
2017/3/1,彰化縣,埔心鄉,10497,34774,17931,16843
2017/3/1,彰化縣,永靖鄉,10934,37712,19545,18167
2017/3/1,彰化縣,社頭鄉,12851,43277,22248,21029
2017/3/1,彰化縣,二水鄉,5306,15438,8102,7336
2017/3/1,彰化縣,田尾鄉,7936,27510,14209,13301
2017/3/1,彰化縣,埤頭鄉,9006,30735,15959,14776
2017/3/1,彰化縣,芳苑鄉,10128,33925,17930,15995
2017/3/1,彰化縣,大城鄉,5286,17176,9291,7885
2017/3/1,彰化縣,竹塘鄉,4614,15418,8116,7302
2017/3/1,彰化縣,溪州鄉,8970,30311,15835,14476
2017/3/1,南投縣,南投市,34629,100797,50457,50340
2017/3/1,南投縣,埔里鎮,28990,81456,40690,40766
2017/3/1,南投縣,草屯鎮,33049,98330,49722,48608
2017/3/1,南投縣,竹山鎮,20072,55404,28433,26971
2017/3/1,南投縣,集集鎮,4293,10966,5703,5263
2017/3/1,南投縣,名間鄉,12616,39102,20584,18518
2017/3/1,南投縣,鹿谷鄉,7887,17938,9577,8361
2017/3/1,南投縣,中寮鄉,5625,14998,8154,6844
2017/3/1,南投縣,魚池鄉,5756,16099,8480,7619
2017/3/1,南投縣,國姓鄉,7285,18987,10271,8716
2017/3/1,南投縣,水里鄉,7156,17986,9441,8545
2017/3/1,南投縣,信義鄉,5246,16343,8751,7592
2017/3/1,南投縣,仁愛鄉,4917,15692,8102,7590
2017/3/1,雲林縣,斗六市,37958,108538,54067,54471
2017/3/1,雲林縣,斗南鎮,15826,45203,22990,22213
2017/3/1,雲林縣,虎尾鎮,24837,70915,35944,34971
2017/3/1,雲林縣,西螺鎮,14614,46498,23543,22955
2017/3/1,雲林縣,土庫鎮,9331,29182,15226,13956
2017/3/1,雲林縣,北港鎮,15915,40547,20979,19568
2017/3/1,雲林縣,古坑鄉,10976,31923,16844,15079
2017/3/1,雲林縣,大埤鄉,6698,19400,10420,8980
2017/3/1,雲林縣,莿桐鄉,9322,29053,15245,13808
2017/3/1,雲林縣,林內鄉,5976,18311,9554,8757
2017/3/1,雲林縣,二崙鄉,8921,27411,14679,12732
2017/3/1,雲林縣,崙背鄉,8512,24982,13224,11758
2017/3/1,雲林縣,麥寮鄉,14207,45129,22687,22442
2017/3/1,雲林縣,東勢鄉,5726,15045,8291,6754
2017/3/1,雲林縣,褒忠鄉,4450,13116,7070,6046
2017/3/1,雲林縣,臺西鄉,8712,24134,12927,11207
2017/3/1,雲林縣,元長鄉,9295,26266,14361,11905
2017/3/1,雲林縣,四湖鄉,8836,24004,13019,10985
2017/3/1,雲林縣,口湖鄉,9513,27955,14858,13097
2017/3/1,雲林縣,水林鄉,10010,25913,14190,11723
2017/3/1,嘉義縣,太保市,12732,37568,19295,18273
2017/3/1,嘉義縣,朴子市,15655,42594,21558,21036
2017/3/1,嘉義縣,布袋鎮,9987,27397,14003,13394
2017/3/1,嘉義縣,大林鎮,11363,31332,16040,15292
2017/3/1,嘉義縣,民雄鄉,24722,71845,36802,35043
2017/3/1,嘉義縣,溪口鄉,5365,14862,7946,6916
2017/3/1,嘉義縣,新港鄉,10633,32328,17018,15310
2017/3/1,嘉義縣,六腳鄉,8915,23606,12559,11047
2017/3/1,嘉義縣,東石鄉,9266,25162,13337,11825
2017/3/1,嘉義縣,義竹鄉,7441,18727,9731,8996
2017/3/1,嘉義縣,鹿草鄉,5767,15723,8432,7291
2017/3/1,嘉義縣,水上鄉,18052,49951,25794,24157
2017/3/1,嘉義縣,中埔鄉,15979,45265,23548,21717
2017/3/1,嘉義縣,竹崎鄉,11712,36142,19282,16860
2017/3/1,嘉義縣,梅山鄉,6764,19714,10486,9228
2017/3/1,嘉義縣,番路鄉,4273,11672,6305,5367
2017/3/1,嘉義縣,大埔鄉,1943,4589,2380,2209
2017/3/1,嘉義縣,阿里山鄉,1948,5657,2995,2662
2017/3/1,屏東縣,屏東市,74076,201347,99667,101680
2017/3/1,屏東縣,潮州鎮,19441,54696,27335,27361
2017/3/1,屏東縣,東港鎮,16670,48084,24320,23764
2017/3/1,屏東縣,恆春鎮,11527,30717,15746,14971
2017/3/1,屏東縣,萬丹鄉,14906,51142,26503,24639
2017/3/1,屏東縣,長治鄉,10107,30098,15651,14447
2017/3/1,屏東縣,麟洛鄉,3780,11119,5784,5335
2017/3/1,屏東縣,九如鄉,6955,22117,11443,10674
2017/3/1,屏東縣,里港鄉,8183,26861,13667,13194
2017/3/1,屏東縣,鹽埔鄉,7842,26124,13580,12544
2017/3/1,屏東縣,高樹鄉,9308,24807,13189,11618
2017/3/1,屏東縣,萬巒鄉,6500,20627,10785,9842
2017/3/1,屏東縣,內埔鄉,18582,55024,28452,26572
2017/3/1,屏東縣,竹田鄉,5639,17286,9170,8116
2017/3/1,屏東縣,新埤鄉,3422,9920,5270,4650
2017/3/1,屏東縣,枋寮鄉,8512,24763,12973,11790
2017/3/1,屏東縣,新園鄉,11804,35551,18441,17110
2017/3/1,屏東縣,崁頂鄉,4487,15913,8083,7830
2017/3/1,屏東縣,林邊鄉,6771,18237,9343,8894
2017/3/1,屏東縣,南州鄉,3712,10775,5515,5260
2017/3/1,屏東縣,佳冬鄉,6984,19620,10187,9433
2017/3/1,屏東縣,琉球鄉,4446,12399,6820,5579
2017/3/1,屏東縣,車城鄉,3464,8653,4663,3990
2017/3/1,屏東縣,滿州鄉,3016,7817,4263,3554
2017/3/1,屏東縣,枋山鄉,2116,5503,2939,2564
2017/3/1,屏東縣,三地門鄉,2310,7657,3864,3793
2017/3/1,屏東縣,霧臺鄉,1055,3281,1692,1589
2017/3/1,屏東縣,瑪家鄉,2052,6760,3442,3318
2017/3/1,屏東縣,泰武鄉,1331,5247,2758,2489
2017/3/1,屏東縣,來義鄉,2228,7495,3804,3691
2017/3/1,屏東縣,春日鄉,1376,4851,2498,2353
2017/3/1,屏東縣,獅子鄉,1553,4812,2491,2321
2017/3/1,屏東縣,牡丹鄉,1901,4888,2501,2387
2017/3/1,臺東縣,臺東市,39620,106357,53341,53016
2017/3/1,臺東縣,成功鎮,5404,14384,7599,6785
2017/3/1,臺東縣,關山鎮,3183,8803,4595,4208
2017/3/1,臺東縣,卑南鄉,6677,17442,9219,8223
2017/3/1,臺東縣,大武鄉,2500,6170,3214,2956
2017/3/1,臺東縣,太麻里鄉,4663,11228,5991,5237
2017/3/1,臺東縣,東河鄉,3771,8645,4783,3862
2017/3/1,臺東縣,長濱鄉,2920,7358,4168,3190
2017/3/1,臺東縣,鹿野鄉,3048,7991,4267,3724
2017/3/1,臺東縣,池上鄉,3222,8333,4341,3992
2017/3/1,臺東縣,綠島鄉,1111,3741,1956,1785
2017/3/1,臺東縣,延平鄉,1069,3529,1895,1634
2017/3/1,臺東縣,海端鄉,1090,4284,2285,1999
2017/3/1,臺東縣,達仁鄉,1448,3519,1915,1604
2017/3/1,臺東縣,金峰鄉,1123,3629,1857,1772
2017/3/1,臺東縣,蘭嶼鄉,1808,5052,2553,2499
2017/3/1,花蓮縣,花蓮市,41487,105031,50714,54317
2017/3/1,花蓮縣,鳳林鎮,4389,10965,5699,5266
2017/3/1,花蓮縣,玉里鎮,8900,24651,13116,11535
2017/3/1,花蓮縣,新城鄉,7681,20191,10399,9792
2017/3/1,花蓮縣,吉安鄉,31828,83722,42230,41492
2017/3/1,花蓮縣,壽豐鄉,7129,18087,9637,8450
2017/3/1,花蓮縣,光復鄉,5032,12979,6903,6076
2017/3/1,花蓮縣,豐濱鄉,1714,4423,2462,1961
2017/3/1,花蓮縣,瑞穗鄉,4733,11703,6328,5375
2017/3/1,花蓮縣,富里鄉,4008,10487,5701,4786
2017/3/1,花蓮縣,秀林鄉,4783,15772,8141,7631
2017/3/1,花蓮縣,萬榮鄉,2095,6398,3388,3010
2017/3/1,花蓮縣,卓溪鄉,1694,6075,3327,2748
2017/3/1,澎湖縣,馬公市,24129,61804,31418,30386
2017/3/1,澎湖縣,湖西鄉,5505,14444,7613,6831
2017/3/1,澎湖縣,白沙鄉,3378,9772,5129,4643
2017/3/1,澎湖縣,西嶼鄉,2981,8389,4318,4071
2017/3/1,澎湖縣,望安鄉,2026,5155,2772,2383
2017/3/1,澎湖縣,七美鄉,1366,3779,1967,1812
2017/3/1,基隆市,中正區,22557,52483,26824,25659
2017/3/1,基隆市,七堵區,21293,54016,27193,26823
2017/3/1,基隆市,暖暖區,15570,38509,19365,19144
2017/3/1,基隆市,仁愛區,19264,44884,22193,22691
2017/3/1,基隆市,中山區,19222,47956,24326,23630
2017/3/1,基隆市,安樂區,33131,82257,40753,41504
2017/3/1,基隆市,信義區,21079,51868,25728,26140
2017/3/1,新竹市,東區,78231,210690,103735,106955
2017/3/1,新竹市,北區,56002,150147,73501,76646
2017/3/1,新竹市,香山區,26811,77485,39380,38105
2017/3/1,嘉義市,東區,45392,122459,59121,63338
2017/3/1,嘉義市,西區,53689,147479,72269,75210
2017/3/1,金門縣,金城鎮,12793,42824,21391,21433
2017/3/1,金門縣,金湖鎮,8769,28840,14520,14320
2017/3/1,金門縣,金沙鎮,6266,20364,10075,10289
2017/3/1,金門縣,金寧鄉,8346,30068,15146,14922
2017/3/1,金門縣,烈嶼鄉,3100,12567,6171,6396
2017/3/1,金門縣,烏坵鄉,133,679,340,339
2017/3/1,連江縣,南竿鄉,1570,7413,4162,3251
2017/3/1,連江縣,北竿鄉,536,2364,1318,1046
2017/3/1,連江縣,莒光鄉,284,1588,959,629
2017/3/1,連江縣,東引鄉,327,1313,786,527
2017/4/1,總計,新北市,1530739,3980867,1952123,2028744
2017/4/1,總計,臺北市,1048379,2692118,1287277,1404841
2017/4/1,總計,桃園市,776323,2160035,1077025,1083010
2017/4/1,總計,臺中市,948711,2773527,1368815,1404712
2017/4/1,總計,臺南市,679754,1886636,942889,943747
2017/4/1,總計,高雄市,1085256,2778734,1377883,1400851
2017/4/1,總計,臺灣省,2473353,7127404,3636713,3490691
2017/4/1,總計,宜蘭縣,167293,457093,231436,225657
2017/4/1,總計,新竹縣,188457,548660,280557,268103
2017/4/1,總計,苗栗縣,186305,557225,287459,269766
2017/4/1,總計,彰化縣,385162,1285450,655657,629793
2017/4/1,總計,南投縣,177549,503862,258271,245591
2017/4/1,總計,雲林縣,239682,693209,359927,333282
2017/4/1,總計,嘉義縣,182596,513772,267350,246422
2017/4/1,總計,屏東縣,286144,833602,426564,407038
2017/4/1,總計,臺東縣,82665,220244,113874,106370
2017/4/1,總計,花蓮縣,125523,330343,167947,162396
2017/4/1,總計,澎湖縣,39431,103385,53264,50121
2017/4/1,總計,基隆市,152202,372086,186370,185716
2017/4/1,總計,新竹市,161174,438524,216669,221855
2017/4/1,總計,嘉義市,99170,269949,131368,138581
2017/4/1,總計,福建省,42187,148127,74908,73219
2017/4/1,總計,金門縣,39448,135440,67674,67766
2017/4/1,總計,連江縣,2739,12687,7234,5453
2017/4/1,新北市,板橋區,207151,552223,269783,282440
2017/4/1,新北市,三重區,150293,388174,191198,196976
2017/4/1,新北市,中和區,164301,413520,201307,212213
2017/4/1,新北市,永和區,90914,223953,106397,117556
2017/4/1,新北市,新莊區,151364,414819,202619,212200
2017/4/1,新北市,新店區,125529,301207,145082,156125
2017/4/1,新北市,樹林區,66190,184412,92017,92395
2017/4/1,新北市,鶯歌區,29654,87005,43615,43390
2017/4/1,新北市,三峽區,42122,114403,57390,57013
2017/4/1,新北市,淡水區,73052,166767,80142,86625
2017/4/1,新北市,汐止區,86182,198201,96764,101437
2017/4/1,新北市,瑞芳區,16170,40544,20490,20054
2017/4/1,新北市,土城區,86741,238519,117757,120762
2017/4/1,新北市,蘆洲區,70487,201091,98870,102221
2017/4/1,新北市,五股區,30876,84270,42536,41734
2017/4/1,新北市,泰山區,28290,78924,39216,39708
2017/4/1,新北市,林口區,40958,104048,50690,53358
2017/4/1,新北市,深坑區,9551,23682,11844,11838
2017/4/1,新北市,石碇區,3360,7691,4227,3464
2017/4/1,新北市,坪林區,2512,6543,3637,2906
2017/4/1,新北市,三芝區,9428,23288,11950,11338
2017/4/1,新北市,石門區,4296,12417,6418,5999
2017/4/1,新北市,八里區,14370,38108,19007,19101
2017/4/1,新北市,平溪區,2322,4744,2626,2118
2017/4/1,新北市,雙溪區,3812,9028,4876,4152
2017/4/1,新北市,貢寮區,4412,12637,6435,6202
2017/4/1,新北市,金山區,7071,22104,10921,11183
2017/4/1,新北市,萬里區,7469,22326,11235,11091
2017/4/1,新北市,烏來區,1862,6219,3074,3145
2017/4/1,臺北市,松山區,80441,208152,97811,110341
2017/4/1,臺北市,信義區,89420,226823,108424,118399
2017/4/1,臺北市,大安區,120543,311185,145500,165685
2017/4/1,臺北市,中山區,99751,231139,107768,123371
2017/4/1,臺北市,中正區,65177,160789,76733,84056
2017/4/1,臺北市,大同區,51687,129761,63298,66463
2017/4/1,臺北市,萬華區,78581,192817,94770,98047
2017/4/1,臺北市,文山區,105137,274910,132013,142897
2017/4/1,臺北市,南港區,46814,122268,59790,62478
2017/4/1,臺北市,內湖區,107398,287760,137591,150169
2017/4/1,臺北市,士林區,106882,289482,139620,149862
2017/4/1,臺北市,北投區,96548,257032,123959,133073
2017/4/1,桃園市,桃園區,163895,436740,212232,224508
2017/4/1,桃園市,中壢區,146262,399060,196881,202179
2017/4/1,桃園市,大溪區,31979,94213,48098,46115
2017/4/1,桃園市,楊梅區,56731,164891,83212,81679
2017/4/1,桃園市,蘆竹區,57216,159618,79385,80233
2017/4/1,桃園市,大園區,32035,87835,44951,42884
2017/4/1,桃園市,龜山區,59833,154313,77058,77255
2017/4/1,桃園市,八德區,68857,194239,97415,96824
2017/4/1,桃園市,龍潭區,41257,120685,60595,60090
2017/4/1,桃園市,平鎮區,76150,222647,110794,111853
2017/4/1,桃園市,新屋區,16064,48733,25957,22776
2017/4/1,桃園市,觀音區,22280,65786,34315,31471
2017/4/1,桃園市,復興區,3764,11275,6132,5143
2017/4/1,臺中市,中區,7969,18741,9313,9428
2017/4/1,臺中市,東區,27679,75543,37671,37872
2017/4/1,臺中市,南區,47752,123807,59541,64266
2017/4/1,臺中市,西區,45623,115893,55056,60837
2017/4/1,臺中市,北區,59124,147730,70742,76988
2017/4/1,臺中市,西屯區,84803,225525,108473,117052
2017/4/1,臺中市,南屯區,61183,167153,79968,87185
2017/4/1,臺中市,北屯區,98486,271883,130632,141251
2017/4/1,臺中市,豐原區,53298,166822,82501,84321
2017/4/1,臺中市,東勢區,17386,50870,26184,24686
2017/4/1,臺中市,大甲區,22952,77737,39130,38607
2017/4/1,臺中市,清水區,26983,86427,44352,42075
2017/4/1,臺中市,沙鹿區,29019,91827,46380,45447
2017/4/1,臺中市,梧棲區,17579,57757,29025,28732
2017/4/1,臺中市,后里區,16040,54325,27621,26704
2017/4/1,臺中市,神岡區,19353,65582,33484,32098
2017/4/1,臺中市,潭子區,36046,107703,53264,54439
2017/4/1,臺中市,大雅區,29270,94779,47327,47452
2017/4/1,臺中市,新社區,7547,24850,12887,11963
2017/4/1,臺中市,石岡區,4901,15127,7852,7275
2017/4/1,臺中市,外埔區,9641,31993,16430,15563
2017/4/1,臺中市,大安區,5456,19388,10246,9142
2017/4/1,臺中市,烏日區,24168,73957,37174,36783
2017/4/1,臺中市,大肚區,17503,57276,29233,28043
2017/4/1,臺中市,龍井區,22801,77163,38918,38245
2017/4/1,臺中市,霧峰區,20049,65016,33026,31990
2017/4/1,臺中市,太平區,62573,186936,92770,94166
2017/4/1,臺中市,大里區,68999,210887,103773,107114
2017/4/1,臺中市,和平區,4528,10830,5842,4988
2017/4/1,臺南市,新營區,28924,78188,38697,39491
2017/4/1,臺南市,鹽水區,10069,25755,13448,12307
2017/4/1,臺南市,白河區,10836,28709,15002,13707
2017/4/1,臺南市,柳營區,7884,21397,11166,10231
2017/4/1,臺南市,後壁區,8881,23955,12464,11491
2017/4/1,臺南市,東山區,8399,21210,11257,9953
2017/4/1,臺南市,麻豆區,15763,44786,22748,22038
2017/4/1,臺南市,下營區,9104,24411,12589,11822
2017/4/1,臺南市,六甲區,7726,22393,11588,10805
2017/4/1,臺南市,官田區,7913,21490,10952,10538
2017/4/1,臺南市,大內區,3898,9912,5296,4616
2017/4/1,臺南市,佳里區,20561,59499,29508,29991
2017/4/1,臺南市,學甲區,9663,26259,13427,12832
2017/4/1,臺南市,西港區,8170,24827,12566,12261
2017/4/1,臺南市,七股區,8046,23126,11961,11165
2017/4/1,臺南市,將軍區,7300,19961,10148,9813
2017/4/1,臺南市,北門區,4270,11249,5709,5540
2017/4/1,臺南市,新化區,14366,43698,22258,21440
2017/4/1,臺南市,善化區,17362,47853,24104,23749
2017/4/1,臺南市,新市區,12105,36333,18231,18102
2017/4/1,臺南市,安定區,10010,30462,15639,14823
2017/4/1,臺南市,山上區,2694,7335,3849,3486
2017/4/1,臺南市,玉井區,5129,14233,7373,6860
2017/4/1,臺南市,楠西區,3518,9825,5199,4626
2017/4/1,臺南市,南化區,2872,8811,4760,4051
2017/4/1,臺南市,左鎮區,1977,4929,2769,2160
2017/4/1,臺南市,仁德區,27437,74999,38054,36945
2017/4/1,臺南市,歸仁區,22605,68336,34732,33604
2017/4/1,臺南市,關廟區,11081,34527,17822,16705
2017/4/1,臺南市,龍崎區,1546,4082,2183,1899
2017/4/1,臺南市,永康區,83328,232795,114805,117990
2017/4/1,臺南市,東區,71921,187885,90156,97729
2017/4/1,臺南市,南區,45410,125759,62347,63412
2017/4/1,臺南市,北區,50591,132899,64701,68198
2017/4/1,臺南市,安南區,62305,191603,96630,94973
2017/4/1,臺南市,安平區,25277,65929,31288,34641
2017/4/1,臺南市,中西區,30813,77216,37463,39753
2017/4/1,高雄市,鹽埕區,10810,24528,12147,12381
2017/4/1,高雄市,鼓山區,57444,138394,66900,71494
2017/4/1,高雄市,左營區,78541,197101,94952,102149
2017/4/1,高雄市,楠梓區,69327,182413,89726,92687
2017/4/1,高雄市,三民區,136407,345015,167080,177935
2017/4/1,高雄市,新興區,22659,51197,24641,26556
2017/4/1,高雄市,前金區,12593,27181,13034,14147
2017/4/1,高雄市,苓雅區,72172,172309,83072,89237
2017/4/1,高雄市,前鎮區,78635,190865,93865,97000
2017/4/1,高雄市,旗津區,11117,28807,14903,13904
2017/4/1,高雄市,小港區,67565,157188,78094,79094
2017/4/1,高雄市,鳳山區,139311,358133,175757,182376
2017/4/1,高雄市,林園區,25756,70082,35513,34569
2017/4/1,高雄市,大寮區,41985,112286,57527,54759
2017/4/1,高雄市,大樹區,13574,42936,22023,20913
2017/4/1,高雄市,大社區,12861,34528,17538,16990
2017/4/1,高雄市,仁武區,32333,84514,42950,41564
2017/4/1,高雄市,鳥松區,18140,44270,22466,21804
2017/4/1,高雄市,岡山區,34903,97592,48482,49110
2017/4/1,高雄市,橋頭區,13518,37536,19065,18471
2017/4/1,高雄市,燕巢區,10468,29878,15780,14098
2017/4/1,高雄市,田寮區,3293,7286,4032,3254
2017/4/1,高雄市,阿蓮區,9421,29017,14654,14363
2017/4/1,高雄市,路竹區,17006,52928,27021,25907
2017/4/1,高雄市,湖內區,10743,29788,15193,14595
2017/4/1,高雄市,茄萣區,10497,30335,15651,14684
2017/4/1,高雄市,永安區,5748,13986,7039,6947
2017/4/1,高雄市,彌陀區,6783,19502,10029,9473
2017/4/1,高雄市,梓官區,12608,36191,18620,17571
2017/4/1,高雄市,旗山區,13783,37248,19273,17975
2017/4/1,高雄市,美濃區,14686,40336,21157,19179
2017/4/1,高雄市,六龜區,5567,13164,7079,6085
2017/4/1,高雄市,甲仙區,2339,6166,3292,2874
2017/4/1,高雄市,杉林區,4795,12144,6633,5511
2017/4/1,高雄市,內門區,5107,14647,7937,6710
2017/4/1,高雄市,茂林區,587,1906,948,958
2017/4/1,高雄市,桃源區,1325,4234,2208,2026
2017/4/1,高雄市,那瑪夏區,849,3103,1602,1501
2017/4/1,宜蘭縣,宜蘭市,36034,95925,46845,49080
2017/4/1,宜蘭縣,羅東鎮,26321,72504,34362,38142
2017/4/1,宜蘭縣,蘇澳鎮,14139,40372,20562,19810
2017/4/1,宜蘭縣,頭城鎮,10230,29586,15234,14352
2017/4/1,宜蘭縣,礁溪鄉,13914,35820,18658,17162
2017/4/1,宜蘭縣,壯圍鄉,8749,24201,12832,11369
2017/4/1,宜蘭縣,員山鄉,11685,32352,17141,15211
2017/4/1,宜蘭縣,冬山鄉,19158,53342,27369,25973
2017/4/1,宜蘭縣,五結鄉,14749,39635,20514,19121
2017/4/1,宜蘭縣,三星鄉,8497,21403,11537,9866
2017/4/1,宜蘭縣,大同鄉,1886,6090,3306,2784
2017/4/1,宜蘭縣,南澳鄉,1931,5863,3076,2787
2017/4/1,新竹縣,竹北市,63858,178091,88702,89389
2017/4/1,新竹縣,關西鎮,9516,29233,15648,13585
2017/4/1,新竹縣,新埔鎮,10712,33612,17907,15705
2017/4/1,新竹縣,竹東鎮,33623,96928,48703,48225
2017/4/1,新竹縣,湖口鄉,26305,77424,39258,38166
2017/4/1,新竹縣,橫山鄉,4470,13249,7181,6068
2017/4/1,新竹縣,新豐鄉,18251,56609,29075,27534
2017/4/1,新竹縣,芎林鄉,6500,20053,10638,9415
2017/4/1,新竹縣,寶山鄉,5415,14418,7782,6636
2017/4/1,新竹縣,北埔鄉,3124,9495,5152,4343
2017/4/1,新竹縣,峨眉鄉,2080,5563,3077,2486
2017/4/1,新竹縣,尖石鄉,2852,9430,4981,4449
2017/4/1,新竹縣,五峰鄉,1751,4555,2453,2102
2017/4/1,苗栗縣,苗栗市,31070,89603,44767,44836
2017/4/1,苗栗縣,頭份市,34160,103134,52049,51085
2017/4/1,苗栗縣,苑裡鎮,14587,46650,24293,22357
2017/4/1,苗栗縣,通霄鎮,11570,35186,18581,16605
2017/4/1,苗栗縣,竹南鎮,28709,85128,42954,42174
2017/4/1,苗栗縣,後龍鎮,11911,37138,19606,17532
2017/4/1,苗栗縣,卓蘭鎮,6057,17412,9112,8300
2017/4/1,苗栗縣,大湖鄉,5384,14948,7945,7003
2017/4/1,苗栗縣,公館鄉,10686,34103,17759,16344
2017/4/1,苗栗縣,銅鑼鄉,6146,18367,9755,8612
2017/4/1,苗栗縣,南庄鄉,3945,10318,5682,4636
2017/4/1,苗栗縣,頭屋鄉,3658,11015,5842,5173
2017/4/1,苗栗縣,三義鄉,5586,16741,8826,7915
2017/4/1,苗栗縣,西湖鄉,2661,7256,4031,3225
2017/4/1,苗栗縣,造橋鄉,4104,13089,6897,6192
2017/4/1,苗栗縣,三灣鄉,2402,6826,3728,3098
2017/4/1,苗栗縣,獅潭鄉,1714,4432,2484,1948
2017/4/1,苗栗縣,泰安鄉,1955,5879,3148,2731
2017/4/1,彰化縣,彰化市,76085,234319,115832,118487
2017/4/1,彰化縣,員林市,39025,124867,62036,62831
2017/4/1,彰化縣,鹿港鎮,24353,86692,44068,42624
2017/4/1,彰化縣,和美鎮,26594,91179,46502,44677
2017/4/1,彰化縣,北斗鎮,10637,33341,16826,16515
2017/4/1,彰化縣,溪湖鎮,16277,55734,28299,27435
2017/4/1,彰化縣,田中鎮,13096,42068,21686,20382
2017/4/1,彰化縣,二林鎮,14995,51365,26467,24898
2017/4/1,彰化縣,線西鄉,4381,16894,8704,8190
2017/4/1,彰化縣,伸港鄉,9875,36774,18779,17995
2017/4/1,彰化縣,福興鄉,12716,47400,24708,22692
2017/4/1,彰化縣,秀水鄉,10648,39361,20313,19048
2017/4/1,彰化縣,花壇鄉,14034,46078,23638,22440
2017/4/1,彰化縣,芬園鄉,6824,23780,12494,11286
2017/4/1,彰化縣,大村鄉,11065,36826,19050,17776
2017/4/1,彰化縣,埔鹽鄉,9020,32668,17169,15499
2017/4/1,彰化縣,埔心鄉,10505,34768,17929,16839
2017/4/1,彰化縣,永靖鄉,10936,37672,19519,18153
2017/4/1,彰化縣,社頭鄉,12858,43287,22253,21034
2017/4/1,彰化縣,二水鄉,5303,15422,8092,7330
2017/4/1,彰化縣,田尾鄉,7942,27510,14219,13291
2017/4/1,彰化縣,埤頭鄉,9011,30698,15944,14754
2017/4/1,彰化縣,芳苑鄉,10131,33925,17924,16001
2017/4/1,彰化縣,大城鄉,5278,17166,9271,7895
2017/4/1,彰化縣,竹塘鄉,4608,15404,8116,7288
2017/4/1,彰化縣,溪州鄉,8965,30252,15819,14433
2017/4/1,南投縣,南投市,34624,100793,50458,50335
2017/4/1,南投縣,埔里鎮,28993,81427,40672,40755
2017/4/1,南投縣,草屯鎮,33054,98282,49700,48582
2017/4/1,南投縣,竹山鎮,20080,55419,28451,26968
2017/4/1,南投縣,集集鎮,4291,10959,5698,5261
2017/4/1,南投縣,名間鄉,12624,39039,20564,18475
2017/4/1,南投縣,鹿谷鄉,7889,17896,9558,8338
2017/4/1,南投縣,中寮鄉,5625,15005,8156,6849
2017/4/1,南投縣,魚池鄉,5759,16079,8474,7605
2017/4/1,南投縣,國姓鄉,7290,18965,10263,8702
2017/4/1,南投縣,水里鄉,7151,17968,9426,8542
2017/4/1,南投縣,信義鄉,5256,16334,8752,7582
2017/4/1,南投縣,仁愛鄉,4913,15696,8099,7597
2017/4/1,雲林縣,斗六市,37962,108532,54046,54486
2017/4/1,雲林縣,斗南鎮,15828,45198,22983,22215
2017/4/1,雲林縣,虎尾鎮,24859,70925,35933,34992
2017/4/1,雲林縣,西螺鎮,14624,46494,23542,22952
2017/4/1,雲林縣,土庫鎮,9340,29170,15230,13940
2017/4/1,雲林縣,北港鎮,15910,40556,20989,19567
2017/4/1,雲林縣,古坑鄉,10971,31884,16821,15063
2017/4/1,雲林縣,大埤鄉,6700,19387,10402,8985
2017/4/1,雲林縣,莿桐鄉,9333,29026,15228,13798
2017/4/1,雲林縣,林內鄉,5981,18372,9602,8770
2017/4/1,雲林縣,二崙鄉,8929,27387,14668,12719
2017/4/1,雲林縣,崙背鄉,8512,24948,13203,11745
2017/4/1,雲林縣,麥寮鄉,14222,45117,22679,22438
2017/4/1,雲林縣,東勢鄉,5729,15038,8289,6749
2017/4/1,雲林縣,褒忠鄉,4445,13103,7060,6043
2017/4/1,雲林縣,臺西鄉,8707,24096,12910,11186
2017/4/1,雲林縣,元長鄉,9292,26233,14345,11888
2017/4/1,雲林縣,四湖鄉,8823,23948,12993,10955
2017/4/1,雲林縣,口湖鄉,9512,27929,14843,13086
2017/4/1,雲林縣,水林鄉,10003,25866,14161,11705
2017/4/1,嘉義縣,太保市,12753,37586,19309,18277
2017/4/1,嘉義縣,朴子市,15671,42587,21558,21029
2017/4/1,嘉義縣,布袋鎮,9984,27374,13978,13396
2017/4/1,嘉義縣,大林鎮,11381,31329,16031,15298
2017/4/1,嘉義縣,民雄鄉,24734,71798,36793,35005
2017/4/1,嘉義縣,溪口鄉,5367,14860,7949,6911
2017/4/1,嘉義縣,新港鄉,10629,32302,17007,15295
2017/4/1,嘉義縣,六腳鄉,8916,23563,12526,11037
2017/4/1,嘉義縣,東石鄉,9262,25125,13317,11808
2017/4/1,嘉義縣,義竹鄉,7445,18697,9721,8976
2017/4/1,嘉義縣,鹿草鄉,5770,15692,8425,7267
2017/4/1,嘉義縣,水上鄉,18059,49915,25773,24142
2017/4/1,嘉義縣,中埔鄉,15987,45234,23538,21696
2017/4/1,嘉義縣,竹崎鄉,11716,36131,19271,16860
2017/4/1,嘉義縣,梅山鄉,6769,19689,10482,9207
2017/4/1,嘉義縣,番路鄉,4265,11668,6308,5360
2017/4/1,嘉義縣,大埔鄉,1945,4581,2377,2204
2017/4/1,嘉義縣,阿里山鄉,1943,5641,2987,2654
2017/4/1,屏東縣,屏東市,74081,201228,99581,101647
2017/4/1,屏東縣,潮州鎮,19442,54706,27334,27372
2017/4/1,屏東縣,東港鎮,16681,48059,24300,23759
2017/4/1,屏東縣,恆春鎮,11534,30682,15741,14941
2017/4/1,屏東縣,萬丹鄉,14924,51103,26501,24602
2017/4/1,屏東縣,長治鄉,10117,30054,15638,14416
2017/4/1,屏東縣,麟洛鄉,3790,11128,5782,5346
2017/4/1,屏東縣,九如鄉,6960,22109,11442,10667
2017/4/1,屏東縣,里港鄉,8184,26820,13644,13176
2017/4/1,屏東縣,鹽埔鄉,7848,26110,13581,12529
2017/4/1,屏東縣,高樹鄉,9311,24772,13172,11600
2017/4/1,屏東縣,萬巒鄉,6505,20630,10787,9843
2017/4/1,屏東縣,內埔鄉,18590,54991,28441,26550
2017/4/1,屏東縣,竹田鄉,5642,17282,9174,8108
2017/4/1,屏東縣,新埤鄉,3417,9904,5260,4644
2017/4/1,屏東縣,枋寮鄉,8519,24774,12980,11794
2017/4/1,屏東縣,新園鄉,11807,35520,18439,17081
2017/4/1,屏東縣,崁頂鄉,4487,15875,8061,7814
2017/4/1,屏東縣,林邊鄉,6757,18194,9324,8870
2017/4/1,屏東縣,南州鄉,3711,10759,5513,5246
2017/4/1,屏東縣,佳冬鄉,6981,19598,10177,9421
2017/4/1,屏東縣,琉球鄉,4452,12391,6815,5576
2017/4/1,屏東縣,車城鄉,3464,8637,4654,3983
2017/4/1,屏東縣,滿州鄉,3016,7818,4257,3561
2017/4/1,屏東縣,枋山鄉,2117,5499,2933,2566
2017/4/1,屏東縣,三地門鄉,2306,7653,3861,3792
2017/4/1,屏東縣,霧臺鄉,1051,3266,1678,1588
2017/4/1,屏東縣,瑪家鄉,2052,6757,3440,3317
2017/4/1,屏東縣,泰武鄉,1329,5243,2755,2488
2017/4/1,屏東縣,來義鄉,2229,7485,3801,3684
2017/4/1,屏東縣,春日鄉,1383,4856,2499,2357
2017/4/1,屏東縣,獅子鄉,1551,4804,2491,2313
2017/4/1,屏東縣,牡丹鄉,1906,4895,2508,2387
2017/4/1,臺東縣,臺東市,39635,106338,53317,53021
2017/4/1,臺東縣,成功鎮,5408,14354,7585,6769
2017/4/1,臺東縣,關山鎮,3181,8786,4581,4205
2017/4/1,臺東縣,卑南鄉,6681,17423,9214,8209
2017/4/1,臺東縣,大武鄉,2496,6154,3206,2948
2017/4/1,臺東縣,太麻里鄉,4659,11206,5985,5221
2017/4/1,臺東縣,東河鄉,3760,8604,4764,3840
2017/4/1,臺東縣,長濱鄉,2921,7332,4150,3182
2017/4/1,臺東縣,鹿野鄉,3043,7983,4274,3709
2017/4/1,臺東縣,池上鄉,3218,8309,4325,3984
2017/4/1,臺東縣,綠島鄉,1116,3764,1974,1790
2017/4/1,臺東縣,延平鄉,1071,3521,1889,1632
2017/4/1,臺東縣,海端鄉,1089,4269,2278,1991
2017/4/1,臺東縣,達仁鄉,1450,3526,1920,1606
2017/4/1,臺東縣,金峰鄉,1123,3639,1860,1779
2017/4/1,臺東縣,蘭嶼鄉,1814,5036,2552,2484
2017/4/1,花蓮縣,花蓮市,41512,105012,50709,54303
2017/4/1,花蓮縣,鳳林鎮,4389,10968,5695,5273
2017/4/1,花蓮縣,玉里鎮,8894,24621,13094,11527
2017/4/1,花蓮縣,新城鄉,7690,20165,10382,9783
2017/4/1,花蓮縣,吉安鄉,31840,83725,42220,41505
2017/4/1,花蓮縣,壽豐鄉,7135,18090,9632,8458
2017/4/1,花蓮縣,光復鄉,5031,12965,6896,6069
2017/4/1,花蓮縣,豐濱鄉,1714,4418,2457,1961
2017/4/1,花蓮縣,瑞穗鄉,4729,11691,6319,5372
2017/4/1,花蓮縣,富里鄉,4014,10481,5702,4779
2017/4/1,花蓮縣,秀林鄉,4787,15766,8136,7630
2017/4/1,花蓮縣,萬榮鄉,2095,6383,3385,2998
2017/4/1,花蓮縣,卓溪鄉,1693,6058,3320,2738
2017/4/1,澎湖縣,馬公市,24156,61833,31455,30378
2017/4/1,澎湖縣,湖西鄉,5511,14446,7610,6836
2017/4/1,澎湖縣,白沙鄉,3377,9771,5126,4645
2017/4/1,澎湖縣,西嶼鄉,2984,8376,4312,4064
2017/4/1,澎湖縣,望安鄉,2031,5167,2784,2383
2017/4/1,澎湖縣,七美鄉,1372,3792,1977,1815
2017/4/1,基隆市,中正區,22561,52462,26808,25654
2017/4/1,基隆市,七堵區,21311,54067,27197,26870
2017/4/1,基隆市,暖暖區,15573,38550,19375,19175
2017/4/1,基隆市,仁愛區,19249,44833,22168,22665
2017/4/1,基隆市,中山區,19238,47983,24333,23650
2017/4/1,基隆市,安樂區,33183,82323,40781,41542
2017/4/1,基隆市,信義區,21087,51868,25708,26160
2017/4/1,新竹市,東區,78286,210861,103784,107077
2017/4/1,新竹市,北區,56028,150135,73492,76643
2017/4/1,新竹市,香山區,26860,77528,39393,38135
2017/4/1,嘉義市,東區,45411,122468,59093,63375
2017/4/1,嘉義市,西區,53759,147481,72275,75206
2017/4/1,金門縣,金城鎮,12796,42859,21398,21461
2017/4/1,金門縣,金湖鎮,8791,28865,14537,14328
2017/4/1,金門縣,金沙鎮,6271,20364,10076,10288
2017/4/1,金門縣,金寧鄉,8353,30104,15152,14952
2017/4/1,金門縣,烈嶼鄉,3103,12567,6169,6398
2017/4/1,金門縣,烏坵鄉,134,681,342,339
2017/4/1,連江縣,南竿鄉,1585,7436,4182,3254
2017/4/1,連江縣,北竿鄉,538,2358,1311,1047
2017/4/1,連江縣,莒光鄉,286,1582,956,626
2017/4/1,連江縣,東引鄉,330,1311,785,526
2017/5/1,總計,新北市,1532655,3982268,1952622,2029646
2017/5/1,總計,臺北市,1049017,2690813,1286421,1404392
2017/5/1,總計,桃園市,778005,2163728,1078692,1085036
2017/5/1,總計,臺中市,950068,2775294,1369447,1405847
2017/5/1,總計,臺南市,680185,1886473,942732,943741
2017/5/1,總計,高雄市,1086107,2778415,1377619,1400796
2017/5/1,總計,臺灣省,2475489,7124855,3635207,3489648
2017/5/1,總計,宜蘭縣,167530,457133,231363,225770
2017/5/1,總計,新竹縣,188914,549118,280780,268338
2017/5/1,總計,苗栗縣,186561,556638,287162,269476
2017/5/1,總計,彰化縣,385396,1284785,655305,629480
2017/5/1,總計,南投縣,177652,503575,258110,245465
2017/5/1,總計,雲林縣,239791,692818,359686,333132
2017/5/1,總計,嘉義縣,182645,513393,267174,246219
2017/5/1,總計,屏東縣,286249,832994,426261,406733
2017/5/1,總計,臺東縣,82705,220191,113818,106373
2017/5/1,總計,花蓮縣,125589,330139,167816,162323
2017/5/1,總計,澎湖縣,39429,103434,53291,50143
2017/5/1,總計,基隆市,152333,371981,186309,185672
2017/5/1,總計,新竹市,161520,438863,216853,222010
2017/5/1,總計,嘉義市,99175,269793,131279,138514
2017/5/1,總計,福建省,42268,148231,74943,73288
2017/5/1,總計,金門縣,39514,135535,67706,67829
2017/5/1,總計,連江縣,2754,12696,7237,5459
2017/5/1,新北市,板橋區,207343,552250,269784,282466
2017/5/1,新北市,三重區,150407,388087,191163,196924
2017/5/1,新北市,中和區,164445,413616,201312,212304
2017/5/1,新北市,永和區,90922,223845,106341,117504
2017/5/1,新北市,新莊區,151622,415031,202685,212346
2017/5/1,新北市,新店區,125722,301381,145181,156200
2017/5/1,新北市,樹林區,66265,184477,92066,92411
2017/5/1,新北市,鶯歌區,29679,87001,43623,43378
2017/5/1,新北市,三峽區,42134,114362,57355,57007
2017/5/1,新北市,淡水區,73337,167283,80381,86902
2017/5/1,新北市,汐止區,86345,198421,96871,101550
2017/5/1,新北市,瑞芳區,16155,40523,20467,20056
2017/5/1,新北市,土城區,86758,238455,117722,120733
2017/5/1,新北市,蘆洲區,70607,201196,98895,102301
2017/5/1,新北市,五股區,30945,84326,42580,41746
2017/5/1,新北市,泰山區,28326,78919,39175,39744
2017/5/1,新北市,林口區,41107,104403,50831,53572
2017/5/1,新北市,深坑區,9566,23676,11838,11838
2017/5/1,新北市,石碇區,3363,7684,4226,3458
2017/5/1,新北市,坪林區,2513,6539,3636,2903
2017/5/1,新北市,三芝區,9454,23330,11964,11366
2017/5/1,新北市,石門區,4295,12387,6400,5987
2017/5/1,新北市,八里區,14378,38105,18997,19108
2017/5/1,新北市,平溪區,2323,4745,2625,2120
2017/5/1,新北市,雙溪區,3810,9013,4871,4142
2017/5/1,新北市,貢寮區,4409,12602,6420,6182
2017/5/1,新北市,金山區,7076,22070,10904,11166
2017/5/1,新北市,萬里區,7486,22348,11248,11100
2017/5/1,新北市,烏來區,1863,6193,3061,3132
2017/5/1,臺北市,松山區,80479,208017,97731,110286
2017/5/1,臺北市,信義區,89416,226612,108286,118326
2017/5/1,臺北市,大安區,120628,311147,145461,165686
2017/5/1,臺北市,中山區,99855,231068,107678,123390
2017/5/1,臺北市,中正區,65210,160703,76706,83997
2017/5/1,臺北市,大同區,51724,129738,63295,66443
2017/5/1,臺北市,萬華區,78627,192656,94671,97985
2017/5/1,臺北市,文山區,105178,274800,131924,142876
2017/5/1,臺北市,南港區,46850,122200,59769,62431
2017/5/1,臺北市,內湖區,107522,287837,137597,150240
2017/5/1,臺北市,士林區,106923,289279,139491,149788
2017/5/1,臺北市,北投區,96605,256756,123812,132944
2017/5/1,桃園市,桃園區,164149,437449,212536,224913
2017/5/1,桃園市,中壢區,146634,399859,197302,202557
2017/5/1,桃園市,大溪區,32008,94241,48097,46144
2017/5/1,桃園市,楊梅區,56867,165243,83382,81861
2017/5/1,桃園市,蘆竹區,57328,159945,79532,80413
2017/5/1,桃園市,大園區,32157,88067,45050,43017
2017/5/1,桃園市,龜山區,59997,154648,77214,77434
2017/5/1,桃園市,八德區,69101,194680,97600,97080
2017/5/1,桃園市,龍潭區,41277,120825,60650,60175
2017/5/1,桃園市,平鎮區,76296,222877,110872,112005
2017/5/1,桃園市,新屋區,16093,48744,25972,22772
2017/5/1,桃園市,觀音區,22332,65853,34343,31510
2017/5/1,桃園市,復興區,3766,11297,6142,5155
2017/5/1,臺中市,中區,7951,18668,9271,9397
2017/5/1,臺中市,東區,27695,75582,37666,37916
2017/5/1,臺中市,南區,47805,123930,59581,64349
2017/5/1,臺中市,西區,45629,115876,55064,60812
2017/5/1,臺中市,北區,59130,147674,70717,76957
2017/5/1,臺中市,西屯區,84924,225673,108520,117153
2017/5/1,臺中市,南屯區,61348,167493,80117,87376
2017/5/1,臺中市,北屯區,98749,272269,130769,141500
2017/5/1,臺中市,豐原區,53351,166864,82488,84376
2017/5/1,臺中市,東勢區,17400,50875,26171,24704
2017/5/1,臺中市,大甲區,22964,77724,39113,38611
2017/5/1,臺中市,清水區,27003,86440,44357,42083
2017/5/1,臺中市,沙鹿區,29087,91920,46415,45505
2017/5/1,臺中市,梧棲區,17606,57766,29020,28746
2017/5/1,臺中市,后里區,16095,54351,27624,26727
2017/5/1,臺中市,神岡區,19366,65605,33497,32108
2017/5/1,臺中市,潭子區,36097,107819,53307,54512
2017/5/1,臺中市,大雅區,29326,94889,47351,47538
2017/5/1,臺中市,新社區,7540,24824,12878,11946
2017/5/1,臺中市,石岡區,4901,15126,7855,7271
2017/5/1,臺中市,外埔區,9653,31995,16435,15560
2017/5/1,臺中市,大安區,5450,19369,10235,9134
2017/5/1,臺中市,烏日區,24211,73990,37184,36806
2017/5/1,臺中市,大肚區,17532,57266,29249,28017
2017/5/1,臺中市,龍井區,22851,77267,38977,38290
2017/5/1,臺中市,霧峰區,20065,65027,33023,32004
2017/5/1,臺中市,太平區,62753,187221,92916,94305
2017/5/1,臺中市,大里區,69060,210958,103805,107153
2017/5/1,臺中市,和平區,4526,10833,5842,4991
2017/5/1,臺南市,新營區,28916,78157,38669,39488
2017/5/1,臺南市,鹽水區,10061,25727,13435,12292
2017/5/1,臺南市,白河區,10847,28710,15000,13710
2017/5/1,臺南市,柳營區,7886,21402,11159,10243
2017/5/1,臺南市,後壁區,8882,23922,12451,11471
2017/5/1,臺南市,東山區,8398,21196,11259,9937
2017/5/1,臺南市,麻豆區,15762,44762,22754,22008
2017/5/1,臺南市,下營區,9111,24408,12596,11812
2017/5/1,臺南市,六甲區,7729,22369,11576,10793
2017/5/1,臺南市,官田區,7919,21484,10941,10543
2017/5/1,臺南市,大內區,3899,9891,5288,4603
2017/5/1,臺南市,佳里區,20573,59496,29518,29978
2017/5/1,臺南市,學甲區,9660,26243,13422,12821
2017/5/1,臺南市,西港區,8166,24819,12568,12251
2017/5/1,臺南市,七股區,8043,23081,11935,11146
2017/5/1,臺南市,將軍區,7303,19958,10146,9812
2017/5/1,臺南市,北門區,4264,11234,5699,5535
2017/5/1,臺南市,新化區,14381,43690,22258,21432
2017/5/1,臺南市,善化區,17393,47896,24118,23778
2017/5/1,臺南市,新市區,12121,36345,18251,18094
2017/5/1,臺南市,安定區,10019,30478,15643,14835
2017/5/1,臺南市,山上區,2705,7343,3851,3492
2017/5/1,臺南市,玉井區,5137,14207,7353,6854
2017/5/1,臺南市,楠西區,3520,9813,5197,4616
2017/5/1,臺南市,南化區,2875,8799,4756,4043
2017/5/1,臺南市,左鎮區,1978,4932,2768,2164
2017/5/1,臺南市,仁德區,27463,75097,38097,37000
2017/5/1,臺南市,歸仁區,22620,68384,34744,33640
2017/5/1,臺南市,關廟區,11084,34479,17791,16688
2017/5/1,臺南市,龍崎區,1543,4077,2178,1899
2017/5/1,臺南市,永康區,83424,232937,114872,118065
2017/5/1,臺南市,東區,71876,187633,90038,97595
2017/5/1,臺南市,南區,45419,125725,62298,63427
2017/5/1,臺南市,北區,50642,132810,64655,68155
2017/5/1,臺南市,安南區,62354,191688,96637,95051
2017/5/1,臺南市,安平區,25331,66007,31337,34670
2017/5/1,臺南市,中西區,30881,77274,37474,39800
2017/5/1,高雄市,鹽埕區,10806,24503,12138,12365
2017/5/1,高雄市,鼓山區,57491,138441,66932,71509
2017/5/1,高雄市,左營區,78608,197171,94972,102199
2017/5/1,高雄市,楠梓區,69444,182596,89829,92767
2017/5/1,高雄市,三民區,136493,344830,166979,177851
2017/5/1,高雄市,新興區,22671,51171,24620,26551
2017/5/1,高雄市,前金區,12600,27173,13008,14165
2017/5/1,高雄市,苓雅區,72167,172125,82988,89137
2017/5/1,高雄市,前鎮區,78623,190672,93742,96930
2017/5/1,高雄市,旗津區,11123,28807,14897,13910
2017/5/1,高雄市,小港區,67662,157259,78151,79108
2017/5/1,高雄市,鳳山區,139535,358248,175800,182448
2017/5/1,高雄市,林園區,25786,70073,35487,34586
2017/5/1,高雄市,大寮區,41992,112249,57527,54722
2017/5/1,高雄市,大樹區,13564,42885,21993,20892
2017/5/1,高雄市,大社區,12876,34496,17539,16957
2017/5/1,高雄市,仁武區,32424,84691,43018,41673
2017/5/1,高雄市,鳥松區,18186,44330,22497,21833
2017/5/1,高雄市,岡山區,34880,97536,48452,49084
2017/5/1,高雄市,橋頭區,13531,37529,19045,18484
2017/5/1,高雄市,燕巢區,10470,29876,15777,14099
2017/5/1,高雄市,田寮區,3293,7275,4027,3248
2017/5/1,高雄市,阿蓮區,9412,28996,14644,14352
2017/5/1,高雄市,路竹區,17020,52900,27005,25895
2017/5/1,高雄市,湖內區,10775,29813,15218,14595
2017/5/1,高雄市,茄萣區,10501,30337,15655,14682
2017/5/1,高雄市,永安區,5752,13979,7026,6953
2017/5/1,高雄市,彌陀區,6788,19476,10022,9454
2017/5/1,高雄市,梓官區,12620,36186,18616,17570
2017/5/1,高雄市,旗山區,13772,37214,19250,17964
2017/5/1,高雄市,美濃區,14689,40279,21118,19161
2017/5/1,高雄市,六龜區,5557,13135,7059,6076
2017/5/1,高雄市,甲仙區,2335,6151,3279,2872
2017/5/1,高雄市,杉林區,4794,12134,6621,5513
2017/5/1,高雄市,內門區,5103,14632,7926,6706
2017/5/1,高雄市,茂林區,587,1909,948,961
2017/5/1,高雄市,桃源區,1327,4235,2213,2022
2017/5/1,高雄市,那瑪夏區,850,3103,1601,1502
2017/5/1,宜蘭縣,宜蘭市,36095,95959,46828,49131
2017/5/1,宜蘭縣,羅東鎮,26343,72509,34349,38160
2017/5/1,宜蘭縣,蘇澳鎮,14153,40319,20518,19801
2017/5/1,宜蘭縣,頭城鎮,10239,29569,15220,14349
2017/5/1,宜蘭縣,礁溪鄉,13938,35838,18666,17172
2017/5/1,宜蘭縣,壯圍鄉,8764,24220,12839,11381
2017/5/1,宜蘭縣,員山鄉,11695,32376,17161,15215
2017/5/1,宜蘭縣,冬山鄉,19173,53328,27342,25986
2017/5/1,宜蘭縣,五結鄉,14797,39668,20527,19141
2017/5/1,宜蘭縣,三星鄉,8514,21428,11549,9879
2017/5/1,宜蘭縣,大同鄉,1886,6064,3289,2775
2017/5/1,宜蘭縣,南澳鄉,1933,5855,3075,2780
2017/5/1,新竹縣,竹北市,64176,178695,88997,89698
2017/5/1,新竹縣,關西鎮,9510,29184,15629,13555
2017/5/1,新竹縣,新埔鎮,10711,33582,17898,15684
2017/5/1,新竹縣,竹東鎮,33691,96878,48675,48203
2017/5/1,新竹縣,湖口鄉,26340,77418,39253,38165
2017/5/1,新竹縣,橫山鄉,4466,13223,7161,6062
2017/5/1,新竹縣,新豐鄉,18278,56623,29077,27546
2017/5/1,新竹縣,芎林鄉,6502,20060,10641,9419
2017/5/1,新竹縣,寶山鄉,5433,14448,7809,6639
2017/5/1,新竹縣,北埔鄉,3129,9492,5150,4342
2017/5/1,新竹縣,峨眉鄉,2074,5564,3077,2487
2017/5/1,新竹縣,尖石鄉,2852,9412,4964,4448
2017/5/1,新竹縣,五峰鄉,1752,4539,2449,2090
2017/5/1,苗栗縣,苗栗市,31125,89576,44745,44831
2017/5/1,苗栗縣,頭份市,34240,103090,52039,51051
2017/5/1,苗栗縣,苑裡鎮,14610,46539,24235,22304
2017/5/1,苗栗縣,通霄鎮,11572,35090,18527,16563
2017/5/1,苗栗縣,竹南鎮,28784,85195,42974,42221
2017/5/1,苗栗縣,後龍鎮,11916,37074,19569,17505
2017/5/1,苗栗縣,卓蘭鎮,6056,17366,9091,8275
2017/5/1,苗栗縣,大湖鄉,5383,14903,7925,6978
2017/5/1,苗栗縣,公館鄉,10699,34056,17752,16304
2017/5/1,苗栗縣,銅鑼鄉,6154,18340,9741,8599
2017/5/1,苗栗縣,南庄鄉,3946,10293,5658,4635
2017/5/1,苗栗縣,頭屋鄉,3652,10978,5822,5156
2017/5/1,苗栗縣,三義鄉,5585,16734,8825,7909
2017/5/1,苗栗縣,西湖鄉,2660,7245,4027,3218
2017/5/1,苗栗縣,造橋鄉,4108,13055,6880,6175
2017/5/1,苗栗縣,三灣鄉,2406,6823,3731,3092
2017/5/1,苗栗縣,獅潭鄉,1711,4428,2480,1948
2017/5/1,苗栗縣,泰安鄉,1954,5853,3141,2712
2017/5/1,彰化縣,彰化市,76099,234160,115761,118399
2017/5/1,彰化縣,員林市,39037,124753,61986,62767
2017/5/1,彰化縣,鹿港鎮,24377,86703,44072,42631
2017/5/1,彰化縣,和美鎮,26623,91178,46487,44691
2017/5/1,彰化縣,北斗鎮,10644,33301,16807,16494
2017/5/1,彰化縣,溪湖鎮,16284,55688,28267,27421
2017/5/1,彰化縣,田中鎮,13100,42008,21656,20352
2017/5/1,彰化縣,二林鎮,14995,51313,26445,24868
2017/5/1,彰化縣,線西鄉,4381,16876,8694,8182
2017/5/1,彰化縣,伸港鄉,9881,36777,18784,17993
2017/5/1,彰化縣,福興鄉,12745,47423,24712,22711
2017/5/1,彰化縣,秀水鄉,10664,39376,20319,19057
2017/5/1,彰化縣,花壇鄉,14036,46036,23617,22419
2017/5/1,彰化縣,芬園鄉,6826,23759,12481,11278
2017/5/1,彰化縣,大村鄉,11092,36849,19050,17799
2017/5/1,彰化縣,埔鹽鄉,9030,32688,17177,15511
2017/5/1,彰化縣,埔心鄉,10523,34775,17940,16835
2017/5/1,彰化縣,永靖鄉,10933,37627,19498,18129
2017/5/1,彰化縣,社頭鄉,12869,43285,22244,21041
2017/5/1,彰化縣,二水鄉,5298,15406,8085,7321
2017/5/1,彰化縣,田尾鄉,7950,27518,14221,13297
2017/5/1,彰化縣,埤頭鄉,9019,30683,15942,14741
2017/5/1,彰化縣,芳苑鄉,10136,33863,17897,15966
2017/5/1,彰化縣,大城鄉,5277,17139,9257,7882
2017/5/1,彰化縣,竹塘鄉,4604,15393,8106,7287
2017/5/1,彰化縣,溪州鄉,8973,30208,15800,14408
2017/5/1,南投縣,南投市,34636,100726,50427,50299
2017/5/1,南投縣,埔里鎮,29001,81421,40650,40771
2017/5/1,南投縣,草屯鎮,33112,98229,49681,48548
2017/5/1,南投縣,竹山鎮,20085,55371,28426,26945
2017/5/1,南投縣,集集鎮,4291,10947,5696,5251
2017/5/1,南投縣,名間鄉,12627,39019,20548,18471
2017/5/1,南投縣,鹿谷鄉,7901,17889,9553,8336
2017/5/1,南投縣,中寮鄉,5632,15002,8151,6851
2017/5/1,南投縣,魚池鄉,5759,16093,8478,7615
2017/5/1,南投縣,國姓鄉,7289,18950,10251,8699
2017/5/1,南投縣,水里鄉,7153,17951,9412,8539
2017/5/1,南投縣,信義鄉,5259,16321,8744,7577
2017/5/1,南投縣,仁愛鄉,4907,15656,8093,7563
2017/5/1,雲林縣,斗六市,38015,108534,54055,54479
2017/5/1,雲林縣,斗南鎮,15831,45162,22951,22211
2017/5/1,雲林縣,虎尾鎮,24891,70949,35950,34999
2017/5/1,雲林縣,西螺鎮,14638,46445,23507,22938
2017/5/1,雲林縣,土庫鎮,9346,29155,15221,13934
2017/5/1,雲林縣,北港鎮,15901,40539,20965,19574
2017/5/1,雲林縣,古坑鄉,10973,31835,16789,15046
2017/5/1,雲林縣,大埤鄉,6702,19373,10395,8978
2017/5/1,雲林縣,莿桐鄉,9333,29000,15220,13780
2017/5/1,雲林縣,林內鄉,5984,18401,9631,8770
2017/5/1,雲林縣,二崙鄉,8952,27386,14655,12731
2017/5/1,雲林縣,崙背鄉,8508,24926,13183,11743
2017/5/1,雲林縣,麥寮鄉,14241,45155,22703,22452
2017/5/1,雲林縣,東勢鄉,5732,15016,8275,6741
2017/5/1,雲林縣,褒忠鄉,4439,13076,7045,6031
2017/5/1,雲林縣,臺西鄉,8708,24052,12884,11168
2017/5/1,雲林縣,元長鄉,9296,26219,14337,11882
2017/5/1,雲林縣,四湖鄉,8813,23903,12963,10940
2017/5/1,雲林縣,口湖鄉,9501,27889,14828,13061
2017/5/1,雲林縣,水林鄉,9987,25803,14129,11674
2017/5/1,嘉義縣,太保市,12781,37584,19320,18264
2017/5/1,嘉義縣,朴子市,15677,42559,21542,21017
2017/5/1,嘉義縣,布袋鎮,9980,27332,13961,13371
2017/5/1,嘉義縣,大林鎮,11378,31307,16025,15282
2017/5/1,嘉義縣,民雄鄉,24756,71787,36783,35004
2017/5/1,嘉義縣,溪口鄉,5371,14850,7944,6906
2017/5/1,嘉義縣,新港鄉,10635,32242,16979,15263
2017/5/1,嘉義縣,六腳鄉,8912,23531,12511,11020
2017/5/1,嘉義縣,東石鄉,9266,25108,13315,11793
2017/5/1,嘉義縣,義竹鄉,7443,18666,9706,8960
2017/5/1,嘉義縣,鹿草鄉,5776,15676,8426,7250
2017/5/1,嘉義縣,水上鄉,18073,49922,25760,24162
2017/5/1,嘉義縣,中埔鄉,15976,45190,23505,21685
2017/5/1,嘉義縣,竹崎鄉,11711,36082,19245,16837
2017/5/1,嘉義縣,梅山鄉,6758,19660,10477,9183
2017/5/1,嘉義縣,番路鄉,4265,11672,6314,5358
2017/5/1,嘉義縣,大埔鄉,1946,4592,2381,2211
2017/5/1,嘉義縣,阿里山鄉,1941,5633,2980,2653
2017/5/1,屏東縣,屏東市,74097,201125,99542,101583
2017/5/1,屏東縣,潮州鎮,19454,54668,27318,27350
2017/5/1,屏東縣,東港鎮,16689,48051,24304,23747
2017/5/1,屏東縣,恆春鎮,11540,30674,15741,14933
2017/5/1,屏東縣,萬丹鄉,14936,51079,26481,24598
2017/5/1,屏東縣,長治鄉,10123,30028,15636,14392
2017/5/1,屏東縣,麟洛鄉,3805,11126,5776,5350
2017/5/1,屏東縣,九如鄉,6964,22087,11426,10661
2017/5/1,屏東縣,里港鄉,8189,26778,13621,13157
2017/5/1,屏東縣,鹽埔鄉,7853,26125,13588,12537
2017/5/1,屏東縣,高樹鄉,9307,24742,13161,11581
2017/5/1,屏東縣,萬巒鄉,6508,20619,10785,9834
2017/5/1,屏東縣,內埔鄉,18596,54948,28420,26528
2017/5/1,屏東縣,竹田鄉,5640,17272,9169,8103
2017/5/1,屏東縣,新埤鄉,3421,9867,5241,4626
2017/5/1,屏東縣,枋寮鄉,8519,24738,12965,11773
2017/5/1,屏東縣,新園鄉,11809,35488,18421,17067
2017/5/1,屏東縣,崁頂鄉,4484,15849,8052,7797
2017/5/1,屏東縣,林邊鄉,6756,18189,9311,8878
2017/5/1,屏東縣,南州鄉,3703,10743,5504,5239
2017/5/1,屏東縣,佳冬鄉,6988,19563,10156,9407
2017/5/1,屏東縣,琉球鄉,4458,12382,6813,5569
2017/5/1,屏東縣,車城鄉,3468,8644,4653,3991
2017/5/1,屏東縣,滿州鄉,3014,7817,4255,3562
2017/5/1,屏東縣,枋山鄉,2112,5478,2921,2557
2017/5/1,屏東縣,三地門鄉,2310,7647,3855,3792
2017/5/1,屏東縣,霧臺鄉,1054,3252,1673,1579
2017/5/1,屏東縣,瑪家鄉,2054,6749,3433,3316
2017/5/1,屏東縣,泰武鄉,1327,5238,2753,2485
2017/5/1,屏東縣,來義鄉,2226,7476,3794,3682
2017/5/1,屏東縣,春日鄉,1386,4838,2488,2350
2017/5/1,屏東縣,獅子鄉,1555,4815,2495,2320
2017/5/1,屏東縣,牡丹鄉,1904,4899,2510,2389
2017/5/1,臺東縣,臺東市,39660,106335,53307,53028
2017/5/1,臺東縣,成功鎮,5401,14348,7579,6769
2017/5/1,臺東縣,關山鎮,3182,8784,4575,4209
2017/5/1,臺東縣,卑南鄉,6696,17431,9210,8221
2017/5/1,臺東縣,大武鄉,2498,6146,3206,2940
2017/5/1,臺東縣,太麻里鄉,4654,11188,5970,5218
2017/5/1,臺東縣,東河鄉,3755,8591,4765,3826
2017/5/1,臺東縣,長濱鄉,2924,7318,4144,3174
2017/5/1,臺東縣,鹿野鄉,3047,7971,4260,3711
2017/5/1,臺東縣,池上鄉,3218,8300,4320,3980
2017/5/1,臺東縣,綠島鄉,1123,3789,1988,1801
2017/5/1,臺東縣,延平鄉,1069,3533,1894,1639
2017/5/1,臺東縣,海端鄉,1089,4244,2265,1979
2017/5/1,臺東縣,達仁鄉,1452,3527,1920,1607
2017/5/1,臺東縣,金峰鄉,1123,3644,1865,1779
2017/5/1,臺東縣,蘭嶼鄉,1814,5042,2550,2492
2017/5/1,花蓮縣,花蓮市,41549,104990,50680,54310
2017/5/1,花蓮縣,鳳林鎮,4393,10948,5691,5257
2017/5/1,花蓮縣,玉里鎮,8901,24600,13080,11520
2017/5/1,花蓮縣,新城鄉,7688,20155,10384,9771
2017/5/1,花蓮縣,吉安鄉,31848,83641,42159,41482
2017/5/1,花蓮縣,壽豐鄉,7153,18093,9639,8454
2017/5/1,花蓮縣,光復鄉,5031,12968,6902,6066
2017/5/1,花蓮縣,豐濱鄉,1711,4408,2452,1956
2017/5/1,花蓮縣,瑞穗鄉,4732,11677,6304,5373
2017/5/1,花蓮縣,富里鄉,4015,10468,5693,4775
2017/5/1,花蓮縣,秀林鄉,4785,15767,8127,7640
2017/5/1,花蓮縣,萬榮鄉,2091,6376,3381,2995
2017/5/1,花蓮縣,卓溪鄉,1692,6048,3324,2724
2017/5/1,澎湖縣,馬公市,24143,61830,31433,30397
2017/5/1,澎湖縣,湖西鄉,5514,14441,7611,6830
2017/5/1,澎湖縣,白沙鄉,3384,9795,5141,4654
2017/5/1,澎湖縣,西嶼鄉,2990,8378,4318,4060
2017/5/1,澎湖縣,望安鄉,2027,5185,2800,2385
2017/5/1,澎湖縣,七美鄉,1371,3805,1988,1817
2017/5/1,基隆市,中正區,22577,52422,26786,25636
2017/5/1,基隆市,七堵區,21330,54058,27192,26866
2017/5/1,基隆市,暖暖區,15596,38568,19375,19193
2017/5/1,基隆市,仁愛區,19264,44804,22166,22638
2017/5/1,基隆市,中山區,19246,47980,24335,23645
2017/5/1,基隆市,安樂區,33228,82278,40737,41541
2017/5/1,基隆市,信義區,21092,51871,25718,26153
2017/5/1,新竹市,東區,78453,211143,103951,107192
2017/5/1,新竹市,北區,56140,150196,73512,76684
2017/5/1,新竹市,香山區,26927,77524,39390,38134
2017/5/1,嘉義市,東區,45401,122335,59013,63322
2017/5/1,嘉義市,西區,53774,147458,72266,75192
2017/5/1,金門縣,金城鎮,12817,42930,21455,21475
2017/5/1,金門縣,金湖鎮,8798,28904,14535,14369
2017/5/1,金門縣,金沙鎮,6273,20350,10066,10284
2017/5/1,金門縣,金寧鄉,8384,30108,15147,14961
2017/5/1,金門縣,烈嶼鄉,3108,12560,6160,6400
2017/5/1,金門縣,烏坵鄉,134,683,343,340
2017/5/1,連江縣,南竿鄉,1598,7439,4178,3261
2017/5/1,連江縣,北竿鄉,541,2349,1304,1045
2017/5/1,連江縣,莒光鄉,286,1597,968,629
2017/5/1,連江縣,東引鄉,329,1311,787,524
2017/6/1,總計,新北市,1533928,3982434,1952479,2029955
2017/6/1,總計,臺北市,1049354,2689845,1285810,1404035
2017/6/1,總計,桃園市,779743,2167616,1080489,1087127
2017/6/1,總計,臺中市,951383,2776579,1369969,1406610
2017/6/1,總計,臺南市,680737,1886502,942629,943873
2017/6/1,總計,高雄市,1087007,2778023,1377216,1400807
2017/6/1,總計,臺灣省,2477035,7123192,3634076,3489116
2017/6/1,總計,宜蘭縣,167742,457106,231387,225719
2017/6/1,總計,新竹縣,189271,549580,280952,268628
2017/6/1,總計,苗栗縣,186749,556324,287015,269309
2017/6/1,總計,彰化縣,385572,1284423,655100,629323
2017/6/1,總計,南投縣,177729,503261,257890,245371
2017/6/1,總計,雲林縣,239882,692570,359510,333060
2017/6/1,總計,嘉義縣,182646,513082,266990,246092
2017/6/1,總計,屏東縣,286320,832489,425970,406519
2017/6/1,總計,臺東縣,82755,220083,113739,106344
2017/6/1,總計,花蓮縣,125621,329976,167749,162227
2017/6/1,總計,澎湖縣,39321,103406,53283,50123
2017/6/1,總計,基隆市,152390,371876,186221,185655
2017/6/1,總計,新竹市,161811,439299,217034,222265
2017/6/1,總計,嘉義市,99226,269717,131236,138481
2017/6/1,總計,福建省,42364,148279,74964,73315
2017/6/1,總計,金門縣,39596,135563,67720,67843
2017/6/1,總計,連江縣,2768,12716,7244,5472
2017/6/1,新北市,板橋區,207398,552004,269665,282339
2017/6/1,新北市,三重區,150449,387881,191019,196862
2017/6/1,新北市,中和區,164563,413489,201203,212286
2017/6/1,新北市,永和區,90908,223701,106261,117440
2017/6/1,新北市,新莊區,151953,415412,202820,212592
2017/6/1,新北市,新店區,125826,301450,145179,156271
2017/6/1,新北市,樹林區,66285,184359,91995,92364
2017/6/1,新北市,鶯歌區,29704,86909,43580,43329
2017/6/1,新北市,三峽區,42181,114396,57375,57021
2017/6/1,新北市,淡水區,73498,167614,80542,87072
2017/6/1,新北市,汐止區,86440,198535,96915,101620
2017/6/1,新北市,瑞芳區,16156,40518,20458,20060
2017/6/1,新北市,土城區,86744,238353,117653,120700
2017/6/1,新北市,蘆洲區,70673,201223,98896,102327
2017/6/1,新北市,五股區,31023,84431,42639,41792
2017/6/1,新北市,泰山區,28355,78906,39169,39737
2017/6/1,新北市,林口區,41229,104630,50934,53696
2017/6/1,新北市,深坑區,9570,23679,11836,11843
2017/6/1,新北市,石碇區,3367,7692,4231,3461
2017/6/1,新北市,坪林區,2509,6541,3631,2910
2017/6/1,新北市,三芝區,9453,23298,11954,11344
2017/6/1,新北市,石門區,4292,12360,6385,5975
2017/6/1,新北市,八里區,14391,38152,19032,19120
2017/6/1,新北市,平溪區,2321,4736,2620,2116
2017/6/1,新北市,雙溪區,3815,9004,4872,4132
2017/6/1,新北市,貢寮區,4407,12566,6401,6165
2017/6/1,新北市,金山區,7076,22039,10893,11146
2017/6/1,新北市,萬里區,7477,22341,11241,11100
2017/6/1,新北市,烏來區,1865,6215,3080,3135
2017/6/1,臺北市,松山區,80532,207957,97662,110295
2017/6/1,臺北市,信義區,89384,226379,108164,118215
2017/6/1,臺北市,大安區,120678,311124,145416,165708
2017/6/1,臺北市,中山區,99962,231068,107652,123416
2017/6/1,臺北市,中正區,65217,160644,76720,83924
2017/6/1,臺北市,大同區,51728,129667,63216,66451
2017/6/1,臺北市,萬華區,78587,192442,94577,97865
2017/6/1,臺北市,文山區,105178,274689,131863,142826
2017/6/1,臺北市,南港區,46898,122214,59763,62451
2017/6/1,臺北市,內湖區,107602,287746,137531,150215
2017/6/1,臺北市,士林區,106945,289149,139432,149717
2017/6/1,臺北市,北投區,96643,256766,123814,132952
2017/6/1,桃園市,桃園區,164316,437830,212754,225076
2017/6/1,桃園市,中壢區,147001,400716,197690,203026
2017/6/1,桃園市,大溪區,32158,94326,48102,46224
2017/6/1,桃園市,楊梅區,57004,165524,83498,82026
2017/6/1,桃園市,蘆竹區,57435,160263,79705,80558
2017/6/1,桃園市,大園區,32281,88295,45172,43123
2017/6/1,桃園市,龜山區,60194,155104,77397,77707
2017/6/1,桃園市,八德區,69336,195322,97923,97399
2017/6/1,桃園市,龍潭區,41364,121068,60748,60320
2017/6/1,桃園市,平鎮區,76385,223106,110966,112140
2017/6/1,桃園市,新屋區,16117,48784,25984,22800
2017/6/1,桃園市,觀音區,22385,65954,34386,31568
2017/6/1,桃園市,復興區,3767,11324,6164,5160
2017/6/1,臺中市,中區,7940,18645,9260,9385
2017/6/1,臺中市,東區,27746,75635,37669,37966
2017/6/1,臺中市,南區,47871,124028,59614,64414
2017/6/1,臺中市,西區,45626,115762,55013,60749
2017/6/1,臺中市,北區,59172,147630,70693,76937
2017/6/1,臺中市,西屯區,85038,225827,108553,117274
2017/6/1,臺中市,南屯區,61442,167723,80213,87510
2017/6/1,臺中市,北屯區,98991,272609,130913,141696
2017/6/1,臺中市,豐原區,53369,166794,82463,84331
2017/6/1,臺中市,東勢區,17416,50866,26170,24696
2017/6/1,臺中市,大甲區,22991,77726,39099,38627
2017/6/1,臺中市,清水區,27046,86440,44368,42072
2017/6/1,臺中市,沙鹿區,29158,92039,46488,45551
2017/6/1,臺中市,梧棲區,17630,57809,29038,28771
2017/6/1,臺中市,后里區,16148,54382,27648,26734
2017/6/1,臺中市,神岡區,19375,65587,33494,32093
2017/6/1,臺中市,潭子區,36153,107935,53368,54567
2017/6/1,臺中市,大雅區,29372,94917,47369,47548
2017/6/1,臺中市,新社區,7540,24822,12878,11944
2017/6/1,臺中市,石岡區,4897,15104,7843,7261
2017/6/1,臺中市,外埔區,9664,32001,16425,15576
2017/6/1,臺中市,大安區,5457,19367,10237,9130
2017/6/1,臺中市,烏日區,24281,74109,37240,36869
2017/6/1,臺中市,大肚區,17557,57285,29246,28039
2017/6/1,臺中市,龍井區,22889,77289,38989,38300
2017/6/1,臺中市,霧峰區,20096,65109,33049,32060
2017/6/1,臺中市,太平區,62861,187362,93006,94356
2017/6/1,臺中市,大里區,69127,210940,103786,107154
2017/6/1,臺中市,和平區,4530,10837,5837,5000
2017/6/1,臺南市,新營區,28945,78153,38666,39487
2017/6/1,臺南市,鹽水區,10062,25699,13427,12272
2017/6/1,臺南市,白河區,10860,28713,14993,13720
2017/6/1,臺南市,柳營區,7893,21420,11174,10246
2017/6/1,臺南市,後壁區,8884,23901,12441,11460
2017/6/1,臺南市,東山區,8408,21176,11250,9926
2017/6/1,臺南市,麻豆區,15774,44732,22743,21989
2017/6/1,臺南市,下營區,9110,24385,12586,11799
2017/6/1,臺南市,六甲區,7736,22356,11575,10781
2017/6/1,臺南市,官田區,7927,21482,10938,10544
2017/6/1,臺南市,大內區,3895,9882,5287,4595
2017/6/1,臺南市,佳里區,20586,59510,29529,29981
2017/6/1,臺南市,學甲區,9654,26225,13416,12809
2017/6/1,臺南市,西港區,8167,24803,12550,12253
2017/6/1,臺南市,七股區,8061,23058,11928,11130
2017/6/1,臺南市,將軍區,7298,19947,10144,9803
2017/6/1,臺南市,北門區,4268,11228,5693,5535
2017/6/1,臺南市,新化區,14383,43694,22255,21439
2017/6/1,臺南市,善化區,17421,47926,24144,23782
2017/6/1,臺南市,新市區,12146,36387,18278,18109
2017/6/1,臺南市,安定區,10031,30507,15659,14848
2017/6/1,臺南市,山上區,2706,7336,3838,3498
2017/6/1,臺南市,玉井區,5143,14194,7356,6838
2017/6/1,臺南市,楠西區,3520,9806,5188,4618
2017/6/1,臺南市,南化區,2872,8773,4741,4032
2017/6/1,臺南市,左鎮區,1975,4925,2760,2165
2017/6/1,臺南市,仁德區,27502,75167,38092,37075
2017/6/1,臺南市,歸仁區,22619,68406,34761,33645
2017/6/1,臺南市,關廟區,11086,34455,17776,16679
2017/6/1,臺南市,龍崎區,1541,4077,2177,1900
2017/6/1,臺南市,永康區,83535,233112,114921,118191
2017/6/1,臺南市,東區,71850,187444,89937,97507
2017/6/1,臺南市,南區,45464,125731,62275,63456
2017/6/1,臺南市,北區,50685,132837,64664,68173
2017/6/1,臺南市,安南區,62407,191694,96626,95068
2017/6/1,臺南市,安平區,25360,66003,31327,34676
2017/6/1,臺南市,中西區,30963,77358,37514,39844
2017/6/1,高雄市,鹽埕區,10800,24467,12118,12349
2017/6/1,高雄市,鼓山區,57567,138450,66896,71554
2017/6/1,高雄市,左營區,78653,197100,94878,102222
2017/6/1,高雄市,楠梓區,69582,182755,89888,92867
2017/6/1,高雄市,三民區,136571,344652,166896,177756
2017/6/1,高雄市,新興區,22682,51141,24612,26529
2017/6/1,高雄市,前金區,12610,27144,12989,14155
2017/6/1,高雄市,苓雅區,72125,171874,82861,89013
2017/6/1,高雄市,前鎮區,78652,190589,93699,96890
2017/6/1,高雄市,旗津區,11128,28785,14883,13902
2017/6/1,高雄市,小港區,67686,157219,78130,79089
2017/6/1,高雄市,鳳山區,139750,358477,175866,182611
2017/6/1,高雄市,林園區,25812,70044,35460,34584
2017/6/1,高雄市,大寮區,42035,112273,57530,54743
2017/6/1,高雄市,大樹區,13575,42857,21980,20877
2017/6/1,高雄市,大社區,12899,34499,17540,16959
2017/6/1,高雄市,仁武區,32523,84911,43164,41747
2017/6/1,高雄市,鳥松區,18199,44332,22485,21847
2017/6/1,高雄市,岡山區,34881,97512,48438,49074
2017/6/1,高雄市,橋頭區,13539,37544,19045,18499
2017/6/1,高雄市,燕巢區,10480,29856,15757,14099
2017/6/1,高雄市,田寮區,3295,7271,4025,3246
2017/6/1,高雄市,阿蓮區,9416,28971,14628,14343
2017/6/1,高雄市,路竹區,17022,52867,26994,25873
2017/6/1,高雄市,湖內區,10817,29854,15218,14636
2017/6/1,高雄市,茄萣區,10508,30335,15658,14677
2017/6/1,高雄市,永安區,5746,13983,7029,6954
2017/6/1,高雄市,彌陀區,6794,19441,10009,9432
2017/6/1,高雄市,梓官區,12638,36189,18606,17583
2017/6/1,高雄市,旗山區,13758,37158,19235,17923
2017/6/1,高雄市,美濃區,14699,40233,21090,19143
2017/6/1,高雄市,六龜區,5560,13109,7052,6057
2017/6/1,高雄市,甲仙區,2332,6142,3265,2877
2017/6/1,高雄市,杉林區,4801,12123,6611,5512
2017/6/1,高雄市,內門區,5109,14618,7919,6699
2017/6/1,高雄市,茂林區,588,1912,951,961
2017/6/1,高雄市,桃源區,1326,4233,2212,2021
2017/6/1,高雄市,那瑪夏區,849,3103,1599,1504
2017/6/1,宜蘭縣,宜蘭市,36126,95919,46800,49119
2017/6/1,宜蘭縣,羅東鎮,26361,72487,34349,38138
2017/6/1,宜蘭縣,蘇澳鎮,14159,40283,20506,19777
2017/6/1,宜蘭縣,頭城鎮,10245,29569,15224,14345
2017/6/1,宜蘭縣,礁溪鄉,13987,35857,18682,17175
2017/6/1,宜蘭縣,壯圍鄉,8780,24237,12857,11380
2017/6/1,宜蘭縣,員山鄉,11709,32401,17176,15225
2017/6/1,宜蘭縣,冬山鄉,19198,53353,27367,25986
2017/6/1,宜蘭縣,五結鄉,14830,39674,20526,19148
2017/6/1,宜蘭縣,三星鄉,8528,21408,11549,9859
2017/6/1,宜蘭縣,大同鄉,1886,6065,3285,2780
2017/6/1,宜蘭縣,南澳鄉,1933,5853,3066,2787
2017/6/1,新竹縣,竹北市,64396,179145,89200,89945
2017/6/1,新竹縣,關西鎮,9520,29160,15606,13554
2017/6/1,新竹縣,新埔鎮,10720,33568,17892,15676
2017/6/1,新竹縣,竹東鎮,33727,96899,48675,48224
2017/6/1,新竹縣,湖口鄉,26382,77460,39257,38203
2017/6/1,新竹縣,橫山鄉,4464,13195,7146,6049
2017/6/1,新竹縣,新豐鄉,18304,56663,29093,27570
2017/6/1,新竹縣,芎林鄉,6500,20047,10635,9412
2017/6/1,新竹縣,寶山鄉,5457,14455,7814,6641
2017/6/1,新竹縣,北埔鄉,3126,9483,5151,4332
2017/6/1,新竹縣,峨眉鄉,2073,5570,3078,2492
2017/6/1,新竹縣,尖石鄉,2850,9402,4962,4440
2017/6/1,新竹縣,五峰鄉,1752,4533,2443,2090
2017/6/1,苗栗縣,苗栗市,31133,89504,44706,44798
2017/6/1,苗栗縣,頭份市,34317,103097,52061,51036
2017/6/1,苗栗縣,苑裡鎮,14618,46461,24203,22258
2017/6/1,苗栗縣,通霄鎮,11589,35055,18499,16556
2017/6/1,苗栗縣,竹南鎮,28843,85256,43017,42239
2017/6/1,苗栗縣,後龍鎮,11929,37039,19540,17499
2017/6/1,苗栗縣,卓蘭鎮,6050,17334,9065,8269
2017/6/1,苗栗縣,大湖鄉,5389,14886,7914,6972
2017/6/1,苗栗縣,公館鄉,10696,34025,17735,16290
2017/6/1,苗栗縣,銅鑼鄉,6159,18347,9749,8598
2017/6/1,苗栗縣,南庄鄉,3946,10281,5652,4629
2017/6/1,苗栗縣,頭屋鄉,3650,10966,5818,5148
2017/6/1,苗栗縣,三義鄉,5592,16695,8807,7888
2017/6/1,苗栗縣,西湖鄉,2661,7236,4021,3215
2017/6/1,苗栗縣,造橋鄉,4113,13037,6874,6163
2017/6/1,苗栗縣,三灣鄉,2401,6808,3724,3084
2017/6/1,苗栗縣,獅潭鄉,1711,4444,2489,1955
2017/6/1,苗栗縣,泰安鄉,1952,5853,3141,2712
2017/6/1,彰化縣,彰化市,76128,234159,115781,118378
2017/6/1,彰化縣,員林市,39041,124690,61964,62726
2017/6/1,彰化縣,鹿港鎮,24372,86688,44083,42605
2017/6/1,彰化縣,和美鎮,26637,91106,46440,44666
2017/6/1,彰化縣,北斗鎮,10655,33300,16803,16497
2017/6/1,彰化縣,溪湖鎮,16297,55694,28260,27434
2017/6/1,彰化縣,田中鎮,13102,42007,21661,20346
2017/6/1,彰化縣,二林鎮,15002,51271,26428,24843
2017/6/1,彰化縣,線西鄉,4382,16864,8676,8188
2017/6/1,彰化縣,伸港鄉,9901,36815,18805,18010
2017/6/1,彰化縣,福興鄉,12760,47411,24696,22715
2017/6/1,彰化縣,秀水鄉,10672,39354,20312,19042
2017/6/1,彰化縣,花壇鄉,14051,46043,23611,22432
2017/6/1,彰化縣,芬園鄉,6825,23738,12464,11274
2017/6/1,彰化縣,大村鄉,11100,36833,19033,17800
2017/6/1,彰化縣,埔鹽鄉,9036,32659,17164,15495
2017/6/1,彰化縣,埔心鄉,10538,34831,17961,16870
2017/6/1,彰化縣,永靖鄉,10932,37598,19481,18117
2017/6/1,彰化縣,社頭鄉,12885,43305,22261,21044
2017/6/1,彰化縣,二水鄉,5290,15390,8075,7315
2017/6/1,彰化縣,田尾鄉,7954,27497,14208,13289
2017/6/1,彰化縣,埤頭鄉,9022,30661,15933,14728
2017/6/1,彰化縣,芳苑鄉,10134,33844,17890,15954
2017/6/1,彰化縣,大城鄉,5273,17112,9237,7875
2017/6/1,彰化縣,竹塘鄉,4605,15373,8093,7280
2017/6/1,彰化縣,溪州鄉,8978,30180,15780,14400
2017/6/1,南投縣,南投市,34644,100665,50397,50268
2017/6/1,南投縣,埔里鎮,29015,81435,40629,40806
2017/6/1,南投縣,草屯鎮,33133,98180,49649,48531
2017/6/1,南投縣,竹山鎮,20109,55373,28425,26948
2017/6/1,南投縣,集集鎮,4288,10923,5674,5249
2017/6/1,南投縣,名間鄉,12631,38996,20539,18457
2017/6/1,南投縣,鹿谷鄉,7905,17874,9543,8331
2017/6/1,南投縣,中寮鄉,5642,14990,8147,6843
2017/6/1,南投縣,魚池鄉,5753,16057,8441,7616
2017/6/1,南投縣,國姓鄉,7281,18911,10227,8684
2017/6/1,南投縣,水里鄉,7156,17933,9400,8533
2017/6/1,南投縣,信義鄉,5261,16288,8733,7555
2017/6/1,南投縣,仁愛鄉,4911,15636,8086,7550
2017/6/1,雲林縣,斗六市,38092,108603,54072,54531
2017/6/1,雲林縣,斗南鎮,15840,45138,22943,22195
2017/6/1,雲林縣,虎尾鎮,24905,70967,35963,35004
2017/6/1,雲林縣,西螺鎮,14643,46440,23488,22952
2017/6/1,雲林縣,土庫鎮,9344,29086,15179,13907
2017/6/1,雲林縣,北港鎮,15893,40514,20947,19567
2017/6/1,雲林縣,古坑鄉,10970,31806,16764,15042
2017/6/1,雲林縣,大埤鄉,6700,19353,10384,8969
2017/6/1,雲林縣,莿桐鄉,9330,28987,15217,13770
2017/6/1,雲林縣,林內鄉,6000,18410,9637,8773
2017/6/1,雲林縣,二崙鄉,8941,27365,14629,12736
2017/6/1,雲林縣,崙背鄉,8500,24871,13147,11724
2017/6/1,雲林縣,麥寮鄉,14260,45196,22737,22459
2017/6/1,雲林縣,東勢鄉,5735,15009,8277,6732
2017/6/1,雲林縣,褒忠鄉,4441,13064,7043,6021
2017/6/1,雲林縣,臺西鄉,8706,24072,12888,11184
2017/6/1,雲林縣,元長鄉,9294,26181,14323,11858
2017/6/1,雲林縣,四湖鄉,8811,23896,12954,10942
2017/6/1,雲林縣,口湖鄉,9496,27855,14812,13043
2017/6/1,雲林縣,水林鄉,9981,25757,14106,11651
2017/6/1,嘉義縣,太保市,12789,37580,19314,18266
2017/6/1,嘉義縣,朴子市,15695,42559,21537,21022
2017/6/1,嘉義縣,布袋鎮,9969,27305,13953,13352
2017/6/1,嘉義縣,大林鎮,11389,31311,16032,15279
2017/6/1,嘉義縣,民雄鄉,24781,71771,36778,34993
2017/6/1,嘉義縣,溪口鄉,5364,14826,7925,6901
2017/6/1,嘉義縣,新港鄉,10635,32221,16969,15252
2017/6/1,嘉義縣,六腳鄉,8910,23520,12497,11023
2017/6/1,嘉義縣,東石鄉,9263,25085,13288,11797
2017/6/1,嘉義縣,義竹鄉,7436,18635,9684,8951
2017/6/1,嘉義縣,鹿草鄉,5774,15664,8416,7248
2017/6/1,嘉義縣,水上鄉,18056,49864,25726,24138
2017/6/1,嘉義縣,中埔鄉,15972,45136,23495,21641
2017/6/1,嘉義縣,竹崎鄉,11713,36080,19243,16837
2017/6/1,嘉義縣,梅山鄉,6755,19640,10462,9178
2017/6/1,嘉義縣,番路鄉,4264,11666,6314,5352
2017/6/1,嘉義縣,大埔鄉,1942,4585,2381,2204
2017/6/1,嘉義縣,阿里山鄉,1939,5634,2976,2658
2017/6/1,屏東縣,屏東市,74100,200995,99463,101532
2017/6/1,屏東縣,潮州鎮,19445,54648,27302,27346
2017/6/1,屏東縣,東港鎮,16712,48051,24298,23753
2017/6/1,屏東縣,恆春鎮,11544,30653,15726,14927
2017/6/1,屏東縣,萬丹鄉,14944,51077,26475,24602
2017/6/1,屏東縣,長治鄉,10139,30029,15642,14387
2017/6/1,屏東縣,麟洛鄉,3810,11125,5772,5353
2017/6/1,屏東縣,九如鄉,6973,22098,11435,10663
2017/6/1,屏東縣,里港鄉,8184,26730,13602,13128
2017/6/1,屏東縣,鹽埔鄉,7858,26118,13581,12537
2017/6/1,屏東縣,高樹鄉,9293,24716,13142,11574
2017/6/1,屏東縣,萬巒鄉,6511,20619,10795,9824
2017/6/1,屏東縣,內埔鄉,18612,54901,28394,26507
2017/6/1,屏東縣,竹田鄉,5630,17244,9156,8088
2017/6/1,屏東縣,新埤鄉,3419,9861,5236,4625
2017/6/1,屏東縣,枋寮鄉,8524,24709,12950,11759
2017/6/1,屏東縣,新園鄉,11811,35458,18407,17051
2017/6/1,屏東縣,崁頂鄉,4483,15821,8031,7790
2017/6/1,屏東縣,林邊鄉,6756,18192,9309,8883
2017/6/1,屏東縣,南州鄉,3704,10737,5510,5227
2017/6/1,屏東縣,佳冬鄉,6986,19544,10143,9401
2017/6/1,屏東縣,琉球鄉,4465,12379,6809,5570
2017/6/1,屏東縣,車城鄉,3464,8663,4664,3999
2017/6/1,屏東縣,滿州鄉,3010,7808,4245,3563
2017/6/1,屏東縣,枋山鄉,2113,5456,2914,2542
2017/6/1,屏東縣,三地門鄉,2312,7631,3842,3789
2017/6/1,屏東縣,霧臺鄉,1055,3244,1669,1575
2017/6/1,屏東縣,瑪家鄉,2051,6741,3428,3313
2017/6/1,屏東縣,泰武鄉,1328,5240,2757,2483
2017/6/1,屏東縣,來義鄉,2227,7477,3798,3679
2017/6/1,屏東縣,春日鄉,1390,4833,2486,2347
2017/6/1,屏東縣,獅子鄉,1555,4796,2486,2310
2017/6/1,屏東縣,牡丹鄉,1912,4895,2503,2392
2017/6/1,臺東縣,臺東市,39687,106270,53269,53001
2017/6/1,臺東縣,成功鎮,5407,14337,7572,6765
2017/6/1,臺東縣,關山鎮,3177,8770,4566,4204
2017/6/1,臺東縣,卑南鄉,6699,17431,9211,8220
2017/6/1,臺東縣,大武鄉,2498,6131,3204,2927
2017/6/1,臺東縣,太麻里鄉,4656,11193,5968,5225
2017/6/1,臺東縣,東河鄉,3759,8591,4764,3827
2017/6/1,臺東縣,長濱鄉,2922,7293,4127,3166
2017/6/1,臺東縣,鹿野鄉,3050,7982,4261,3721
2017/6/1,臺東縣,池上鄉,3220,8280,4312,3968
2017/6/1,臺東縣,綠島鄉,1123,3804,1996,1808
2017/6/1,臺東縣,延平鄉,1071,3527,1895,1632
2017/6/1,臺東縣,海端鄉,1089,4254,2259,1995
2017/6/1,臺東縣,達仁鄉,1458,3546,1925,1621
2017/6/1,臺東縣,金峰鄉,1125,3639,1864,1775
2017/6/1,臺東縣,蘭嶼鄉,1814,5035,2546,2489
2017/6/1,花蓮縣,花蓮市,41535,104919,50670,54249
2017/6/1,花蓮縣,鳳林鎮,4396,10938,5682,5256
2017/6/1,花蓮縣,玉里鎮,8903,24587,13067,11520
2017/6/1,花蓮縣,新城鄉,7687,20155,10391,9764
2017/6/1,花蓮縣,吉安鄉,31857,83625,42147,41478
2017/6/1,花蓮縣,壽豐鄉,7160,18105,9641,8464
2017/6/1,花蓮縣,光復鄉,5032,12959,6896,6063
2017/6/1,花蓮縣,豐濱鄉,1713,4403,2448,1955
2017/6/1,花蓮縣,瑞穗鄉,4736,11677,6302,5375
2017/6/1,花蓮縣,富里鄉,4021,10456,5687,4769
2017/6/1,花蓮縣,秀林鄉,4795,15753,8131,7622
2017/6/1,花蓮縣,萬榮鄉,2093,6363,3373,2990
2017/6/1,花蓮縣,卓溪鄉,1693,6036,3314,2722
2017/6/1,澎湖縣,馬公市,24020,61727,31393,30334
2017/6/1,澎湖縣,湖西鄉,5522,14457,7611,6846
2017/6/1,澎湖縣,白沙鄉,3390,9805,5146,4659
2017/6/1,澎湖縣,西嶼鄉,2993,8395,4329,4066
2017/6/1,澎湖縣,望安鄉,2023,5195,2805,2390
2017/6/1,澎湖縣,七美鄉,1373,3827,1999,1828
2017/6/1,基隆市,中正區,22572,52376,26782,25594
2017/6/1,基隆市,七堵區,21345,54051,27192,26859
2017/6/1,基隆市,暖暖區,15619,38609,19381,19228
2017/6/1,基隆市,仁愛區,19250,44734,22133,22601
2017/6/1,基隆市,中山區,19255,47974,24320,23654
2017/6/1,基隆市,安樂區,33244,82245,40714,41531
2017/6/1,基隆市,信義區,21105,51887,25699,26188
2017/6/1,新竹市,東區,78606,211429,104063,107366
2017/6/1,新竹市,北區,56236,150304,73534,76770
2017/6/1,新竹市,香山區,26969,77566,39437,38129
2017/6/1,嘉義市,東區,45411,122294,58983,63311
2017/6/1,嘉義市,西區,53815,147423,72253,75170
2017/6/1,金門縣,金城鎮,12831,43027,21502,21525
2017/6/1,金門縣,金湖鎮,8817,28987,14573,14414
2017/6/1,金門縣,金沙鎮,6283,20394,10088,10306
2017/6/1,金門縣,金寧鄉,8413,29884,15041,14843
2017/6/1,金門縣,烈嶼鄉,3118,12589,6173,6416
2017/6/1,金門縣,烏坵鄉,134,682,343,339
2017/6/1,連江縣,南竿鄉,1607,7442,4175,3267
2017/6/1,連江縣,北竿鄉,545,2362,1314,1048
2017/6/1,連江縣,莒光鄉,287,1595,966,629
2017/6/1,連江縣,東引鄉,329,1317,789,528
2017/7/1,總計,新北市,1535562,3984051,1953075,2030976
2017/7/1,總計,臺北市,1049309,2687629,1284637,1402992
2017/7/1,總計,桃園市,781687,2171127,1082047,1089080
2017/7/1,總計,臺中市,952503,2778182,1370560,1407622
2017/7/1,總計,臺南市,681214,1886267,942468,943799
2017/7/1,總計,高雄市,1087963,2777873,1376936,1400937
2017/7/1,總計,臺灣省,2478457,7121131,3632771,3488360
2017/7/1,總計,宜蘭縣,167882,456985,231292,225693
2017/7/1,總計,新竹縣,189619,550070,281190,268880
2017/7/1,總計,苗栗縣,186940,555972,286841,269131
2017/7/1,總計,彰化縣,385807,1284045,654805,629240
2017/7/1,總計,南投縣,177820,502932,257730,245202
2017/7/1,總計,雲林縣,239956,692074,359292,332782
2017/7/1,總計,嘉義縣,182705,512792,266824,245968
2017/7/1,總計,屏東縣,286375,832127,425774,406353
2017/7/1,總計,臺東縣,82761,219974,113658,106316
2017/7/1,總計,花蓮縣,125638,329845,167639,162206
2017/7/1,總計,澎湖縣,39294,103419,53282,50137
2017/7/1,總計,基隆市,152454,371853,186184,185669
2017/7/1,總計,新竹市,161970,439435,217068,222367
2017/7/1,總計,嘉義市,99236,269608,131192,138416
2017/7/1,總計,福建省,42459,148543,75104,73439
2017/7/1,總計,金門縣,39679,135816,67860,67956
2017/7/1,總計,連江縣,2780,12727,7244,5483
2017/7/1,新北市,板橋區,207480,551826,269584,282242
2017/7/1,新北市,三重區,150561,388052,191062,196990
2017/7/1,新北市,中和區,164719,413676,201233,212443
2017/7/1,新北市,永和區,90892,223488,106107,117381
2017/7/1,新北市,新莊區,152262,415720,202903,212817
2017/7/1,新北市,新店區,125993,301647,145269,156378
2017/7/1,新北市,樹林區,66335,184347,91967,92380
2017/7/1,新北市,鶯歌區,29723,86827,43539,43288
2017/7/1,新北市,三峽區,42247,114483,57434,57049
2017/7/1,新北市,淡水區,73745,168090,80760,87330
2017/7/1,新北市,汐止區,86498,198734,97035,101699
2017/7/1,新北市,瑞芳區,16171,40501,20450,20051
2017/7/1,新北市,土城區,86774,238383,117690,120693
2017/7/1,新北市,蘆洲區,70685,201248,98914,102334
2017/7/1,新北市,五股區,31125,84585,42710,41875
2017/7/1,新北市,泰山區,28372,78884,39151,39733
2017/7/1,新北市,林口區,41380,104931,51095,53836
2017/7/1,新北市,深坑區,9584,23669,11838,11831
2017/7/1,新北市,石碇區,3368,7678,4224,3454
2017/7/1,新北市,坪林區,2510,6536,3632,2904
2017/7/1,新北市,三芝區,9458,23288,11949,11339
2017/7/1,新北市,石門區,4293,12338,6373,5965
2017/7/1,新北市,八里區,14421,38225,19078,19147
2017/7/1,新北市,平溪區,2312,4724,2613,2111
2017/7/1,新北市,雙溪區,3814,8989,4861,4128
2017/7/1,新北市,貢寮區,4405,12563,6398,6165
2017/7/1,新北市,金山區,7093,22053,10889,11164
2017/7/1,新北市,萬里區,7481,22338,11242,11096
2017/7/1,新北市,烏來區,1861,6228,3075,3153
2017/7/1,臺北市,松山區,80464,207640,97489,110151
2017/7/1,臺北市,信義區,89351,226162,108025,118137
2017/7/1,臺北市,大安區,120670,310811,145279,165532
2017/7/1,臺北市,中山區,99994,230951,107531,123420
2017/7/1,臺北市,中正區,65235,160409,76613,83796
2017/7/1,臺北市,大同區,51660,129420,63092,66328
2017/7/1,臺北市,萬華區,78587,192349,94536,97813
2017/7/1,臺北市,文山區,105181,274553,131782,142771
2017/7/1,臺北市,南港區,46926,122197,59764,62433
2017/7/1,臺北市,內湖區,107611,287592,137433,150159
2017/7/1,臺北市,士林區,107013,288991,139417,149574
2017/7/1,臺北市,北投區,96617,256554,123676,132878
2017/7/1,桃園市,桃園區,164638,438271,212949,225322
2017/7/1,桃園市,中壢區,147433,401425,198010,203415
2017/7/1,桃園市,大溪區,32194,94377,48105,46272
2017/7/1,桃園市,楊梅區,57213,165979,83712,82267
2017/7/1,桃園市,蘆竹區,57574,160566,79845,80721
2017/7/1,桃園市,大園區,32427,88526,45298,43228
2017/7/1,桃園市,龜山區,60377,155530,77598,77932
2017/7/1,桃園市,八德區,69584,195860,98182,97678
2017/7/1,桃園市,龍潭區,41423,121189,60797,60392
2017/7/1,桃園市,平鎮區,76466,223237,110986,112251
2017/7/1,桃園市,新屋區,16145,48810,25993,22817
2017/7/1,桃園市,觀音區,22439,65995,34388,31607
2017/7/1,桃園市,復興區,3774,11362,6184,5178
2017/7/1,臺中市,中區,7922,18570,9229,9341
2017/7/1,臺中市,東區,27778,75718,37707,38011
2017/7/1,臺中市,南區,47959,124259,59706,64553
2017/7/1,臺中市,西區,45644,115745,54964,60781
2017/7/1,臺中市,北區,59216,147602,70670,76932
2017/7/1,臺中市,西屯區,85162,226004,108634,117370
2017/7/1,臺中市,南屯區,61538,167874,80297,87577
2017/7/1,臺中市,北屯區,99171,272889,131053,141836
2017/7/1,臺中市,豐原區,53383,166806,82459,84347
2017/7/1,臺中市,東勢區,17408,50815,26129,24686
2017/7/1,臺中市,大甲區,23008,77745,39099,38646
2017/7/1,臺中市,清水區,27056,86417,44353,42064
2017/7/1,臺中市,沙鹿區,29225,92136,46548,45588
2017/7/1,臺中市,梧棲區,17646,57837,29063,28774
2017/7/1,臺中市,后里區,16160,54417,27659,26758
2017/7/1,臺中市,神岡區,19380,65552,33479,32073
2017/7/1,臺中市,潭子區,36185,107985,53378,54607
2017/7/1,臺中市,大雅區,29423,95011,47433,47578
2017/7/1,臺中市,新社區,7547,24831,12883,11948
2017/7/1,臺中市,石岡區,4894,15087,7838,7249
2017/7/1,臺中市,外埔區,9677,32012,16421,15591
2017/7/1,臺中市,大安區,5459,19363,10230,9133
2017/7/1,臺中市,烏日區,24337,74164,37255,36909
2017/7/1,臺中市,大肚區,17570,57281,29242,28039
2017/7/1,臺中市,龍井區,22911,77346,39006,38340
2017/7/1,臺中市,霧峰區,20135,65228,33093,32135
2017/7/1,臺中市,太平區,62983,187569,93085,94484
2017/7/1,臺中市,大里區,69184,211059,103800,107259
2017/7/1,臺中市,和平區,4542,10860,5847,5013
2017/7/1,臺南市,新營區,28962,78097,38631,39466
2017/7/1,臺南市,鹽水區,10058,25661,13411,12250
2017/7/1,臺南市,白河區,10855,28653,14961,13692
2017/7/1,臺南市,柳營區,7901,21412,11173,10239
2017/7/1,臺南市,後壁區,8888,23874,12430,11444
2017/7/1,臺南市,東山區,8407,21131,11229,9902
2017/7/1,臺南市,麻豆區,15779,44718,22733,21985
2017/7/1,臺南市,下營區,9107,24373,12585,11788
2017/7/1,臺南市,六甲區,7746,22369,11582,10787
2017/7/1,臺南市,官田區,7931,21482,10937,10545
2017/7/1,臺南市,大內區,3887,9869,5283,4586
2017/7/1,臺南市,佳里區,20602,59510,29524,29986
2017/7/1,臺南市,學甲區,9645,26170,13379,12791
2017/7/1,臺南市,西港區,8168,24786,12533,12253
2017/7/1,臺南市,七股區,8063,23033,11916,11117
2017/7/1,臺南市,將軍區,7294,19910,10130,9780
2017/7/1,臺南市,北門區,4266,11220,5683,5537
2017/7/1,臺南市,新化區,14401,43710,22257,21453
2017/7/1,臺南市,善化區,17476,48044,24183,23861
2017/7/1,臺南市,新市區,12155,36363,18272,18091
2017/7/1,臺南市,安定區,10049,30529,15662,14867
2017/7/1,臺南市,山上區,2704,7329,3840,3489
2017/7/1,臺南市,玉井區,5149,14178,7342,6836
2017/7/1,臺南市,楠西區,3520,9785,5178,4607
2017/7/1,臺南市,南化區,2869,8779,4741,4038
2017/7/1,臺南市,左鎮區,1976,4906,2756,2150
2017/7/1,臺南市,仁德區,27522,75224,38125,37099
2017/7/1,臺南市,歸仁區,22619,68412,34765,33647
2017/7/1,臺南市,關廟區,11087,34434,17775,16659
2017/7/1,臺南市,龍崎區,1539,4061,2170,1891
2017/7/1,臺南市,永康區,83620,233248,114955,118293
2017/7/1,臺南市,東區,71846,187262,89822,97440
2017/7/1,臺南市,南區,45521,125646,62231,63415
2017/7/1,臺南市,北區,50704,132761,64640,68121
2017/7/1,臺南市,安南區,62470,191821,96709,95112
2017/7/1,臺南市,安平區,25416,66107,31372,34735
2017/7/1,臺南市,中西區,31012,77400,37553,39847
2017/7/1,高雄市,鹽埕區,10796,24413,12084,12329
2017/7/1,高雄市,鼓山區,57645,138537,66934,71603
2017/7/1,高雄市,左營區,78733,197072,94818,102254
2017/7/1,高雄市,楠梓區,69730,182905,89926,92979
2017/7/1,高雄市,三民區,136557,344265,166670,177595
2017/7/1,高雄市,新興區,22714,51166,24625,26541
2017/7/1,高雄市,前金區,12617,27126,12976,14150
2017/7/1,高雄市,苓雅區,72112,171751,82761,88990
2017/7/1,高雄市,前鎮區,78652,190458,93660,96798
2017/7/1,高雄市,旗津區,11126,28781,14856,13925
2017/7/1,高雄市,小港區,67742,157274,78165,79109
2017/7/1,高雄市,鳳山區,139997,358708,175977,182731
2017/7/1,高雄市,林園區,25819,70027,35436,34591
2017/7/1,高雄市,大寮區,42098,112324,57530,54794
2017/7/1,高雄市,大樹區,13595,42850,21978,20872
2017/7/1,高雄市,大社區,12926,34537,17560,16977
2017/7/1,高雄市,仁武區,32597,85101,43253,41848
2017/7/1,高雄市,鳥松區,18215,44293,22468,21825
2017/7/1,高雄市,岡山區,34888,97439,48412,49027
2017/7/1,高雄市,橋頭區,13574,37590,19068,18522
2017/7/1,高雄市,燕巢區,10503,29888,15777,14111
2017/7/1,高雄市,田寮區,3289,7275,4028,3247
2017/7/1,高雄市,阿蓮區,9427,28967,14622,14345
2017/7/1,高雄市,路竹區,17030,52839,26989,25850
2017/7/1,高雄市,湖內區,10830,29840,15219,14621
2017/7/1,高雄市,茄萣區,10517,30327,15650,14677
2017/7/1,高雄市,永安區,5746,13982,7027,6955
2017/7/1,高雄市,彌陀區,6797,19431,10000,9431
2017/7/1,高雄市,梓官區,12638,36167,18589,17578
2017/7/1,高雄市,旗山區,13759,37148,19223,17925
2017/7/1,高雄市,美濃區,14718,40199,21069,19130
2017/7/1,高雄市,六龜區,5564,13093,7047,6046
2017/7/1,高雄市,甲仙區,2330,6138,3263,2875
2017/7/1,高雄市,杉林區,4803,12098,6601,5497
2017/7/1,高雄市,內門區,5110,14614,7915,6699
2017/7/1,高雄市,茂林區,590,1913,949,964
2017/7/1,高雄市,桃源區,1330,4234,2217,2017
2017/7/1,高雄市,那瑪夏區,849,3103,1594,1509
2017/7/1,宜蘭縣,宜蘭市,36149,95912,46777,49135
2017/7/1,宜蘭縣,羅東鎮,26366,72387,34318,38069
2017/7/1,宜蘭縣,蘇澳鎮,14152,40226,20481,19745
2017/7/1,宜蘭縣,頭城鎮,10260,29552,15222,14330
2017/7/1,宜蘭縣,礁溪鄉,13995,35815,18643,17172
2017/7/1,宜蘭縣,壯圍鄉,8795,24233,12857,11376
2017/7/1,宜蘭縣,員山鄉,11725,32438,17193,15245
2017/7/1,宜蘭縣,冬山鄉,19237,53397,27385,26012
2017/7/1,宜蘭縣,五結鄉,14855,39668,20506,19162
2017/7/1,宜蘭縣,三星鄉,8528,21411,11551,9860
2017/7/1,宜蘭縣,大同鄉,1884,6083,3291,2792
2017/7/1,宜蘭縣,南澳鄉,1936,5863,3068,2795
2017/7/1,新竹縣,竹北市,64600,179602,89435,90167
2017/7/1,新竹縣,關西鎮,9519,29133,15600,13533
2017/7/1,新竹縣,新埔鎮,10734,33591,17900,15691
2017/7/1,新竹縣,竹東鎮,33776,96940,48683,48257
2017/7/1,新竹縣,湖口鄉,26428,77502,39281,38221
2017/7/1,新竹縣,橫山鄉,4465,13171,7132,6039
2017/7/1,新竹縣,新豐鄉,18322,56669,29088,27581
2017/7/1,新竹縣,芎林鄉,6492,20031,10622,9409
2017/7/1,新竹縣,寶山鄉,5471,14467,7827,6640
2017/7/1,新竹縣,北埔鄉,3122,9466,5143,4323
2017/7/1,新竹縣,峨眉鄉,2073,5559,3068,2491
2017/7/1,新竹縣,尖石鄉,2857,9395,4961,4434
2017/7/1,新竹縣,五峰鄉,1760,4544,2450,2094
2017/7/1,苗栗縣,苗栗市,31184,89506,44696,44810
2017/7/1,苗栗縣,頭份市,34371,103105,52041,51064
2017/7/1,苗栗縣,苑裡鎮,14617,46366,24164,22202
2017/7/1,苗栗縣,通霄鎮,11598,34995,18454,16541
2017/7/1,苗栗縣,竹南鎮,28913,85337,43079,42258
2017/7/1,苗栗縣,後龍鎮,11931,37003,19524,17479
2017/7/1,苗栗縣,卓蘭鎮,6052,17301,9048,8253
2017/7/1,苗栗縣,大湖鄉,5395,14874,7901,6973
2017/7/1,苗栗縣,公館鄉,10691,33980,17725,16255
2017/7/1,苗栗縣,銅鑼鄉,6156,18312,9732,8580
2017/7/1,苗栗縣,南庄鄉,3944,10252,5638,4614
2017/7/1,苗栗縣,頭屋鄉,3653,10934,5808,5126
2017/7/1,苗栗縣,三義鄉,5590,16663,8794,7869
2017/7/1,苗栗縣,西湖鄉,2657,7228,4020,3208
2017/7/1,苗栗縣,造橋鄉,4123,13028,6870,6158
2017/7/1,苗栗縣,三灣鄉,2402,6800,3721,3079
2017/7/1,苗栗縣,獅潭鄉,1712,4437,2485,1952
2017/7/1,苗栗縣,泰安鄉,1951,5851,3141,2710
2017/7/1,彰化縣,彰化市,76164,234053,115720,118333
2017/7/1,彰化縣,員林市,39060,124604,61930,62674
2017/7/1,彰化縣,鹿港鎮,24395,86701,44096,42605
2017/7/1,彰化縣,和美鎮,26671,91070,46404,44666
2017/7/1,彰化縣,北斗鎮,10657,33310,16795,16515
2017/7/1,彰化縣,溪湖鎮,16309,55697,28257,27440
2017/7/1,彰化縣,田中鎮,13126,42015,21654,20361
2017/7/1,彰化縣,二林鎮,15018,51215,26388,24827
2017/7/1,彰化縣,線西鄉,4392,16896,8688,8208
2017/7/1,彰化縣,伸港鄉,9914,36837,18816,18021
2017/7/1,彰化縣,福興鄉,12763,47392,24706,22686
2017/7/1,彰化縣,秀水鄉,10681,39337,20303,19034
2017/7/1,彰化縣,花壇鄉,14049,46009,23589,22420
2017/7/1,彰化縣,芬園鄉,6825,23772,12484,11288
2017/7/1,彰化縣,大村鄉,11114,36840,19023,17817
2017/7/1,彰化縣,埔鹽鄉,9041,32646,17147,15499
2017/7/1,彰化縣,埔心鄉,10548,34876,17979,16897
2017/7/1,彰化縣,永靖鄉,10932,37542,19445,18097
2017/7/1,彰化縣,社頭鄉,12899,43302,22263,21039
2017/7/1,彰化縣,二水鄉,5292,15377,8066,7311
2017/7/1,彰化縣,田尾鄉,7953,27482,14192,13290
2017/7/1,彰化縣,埤頭鄉,9026,30660,15923,14737
2017/7/1,彰化縣,芳苑鄉,10133,33809,17873,15936
2017/7/1,彰化縣,大城鄉,5261,17071,9208,7863
2017/7/1,彰化縣,竹塘鄉,4602,15367,8083,7284
2017/7/1,彰化縣,溪州鄉,8982,30165,15773,14392
2017/7/1,南投縣,南投市,34664,100579,50361,50218
2017/7/1,南投縣,埔里鎮,29023,81369,40576,40793
2017/7/1,南投縣,草屯鎮,33167,98180,49668,48512
2017/7/1,南投縣,竹山鎮,20123,55341,28390,26951
2017/7/1,南投縣,集集鎮,4287,10921,5678,5243
2017/7/1,南投縣,名間鄉,12635,38974,20529,18445
2017/7/1,南投縣,鹿谷鄉,7918,17865,9538,8327
2017/7/1,南投縣,中寮鄉,5639,14982,8144,6838
2017/7/1,南投縣,魚池鄉,5759,16044,8439,7605
2017/7/1,南投縣,國姓鄉,7270,18880,10212,8668
2017/7/1,南投縣,水里鄉,7154,17903,9390,8513
2017/7/1,南投縣,信義鄉,5272,16263,8727,7536
2017/7/1,南投縣,仁愛鄉,4909,15631,8078,7553
2017/7/1,雲林縣,斗六市,38122,108589,54053,54536
2017/7/1,雲林縣,斗南鎮,15847,45080,22922,22158
2017/7/1,雲林縣,虎尾鎮,24943,70990,35974,35016
2017/7/1,雲林縣,西螺鎮,14645,46390,23475,22915
2017/7/1,雲林縣,土庫鎮,9351,29043,15171,13872
2017/7/1,雲林縣,北港鎮,15912,40440,20909,19531
2017/7/1,雲林縣,古坑鄉,10974,31776,16746,15030
2017/7/1,雲林縣,大埤鄉,6695,19339,10379,8960
2017/7/1,雲林縣,莿桐鄉,9332,28966,15209,13757
2017/7/1,雲林縣,林內鄉,5997,18381,9619,8762
2017/7/1,雲林縣,二崙鄉,8937,27344,14621,12723
2017/7/1,雲林縣,崙背鄉,8502,24849,13131,11718
2017/7/1,雲林縣,麥寮鄉,14270,45239,22757,22482
2017/7/1,雲林縣,東勢鄉,5737,14996,8274,6722
2017/7/1,雲林縣,褒忠鄉,4438,13057,7040,6017
2017/7/1,雲林縣,臺西鄉,8703,24048,12881,11167
2017/7/1,雲林縣,元長鄉,9294,26144,14305,11839
2017/7/1,雲林縣,四湖鄉,8798,23848,12934,10914
2017/7/1,雲林縣,口湖鄉,9491,27821,14792,13029
2017/7/1,雲林縣,水林鄉,9968,25734,14100,11634
2017/7/1,嘉義縣,太保市,12819,37615,19338,18277
2017/7/1,嘉義縣,朴子市,15696,42521,21504,21017
2017/7/1,嘉義縣,布袋鎮,9969,27285,13931,13354
2017/7/1,嘉義縣,大林鎮,11388,31271,16017,15254
2017/7/1,嘉義縣,民雄鄉,24821,71793,36774,35019
2017/7/1,嘉義縣,溪口鄉,5359,14812,7920,6892
2017/7/1,嘉義縣,新港鄉,10634,32177,16931,15246
2017/7/1,嘉義縣,六腳鄉,8905,23505,12492,11013
2017/7/1,嘉義縣,東石鄉,9260,25087,13288,11799
2017/7/1,嘉義縣,義竹鄉,7428,18592,9670,8922
2017/7/1,嘉義縣,鹿草鄉,5774,15651,8407,7244
2017/7/1,嘉義縣,水上鄉,18063,49835,25721,24114
2017/7/1,嘉義縣,中埔鄉,15983,45075,23479,21596
2017/7/1,嘉義縣,竹崎鄉,11709,36070,19234,16836
2017/7/1,嘉義縣,梅山鄉,6758,19626,10452,9174
2017/7/1,嘉義縣,番路鄉,4263,11665,6310,5355
2017/7/1,嘉義縣,大埔鄉,1939,4585,2387,2198
2017/7/1,嘉義縣,阿里山鄉,1937,5627,2969,2658
2017/7/1,屏東縣,屏東市,74127,200926,99427,101499
2017/7/1,屏東縣,潮州鎮,19445,54667,27307,27360
2017/7/1,屏東縣,東港鎮,16703,48027,24267,23760
2017/7/1,屏東縣,恆春鎮,11555,30667,15733,14934
2017/7/1,屏東縣,萬丹鄉,14950,51063,26469,24594
2017/7/1,屏東縣,長治鄉,10147,30037,15648,14389
2017/7/1,屏東縣,麟洛鄉,3807,11112,5768,5344
2017/7/1,屏東縣,九如鄉,6969,22094,11429,10665
2017/7/1,屏東縣,里港鄉,8188,26657,13578,13079
2017/7/1,屏東縣,鹽埔鄉,7855,26108,13572,12536
2017/7/1,屏東縣,高樹鄉,9296,24702,13147,11555
2017/7/1,屏東縣,萬巒鄉,6512,20595,10787,9808
2017/7/1,屏東縣,內埔鄉,18619,54872,28379,26493
2017/7/1,屏東縣,竹田鄉,5620,17233,9148,8085
2017/7/1,屏東縣,新埤鄉,3417,9855,5235,4620
2017/7/1,屏東縣,枋寮鄉,8531,24694,12934,11760
2017/7/1,屏東縣,新園鄉,11815,35450,18395,17055
2017/7/1,屏東縣,崁頂鄉,4483,15798,8020,7778
2017/7/1,屏東縣,林邊鄉,6753,18183,9316,8867
2017/7/1,屏東縣,南州鄉,3704,10749,5518,5231
2017/7/1,屏東縣,佳冬鄉,6989,19505,10123,9382
2017/7/1,屏東縣,琉球鄉,4465,12363,6798,5565
2017/7/1,屏東縣,車城鄉,3467,8658,4659,3999
2017/7/1,屏東縣,滿州鄉,3010,7803,4243,3560
2017/7/1,屏東縣,枋山鄉,2109,5449,2909,2540
2017/7/1,屏東縣,三地門鄉,2312,7637,3848,3789
2017/7/1,屏東縣,霧臺鄉,1055,3223,1654,1569
2017/7/1,屏東縣,瑪家鄉,2048,6749,3427,3322
2017/7/1,屏東縣,泰武鄉,1330,5236,2757,2479
2017/7/1,屏東縣,來義鄉,2230,7484,3795,3689
2017/7/1,屏東縣,春日鄉,1392,4839,2490,2349
2017/7/1,屏東縣,獅子鄉,1555,4789,2486,2303
2017/7/1,屏東縣,牡丹鄉,1917,4903,2508,2395
2017/7/1,臺東縣,臺東市,39680,106200,53229,52971
2017/7/1,臺東縣,成功鎮,5405,14338,7575,6763
2017/7/1,臺東縣,關山鎮,3176,8768,4561,4207
2017/7/1,臺東縣,卑南鄉,6700,17435,9204,8231
2017/7/1,臺東縣,大武鄉,2494,6112,3192,2920
2017/7/1,臺東縣,太麻里鄉,4659,11181,5956,5225
2017/7/1,臺東縣,東河鄉,3756,8583,4753,3830
2017/7/1,臺東縣,長濱鄉,2925,7286,4117,3169
2017/7/1,臺東縣,鹿野鄉,3050,7978,4258,3720
2017/7/1,臺東縣,池上鄉,3217,8278,4316,3962
2017/7/1,臺東縣,綠島鄉,1137,3814,2008,1806
2017/7/1,臺東縣,延平鄉,1071,3529,1897,1632
2017/7/1,臺東縣,海端鄉,1089,4241,2254,1987
2017/7/1,臺東縣,達仁鄉,1459,3537,1921,1616
2017/7/1,臺東縣,金峰鄉,1125,3641,1869,1772
2017/7/1,臺東縣,蘭嶼鄉,1818,5053,2548,2505
2017/7/1,花蓮縣,花蓮市,41507,104828,50621,54207
2017/7/1,花蓮縣,鳳林鎮,4398,10935,5679,5256
2017/7/1,花蓮縣,玉里鎮,8901,24526,13023,11503
2017/7/1,花蓮縣,新城鄉,7693,20141,10385,9756
2017/7/1,花蓮縣,吉安鄉,31896,83658,42145,41513
2017/7/1,花蓮縣,壽豐鄉,7179,18114,9641,8473
2017/7/1,花蓮縣,光復鄉,5026,12947,6889,6058
2017/7/1,花蓮縣,豐濱鄉,1710,4390,2445,1945
2017/7/1,花蓮縣,瑞穗鄉,4733,11672,6303,5369
2017/7/1,花蓮縣,富里鄉,4021,10441,5679,4762
2017/7/1,花蓮縣,秀林鄉,4792,15783,8140,7643
2017/7/1,花蓮縣,萬榮鄉,2092,6374,3374,3000
2017/7/1,花蓮縣,卓溪鄉,1690,6036,3315,2721
2017/7/1,澎湖縣,馬公市,24000,61721,31375,30346
2017/7/1,澎湖縣,湖西鄉,5517,14454,7610,6844
2017/7/1,澎湖縣,白沙鄉,3386,9793,5136,4657
2017/7/1,澎湖縣,西嶼鄉,2992,8411,4341,4070
2017/7/1,澎湖縣,望安鄉,2024,5195,2809,2386
2017/7/1,澎湖縣,七美鄉,1375,3845,2011,1834
2017/7/1,基隆市,中正區,22582,52303,26748,25555
2017/7/1,基隆市,七堵區,21364,54054,27197,26857
2017/7/1,基隆市,暖暖區,15621,38619,19384,19235
2017/7/1,基隆市,仁愛區,19242,44685,22100,22585
2017/7/1,基隆市,中山區,19269,47966,24311,23655
2017/7/1,基隆市,安樂區,33253,82278,40715,41563
2017/7/1,基隆市,信義區,21123,51948,25729,26219
2017/7/1,新竹市,東區,78701,211505,104103,107402
2017/7/1,新竹市,北區,56281,150278,73504,76774
2017/7/1,新竹市,香山區,26988,77652,39461,38191
2017/7/1,嘉義市,東區,45410,122263,58958,63305
2017/7/1,嘉義市,西區,53826,147345,72234,75111
2017/7/1,金門縣,金城鎮,12853,43106,21543,21563
2017/7/1,金門縣,金湖鎮,8840,29102,14624,14478
2017/7/1,金門縣,金沙鎮,6284,20414,10100,10314
2017/7/1,金門縣,金寧鄉,8449,29897,15052,14845
2017/7/1,金門縣,烈嶼鄉,3119,12614,6195,6419
2017/7/1,金門縣,烏坵鄉,134,683,346,337
2017/7/1,連江縣,南竿鄉,1618,7457,4184,3273
2017/7/1,連江縣,北竿鄉,546,2362,1310,1052
2017/7/1,連江縣,莒光鄉,287,1586,957,629
2017/7/1,連江縣,東引鄉,329,1322,793,529
2017/8/1,總計,新北市,1537861,3984720,1953089,2031631
2017/8/1,總計,臺北市,1049953,2685202,1283373,1401829
2017/8/1,總計,桃園市,784383,2174895,1083834,1091061
2017/8/1,總計,臺中市,954403,2780155,1371360,1408795
2017/8/1,總計,臺南市,682167,1886145,942334,943811
2017/8/1,總計,高雄市,1089725,2777564,1376688,1400876
2017/8/1,總計,臺灣省,2481475,7118728,3631160,3487568
2017/8/1,總計,宜蘭縣,168219,456904,231249,225655
2017/8/1,總計,新竹縣,190085,550621,281435,269186
2017/8/1,總計,苗栗縣,187235,555485,286612,268873
2017/8/1,總計,彰化縣,386307,1283426,654465,628961
2017/8/1,總計,南投縣,177932,502482,257490,244992
2017/8/1,總計,雲林縣,240155,691673,359049,332624
2017/8/1,總計,嘉義縣,182823,512548,266639,245909
2017/8/1,總計,屏東縣,286598,831629,425446,406183
2017/8/1,總計,臺東縣,82833,219879,113573,106306
2017/8/1,總計,花蓮縣,125682,329676,167552,162124
2017/8/1,總計,澎湖縣,39331,103412,53272,50140
2017/8/1,總計,基隆市,152624,371819,186123,185696
2017/8/1,總計,新竹市,162352,439747,217175,222572
2017/8/1,總計,嘉義市,99299,269427,131080,138347
2017/8/1,總計,福建省,42579,148760,75209,73551
2017/8/1,總計,金門縣,39776,136004,67952,68052
2017/8/1,總計,連江縣,2803,12756,7257,5499
2017/8/1,新北市,板橋區,207783,551795,269520,282275
2017/8/1,新北市,三重區,150684,387931,190974,196957
2017/8/1,新北市,中和區,164915,413583,201179,212404
2017/8/1,新北市,永和區,90955,223185,105940,117245
2017/8/1,新北市,新莊區,152500,415820,202943,212877
2017/8/1,新北市,新店區,126178,301819,145302,156517
2017/8/1,新北市,樹林區,66389,184232,91919,92313
2017/8/1,新北市,鶯歌區,29729,86730,43486,43244
2017/8/1,新北市,三峽區,42365,114603,57498,57105
2017/8/1,新北市,淡水區,74016,168536,80920,87616
2017/8/1,新北市,汐止區,86667,198948,97116,101832
2017/8/1,新北市,瑞芳區,16200,40460,20443,20017
2017/8/1,新北市,土城區,86878,238406,117660,120746
2017/8/1,新北市,蘆洲區,70784,201331,98908,102423
2017/8/1,新北市,五股區,31218,84680,42736,41944
2017/8/1,新北市,泰山區,28411,78911,39161,39750
2017/8/1,新北市,林口區,41534,105192,51229,53963
2017/8/1,新北市,深坑區,9608,23684,11845,11839
2017/8/1,新北市,石碇區,3368,7668,4220,3448
2017/8/1,新北市,坪林區,2513,6540,3638,2902
2017/8/1,新北市,三芝區,9451,23240,11939,11301
2017/8/1,新北市,石門區,4292,12321,6368,5953
2017/8/1,新北市,八里區,14459,38308,19117,19191
2017/8/1,新北市,平溪區,2309,4716,2609,2107
2017/8/1,新北市,雙溪區,3809,8956,4850,4106
2017/8/1,新北市,貢寮區,4404,12534,6391,6143
2017/8/1,新北市,金山區,7100,22032,10869,11163
2017/8/1,新北市,萬里區,7481,22335,11236,11099
2017/8/1,新北市,烏來區,1861,6224,3073,3151
2017/8/1,臺北市,松山區,80445,207194,97268,109926
2017/8/1,臺北市,信義區,89419,226046,107928,118118
2017/8/1,臺北市,大安區,120633,310302,145030,165272
2017/8/1,臺北市,中山區,100180,230881,107486,123395
2017/8/1,臺北市,中正區,65217,160138,76461,83677
2017/8/1,臺北市,大同區,51698,129306,63056,66250
2017/8/1,臺北市,萬華區,78655,192150,94435,97715
2017/8/1,臺北市,文山區,105257,274312,131683,142629
2017/8/1,臺北市,南港區,46988,122177,59741,62436
2017/8/1,臺北市,內湖區,107707,287496,137368,150128
2017/8/1,臺北市,士林區,107067,288704,139306,149398
2017/8/1,臺北市,北投區,96687,256496,123611,132885
2017/8/1,桃園市,桃園區,165075,438704,213154,225550
2017/8/1,桃園市,中壢區,148100,402327,198418,203909
2017/8/1,桃園市,大溪區,32258,94351,48115,46236
2017/8/1,桃園市,楊梅區,57421,166409,83912,82497
2017/8/1,桃園市,蘆竹區,57785,160909,80009,80900
2017/8/1,桃園市,大園區,32578,88669,45339,43330
2017/8/1,桃園市,龜山區,60651,156059,77859,78200
2017/8/1,桃園市,八德區,69910,196496,98500,97996
2017/8/1,桃園市,龍潭區,41499,121246,60807,60439
2017/8/1,桃園市,平鎮區,76619,223337,111034,112303
2017/8/1,桃園市,新屋區,16179,48857,26023,22834
2017/8/1,桃園市,觀音區,22527,66132,34466,31666
2017/8/1,桃園市,復興區,3781,11399,6198,5201
2017/8/1,臺中市,中區,7900,18471,9176,9295
2017/8/1,臺中市,東區,27823,75769,37726,38043
2017/8/1,臺中市,南區,48115,124522,59800,64722
2017/8/1,臺中市,西區,45659,115700,54967,60733
2017/8/1,臺中市,北區,59265,147518,70610,76908
2017/8/1,臺中市,西屯區,85356,226143,108694,117449
2017/8/1,臺中市,南屯區,61685,168031,80349,87682
2017/8/1,臺中市,北屯區,99470,273419,131315,142104
2017/8/1,臺中市,豐原區,53453,166830,82476,84354
2017/8/1,臺中市,東勢區,17425,50821,26136,24685
2017/8/1,臺中市,大甲區,23019,77694,39097,38597
2017/8/1,臺中市,清水區,27098,86444,44372,42072
2017/8/1,臺中市,沙鹿區,29301,92221,46571,45650
2017/8/1,臺中市,梧棲區,17674,57838,29072,28766
2017/8/1,臺中市,后里區,16174,54388,27640,26748
2017/8/1,臺中市,神岡區,19379,65485,33452,32033
2017/8/1,臺中市,潭子區,36250,108093,53404,54689
2017/8/1,臺中市,大雅區,29499,95119,47477,47642
2017/8/1,臺中市,新社區,7554,24832,12888,11944
2017/8/1,臺中市,石岡區,4890,15084,7828,7256
2017/8/1,臺中市,外埔區,9700,32077,16439,15638
2017/8/1,臺中市,大安區,5472,19335,10209,9126
2017/8/1,臺中市,烏日區,24411,74298,37323,36975
2017/8/1,臺中市,大肚區,17613,57337,29282,28055
2017/8/1,臺中市,龍井區,22968,77426,39028,38398
2017/8/1,臺中市,霧峰區,20172,65297,33117,32180
2017/8/1,臺中市,太平區,63254,188031,93281,94750
2017/8/1,臺中市,大里區,69276,211074,103787,107287
2017/8/1,臺中市,和平區,4548,10858,5844,5014
2017/8/1,臺南市,新營區,28979,77985,38593,39392
2017/8/1,臺南市,鹽水區,10051,25613,13381,12232
2017/8/1,臺南市,白河區,10855,28642,14955,13687
2017/8/1,臺南市,柳營區,7895,21385,11159,10226
2017/8/1,臺南市,後壁區,8884,23819,12398,11421
2017/8/1,臺南市,東山區,8404,21117,11226,9891
2017/8/1,臺南市,麻豆區,15796,44675,22711,21964
2017/8/1,臺南市,下營區,9113,24339,12567,11772
2017/8/1,臺南市,六甲區,7757,22354,11570,10784
2017/8/1,臺南市,官田區,7946,21505,10958,10547
2017/8/1,臺南市,大內區,3882,9836,5268,4568
2017/8/1,臺南市,佳里區,20621,59474,29507,29967
2017/8/1,臺南市,學甲區,9649,26153,13354,12799
2017/8/1,臺南市,西港區,8174,24773,12528,12245
2017/8/1,臺南市,七股區,8075,23048,11915,11133
2017/8/1,臺南市,將軍區,7286,19879,10122,9757
2017/8/1,臺南市,北門區,4262,11208,5668,5540
2017/8/1,臺南市,新化區,14416,43711,22257,21454
2017/8/1,臺南市,善化區,17551,48147,24230,23917
2017/8/1,臺南市,新市區,12208,36411,18287,18124
2017/8/1,臺南市,安定區,10070,30553,15695,14858
2017/8/1,臺南市,山上區,2711,7323,3839,3484
2017/8/1,臺南市,玉井區,5151,14169,7326,6843
2017/8/1,臺南市,楠西區,3514,9745,5159,4586
2017/8/1,臺南市,南化區,2870,8790,4748,4042
2017/8/1,臺南市,左鎮區,1974,4892,2745,2147
2017/8/1,臺南市,仁德區,27589,75344,38166,37178
2017/8/1,臺南市,歸仁區,22645,68385,34747,33638
2017/8/1,臺南市,關廟區,11097,34429,17761,16668
2017/8/1,臺南市,龍崎區,1539,4054,2170,1884
2017/8/1,臺南市,永康區,83782,233387,115020,118367
2017/8/1,臺南市,東區,71889,187091,89723,97368
2017/8/1,臺南市,南區,45590,125644,62239,63405
2017/8/1,臺南市,北區,50803,132733,64579,68154
2017/8/1,臺南市,安南區,62585,191960,96797,95163
2017/8/1,臺南市,安平區,25504,66252,31456,34796
2017/8/1,臺南市,中西區,31050,77320,37510,39810
2017/8/1,高雄市,鹽埕區,10794,24363,12066,12297
2017/8/1,高雄市,鼓山區,57849,138764,67043,71721
2017/8/1,高雄市,左營區,78877,197152,94870,102282
2017/8/1,高雄市,楠梓區,70018,183155,89998,93157
2017/8/1,高雄市,三民區,136716,344046,166576,177470
2017/8/1,高雄市,新興區,22767,51178,24639,26539
2017/8/1,高雄市,前金區,12611,27070,12944,14126
2017/8/1,高雄市,苓雅區,72202,171641,82693,88948
2017/8/1,高雄市,前鎮區,78729,190225,93537,96688
2017/8/1,高雄市,旗津區,11129,28746,14841,13905
2017/8/1,高雄市,小港區,67850,157310,78171,79139
2017/8/1,高雄市,鳳山區,140262,358710,175982,182728
2017/8/1,高雄市,林園區,25839,69980,35395,34585
2017/8/1,高雄市,大寮區,42147,112319,57523,54796
2017/8/1,高雄市,大樹區,13597,42794,21940,20854
2017/8/1,高雄市,大社區,12969,34571,17573,16998
2017/8/1,高雄市,仁武區,32756,85363,43365,41998
2017/8/1,高雄市,鳥松區,18241,44243,22441,21802
2017/8/1,高雄市,岡山區,34897,97332,48365,48967
2017/8/1,高雄市,橋頭區,13603,37586,19064,18522
2017/8/1,高雄市,燕巢區,10512,29912,15777,14135
2017/8/1,高雄市,田寮區,3287,7283,4031,3252
2017/8/1,高雄市,阿蓮區,9425,28949,14606,14343
2017/8/1,高雄市,路竹區,17038,52798,26974,25824
2017/8/1,高雄市,湖內區,10845,29841,15235,14606
2017/8/1,高雄市,茄萣區,10515,30284,15631,14653
2017/8/1,高雄市,永安區,5749,13980,7025,6955
2017/8/1,高雄市,彌陀區,6805,19423,9989,9434
2017/8/1,高雄市,梓官區,12635,36169,18603,17566
2017/8/1,高雄市,旗山區,13762,37082,19184,17898
2017/8/1,高雄市,美濃區,14717,40130,21031,19099
2017/8/1,高雄市,六龜區,5565,13065,7029,6036
2017/8/1,高雄市,甲仙區,2330,6140,3262,2878
2017/8/1,高雄市,杉林區,4803,12095,6594,5501
2017/8/1,高雄市,內門區,5114,14617,7924,6693
2017/8/1,高雄市,茂林區,591,1914,953,961
2017/8/1,高雄市,桃源區,1332,4226,2217,2009
2017/8/1,高雄市,那瑪夏區,847,3108,1597,1511
2017/8/1,宜蘭縣,宜蘭市,36236,95930,46789,49141
2017/8/1,宜蘭縣,羅東鎮,26384,72363,34305,38058
2017/8/1,宜蘭縣,蘇澳鎮,14176,40169,20453,19716
2017/8/1,宜蘭縣,頭城鎮,10270,29511,15200,14311
2017/8/1,宜蘭縣,礁溪鄉,14035,35801,18640,17161
2017/8/1,宜蘭縣,壯圍鄉,8815,24221,12852,11369
2017/8/1,宜蘭縣,員山鄉,11729,32481,17208,15273
2017/8/1,宜蘭縣,冬山鄉,19284,53352,27374,25978
2017/8/1,宜蘭縣,五結鄉,14902,39653,20504,19149
2017/8/1,宜蘭縣,三星鄉,8559,21457,11568,9889
2017/8/1,宜蘭縣,大同鄉,1886,6084,3285,2799
2017/8/1,宜蘭縣,南澳鄉,1943,5882,3071,2811
2017/8/1,新竹縣,竹北市,64838,180033,89659,90374
2017/8/1,新竹縣,關西鎮,9483,29094,15574,13520
2017/8/1,新竹縣,新埔鎮,10738,33588,17896,15692
2017/8/1,新竹縣,竹東鎮,33876,97020,48716,48304
2017/8/1,新竹縣,湖口鄉,26481,77515,39273,38242
2017/8/1,新竹縣,橫山鄉,4465,13132,7120,6012
2017/8/1,新竹縣,新豐鄉,18380,56722,29106,27616
2017/8/1,新竹縣,芎林鄉,6500,20061,10635,9426
2017/8/1,新竹縣,寶山鄉,5496,14489,7833,6656
2017/8/1,新竹縣,北埔鄉,3128,9456,5134,4322
2017/8/1,新竹縣,峨眉鄉,2074,5551,3063,2488
2017/8/1,新竹縣,尖石鄉,2866,9415,4977,4438
2017/8/1,新竹縣,五峰鄉,1760,4545,2449,2096
2017/8/1,苗栗縣,苗栗市,31218,89404,44638,44766
2017/8/1,苗栗縣,頭份市,34481,103112,52041,51071
2017/8/1,苗栗縣,苑裡鎮,14635,46246,24107,22139
2017/8/1,苗栗縣,通霄鎮,11602,34907,18421,16486
2017/8/1,苗栗縣,竹南鎮,29020,85440,43122,42318
2017/8/1,苗栗縣,後龍鎮,11944,36961,19505,17456
2017/8/1,苗栗縣,卓蘭鎮,6050,17274,9035,8239
2017/8/1,苗栗縣,大湖鄉,5398,14844,7887,6957
2017/8/1,苗栗縣,公館鄉,10698,33917,17700,16217
2017/8/1,苗栗縣,銅鑼鄉,6157,18289,9719,8570
2017/8/1,苗栗縣,南庄鄉,3939,10224,5622,4602
2017/8/1,苗栗縣,頭屋鄉,3650,10909,5803,5106
2017/8/1,苗栗縣,三義鄉,5586,16638,8779,7859
2017/8/1,苗栗縣,西湖鄉,2655,7229,4023,3206
2017/8/1,苗栗縣,造橋鄉,4135,13023,6877,6146
2017/8/1,苗栗縣,三灣鄉,2403,6798,3716,3082
2017/8/1,苗栗縣,獅潭鄉,1713,4431,2483,1948
2017/8/1,苗栗縣,泰安鄉,1951,5839,3134,2705
2017/8/1,彰化縣,彰化市,76259,233872,115658,118214
2017/8/1,彰化縣,員林市,39140,124520,61885,62635
2017/8/1,彰化縣,鹿港鎮,24423,86723,44114,42609
2017/8/1,彰化縣,和美鎮,26708,91062,46394,44668
2017/8/1,彰化縣,北斗鎮,10681,33311,16795,16516
2017/8/1,彰化縣,溪湖鎮,16323,55656,28224,27432
2017/8/1,彰化縣,田中鎮,13144,41970,21637,20333
2017/8/1,彰化縣,二林鎮,15032,51148,26360,24788
2017/8/1,彰化縣,線西鄉,4399,16901,8684,8217
2017/8/1,彰化縣,伸港鄉,9939,36865,18829,18036
2017/8/1,彰化縣,福興鄉,12790,47359,24688,22671
2017/8/1,彰化縣,秀水鄉,10715,39344,20296,19048
2017/8/1,彰化縣,花壇鄉,14059,45993,23576,22417
2017/8/1,彰化縣,芬園鄉,6829,23775,12492,11283
2017/8/1,彰化縣,大村鄉,11120,36838,19016,17822
2017/8/1,彰化縣,埔鹽鄉,9062,32657,17160,15497
2017/8/1,彰化縣,埔心鄉,10561,34875,17970,16905
2017/8/1,彰化縣,永靖鄉,10937,37479,19409,18070
2017/8/1,彰化縣,社頭鄉,12908,43251,22235,21016
2017/8/1,彰化縣,二水鄉,5292,15368,8057,7311
2017/8/1,彰化縣,田尾鄉,7969,27498,14191,13307
2017/8/1,彰化縣,埤頭鄉,9031,30645,15903,14742
2017/8/1,彰化縣,芳苑鄉,10135,33777,17869,15908
2017/8/1,彰化縣,大城鄉,5257,17047,9195,7852
2017/8/1,彰化縣,竹塘鄉,4613,15366,8079,7287
2017/8/1,彰化縣,溪州鄉,8981,30126,15749,14377
2017/8/1,南投縣,南投市,34696,100449,50299,50150
2017/8/1,南投縣,埔里鎮,29047,81326,40535,40791
2017/8/1,南投縣,草屯鎮,33217,98114,49648,48466
2017/8/1,南投縣,竹山鎮,20125,55278,28351,26927
2017/8/1,南投縣,集集鎮,4298,10927,5689,5238
2017/8/1,南投縣,名間鄉,12635,38940,20508,18432
2017/8/1,南投縣,鹿谷鄉,7921,17843,9525,8318
2017/8/1,南投縣,中寮鄉,5637,14925,8111,6814
2017/8/1,南投縣,魚池鄉,5760,16025,8432,7593
2017/8/1,南投縣,國姓鄉,7268,18865,10212,8653
2017/8/1,南投縣,水里鄉,7157,17890,9383,8507
2017/8/1,南投縣,信義鄉,5268,16241,8705,7536
2017/8/1,南投縣,仁愛鄉,4903,15659,8092,7567
2017/8/1,雲林縣,斗六市,38208,108617,54058,54559
2017/8/1,雲林縣,斗南鎮,15859,45040,22904,22136
2017/8/1,雲林縣,虎尾鎮,24984,70970,35956,35014
2017/8/1,雲林縣,西螺鎮,14645,46319,23434,22885
2017/8/1,雲林縣,土庫鎮,9352,29026,15157,13869
2017/8/1,雲林縣,北港鎮,15932,40425,20910,19515
2017/8/1,雲林縣,古坑鄉,10982,31784,16761,15023
2017/8/1,雲林縣,大埤鄉,6688,19348,10387,8961
2017/8/1,雲林縣,莿桐鄉,9338,28923,15187,13736
2017/8/1,雲林縣,林內鄉,6005,18368,9615,8753
2017/8/1,雲林縣,二崙鄉,8925,27305,14596,12709
2017/8/1,雲林縣,崙背鄉,8507,24810,13108,11702
2017/8/1,雲林縣,麥寮鄉,14284,45295,22777,22518
2017/8/1,雲林縣,東勢鄉,5740,14980,8276,6704
2017/8/1,雲林縣,褒忠鄉,4442,13052,7025,6027
2017/8/1,雲林縣,臺西鄉,8701,24023,12863,11160
2017/8/1,雲林縣,元長鄉,9293,26098,14276,11822
2017/8/1,雲林縣,四湖鄉,8799,23779,12895,10884
2017/8/1,雲林縣,口湖鄉,9504,27775,14770,13005
2017/8/1,雲林縣,水林鄉,9967,25736,14094,11642
2017/8/1,嘉義縣,太保市,12880,37661,19358,18303
2017/8/1,嘉義縣,朴子市,15695,42482,21483,20999
2017/8/1,嘉義縣,布袋鎮,9968,27278,13922,13356
2017/8/1,嘉義縣,大林鎮,11413,31246,16003,15243
2017/8/1,嘉義縣,民雄鄉,24851,71751,36739,35012
2017/8/1,嘉義縣,溪口鄉,5357,14807,7922,6885
2017/8/1,嘉義縣,新港鄉,10640,32105,16891,15214
2017/8/1,嘉義縣,六腳鄉,8892,23459,12461,10998
2017/8/1,嘉義縣,東石鄉,9256,25085,13285,11800
2017/8/1,嘉義縣,義竹鄉,7420,18564,9651,8913
2017/8/1,嘉義縣,鹿草鄉,5773,15645,8406,7239
2017/8/1,嘉義縣,水上鄉,18075,49829,25717,24112
2017/8/1,嘉義縣,中埔鄉,15996,45124,23495,21629
2017/8/1,嘉義縣,竹崎鄉,11716,36065,19225,16840
2017/8/1,嘉義縣,梅山鄉,6760,19590,10434,9156
2017/8/1,嘉義縣,番路鄉,4258,11652,6300,5352
2017/8/1,嘉義縣,大埔鄉,1936,4586,2381,2205
2017/8/1,嘉義縣,阿里山鄉,1937,5619,2966,2653
2017/8/1,屏東縣,屏東市,74190,200803,99346,101457
2017/8/1,屏東縣,潮州鎮,19461,54600,27279,27321
2017/8/1,屏東縣,東港鎮,16706,47958,24229,23729
2017/8/1,屏東縣,恆春鎮,11554,30667,15724,14943
2017/8/1,屏東縣,萬丹鄉,14970,51039,26447,24592
2017/8/1,屏東縣,長治鄉,10161,30056,15671,14385
2017/8/1,屏東縣,麟洛鄉,3810,11118,5768,5350
2017/8/1,屏東縣,九如鄉,6978,22111,11445,10666
2017/8/1,屏東縣,里港鄉,8193,26613,13547,13066
2017/8/1,屏東縣,鹽埔鄉,7859,26088,13563,12525
2017/8/1,屏東縣,高樹鄉,9299,24673,13135,11538
2017/8/1,屏東縣,萬巒鄉,6513,20588,10771,9817
2017/8/1,屏東縣,內埔鄉,18634,54858,28359,26499
2017/8/1,屏東縣,竹田鄉,5627,17198,9130,8068
2017/8/1,屏東縣,新埤鄉,3417,9863,5230,4633
2017/8/1,屏東縣,枋寮鄉,8535,24654,12916,11738
2017/8/1,屏東縣,新園鄉,11825,35436,18387,17049
2017/8/1,屏東縣,崁頂鄉,4487,15767,8016,7751
2017/8/1,屏東縣,林邊鄉,6755,18161,9299,8862
2017/8/1,屏東縣,南州鄉,3707,10728,5508,5220
2017/8/1,屏東縣,佳冬鄉,6996,19497,10122,9375
2017/8/1,屏東縣,琉球鄉,4473,12364,6790,5574
2017/8/1,屏東縣,車城鄉,3470,8651,4654,3997
2017/8/1,屏東縣,滿州鄉,3011,7804,4242,3562
2017/8/1,屏東縣,枋山鄉,2115,5456,2905,2551
2017/8/1,屏東縣,三地門鄉,2315,7643,3843,3800
2017/8/1,屏東縣,霧臺鄉,1059,3222,1657,1565
2017/8/1,屏東縣,瑪家鄉,2049,6735,3414,3321
2017/8/1,屏東縣,泰武鄉,1329,5238,2755,2483
2017/8/1,屏東縣,來義鄉,2233,7489,3792,3697
2017/8/1,屏東縣,春日鄉,1391,4853,2499,2354
2017/8/1,屏東縣,獅子鄉,1556,4785,2486,2299
2017/8/1,屏東縣,牡丹鄉,1920,4913,2517,2396
2017/8/1,臺東縣,臺東市,39707,106092,53160,52932
2017/8/1,臺東縣,成功鎮,5403,14296,7546,6750
2017/8/1,臺東縣,關山鎮,3178,8779,4563,4216
2017/8/1,臺東縣,卑南鄉,6706,17442,9209,8233
2017/8/1,臺東縣,大武鄉,2498,6129,3201,2928
2017/8/1,臺東縣,太麻里鄉,4665,11177,5950,5227
2017/8/1,臺東縣,東河鄉,3765,8571,4757,3814
2017/8/1,臺東縣,長濱鄉,2922,7293,4119,3174
2017/8/1,臺東縣,鹿野鄉,3051,7984,4259,3725
2017/8/1,臺東縣,池上鄉,3211,8271,4306,3965
2017/8/1,臺東縣,綠島鄉,1146,3837,2018,1819
2017/8/1,臺東縣,延平鄉,1069,3542,1903,1639
2017/8/1,臺東縣,海端鄉,1090,4234,2249,1985
2017/8/1,臺東縣,達仁鄉,1459,3535,1920,1615
2017/8/1,臺東縣,金峰鄉,1125,3639,1865,1774
2017/8/1,臺東縣,蘭嶼鄉,1838,5058,2548,2510
2017/8/1,花蓮縣,花蓮市,41480,104635,50498,54137
2017/8/1,花蓮縣,鳳林鎮,4403,10916,5685,5231
2017/8/1,花蓮縣,玉里鎮,8903,24501,13013,11488
2017/8/1,花蓮縣,新城鄉,7703,20183,10397,9786
2017/8/1,花蓮縣,吉安鄉,31931,83721,42186,41535
2017/8/1,花蓮縣,壽豐鄉,7180,18096,9623,8473
2017/8/1,花蓮縣,光復鄉,5026,12950,6883,6067
2017/8/1,花蓮縣,豐濱鄉,1710,4388,2447,1941
2017/8/1,花蓮縣,瑞穗鄉,4735,11654,6291,5363
2017/8/1,花蓮縣,富里鄉,4021,10439,5692,4747
2017/8/1,花蓮縣,秀林鄉,4796,15763,8137,7626
2017/8/1,花蓮縣,萬榮鄉,2099,6393,3378,3015
2017/8/1,花蓮縣,卓溪鄉,1695,6037,3322,2715
2017/8/1,澎湖縣,馬公市,24029,61743,31381,30362
2017/8/1,澎湖縣,湖西鄉,5532,14466,7622,6844
2017/8/1,澎湖縣,白沙鄉,3380,9776,5123,4653
2017/8/1,澎湖縣,西嶼鄉,2999,8409,4342,4067
2017/8/1,澎湖縣,望安鄉,2019,5175,2796,2379
2017/8/1,澎湖縣,七美鄉,1372,3843,2008,1835
2017/8/1,基隆市,中正區,22590,52248,26705,25543
2017/8/1,基隆市,七堵區,21392,54030,27150,26880
2017/8/1,基隆市,暖暖區,15646,38677,19409,19268
2017/8/1,基隆市,仁愛區,19246,44582,22070,22512
2017/8/1,基隆市,中山區,19297,47979,24310,23669
2017/8/1,基隆市,安樂區,33310,82284,40712,41572
2017/8/1,基隆市,信義區,21143,52019,25767,26252
2017/8/1,新竹市,東區,78903,211673,104157,107516
2017/8/1,新竹市,北區,56395,150391,73543,76848
2017/8/1,新竹市,香山區,27054,77683,39475,38208
2017/8/1,嘉義市,東區,45419,122127,58868,63259
2017/8/1,嘉義市,西區,53880,147300,72212,75088
2017/8/1,金門縣,金城鎮,12875,43154,21560,21594
2017/8/1,金門縣,金湖鎮,8857,29135,14638,14497
2017/8/1,金門縣,金沙鎮,6293,20437,10108,10329
2017/8/1,金門縣,金寧鄉,8494,29958,15093,14865
2017/8/1,金門縣,烈嶼鄉,3123,12638,6208,6430
2017/8/1,金門縣,烏坵鄉,134,682,345,337
2017/8/1,連江縣,南竿鄉,1635,7483,4192,3291
2017/8/1,連江縣,北竿鄉,550,2352,1305,1047
2017/8/1,連江縣,莒光鄉,288,1594,965,629
2017/8/1,連江縣,東引鄉,330,1327,795,532
2017/9/1,總計,新北市,1540500,3984975,1953080,2031895
2017/9/1,總計,臺北市,1050873,2682893,1282133,1400760
2017/9/1,總計,桃園市,786938,2178458,1085409,1093049
2017/9/1,總計,臺中市,956251,2781498,1371911,1409587
2017/9/1,總計,臺南市,683188,1886088,942212,943876
2017/9/1,總計,高雄市,1091278,2777021,1376232,1400789
2017/9/1,總計,臺灣省,2485253,7116956,3629940,3487016
2017/9/1,總計,宜蘭縣,168505,456851,231178,225673
2017/9/1,總計,新竹縣,190656,551201,281675,269526
2017/9/1,總計,苗栗縣,187565,555049,286412,268637
2017/9/1,總計,彰化縣,386830,1282991,654153,628838
2017/9/1,總計,南投縣,178073,502095,257275,244820
2017/9/1,總計,雲林縣,240378,691348,358825,332523
2017/9/1,總計,嘉義縣,182907,512064,266387,245677
2017/9/1,總計,屏東縣,286776,831073,425131,405942
2017/9/1,總計,臺東縣,82876,219716,113483,106233
2017/9/1,總計,花蓮縣,125803,329531,167419,162112
2017/9/1,總計,澎湖縣,39815,103843,53526,50317
2017/9/1,總計,基隆市,152833,371758,186094,185664
2017/9/1,總計,新竹市,162832,440098,217366,222732
2017/9/1,總計,嘉義市,99404,269338,131016,138322
2017/9/1,總計,福建省,42641,149578,75640,73938
2017/9/1,總計,金門縣,39825,136812,68372,68440
2017/9/1,總計,連江縣,2816,12766,7268,5498
2017/9/1,新北市,板橋區,208031,551597,269419,282178
2017/9/1,新北市,三重區,150873,387879,190934,196945
2017/9/1,新北市,中和區,165197,413541,201133,212408
2017/9/1,新北市,永和區,91010,222927,105815,117112
2017/9/1,新北市,新莊區,152836,415961,203023,212938
2017/9/1,新北市,新店區,126511,301998,145337,156661
2017/9/1,新北市,樹林區,66420,184151,91878,92273
2017/9/1,新北市,鶯歌區,29740,86636,43435,43201
2017/9/1,新北市,三峽區,42478,114625,57528,57097
2017/9/1,新北市,淡水區,74338,168907,81087,87820
2017/9/1,新北市,汐止區,86837,199126,97226,101900
2017/9/1,新北市,瑞芳區,16197,40397,20396,20001
2017/9/1,新北市,土城區,86956,238266,117572,120694
2017/9/1,新北市,蘆洲區,70856,201292,98910,102382
2017/9/1,新北市,五股區,31320,84737,42742,41995
2017/9/1,新北市,泰山區,28452,78892,39139,39753
2017/9/1,新北市,林口區,41708,105444,51349,54095
2017/9/1,新北市,深坑區,9630,23710,11853,11857
2017/9/1,新北市,石碇區,3368,7664,4214,3450
2017/9/1,新北市,坪林區,2514,6536,3632,2904
2017/9/1,新北市,三芝區,9474,23253,11961,11292
2017/9/1,新北市,石門區,4294,12302,6361,5941
2017/9/1,新北市,八里區,14491,38353,19137,19216
2017/9/1,新北市,平溪區,2305,4711,2606,2105
2017/9/1,新北市,雙溪區,3814,8947,4844,4103
2017/9/1,新北市,貢寮區,4400,12534,6385,6149
2017/9/1,新北市,金山區,7104,22018,10848,11170
2017/9/1,新北市,萬里區,7482,22321,11230,11091
2017/9/1,新北市,烏來區,1864,6250,3086,3164
2017/9/1,臺北市,松山區,80435,206829,97082,109747
2017/9/1,臺北市,信義區,89538,225870,107840,118030
2017/9/1,臺北市,大安區,120755,309948,144813,165135
2017/9/1,臺北市,中山區,100330,230812,107397,123415
2017/9/1,臺北市,中正區,65166,159617,76215,83402
2017/9/1,臺北市,大同區,51751,129261,63052,66209
2017/9/1,臺北市,萬華區,78732,192104,94424,97680
2017/9/1,臺北市,文山區,105385,274161,131608,142553
2017/9/1,臺北市,南港區,47048,122144,59721,62423
2017/9/1,臺北市,內湖區,107799,287389,137316,150073
2017/9/1,臺北市,士林區,107135,288334,139099,149235
2017/9/1,臺北市,北投區,96799,256424,123566,132858
2017/9/1,桃園市,桃園區,165437,439176,213401,225775
2017/9/1,桃園市,中壢區,148731,403318,198847,204471
2017/9/1,桃園市,大溪區,32311,94325,48094,46231
2017/9/1,桃園市,楊梅區,57681,166793,84084,82709
2017/9/1,桃園市,蘆竹區,57994,161193,80116,81077
2017/9/1,桃園市,大園區,32674,88729,45350,43379
2017/9/1,桃園市,龜山區,61008,156636,78113,78523
2017/9/1,桃園市,八德區,70152,196892,98659,98233
2017/9/1,桃園市,龍潭區,41586,121370,60864,60506
2017/9/1,桃園市,平鎮區,76746,223500,111137,112363
2017/9/1,桃園市,新屋區,16211,48862,26021,22841
2017/9/1,桃園市,觀音區,22623,66224,34508,31716
2017/9/1,桃園市,復興區,3784,11440,6215,5225
2017/9/1,臺中市,中區,7911,18461,9165,9296
2017/9/1,臺中市,東區,27852,75748,37710,38038
2017/9/1,臺中市,南區,48264,124730,59885,64845
2017/9/1,臺中市,西區,45688,115646,54934,60712
2017/9/1,臺中市,北區,59330,147465,70564,76901
2017/9/1,臺中市,西屯區,85601,226321,108790,117531
2017/9/1,臺中市,南屯區,61875,168219,80463,87756
2017/9/1,臺中市,北屯區,99769,273774,131443,142331
2017/9/1,臺中市,豐原區,53500,166786,82446,84340
2017/9/1,臺中市,東勢區,17437,50799,26116,24683
2017/9/1,臺中市,大甲區,23035,77669,39072,38597
2017/9/1,臺中市,清水區,27140,86395,44341,42054
2017/9/1,臺中市,沙鹿區,29380,92260,46570,45690
2017/9/1,臺中市,梧棲區,17690,57880,29093,28787
2017/9/1,臺中市,后里區,16188,54363,27630,26733
2017/9/1,臺中市,神岡區,19405,65518,33456,32062
2017/9/1,臺中市,潭子區,36303,108153,53423,54730
2017/9/1,臺中市,大雅區,29525,95131,47470,47661
2017/9/1,臺中市,新社區,7564,24806,12878,11928
2017/9/1,臺中市,石岡區,4890,15072,7819,7253
2017/9/1,臺中市,外埔區,9720,32123,16461,15662
2017/9/1,臺中市,大安區,5476,19325,10208,9117
2017/9/1,臺中市,烏日區,24470,74324,37343,36981
2017/9/1,臺中市,大肚區,17624,57294,29263,28031
2017/9/1,臺中市,龍井區,23026,77522,39070,38452
2017/9/1,臺中市,霧峰區,20203,65353,33142,32211
2017/9/1,臺中市,太平區,63493,188359,93449,94910
2017/9/1,臺中市,大里區,69342,211132,103855,107277
2017/9/1,臺中市,和平區,4550,10870,5852,5018
2017/9/1,臺南市,新營區,29023,77976,38589,39387
2017/9/1,臺南市,鹽水區,10051,25593,13377,12216
2017/9/1,臺南市,白河區,10851,28605,14941,13664
2017/9/1,臺南市,柳營區,7912,21381,11173,10208
2017/9/1,臺南市,後壁區,8888,23811,12399,11412
2017/9/1,臺南市,東山區,8391,21103,11213,9890
2017/9/1,臺南市,麻豆區,15808,44645,22686,21959
2017/9/1,臺南市,下營區,9105,24304,12545,11759
2017/9/1,臺南市,六甲區,7757,22324,11555,10769
2017/9/1,臺南市,官田區,7947,21477,10946,10531
2017/9/1,臺南市,大內區,3875,9815,5259,4556
2017/9/1,臺南市,佳里區,20665,59437,29485,29952
2017/9/1,臺南市,學甲區,9649,26112,13332,12780
2017/9/1,臺南市,西港區,8182,24763,12517,12246
2017/9/1,臺南市,七股區,8082,23046,11915,11131
2017/9/1,臺南市,將軍區,7286,19867,10112,9755
2017/9/1,臺南市,北門區,4261,11199,5669,5530
2017/9/1,臺南市,新化區,14431,43686,22261,21425
2017/9/1,臺南市,善化區,17633,48239,24270,23969
2017/9/1,臺南市,新市區,12239,36448,18298,18150
2017/9/1,臺南市,安定區,10096,30581,15710,14871
2017/9/1,臺南市,山上區,2715,7325,3834,3491
2017/9/1,臺南市,玉井區,5146,14159,7322,6837
2017/9/1,臺南市,楠西區,3509,9729,5147,4582
2017/9/1,臺南市,南化區,2872,8781,4746,4035
2017/9/1,臺南市,左鎮區,1978,4894,2747,2147
2017/9/1,臺南市,仁德區,27612,75410,38180,37230
2017/9/1,臺南市,歸仁區,22680,68340,34716,33624
2017/9/1,臺南市,關廟區,11110,34438,17761,16677
2017/9/1,臺南市,龍崎區,1539,4048,2160,1888
2017/9/1,臺南市,永康區,83968,233555,115100,118455
2017/9/1,臺南市,東區,71953,186959,89659,97300
2017/9/1,臺南市,南區,45679,125596,62201,63395
2017/9/1,臺南市,北區,50899,132702,64556,68146
2017/9/1,臺南市,安南區,62688,192024,96789,95235
2017/9/1,臺南市,安平區,25590,66319,31505,34814
2017/9/1,臺南市,中西區,31118,77397,37537,39860
2017/9/1,高雄市,鹽埕區,10800,24287,12038,12249
2017/9/1,高雄市,鼓山區,57988,138828,67058,71770
2017/9/1,高雄市,左營區,79016,197196,94877,102319
2017/9/1,高雄市,楠梓區,70228,183272,90054,93218
2017/9/1,高雄市,三民區,136831,343787,166392,177395
2017/9/1,高雄市,新興區,22822,51228,24646,26582
2017/9/1,高雄市,前金區,12624,27022,12901,14121
2017/9/1,高雄市,苓雅區,72229,171398,82537,88861
2017/9/1,高雄市,前鎮區,78783,190034,93450,96584
2017/9/1,高雄市,旗津區,11130,28792,14863,13929
2017/9/1,高雄市,小港區,67970,157294,78153,79141
2017/9/1,高雄市,鳳山區,140514,358787,176027,182760
2017/9/1,高雄市,林園區,25853,69957,35374,34583
2017/9/1,高雄市,大寮區,42184,112324,57492,54832
2017/9/1,高雄市,大樹區,13620,42790,21934,20856
2017/9/1,高雄市,大社區,13005,34568,17565,17003
2017/9/1,高雄市,仁武區,32893,85539,43463,42076
2017/9/1,高雄市,鳥松區,18279,44256,22458,21798
2017/9/1,高雄市,岡山區,34921,97325,48353,48972
2017/9/1,高雄市,橋頭區,13633,37575,19049,18526
2017/9/1,高雄市,燕巢區,10535,29917,15776,14141
2017/9/1,高雄市,田寮區,3281,7264,4019,3245
2017/9/1,高雄市,阿蓮區,9429,28934,14604,14330
2017/9/1,高雄市,路竹區,17056,52739,26935,25804
2017/9/1,高雄市,湖內區,10866,29833,15236,14597
2017/9/1,高雄市,茄萣區,10515,30277,15635,14642
2017/9/1,高雄市,永安區,5750,13988,7035,6953
2017/9/1,高雄市,彌陀區,6797,19399,9975,9424
2017/9/1,高雄市,梓官區,12643,36149,18598,17551
2017/9/1,高雄市,旗山區,13773,37039,19155,17884
2017/9/1,高雄市,美濃區,14719,40060,20996,19064
2017/9/1,高雄市,六龜區,5560,13057,7025,6032
2017/9/1,高雄市,甲仙區,2334,6143,3266,2877
2017/9/1,高雄市,杉林區,4804,12080,6592,5488
2017/9/1,高雄市,內門區,5116,14612,7919,6693
2017/9/1,高雄市,茂林區,592,1919,956,963
2017/9/1,高雄市,桃源區,1339,4238,2225,2013
2017/9/1,高雄市,那瑪夏區,846,3114,1601,1513
2017/9/1,宜蘭縣,宜蘭市,36320,95895,46770,49125
2017/9/1,宜蘭縣,羅東鎮,26375,72306,34281,38025
2017/9/1,宜蘭縣,蘇澳鎮,14188,40143,20432,19711
2017/9/1,宜蘭縣,頭城鎮,10282,29482,15192,14290
2017/9/1,宜蘭縣,礁溪鄉,14070,35807,18634,17173
2017/9/1,宜蘭縣,壯圍鄉,8829,24240,12849,11391
2017/9/1,宜蘭縣,員山鄉,11731,32485,17212,15273
2017/9/1,宜蘭縣,冬山鄉,19336,53387,27379,26008
2017/9/1,宜蘭縣,五結鄉,14952,39645,20484,19161
2017/9/1,宜蘭縣,三星鄉,8583,21477,11579,9898
2017/9/1,宜蘭縣,大同鄉,1889,6095,3288,2807
2017/9/1,宜蘭縣,南澳鄉,1950,5889,3078,2811
2017/9/1,新竹縣,竹北市,65207,180658,89960,90698
2017/9/1,新竹縣,關西鎮,9465,29027,15539,13488
2017/9/1,新竹縣,新埔鎮,10733,33531,17864,15667
2017/9/1,新竹縣,竹東鎮,33963,97055,48725,48330
2017/9/1,新竹縣,湖口鄉,26535,77497,39259,38238
2017/9/1,新竹縣,橫山鄉,4460,13110,7107,6003
2017/9/1,新竹縣,新豐鄉,18429,56745,29119,27626
2017/9/1,新竹縣,芎林鄉,6506,20059,10621,9438
2017/9/1,新竹縣,寶山鄉,5522,14518,7835,6683
2017/9/1,新竹縣,北埔鄉,3129,9440,5134,4306
2017/9/1,新竹縣,峨眉鄉,2076,5548,3060,2488
2017/9/1,新竹縣,尖石鄉,2871,9456,4997,4459
2017/9/1,新竹縣,五峰鄉,1760,4557,2455,2102
2017/9/1,苗栗縣,苗栗市,31299,89363,44603,44760
2017/9/1,苗栗縣,頭份市,34585,103063,52015,51048
2017/9/1,苗栗縣,苑裡鎮,14646,46185,24071,22114
2017/9/1,苗栗縣,通霄鎮,11608,34846,18407,16439
2017/9/1,苗栗縣,竹南鎮,29135,85489,43141,42348
2017/9/1,苗栗縣,後龍鎮,11943,36913,19491,17422
2017/9/1,苗栗縣,卓蘭鎮,6049,17225,9017,8208
2017/9/1,苗栗縣,大湖鄉,5404,14825,7877,6948
2017/9/1,苗栗縣,公館鄉,10714,33903,17685,16218
2017/9/1,苗栗縣,銅鑼鄉,6157,18241,9706,8535
2017/9/1,苗栗縣,南庄鄉,3941,10211,5617,4594
2017/9/1,苗栗縣,頭屋鄉,3648,10886,5793,5093
2017/9/1,苗栗縣,三義鄉,5580,16611,8768,7843
2017/9/1,苗栗縣,西湖鄉,2653,7210,4013,3197
2017/9/1,苗栗縣,造橋鄉,4135,13024,6880,6144
2017/9/1,苗栗縣,三灣鄉,2404,6787,3712,3075
2017/9/1,苗栗縣,獅潭鄉,1714,4421,2476,1945
2017/9/1,苗栗縣,泰安鄉,1950,5846,3140,2706
2017/9/1,彰化縣,彰化市,76381,233715,115535,118180
2017/9/1,彰化縣,員林市,39232,124477,61853,62624
2017/9/1,彰化縣,鹿港鎮,24468,86741,44111,42630
2017/9/1,彰化縣,和美鎮,26754,91036,46364,44672
2017/9/1,彰化縣,北斗鎮,10701,33340,16804,16536
2017/9/1,彰化縣,溪湖鎮,16329,55649,28223,27426
2017/9/1,彰化縣,田中鎮,13148,41890,21610,20280
2017/9/1,彰化縣,二林鎮,15040,51078,26313,24765
2017/9/1,彰化縣,線西鄉,4397,16883,8683,8200
2017/9/1,彰化縣,伸港鄉,9963,36891,18839,18052
2017/9/1,彰化縣,福興鄉,12799,47362,24677,22685
2017/9/1,彰化縣,秀水鄉,10749,39387,20317,19070
2017/9/1,彰化縣,花壇鄉,14080,45979,23581,22398
2017/9/1,彰化縣,芬園鄉,6841,23761,12491,11270
2017/9/1,彰化縣,大村鄉,11119,36844,19017,17827
2017/9/1,彰化縣,埔鹽鄉,9076,32660,17167,15493
2017/9/1,彰化縣,埔心鄉,10584,34892,17975,16917
2017/9/1,彰化縣,永靖鄉,10941,37437,19384,18053
2017/9/1,彰化縣,社頭鄉,12918,43224,22223,21001
2017/9/1,彰化縣,二水鄉,5293,15360,8051,7309
2017/9/1,彰化縣,田尾鄉,7979,27502,14187,13315
2017/9/1,彰化縣,埤頭鄉,9040,30660,15896,14764
2017/9/1,彰化縣,芳苑鄉,10130,33747,17856,15891
2017/9/1,彰化縣,大城鄉,5256,17036,9192,7844
2017/9/1,彰化縣,竹塘鄉,4620,15335,8065,7270
2017/9/1,彰化縣,溪州鄉,8992,30105,15739,14366
2017/9/1,南投縣,南投市,34734,100324,50231,50093
2017/9/1,南投縣,埔里鎮,29059,81227,40495,40732
2017/9/1,南投縣,草屯鎮,33236,98017,49585,48432
2017/9/1,南投縣,竹山鎮,20147,55235,28327,26908
2017/9/1,南投縣,集集鎮,4299,10915,5681,5234
2017/9/1,南投縣,名間鄉,12649,38931,20507,18424
2017/9/1,南投縣,鹿谷鄉,7933,17850,9528,8322
2017/9/1,南投縣,中寮鄉,5634,14906,8091,6815
2017/9/1,南投縣,魚池鄉,5763,16003,8426,7577
2017/9/1,南投縣,國姓鄉,7271,18855,10208,8647
2017/9/1,南投縣,水里鄉,7167,17877,9367,8510
2017/9/1,南投縣,信義鄉,5272,16247,8708,7539
2017/9/1,南投縣,仁愛鄉,4909,15708,8121,7587
2017/9/1,雲林縣,斗六市,38261,108615,54046,54569
2017/9/1,雲林縣,斗南鎮,15877,44989,22865,22124
2017/9/1,雲林縣,虎尾鎮,25033,70980,35953,35027
2017/9/1,雲林縣,西螺鎮,14655,46296,23417,22879
2017/9/1,雲林縣,土庫鎮,9367,29008,15153,13855
2017/9/1,雲林縣,北港鎮,15978,40394,20896,19498
2017/9/1,雲林縣,古坑鄉,10981,31750,16729,15021
2017/9/1,雲林縣,大埤鄉,6684,19314,10377,8937
2017/9/1,雲林縣,莿桐鄉,9341,28933,15193,13740
2017/9/1,雲林縣,林內鄉,6018,18355,9605,8750
2017/9/1,雲林縣,二崙鄉,8941,27303,14595,12708
2017/9/1,雲林縣,崙背鄉,8508,24756,13071,11685
2017/9/1,雲林縣,麥寮鄉,14310,45443,22852,22591
2017/9/1,雲林縣,東勢鄉,5744,14949,8264,6685
2017/9/1,雲林縣,褒忠鄉,4439,13019,7009,6010
2017/9/1,雲林縣,臺西鄉,8699,23988,12850,11138
2017/9/1,雲林縣,元長鄉,9295,26063,14253,11810
2017/9/1,雲林縣,四湖鄉,8791,23756,12878,10878
2017/9/1,雲林縣,口湖鄉,9499,27731,14747,12984
2017/9/1,雲林縣,水林鄉,9957,25706,14072,11634
2017/9/1,嘉義縣,太保市,12934,37712,19378,18334
2017/9/1,嘉義縣,朴子市,15716,42449,21482,20967
2017/9/1,嘉義縣,布袋鎮,9966,27244,13910,13334
2017/9/1,嘉義縣,大林鎮,11417,31212,15995,15217
2017/9/1,嘉義縣,民雄鄉,24876,71715,36720,34995
2017/9/1,嘉義縣,溪口鄉,5352,14789,7912,6877
2017/9/1,嘉義縣,新港鄉,10643,32037,16863,15174
2017/9/1,嘉義縣,六腳鄉,8874,23399,12427,10972
2017/9/1,嘉義縣,東石鄉,9247,25040,13257,11783
2017/9/1,嘉義縣,義竹鄉,7417,18528,9636,8892
2017/9/1,嘉義縣,鹿草鄉,5779,15622,8378,7244
2017/9/1,嘉義縣,水上鄉,18078,49764,25679,24085
2017/9/1,嘉義縣,中埔鄉,16000,45084,23467,21617
2017/9/1,嘉義縣,竹崎鄉,11712,36046,19214,16832
2017/9/1,嘉義縣,梅山鄉,6760,19569,10420,9149
2017/9/1,嘉義縣,番路鄉,4262,11645,6302,5343
2017/9/1,嘉義縣,大埔鄉,1936,4585,2380,2205
2017/9/1,嘉義縣,阿里山鄉,1938,5624,2967,2657
2017/9/1,屏東縣,屏東市,74276,200640,99231,101409
2017/9/1,屏東縣,潮州鎮,19479,54510,27232,27278
2017/9/1,屏東縣,東港鎮,16731,47956,24234,23722
2017/9/1,屏東縣,恆春鎮,11540,30645,15715,14930
2017/9/1,屏東縣,萬丹鄉,14968,50999,26426,24573
2017/9/1,屏東縣,長治鄉,10172,30056,15669,14387
2017/9/1,屏東縣,麟洛鄉,3807,11102,5763,5339
2017/9/1,屏東縣,九如鄉,6990,22096,11440,10656
2017/9/1,屏東縣,里港鄉,8207,26586,13536,13050
2017/9/1,屏東縣,鹽埔鄉,7856,26044,13540,12504
2017/9/1,屏東縣,高樹鄉,9303,24668,13138,11530
2017/9/1,屏東縣,萬巒鄉,6515,20599,10779,9820
2017/9/1,屏東縣,內埔鄉,18646,54818,28340,26478
2017/9/1,屏東縣,竹田鄉,5626,17180,9131,8049
2017/9/1,屏東縣,新埤鄉,3429,9914,5255,4659
2017/9/1,屏東縣,枋寮鄉,8534,24624,12905,11719
2017/9/1,屏東縣,新園鄉,11829,35408,18362,17046
2017/9/1,屏東縣,崁頂鄉,4484,15764,8009,7755
2017/9/1,屏東縣,林邊鄉,6750,18151,9291,8860
2017/9/1,屏東縣,南州鄉,3710,10706,5497,5209
2017/9/1,屏東縣,佳冬鄉,6994,19483,10119,9364
2017/9/1,屏東縣,琉球鄉,4476,12343,6777,5566
2017/9/1,屏東縣,車城鄉,3467,8627,4632,3995
2017/9/1,屏東縣,滿州鄉,3016,7805,4241,3564
2017/9/1,屏東縣,枋山鄉,2114,5456,2910,2546
2017/9/1,屏東縣,三地門鄉,2312,7638,3837,3801
2017/9/1,屏東縣,霧臺鄉,1058,3227,1658,1569
2017/9/1,屏東縣,瑪家鄉,2053,6741,3415,3326
2017/9/1,屏東縣,泰武鄉,1328,5244,2755,2489
2017/9/1,屏東縣,來義鄉,2236,7485,3788,3697
2017/9/1,屏東縣,春日鄉,1393,4863,2504,2359
2017/9/1,屏東縣,獅子鄉,1554,4786,2487,2299
2017/9/1,屏東縣,牡丹鄉,1923,4909,2515,2394
2017/9/1,臺東縣,臺東市,39744,106026,53104,52922
2017/9/1,臺東縣,成功鎮,5397,14284,7534,6750
2017/9/1,臺東縣,關山鎮,3177,8769,4564,4205
2017/9/1,臺東縣,卑南鄉,6714,17436,9201,8235
2017/9/1,臺東縣,大武鄉,2504,6124,3201,2923
2017/9/1,臺東縣,太麻里鄉,4671,11156,5949,5207
2017/9/1,臺東縣,東河鄉,3760,8529,4736,3793
2017/9/1,臺東縣,長濱鄉,2929,7283,4120,3163
2017/9/1,臺東縣,鹿野鄉,3048,7973,4249,3724
2017/9/1,臺東縣,池上鄉,3207,8259,4303,3956
2017/9/1,臺東縣,綠島鄉,1145,3861,2033,1828
2017/9/1,臺東縣,延平鄉,1068,3549,1902,1647
2017/9/1,臺東縣,海端鄉,1092,4226,2242,1984
2017/9/1,臺東縣,達仁鄉,1459,3543,1930,1613
2017/9/1,臺東縣,金峰鄉,1124,3644,1866,1778
2017/9/1,臺東縣,蘭嶼鄉,1837,5054,2549,2505
2017/9/1,花蓮縣,花蓮市,41509,104495,50419,54076
2017/9/1,花蓮縣,鳳林鎮,4403,10899,5670,5229
2017/9/1,花蓮縣,玉里鎮,8910,24450,12971,11479
2017/9/1,花蓮縣,新城鄉,7718,20193,10396,9797
2017/9/1,花蓮縣,吉安鄉,31977,83730,42183,41547
2017/9/1,花蓮縣,壽豐鄉,7203,18094,9620,8474
2017/9/1,花蓮縣,光復鄉,5023,12936,6876,6060
2017/9/1,花蓮縣,豐濱鄉,1708,4391,2445,1946
2017/9/1,花蓮縣,瑞穗鄉,4742,11662,6289,5373
2017/9/1,花蓮縣,富里鄉,4022,10441,5687,4754
2017/9/1,花蓮縣,秀林鄉,4797,15810,8159,7651
2017/9/1,花蓮縣,萬榮鄉,2093,6383,3370,3013
2017/9/1,花蓮縣,卓溪鄉,1698,6047,3334,2713
2017/9/1,澎湖縣,馬公市,24491,62153,31631,30522
2017/9/1,澎湖縣,湖西鄉,5539,14480,7624,6856
2017/9/1,澎湖縣,白沙鄉,3387,9781,5127,4654
2017/9/1,澎湖縣,西嶼鄉,3002,8406,4342,4064
2017/9/1,澎湖縣,望安鄉,2022,5176,2795,2381
2017/9/1,澎湖縣,七美鄉,1374,3847,2007,1840
2017/9/1,基隆市,中正區,22624,52259,26710,25549
2017/9/1,基隆市,七堵區,21442,54010,27146,26864
2017/9/1,基隆市,暖暖區,15674,38703,19421,19282
2017/9/1,基隆市,仁愛區,19216,44443,22020,22423
2017/9/1,基隆市,中山區,19285,47926,24291,23635
2017/9/1,基隆市,安樂區,33436,82384,40741,41643
2017/9/1,基隆市,信義區,21156,52033,25765,26268
2017/9/1,新竹市,東區,79129,211844,104253,107591
2017/9/1,新竹市,北區,56566,150494,73589,76905
2017/9/1,新竹市,香山區,27137,77760,39524,38236
2017/9/1,嘉義市,東區,45469,122069,58828,63241
2017/9/1,嘉義市,西區,53935,147269,72188,75081
2017/9/1,金門縣,金城鎮,12869,43135,21549,21586
2017/9/1,金門縣,金湖鎮,8877,29224,14690,14534
2017/9/1,金門縣,金沙鎮,6297,20457,10122,10335
2017/9/1,金門縣,金寧鄉,8521,30655,15449,15206
2017/9/1,金門縣,烈嶼鄉,3127,12657,6215,6442
2017/9/1,金門縣,烏坵鄉,134,684,347,337
2017/9/1,連江縣,南竿鄉,1643,7485,4192,3293
2017/9/1,連江縣,北竿鄉,554,2354,1309,1045
2017/9/1,連江縣,莒光鄉,288,1594,966,628
2017/9/1,連江縣,東引鄉,331,1333,801,532
2017/10/1,總計,新北市,1540904,3985698,1953214,2032484
2017/10/1,總計,臺北市,1050509,2683202,1282133,1401069
2017/10/1,總計,桃園市,787671,2181470,1086784,1094686
2017/10/1,總計,臺中市,956889,2783298,1372589,1410709
2017/10/1,總計,臺南市,683336,1886387,942286,944101
2017/10/1,總計,高雄市,1091320,2776791,1375921,1400870
2017/10/1,總計,臺灣省,2485417,7115607,3628888,3486719
2017/10/1,總計,宜蘭縣,168496,456756,231133,225623
2017/10/1,總計,新竹縣,190746,551447,281746,269701
2017/10/1,總計,苗栗縣,187631,554652,286255,268397
2017/10/1,總計,彰化縣,386917,1282934,654036,628898
2017/10/1,總計,南投縣,178051,501757,257101,244656
2017/10/1,總計,雲林縣,240332,691021,358578,332443
2017/10/1,總計,嘉義縣,182860,511797,266244,245553
2017/10/1,總計,屏東縣,286721,830697,424893,405804
2017/10/1,總計,臺東縣,82872,219686,113451,106235
2017/10/1,總計,花蓮縣,125808,329462,167352,162110
2017/10/1,總計,澎湖縣,39849,103956,53579,50377
2017/10/1,總計,基隆市,152809,371669,186037,185632
2017/10/1,總計,新竹市,162915,440409,217528,222881
2017/10/1,總計,嘉義市,99410,269364,130955,138409
2017/10/1,總計,福建省,42684,149865,75800,74065
2017/10/1,總計,金門縣,39853,137042,68495,68547
2017/10/1,總計,連江縣,2831,12823,7305,5518
2017/10/1,新北市,板橋區,208053,551464,269293,282171
2017/10/1,新北市,三重區,150900,387823,190889,196934
2017/10/1,新北市,中和區,165208,413633,201173,212460
2017/10/1,新北市,永和區,90969,222815,105736,117079
2017/10/1,新北市,新莊區,152911,416221,203151,213070
2017/10/1,新北市,新店區,126528,302032,145306,156726
2017/10/1,新北市,樹林區,66430,184195,91890,92305
2017/10/1,新北市,鶯歌區,29748,86632,43432,43200
2017/10/1,新北市,三峽區,42536,114735,57580,57155
2017/10/1,新北市,淡水區,74431,169121,81172,87949
2017/10/1,新北市,汐止區,86874,199240,97243,101997
2017/10/1,新北市,瑞芳區,16194,40375,20375,20000
2017/10/1,新北市,土城區,86933,238175,117558,120617
2017/10/1,新北市,蘆洲區,70875,201285,98871,102414
2017/10/1,新北市,五股區,31348,84797,42782,42015
2017/10/1,新北市,泰山區,28465,78885,39147,39738
2017/10/1,新北市,林口區,41769,105645,51445,54200
2017/10/1,新北市,深坑區,9614,23684,11850,11834
2017/10/1,新北市,石碇區,3369,7672,4217,3455
2017/10/1,新北市,坪林區,2515,6542,3634,2908
2017/10/1,新北市,三芝區,9464,23235,11950,11285
2017/10/1,新北市,石門區,4295,12303,6363,5940
2017/10/1,新北市,八里區,14502,38382,19146,19236
2017/10/1,新北市,平溪區,2307,4711,2606,2105
2017/10/1,新北市,雙溪區,3812,8937,4835,4102
2017/10/1,新北市,貢寮區,4401,12542,6383,6159
2017/10/1,新北市,金山區,7107,22022,10856,11166
2017/10/1,新北市,萬里區,7482,22323,11229,11094
2017/10/1,新北市,烏來區,1864,6272,3102,3170
2017/10/1,臺北市,松山區,80459,206905,97095,109810
2017/10/1,臺北市,信義區,89483,225911,107860,118051
2017/10/1,臺北市,大安區,120750,309977,144816,165161
2017/10/1,臺北市,中山區,100250,230778,107377,123401
2017/10/1,臺北市,中正區,65092,159556,76180,83376
2017/10/1,臺北市,大同區,51737,129263,63064,66199
2017/10/1,臺北市,萬華區,78674,192074,94361,97713
2017/10/1,臺北市,文山區,105377,274287,131646,142641
2017/10/1,臺北市,南港區,47058,122203,59756,62447
2017/10/1,臺北市,內湖區,107800,287484,137339,150145
2017/10/1,臺北市,士林區,107068,288320,139114,149206
2017/10/1,臺北市,北投區,96761,256444,123525,132919
2017/10/1,桃園市,桃園區,165488,439643,213627,226016
2017/10/1,桃園市,中壢區,148884,403915,199107,204808
2017/10/1,桃園市,大溪區,32328,94370,48126,46244
2017/10/1,桃園市,楊梅區,57823,167075,84211,82864
2017/10/1,桃園市,蘆竹區,58055,161450,80218,81232
2017/10/1,桃園市,大園區,32734,88860,45422,43438
2017/10/1,桃園市,龜山區,61079,156971,78259,78712
2017/10/1,桃園市,八德區,70224,197261,98822,98439
2017/10/1,桃園市,龍潭區,41595,121496,60906,60590
2017/10/1,桃園市,平鎮區,76792,223754,111263,112491
2017/10/1,桃園市,新屋區,16235,48888,26033,22855
2017/10/1,桃園市,觀音區,22653,66334,34566,31768
2017/10/1,桃園市,復興區,3781,11453,6224,5229
2017/10/1,臺中市,中區,7916,18472,9157,9315
2017/10/1,臺中市,東區,27870,75739,37714,38025
2017/10/1,臺中市,南區,48287,124795,59938,64857
2017/10/1,臺中市,西區,45695,115685,54938,60747
2017/10/1,臺中市,北區,59331,147518,70591,76927
2017/10/1,臺中市,西屯區,85660,226532,108857,117675
2017/10/1,臺中市,南屯區,61933,168368,80525,87843
2017/10/1,臺中市,北屯區,99871,274131,131584,142547
2017/10/1,臺中市,豐原區,53547,166767,82442,84325
2017/10/1,臺中市,東勢區,17431,50773,26086,24687
2017/10/1,臺中市,大甲區,23054,77734,39091,38643
2017/10/1,臺中市,清水區,27156,86389,44333,42056
2017/10/1,臺中市,沙鹿區,29428,92407,46617,45790
2017/10/1,臺中市,梧棲區,17719,57936,29108,28828
2017/10/1,臺中市,后里區,16203,54424,27647,26777
2017/10/1,臺中市,神岡區,19411,65567,33468,32099
2017/10/1,臺中市,潭子區,36329,108206,53451,54755
2017/10/1,臺中市,大雅區,29532,95190,47492,47698
2017/10/1,臺中市,新社區,7565,24784,12872,11912
2017/10/1,臺中市,石岡區,4885,15054,7813,7241
2017/10/1,臺中市,外埔區,9718,32119,16456,15663
2017/10/1,臺中市,大安區,5483,19319,10203,9116
2017/10/1,臺中市,烏日區,24508,74409,37388,37021
2017/10/1,臺中市,大肚區,17623,57319,29282,28037
2017/10/1,臺中市,龍井區,23044,77617,39115,38502
2017/10/1,臺中市,霧峰區,20208,65374,33154,32220
2017/10/1,臺中市,太平區,63522,188491,93500,94991
2017/10/1,臺中市,大里區,69403,211272,103893,107379
2017/10/1,臺中市,和平區,4557,10907,5874,5033
2017/10/1,臺南市,新營區,29020,77952,38559,39393
2017/10/1,臺南市,鹽水區,10047,25606,13380,12226
2017/10/1,臺南市,白河區,10852,28596,14934,13662
2017/10/1,臺南市,柳營區,7903,21378,11161,10217
2017/10/1,臺南市,後壁區,8887,23776,12379,11397
2017/10/1,臺南市,東山區,8385,21091,11213,9878
2017/10/1,臺南市,麻豆區,15808,44647,22681,21966
2017/10/1,臺南市,下營區,9099,24286,12544,11742
2017/10/1,臺南市,六甲區,7759,22303,11542,10761
2017/10/1,臺南市,官田區,7945,21473,10941,10532
2017/10/1,臺南市,大內區,3866,9795,5257,4538
2017/10/1,臺南市,佳里區,20647,59380,29465,29915
2017/10/1,臺南市,學甲區,9645,26110,13331,12779
2017/10/1,臺南市,西港區,8184,24778,12520,12258
2017/10/1,臺南市,七股區,8074,23026,11904,11122
2017/10/1,臺南市,將軍區,7289,19868,10114,9754
2017/10/1,臺南市,北門區,4261,11209,5675,5534
2017/10/1,臺南市,新化區,14438,43678,22252,21426
2017/10/1,臺南市,善化區,17648,48284,24295,23989
2017/10/1,臺南市,新市區,12255,36489,18312,18177
2017/10/1,臺南市,安定區,10099,30565,15706,14859
2017/10/1,臺南市,山上區,2717,7319,3828,3491
2017/10/1,臺南市,玉井區,5147,14165,7322,6843
2017/10/1,臺南市,楠西區,3511,9704,5131,4573
2017/10/1,臺南市,南化區,2874,8792,4752,4040
2017/10/1,臺南市,左鎮區,1976,4883,2739,2144
2017/10/1,臺南市,仁德區,27618,75477,38202,37275
2017/10/1,臺南市,歸仁區,22696,68387,34746,33641
2017/10/1,臺南市,關廟區,11116,34450,17768,16682
2017/10/1,臺南市,龍崎區,1539,4043,2164,1879
2017/10/1,臺南市,永康區,84002,233748,115169,118579
2017/10/1,臺南市,東區,71932,186908,89627,97281
2017/10/1,臺南市,南區,45675,125488,62153,63335
2017/10/1,臺南市,北區,50892,132687,64558,68129
2017/10/1,臺南市,安南區,62747,192152,96834,95318
2017/10/1,臺南市,安平區,25608,66353,31532,34821
2017/10/1,臺南市,中西區,31175,77541,37596,39945
2017/10/1,高雄市,鹽埕區,10788,24245,12013,12232
2017/10/1,高雄市,鼓山區,57998,138889,67058,71831
2017/10/1,高雄市,左營區,78977,197148,94869,102279
2017/10/1,高雄市,楠梓區,70259,183367,90097,93270
2017/10/1,高雄市,三民區,136792,343553,166297,177256
2017/10/1,高雄市,新興區,22810,51232,24647,26585
2017/10/1,高雄市,前金區,12622,26978,12886,14092
2017/10/1,高雄市,苓雅區,72175,171237,82436,88801
2017/10/1,高雄市,前鎮區,78782,189958,93381,96577
2017/10/1,高雄市,旗津區,11132,28789,14863,13926
2017/10/1,高雄市,小港區,67990,157324,78168,79156
2017/10/1,高雄市,鳳山區,140537,358856,176016,182840
2017/10/1,高雄市,林園區,25876,69987,35383,34604
2017/10/1,高雄市,大寮區,42172,112343,57479,54864
2017/10/1,高雄市,大樹區,13628,42780,21941,20839
2017/10/1,高雄市,大社區,13014,34571,17557,17014
2017/10/1,高雄市,仁武區,32958,85678,43521,42157
2017/10/1,高雄市,鳥松區,18285,44304,22482,21822
2017/10/1,高雄市,岡山區,34911,97301,48347,48954
2017/10/1,高雄市,橋頭區,13651,37605,19057,18548
2017/10/1,高雄市,燕巢區,10537,29923,15769,14154
2017/10/1,高雄市,田寮區,3277,7265,4019,3246
2017/10/1,高雄市,阿蓮區,9433,28904,14585,14319
2017/10/1,高雄市,路竹區,17060,52766,26948,25818
2017/10/1,高雄市,湖內區,10869,29832,15220,14612
2017/10/1,高雄市,茄萣區,10518,30259,15620,14639
2017/10/1,高雄市,永安區,5738,13982,7029,6953
2017/10/1,高雄市,彌陀區,6800,19410,9985,9425
2017/10/1,高雄市,梓官區,12629,36115,18569,17546
2017/10/1,高雄市,旗山區,13779,37009,19129,17880
2017/10/1,高雄市,美濃區,14720,40028,20979,19049
2017/10/1,高雄市,六龜區,5563,13063,7027,6036
2017/10/1,高雄市,甲仙區,2334,6131,3254,2877
2017/10/1,高雄市,杉林區,4805,12075,6586,5489
2017/10/1,高雄市,內門區,5118,14605,7916,6689
2017/10/1,高雄市,茂林區,592,1918,958,960
2017/10/1,高雄市,桃源區,1342,4242,2229,2013
2017/10/1,高雄市,那瑪夏區,849,3119,1601,1518
2017/10/1,宜蘭縣,宜蘭市,36301,95923,46815,49108
2017/10/1,宜蘭縣,羅東鎮,26370,72255,34242,38013
2017/10/1,宜蘭縣,蘇澳鎮,14192,40111,20412,19699
2017/10/1,宜蘭縣,頭城鎮,10278,29462,15185,14277
2017/10/1,宜蘭縣,礁溪鄉,14071,35820,18632,17188
2017/10/1,宜蘭縣,壯圍鄉,8832,24241,12837,11404
2017/10/1,宜蘭縣,員山鄉,11742,32472,17210,15262
2017/10/1,宜蘭縣,冬山鄉,19321,53348,27368,25980
2017/10/1,宜蘭縣,五結鄉,14967,39651,20494,19157
2017/10/1,宜蘭縣,三星鄉,8579,21481,11573,9908
2017/10/1,宜蘭縣,大同鄉,1896,6084,3280,2804
2017/10/1,宜蘭縣,南澳鄉,1947,5908,3085,2823
2017/10/1,新竹縣,竹北市,65301,181030,90138,90892
2017/10/1,新竹縣,關西鎮,9447,28983,15515,13468
2017/10/1,新竹縣,新埔鎮,10725,33478,17837,15641
2017/10/1,新竹縣,竹東鎮,33966,96995,48685,48310
2017/10/1,新竹縣,湖口鄉,26528,77468,39248,38220
2017/10/1,新竹縣,橫山鄉,4457,13097,7100,5997
2017/10/1,新竹縣,新豐鄉,18445,56740,29094,27646
2017/10/1,新竹縣,芎林鄉,6507,20067,10619,9448
2017/10/1,新竹縣,寶山鄉,5536,14561,7842,6719
2017/10/1,新竹縣,北埔鄉,3125,9429,5130,4299
2017/10/1,新竹縣,峨眉鄉,2076,5542,3056,2486
2017/10/1,新竹縣,尖石鄉,2873,9496,5019,4477
2017/10/1,新竹縣,五峰鄉,1760,4561,2463,2098
2017/10/1,苗栗縣,苗栗市,31314,89308,44595,44713
2017/10/1,苗栗縣,頭份市,34621,103037,52019,51018
2017/10/1,苗栗縣,苑裡鎮,14658,46133,24049,22084
2017/10/1,苗栗縣,通霄鎮,11610,34808,18395,16413
2017/10/1,苗栗縣,竹南鎮,29141,85506,43156,42350
2017/10/1,苗栗縣,後龍鎮,11922,36845,19459,17386
2017/10/1,苗栗縣,卓蘭鎮,6054,17207,9001,8206
2017/10/1,苗栗縣,大湖鄉,5410,14805,7870,6935
2017/10/1,苗栗縣,公館鄉,10732,33869,17674,16195
2017/10/1,苗栗縣,銅鑼鄉,6156,18215,9690,8525
2017/10/1,苗栗縣,南庄鄉,3938,10202,5610,4592
2017/10/1,苗栗縣,頭屋鄉,3646,10878,5791,5087
2017/10/1,苗栗縣,三義鄉,5583,16592,8759,7833
2017/10/1,苗栗縣,西湖鄉,2651,7198,4007,3191
2017/10/1,苗栗縣,造橋鄉,4125,13009,6863,6146
2017/10/1,苗栗縣,三灣鄉,2400,6761,3698,3063
2017/10/1,苗栗縣,獅潭鄉,1716,4419,2473,1946
2017/10/1,苗栗縣,泰安鄉,1954,5860,3146,2714
2017/10/1,彰化縣,彰化市,76397,233663,115465,118198
2017/10/1,彰化縣,員林市,39230,124506,61867,62639
2017/10/1,彰化縣,鹿港鎮,24483,86780,44134,42646
2017/10/1,彰化縣,和美鎮,26748,91056,46357,44699
2017/10/1,彰化縣,北斗鎮,10703,33355,16807,16548
2017/10/1,彰化縣,溪湖鎮,16334,55653,28217,27436
2017/10/1,彰化縣,田中鎮,13161,41875,21608,20267
2017/10/1,彰化縣,二林鎮,15038,51058,26295,24763
2017/10/1,彰化縣,線西鄉,4402,16898,8686,8212
2017/10/1,彰化縣,伸港鄉,9975,36925,18860,18065
2017/10/1,彰化縣,福興鄉,12807,47361,24666,22695
2017/10/1,彰化縣,秀水鄉,10756,39372,20308,19064
2017/10/1,彰化縣,花壇鄉,14094,45977,23585,22392
2017/10/1,彰化縣,芬園鄉,6841,23771,12495,11276
2017/10/1,彰化縣,大村鄉,11119,36842,19023,17819
2017/10/1,彰化縣,埔鹽鄉,9081,32650,17171,15479
2017/10/1,彰化縣,埔心鄉,10589,34891,17968,16923
2017/10/1,彰化縣,永靖鄉,10929,37386,19352,18034
2017/10/1,彰化縣,社頭鄉,12920,43217,22219,20998
2017/10/1,彰化縣,二水鄉,5288,15362,8049,7313
2017/10/1,彰化縣,田尾鄉,7987,27507,14183,13324
2017/10/1,彰化縣,埤頭鄉,9043,30660,15888,14772
2017/10/1,彰化縣,芳苑鄉,10134,33727,17846,15881
2017/10/1,彰化縣,大城鄉,5260,17009,9184,7825
2017/10/1,彰化縣,竹塘鄉,4619,15334,8073,7261
2017/10/1,彰化縣,溪州鄉,8979,30099,15730,14369
2017/10/1,南投縣,南投市,34723,100225,50188,50037
2017/10/1,南投縣,埔里鎮,29049,81153,40444,40709
2017/10/1,南投縣,草屯鎮,33251,97994,49575,48419
2017/10/1,南投縣,竹山鎮,20121,55166,28288,26878
2017/10/1,南投縣,集集鎮,4299,10907,5669,5238
2017/10/1,南投縣,名間鄉,12647,38903,20492,18411
2017/10/1,南投縣,鹿谷鄉,7938,17835,9521,8314
2017/10/1,南投縣,中寮鄉,5637,14905,8090,6815
2017/10/1,南投縣,魚池鄉,5766,15976,8419,7557
2017/10/1,南投縣,國姓鄉,7264,18823,10188,8635
2017/10/1,南投縣,水里鄉,7167,17847,9355,8492
2017/10/1,南投縣,信義鄉,5279,16286,8733,7553
2017/10/1,南投縣,仁愛鄉,4910,15737,8139,7598
2017/10/1,雲林縣,斗六市,38265,108608,54030,54578
2017/10/1,雲林縣,斗南鎮,15884,44960,22850,22110
2017/10/1,雲林縣,虎尾鎮,25028,70937,35938,34999
2017/10/1,雲林縣,西螺鎮,14631,46228,23395,22833
2017/10/1,雲林縣,土庫鎮,9370,28998,15141,13857
2017/10/1,雲林縣,北港鎮,15970,40337,20868,19469
2017/10/1,雲林縣,古坑鄉,10982,31759,16720,15039
2017/10/1,雲林縣,大埤鄉,6682,19294,10355,8939
2017/10/1,雲林縣,莿桐鄉,9339,28934,15184,13750
2017/10/1,雲林縣,林內鄉,6021,18292,9563,8729
2017/10/1,雲林縣,二崙鄉,8946,27287,14580,12707
2017/10/1,雲林縣,崙背鄉,8504,24744,13066,11678
2017/10/1,雲林縣,麥寮鄉,14314,45545,22896,22649
2017/10/1,雲林縣,東勢鄉,5743,14930,8254,6676
2017/10/1,雲林縣,褒忠鄉,4443,13002,6989,6013
2017/10/1,雲林縣,臺西鄉,8698,23978,12845,11133
2017/10/1,雲林縣,元長鄉,9296,26052,14248,11804
2017/10/1,雲林縣,四湖鄉,8780,23736,12863,10873
2017/10/1,雲林縣,口湖鄉,9494,27705,14732,12973
2017/10/1,雲林縣,水林鄉,9942,25695,14061,11634
2017/10/1,嘉義縣,太保市,12939,37714,19383,18331
2017/10/1,嘉義縣,朴子市,15714,42436,21468,20968
2017/10/1,嘉義縣,布袋鎮,9967,27210,13891,13319
2017/10/1,嘉義縣,大林鎮,11413,31206,15993,15213
2017/10/1,嘉義縣,民雄鄉,24887,71728,36734,34994
2017/10/1,嘉義縣,溪口鄉,5345,14778,7905,6873
2017/10/1,嘉義縣,新港鄉,10639,32013,16847,15166
2017/10/1,嘉義縣,六腳鄉,8866,23377,12412,10965
2017/10/1,嘉義縣,東石鄉,9242,25018,13236,11782
2017/10/1,嘉義縣,義竹鄉,7413,18522,9637,8885
2017/10/1,嘉義縣,鹿草鄉,5777,15613,8378,7235
2017/10/1,嘉義縣,水上鄉,18082,49730,25662,24068
2017/10/1,嘉義縣,中埔鄉,15993,45050,23461,21589
2017/10/1,嘉義縣,竹崎鄉,11704,36042,19217,16825
2017/10/1,嘉義縣,梅山鄉,6758,19541,10396,9145
2017/10/1,嘉義縣,番路鄉,4255,11620,6289,5331
2017/10/1,嘉義縣,大埔鄉,1932,4577,2373,2204
2017/10/1,嘉義縣,阿里山鄉,1934,5622,2962,2660
2017/10/1,屏東縣,屏東市,74240,200554,99178,101376
2017/10/1,屏東縣,潮州鎮,19470,54431,27188,27243
2017/10/1,屏東縣,東港鎮,16727,47937,24214,23723
2017/10/1,屏東縣,恆春鎮,11542,30669,15719,14950
2017/10/1,屏東縣,萬丹鄉,14969,50961,26404,24557
2017/10/1,屏東縣,長治鄉,10174,30067,15674,14393
2017/10/1,屏東縣,麟洛鄉,3806,11088,5762,5326
2017/10/1,屏東縣,九如鄉,6985,22088,11435,10653
2017/10/1,屏東縣,里港鄉,8206,26557,13515,13042
2017/10/1,屏東縣,鹽埔鄉,7857,26028,13534,12494
2017/10/1,屏東縣,高樹鄉,9296,24659,13144,11515
2017/10/1,屏東縣,萬巒鄉,6508,20579,10764,9815
2017/10/1,屏東縣,內埔鄉,18650,54784,28306,26478
2017/10/1,屏東縣,竹田鄉,5630,17170,9129,8041
2017/10/1,屏東縣,新埤鄉,3435,9933,5263,4670
2017/10/1,屏東縣,枋寮鄉,8534,24605,12894,11711
2017/10/1,屏東縣,新園鄉,11819,35371,18339,17032
2017/10/1,屏東縣,崁頂鄉,4485,15752,8005,7747
2017/10/1,屏東縣,林邊鄉,6746,18140,9284,8856
2017/10/1,屏東縣,南州鄉,3710,10687,5492,5195
2017/10/1,屏東縣,佳冬鄉,6983,19459,10108,9351
2017/10/1,屏東縣,琉球鄉,4486,12342,6773,5569
2017/10/1,屏東縣,車城鄉,3463,8622,4631,3991
2017/10/1,屏東縣,滿州鄉,3012,7816,4250,3566
2017/10/1,屏東縣,枋山鄉,2113,5470,2919,2551
2017/10/1,屏東縣,三地門鄉,2314,7645,3845,3800
2017/10/1,屏東縣,霧臺鄉,1058,3233,1659,1574
2017/10/1,屏東縣,瑪家鄉,2055,6734,3415,3319
2017/10/1,屏東縣,泰武鄉,1334,5247,2760,2487
2017/10/1,屏東縣,來義鄉,2240,7478,3781,3697
2017/10/1,屏東縣,春日鄉,1394,4864,2497,2367
2017/10/1,屏東縣,獅子鄉,1556,4809,2493,2316
2017/10/1,屏東縣,牡丹鄉,1924,4918,2519,2399
2017/10/1,臺東縣,臺東市,39749,106018,53106,52912
2017/10/1,臺東縣,成功鎮,5388,14256,7520,6736
2017/10/1,臺東縣,關山鎮,3177,8752,4557,4195
2017/10/1,臺東縣,卑南鄉,6721,17433,9200,8233
2017/10/1,臺東縣,大武鄉,2503,6122,3198,2924
2017/10/1,臺東縣,太麻里鄉,4669,11157,5944,5213
2017/10/1,臺東縣,東河鄉,3759,8526,4732,3794
2017/10/1,臺東縣,長濱鄉,2928,7279,4121,3158
2017/10/1,臺東縣,鹿野鄉,3049,7979,4245,3734
2017/10/1,臺東縣,池上鄉,3206,8263,4305,3958
2017/10/1,臺東縣,綠島鄉,1140,3877,2034,1843
2017/10/1,臺東縣,延平鄉,1068,3555,1903,1652
2017/10/1,臺東縣,海端鄉,1091,4229,2245,1984
2017/10/1,臺東縣,達仁鄉,1455,3529,1924,1605
2017/10/1,臺東縣,金峰鄉,1126,3643,1864,1779
2017/10/1,臺東縣,蘭嶼鄉,1843,5068,2553,2515
2017/10/1,花蓮縣,花蓮市,41489,104417,50392,54025
2017/10/1,花蓮縣,鳳林鎮,4407,10887,5658,5229
2017/10/1,花蓮縣,玉里鎮,8907,24418,12950,11468
2017/10/1,花蓮縣,新城鄉,7723,20204,10399,9805
2017/10/1,花蓮縣,吉安鄉,32003,83756,42163,41593
2017/10/1,花蓮縣,壽豐鄉,7200,18085,9632,8453
2017/10/1,花蓮縣,光復鄉,5012,12925,6870,6055
2017/10/1,花蓮縣,豐濱鄉,1706,4381,2434,1947
2017/10/1,花蓮縣,瑞穗鄉,4747,11664,6295,5369
2017/10/1,花蓮縣,富里鄉,4024,10436,5676,4760
2017/10/1,花蓮縣,秀林鄉,4803,15850,8173,7677
2017/10/1,花蓮縣,萬榮鄉,2092,6387,3373,3014
2017/10/1,花蓮縣,卓溪鄉,1695,6052,3337,2715
2017/10/1,澎湖縣,馬公市,24511,62209,31655,30554
2017/10/1,澎湖縣,湖西鄉,5548,14506,7640,6866
2017/10/1,澎湖縣,白沙鄉,3389,9789,5131,4658
2017/10/1,澎湖縣,西嶼鄉,3002,8413,4340,4073
2017/10/1,澎湖縣,望安鄉,2025,5185,2802,2383
2017/10/1,澎湖縣,七美鄉,1374,3854,2011,1843
2017/10/1,基隆市,中正區,22633,52242,26698,25544
2017/10/1,基隆市,七堵區,21448,54014,27136,26878
2017/10/1,基隆市,暖暖區,15660,38680,19420,19260
2017/10/1,基隆市,仁愛區,19215,44404,22001,22403
2017/10/1,基隆市,中山區,19276,47933,24284,23649
2017/10/1,基隆市,安樂區,33435,82366,40742,41624
2017/10/1,基隆市,信義區,21142,52030,25756,26274
2017/10/1,新竹市,東區,79175,212082,104363,107719
2017/10/1,新竹市,北區,56582,150501,73601,76900
2017/10/1,新竹市,香山區,27158,77826,39564,38262
2017/10/1,嘉義市,東區,45466,122092,58781,63311
2017/10/1,嘉義市,西區,53944,147272,72174,75098
2017/10/1,金門縣,金城鎮,12867,43182,21553,21629
2017/10/1,金門縣,金湖鎮,8884,29272,14716,14556
2017/10/1,金門縣,金沙鎮,6295,20489,10143,10346
2017/10/1,金門縣,金寧鄉,8540,30736,15507,15229
2017/10/1,金門縣,烈嶼鄉,3133,12678,6229,6449
2017/10/1,金門縣,烏坵鄉,134,685,347,338
2017/10/1,連江縣,南竿鄉,1651,7511,4212,3299
2017/10/1,連江縣,北竿鄉,560,2365,1313,1052
2017/10/1,連江縣,莒光鄉,289,1610,979,631
2017/10/1,連江縣,東引鄉,331,1337,801,536
2017/11/1,總計,新北市,1542120,3986291,1953303,2032988
2017/11/1,總計,臺北市,1050593,2683321,1282030,1401291
2017/11/1,總計,桃園市,789075,2184655,1088179,1096476
2017/11/1,總計,臺中市,957971,2785159,1373382,1411777
2017/11/1,總計,臺南市,683520,1886465,942317,944148
2017/11/1,總計,高雄市,1091722,2776846,1375691,1401155
2017/11/1,總計,臺灣省,2486078,7114020,3627697,3486323
2017/11/1,總計,宜蘭縣,168543,456688,231048,225640
2017/11/1,總計,新竹縣,190932,551816,281899,269917
2017/11/1,總計,苗栗縣,187738,554267,286057,268210
2017/11/1,總計,彰化縣,387010,1282669,653799,628870
2017/11/1,總計,南投縣,178037,501474,256920,244554
2017/11/1,總計,雲林縣,240303,690662,358358,332304
2017/11/1,總計,嘉義縣,182879,511520,266108,245412
2017/11/1,總計,屏東縣,286757,830303,424680,405623
2017/11/1,總計,臺東縣,82869,219627,113415,106212
2017/11/1,總計,花蓮縣,125901,329374,167288,162086
2017/11/1,總計,澎湖縣,39884,104005,53592,50413
2017/11/1,總計,基隆市,152800,371560,185963,185597
2017/11/1,總計,新竹市,162992,440717,217633,223084
2017/11/1,總計,嘉義市,99433,269338,130937,138401
2017/11/1,總計,福建省,42741,150096,75926,74170
2017/11/1,總計,金門縣,39899,137255,68605,68650
2017/11/1,總計,連江縣,2842,12841,7321,5520
2017/11/1,新北市,板橋區,208233,551557,269319,282238
2017/11/1,新北市,三重區,150999,387651,190761,196890
2017/11/1,新北市,中和區,165238,413563,201103,212460
2017/11/1,新北市,永和區,90978,222731,105729,117002
2017/11/1,新北市,新莊區,153120,416453,203262,213191
2017/11/1,新北市,新店區,126606,302054,145296,156758
2017/11/1,新北市,樹林區,66450,184170,91880,92290
2017/11/1,新北市,鶯歌區,29767,86624,43420,43204
2017/11/1,新北市,三峽區,42620,114841,57608,57233
2017/11/1,新北市,淡水區,74597,169319,81235,88084
2017/11/1,新北市,汐止區,86887,199219,97214,102005
2017/11/1,新北市,瑞芳區,16212,40354,20363,19991
2017/11/1,新北市,土城區,86944,238179,117550,120629
2017/11/1,新北市,蘆洲區,70923,201290,98871,102419
2017/11/1,新北市,五股區,31423,84875,42823,42052
2017/11/1,新北市,泰山區,28477,78859,39144,39715
2017/11/1,新北市,林口區,41868,105912,51564,54348
2017/11/1,新北市,深坑區,9610,23662,11840,11822
2017/11/1,新北市,石碇區,3373,7678,4223,3455
2017/11/1,新北市,坪林區,2513,6541,3630,2911
2017/11/1,新北市,三芝區,9467,23209,11948,11261
2017/11/1,新北市,石門區,4293,12282,6357,5925
2017/11/1,新北市,八里區,14546,38450,19173,19277
2017/11/1,新北市,平溪區,2305,4718,2608,2110
2017/11/1,新北市,雙溪區,3809,8922,4822,4100
2017/11/1,新北市,貢寮區,4399,12546,6378,6168
2017/11/1,新北市,金山區,7106,22038,10862,11176
2017/11/1,新北市,萬里區,7486,22318,11215,11103
2017/11/1,新北市,烏來區,1871,6276,3105,3171
2017/11/1,臺北市,松山區,80462,206879,97064,109815
2017/11/1,臺北市,信義區,89460,225831,107835,117996
2017/11/1,臺北市,大安區,120716,309882,144765,165117
2017/11/1,臺北市,中山區,100248,230748,107314,123434
2017/11/1,臺北市,中正區,65117,159675,76218,83457
2017/11/1,臺北市,大同區,51757,129287,63052,66235
2017/11/1,臺北市,萬華區,78669,191961,94285,97676
2017/11/1,臺北市,文山區,105382,274325,131674,142651
2017/11/1,臺北市,南港區,47053,122218,59755,62463
2017/11/1,臺北市,內湖區,107908,287738,137462,150276
2017/11/1,臺北市,士林區,107044,288277,139070,149207
2017/11/1,臺北市,北投區,96777,256500,123536,132964
2017/11/1,桃園市,桃園區,165723,440179,213807,226372
2017/11/1,桃園市,中壢區,149149,404521,199366,205155
2017/11/1,桃園市,大溪區,32364,94413,48147,46266
2017/11/1,桃園市,楊梅區,57981,167339,84317,83022
2017/11/1,桃園市,蘆竹區,58141,161676,80320,81356
2017/11/1,桃園市,大園區,32876,89054,45522,43532
2017/11/1,桃園市,龜山區,61219,157281,78410,78871
2017/11/1,桃園市,八德區,70325,197636,99017,98619
2017/11/1,桃園市,龍潭區,41673,121692,60996,60696
2017/11/1,桃園市,平鎮區,76899,224054,111405,112649
2017/11/1,桃園市,新屋區,16267,48930,26046,22884
2017/11/1,桃園市,觀音區,22675,66401,34587,31814
2017/11/1,桃園市,復興區,3783,11479,6239,5240
2017/11/1,臺中市,中區,7917,18464,9162,9302
2017/11/1,臺中市,東區,27892,75786,37727,38059
2017/11/1,臺中市,南區,48332,124900,59967,64933
2017/11/1,臺中市,西區,45683,115665,54926,60739
2017/11/1,臺中市,北區,59350,147629,70674,76955
2017/11/1,臺中市,西屯區,85776,226836,108948,117888
2017/11/1,臺中市,南屯區,62006,168528,80608,87920
2017/11/1,臺中市,北屯區,100050,274497,131755,142742
2017/11/1,臺中市,豐原區,53624,166794,82452,84342
2017/11/1,臺中市,東勢區,17437,50749,26065,24684
2017/11/1,臺中市,大甲區,23058,77711,39082,38629
2017/11/1,臺中市,清水區,27187,86425,44345,42080
2017/11/1,臺中市,沙鹿區,29465,92457,46659,45798
2017/11/1,臺中市,梧棲區,17739,57962,29123,28839
2017/11/1,臺中市,后里區,16230,54467,27663,26804
2017/11/1,臺中市,神岡區,19431,65545,33449,32096
2017/11/1,臺中市,潭子區,36344,108282,53466,54816
2017/11/1,臺中市,大雅區,29569,95250,47515,47735
2017/11/1,臺中市,新社區,7568,24777,12867,11910
2017/11/1,臺中市,石岡區,4887,15053,7816,7237
2017/11/1,臺中市,外埔區,9735,32157,16473,15684
2017/11/1,臺中市,大安區,5487,19325,10204,9121
2017/11/1,臺中市,烏日區,24558,74483,37433,37050
2017/11/1,臺中市,大肚區,17652,57339,29313,28026
2017/11/1,臺中市,龍井區,23085,77729,39164,38565
2017/11/1,臺中市,霧峰區,20219,65353,33137,32216
2017/11/1,臺中市,太平區,63651,188708,93589,95119
2017/11/1,臺中市,大里區,69476,211363,103925,107438
2017/11/1,臺中市,和平區,4563,10925,5875,5050
2017/11/1,臺南市,新營區,29014,78019,38583,39436
2017/11/1,臺南市,鹽水區,10036,25588,13363,12225
2017/11/1,臺南市,白河區,10841,28564,14930,13634
2017/11/1,臺南市,柳營區,7905,21369,11161,10208
2017/11/1,臺南市,後壁區,8885,23750,12373,11377
2017/11/1,臺南市,東山區,8389,21075,11205,9870
2017/11/1,臺南市,麻豆區,15804,44623,22681,21942
2017/11/1,臺南市,下營區,9086,24258,12530,11728
2017/11/1,臺南市,六甲區,7767,22296,11535,10761
2017/11/1,臺南市,官田區,7937,21462,10936,10526
2017/11/1,臺南市,大內區,3867,9773,5254,4519
2017/11/1,臺南市,佳里區,20669,59386,29474,29912
2017/11/1,臺南市,學甲區,9647,26106,13328,12778
2017/11/1,臺南市,西港區,8185,24739,12498,12241
2017/11/1,臺南市,七股區,8071,22987,11893,11094
2017/11/1,臺南市,將軍區,7285,19877,10122,9755
2017/11/1,臺南市,北門區,4258,11191,5672,5519
2017/11/1,臺南市,新化區,14431,43624,22234,21390
2017/11/1,臺南市,善化區,17660,48322,24318,24004
2017/11/1,臺南市,新市區,12281,36538,18326,18212
2017/11/1,臺南市,安定區,10106,30577,15709,14868
2017/11/1,臺南市,山上區,2715,7310,3819,3491
2017/11/1,臺南市,玉井區,5145,14172,7334,6838
2017/11/1,臺南市,楠西區,3514,9714,5135,4579
2017/11/1,臺南市,南化區,2879,8789,4746,4043
2017/11/1,臺南市,左鎮區,1977,4878,2735,2143
2017/11/1,臺南市,仁德區,27618,75512,38206,37306
2017/11/1,臺南市,歸仁區,22701,68402,34739,33663
2017/11/1,臺南市,關廟區,11128,34458,17785,16673
2017/11/1,臺南市,龍崎區,1538,4038,2163,1875
2017/11/1,臺南市,永康區,84017,233777,115176,118601
2017/11/1,臺南市,東區,71880,186821,89580,97241
2017/11/1,臺南市,南區,45704,125419,62117,63302
2017/11/1,臺南市,北區,50927,132747,64598,68149
2017/11/1,臺南市,安南區,62781,192219,96853,95366
2017/11/1,臺南市,安平區,25636,66439,31582,34857
2017/11/1,臺南市,中西區,31236,77646,37624,40022
2017/11/1,高雄市,鹽埕區,10786,24249,12018,12231
2017/11/1,高雄市,鼓山區,58043,139014,67108,71906
2017/11/1,高雄市,左營區,79018,197140,94830,102310
2017/11/1,高雄市,楠梓區,70359,183493,90162,93331
2017/11/1,高雄市,三民區,136798,343488,166222,177266
2017/11/1,高雄市,新興區,22797,51178,24604,26574
2017/11/1,高雄市,前金區,12607,26959,12874,14085
2017/11/1,高雄市,苓雅區,72166,171102,82390,88712
2017/11/1,高雄市,前鎮區,78764,189882,93315,96567
2017/11/1,高雄市,旗津區,11127,28789,14857,13932
2017/11/1,高雄市,小港區,68043,157424,78214,79210
2017/11/1,高雄市,鳳山區,140628,358986,176063,182923
2017/11/1,高雄市,林園區,25884,69975,35367,34608
2017/11/1,高雄市,大寮區,42184,112396,57468,54928
2017/11/1,高雄市,大樹區,13628,42779,21941,20838
2017/11/1,高雄市,大社區,13031,34571,17548,17023
2017/11/1,高雄市,仁武區,33019,85759,43562,42197
2017/11/1,高雄市,鳥松區,18304,44290,22446,21844
2017/11/1,高雄市,岡山區,34905,97321,48359,48962
2017/11/1,高雄市,橋頭區,13664,37606,19064,18542
2017/11/1,高雄市,燕巢區,10548,29952,15785,14167
2017/11/1,高雄市,田寮區,3274,7260,4012,3248
2017/11/1,高雄市,阿蓮區,9431,28868,14570,14298
2017/11/1,高雄市,路竹區,17066,52757,26940,25817
2017/11/1,高雄市,湖內區,10886,29824,15205,14619
2017/11/1,高雄市,茄萣區,10517,30248,15599,14649
2017/11/1,高雄市,永安區,5740,13984,7035,6949
2017/11/1,高雄市,彌陀區,6800,19405,9974,9431
2017/11/1,高雄市,梓官區,12627,36111,18561,17550
2017/11/1,高雄市,旗山區,13763,36963,19105,17858
2017/11/1,高雄市,美濃區,14722,39992,20968,19024
2017/11/1,高雄市,六龜區,5557,13038,7013,6025
2017/11/1,高雄市,甲仙區,2327,6119,3248,2871
2017/11/1,高雄市,杉林區,4810,12066,6583,5483
2017/11/1,高雄市,內門區,5116,14576,7892,6684
2017/11/1,高雄市,茂林區,592,1926,962,964
2017/11/1,高雄市,桃源區,1344,4243,2229,2014
2017/11/1,高雄市,那瑪夏區,847,3113,1598,1515
2017/11/1,宜蘭縣,宜蘭市,36322,95901,46792,49109
2017/11/1,宜蘭縣,羅東鎮,26355,72205,34221,37984
2017/11/1,宜蘭縣,蘇澳鎮,14195,40121,20411,19710
2017/11/1,宜蘭縣,頭城鎮,10277,29437,15176,14261
2017/11/1,宜蘭縣,礁溪鄉,14089,35808,18624,17184
2017/11/1,宜蘭縣,壯圍鄉,8842,24247,12827,11420
2017/11/1,宜蘭縣,員山鄉,11736,32461,17206,15255
2017/11/1,宜蘭縣,冬山鄉,19325,53362,27344,26018
2017/11/1,宜蘭縣,五結鄉,14975,39654,20500,19154
2017/11/1,宜蘭縣,三星鄉,8582,21484,11574,9910
2017/11/1,宜蘭縣,大同鄉,1897,6090,3286,2804
2017/11/1,宜蘭縣,南澳鄉,1948,5918,3087,2831
2017/11/1,新竹縣,竹北市,65427,181419,90319,91100
2017/11/1,新竹縣,關西鎮,9446,28933,15484,13449
2017/11/1,新竹縣,新埔鎮,10727,33469,17837,15632
2017/11/1,新竹縣,竹東鎮,33980,96929,48664,48265
2017/11/1,新竹縣,湖口鄉,26560,77500,39253,38247
2017/11/1,新竹縣,橫山鄉,4449,13101,7095,6006
2017/11/1,新竹縣,新豐鄉,18470,56800,29117,27683
2017/11/1,新竹縣,芎林鄉,6512,20076,10626,9450
2017/11/1,新竹縣,寶山鄉,5538,14550,7839,6711
2017/11/1,新竹縣,北埔鄉,3115,9408,5120,4288
2017/11/1,新竹縣,峨眉鄉,2075,5535,3046,2489
2017/11/1,新竹縣,尖石鄉,2875,9534,5036,4498
2017/11/1,新竹縣,五峰鄉,1758,4562,2463,2099
2017/11/1,苗栗縣,苗栗市,31332,89222,44558,44664
2017/11/1,苗栗縣,頭份市,34689,103098,52048,51050
2017/11/1,苗栗縣,苑裡鎮,14656,46087,24022,22065
2017/11/1,苗栗縣,通霄鎮,11606,34757,18370,16387
2017/11/1,苗栗縣,竹南鎮,29169,85532,43159,42373
2017/11/1,苗栗縣,後龍鎮,11916,36816,19448,17368
2017/11/1,苗栗縣,卓蘭鎮,6057,17177,8988,8189
2017/11/1,苗栗縣,大湖鄉,5411,14772,7857,6915
2017/11/1,苗栗縣,公館鄉,10744,33839,17664,16175
2017/11/1,苗栗縣,銅鑼鄉,6154,18173,9668,8505
2017/11/1,苗栗縣,南庄鄉,3938,10197,5604,4593
2017/11/1,苗栗縣,頭屋鄉,3640,10842,5766,5076
2017/11/1,苗栗縣,三義鄉,5571,16547,8745,7802
2017/11/1,苗栗縣,西湖鄉,2652,7182,4002,3180
2017/11/1,苗栗縣,造橋鄉,4124,12981,6841,6140
2017/11/1,苗栗縣,三灣鄉,2400,6757,3692,3065
2017/11/1,苗栗縣,獅潭鄉,1719,4416,2473,1943
2017/11/1,苗栗縣,泰安鄉,1960,5872,3152,2720
2017/11/1,彰化縣,彰化市,76360,233564,115396,118168
2017/11/1,彰化縣,員林市,39251,124572,61903,62669
2017/11/1,彰化縣,鹿港鎮,24493,86766,44113,42653
2017/11/1,彰化縣,和美鎮,26759,91024,46330,44694
2017/11/1,彰化縣,北斗鎮,10702,33345,16793,16552
2017/11/1,彰化縣,溪湖鎮,16349,55680,28215,27465
2017/11/1,彰化縣,田中鎮,13164,41867,21602,20265
2017/11/1,彰化縣,二林鎮,15058,51037,26265,24772
2017/11/1,彰化縣,線西鄉,4397,16919,8693,8226
2017/11/1,彰化縣,伸港鄉,9977,36941,18864,18077
2017/11/1,彰化縣,福興鄉,12815,47381,24679,22702
2017/11/1,彰化縣,秀水鄉,10767,39344,20296,19048
2017/11/1,彰化縣,花壇鄉,14100,45971,23571,22400
2017/11/1,彰化縣,芬園鄉,6836,23754,12484,11270
2017/11/1,彰化縣,大村鄉,11136,36876,19039,17837
2017/11/1,彰化縣,埔鹽鄉,9082,32608,17152,15456
2017/11/1,彰化縣,埔心鄉,10586,34873,17959,16914
2017/11/1,彰化縣,永靖鄉,10931,37379,19359,18020
2017/11/1,彰化縣,社頭鄉,12923,43192,22207,20985
2017/11/1,彰化縣,二水鄉,5288,15345,8047,7298
2017/11/1,彰化縣,田尾鄉,7991,27490,14171,13319
2017/11/1,彰化縣,埤頭鄉,9046,30649,15874,14775
2017/11/1,彰化縣,芳苑鄉,10138,33735,17850,15885
2017/11/1,彰化縣,大城鄉,5257,16988,9171,7817
2017/11/1,彰化縣,竹塘鄉,4617,15301,8055,7246
2017/11/1,彰化縣,溪州鄉,8987,30068,15711,14357
2017/11/1,南投縣,南投市,34729,100226,50173,50053
2017/11/1,南投縣,埔里鎮,29027,81078,40392,40686
2017/11/1,南投縣,草屯鎮,33275,97949,49540,48409
2017/11/1,南投縣,竹山鎮,20124,55125,28272,26853
2017/11/1,南投縣,集集鎮,4300,10905,5673,5232
2017/11/1,南投縣,名間鄉,12644,38870,20467,18403
2017/11/1,南投縣,鹿谷鄉,7933,17821,9520,8301
2017/11/1,南投縣,中寮鄉,5635,14884,8075,6809
2017/11/1,南投縣,魚池鄉,5771,15967,8419,7548
2017/11/1,南投縣,國姓鄉,7266,18823,10178,8645
2017/11/1,南投縣,水里鄉,7151,17823,9347,8476
2017/11/1,南投縣,信義鄉,5274,16261,8719,7542
2017/11/1,南投縣,仁愛鄉,4908,15742,8145,7597
2017/11/1,雲林縣,斗六市,38255,108591,54003,54588
2017/11/1,雲林縣,斗南鎮,15888,44951,22830,22121
2017/11/1,雲林縣,虎尾鎮,25016,70926,35921,35005
2017/11/1,雲林縣,西螺鎮,14645,46235,23405,22830
2017/11/1,雲林縣,土庫鎮,9376,28956,15122,13834
2017/11/1,雲林縣,北港鎮,15984,40327,20860,19467
2017/11/1,雲林縣,古坑鄉,10971,31728,16719,15009
2017/11/1,雲林縣,大埤鄉,6680,19282,10349,8933
2017/11/1,雲林縣,莿桐鄉,9338,28940,15184,13756
2017/11/1,雲林縣,林內鄉,6028,18257,9532,8725
2017/11/1,雲林縣,二崙鄉,8948,27254,14567,12687
2017/11/1,雲林縣,崙背鄉,8500,24697,13044,11653
2017/11/1,雲林縣,麥寮鄉,14333,45610,22929,22681
2017/11/1,雲林縣,東勢鄉,5739,14905,8236,6669
2017/11/1,雲林縣,褒忠鄉,4439,13003,6990,6013
2017/11/1,雲林縣,臺西鄉,8691,23957,12838,11119
2017/11/1,雲林縣,元長鄉,9292,26009,14220,11789
2017/11/1,雲林縣,四湖鄉,8775,23697,12840,10857
2017/11/1,雲林縣,口湖鄉,9483,27685,14731,12954
2017/11/1,雲林縣,水林鄉,9922,25652,14038,11614
2017/11/1,嘉義縣,太保市,12959,37744,19397,18347
2017/11/1,嘉義縣,朴子市,15719,42406,21444,20962
2017/11/1,嘉義縣,布袋鎮,9959,27172,13879,13293
2017/11/1,嘉義縣,大林鎮,11412,31202,15983,15219
2017/11/1,嘉義縣,民雄鄉,24902,71713,36720,34993
2017/11/1,嘉義縣,溪口鄉,5352,14769,7899,6870
2017/11/1,嘉義縣,新港鄉,10644,32000,16847,15153
2017/11/1,嘉義縣,六腳鄉,8864,23332,12392,10940
2017/11/1,嘉義縣,東石鄉,9236,24988,13225,11763
2017/11/1,嘉義縣,義竹鄉,7402,18509,9628,8881
2017/11/1,嘉義縣,鹿草鄉,5773,15598,8376,7222
2017/11/1,嘉義縣,水上鄉,18089,49741,25674,24067
2017/11/1,嘉義縣,中埔鄉,15991,45036,23456,21580
2017/11/1,嘉義縣,竹崎鄉,11696,35999,19194,16805
2017/11/1,嘉義縣,梅山鄉,6765,19510,10383,9127
2017/11/1,嘉義縣,番路鄉,4256,11608,6279,5329
2017/11/1,嘉義縣,大埔鄉,1930,4574,2370,2204
2017/11/1,嘉義縣,阿里山鄉,1930,5619,2962,2657
2017/11/1,屏東縣,屏東市,74268,200489,99150,101339
2017/11/1,屏東縣,潮州鎮,19476,54405,27173,27232
2017/11/1,屏東縣,東港鎮,16721,47890,24189,23701
2017/11/1,屏東縣,恆春鎮,11557,30706,15740,14966
2017/11/1,屏東縣,萬丹鄉,14967,50930,26395,24535
2017/11/1,屏東縣,長治鄉,10176,30036,15655,14381
2017/11/1,屏東縣,麟洛鄉,3803,11077,5759,5318
2017/11/1,屏東縣,九如鄉,6997,22080,11421,10659
2017/11/1,屏東縣,里港鄉,8204,26530,13508,13022
2017/11/1,屏東縣,鹽埔鄉,7860,26005,13523,12482
2017/11/1,屏東縣,高樹鄉,9291,24638,13131,11507
2017/11/1,屏東縣,萬巒鄉,6512,20566,10750,9816
2017/11/1,屏東縣,內埔鄉,18646,54753,28286,26467
2017/11/1,屏東縣,竹田鄉,5638,17172,9131,8041
2017/11/1,屏東縣,新埤鄉,3435,9946,5275,4671
2017/11/1,屏東縣,枋寮鄉,8531,24588,12879,11709
2017/11/1,屏東縣,新園鄉,11820,35353,18322,17031
2017/11/1,屏東縣,崁頂鄉,4485,15739,8002,7737
2017/11/1,屏東縣,林邊鄉,6746,18107,9273,8834
2017/11/1,屏東縣,南州鄉,3704,10670,5484,5186
2017/11/1,屏東縣,佳冬鄉,6972,19417,10083,9334
2017/11/1,屏東縣,琉球鄉,4481,12325,6765,5560
2017/11/1,屏東縣,車城鄉,3462,8608,4621,3987
2017/11/1,屏東縣,滿州鄉,3014,7839,4265,3574
2017/11/1,屏東縣,枋山鄉,2109,5467,2916,2551
2017/11/1,屏東縣,三地門鄉,2318,7646,3846,3800
2017/11/1,屏東縣,霧臺鄉,1058,3241,1663,1578
2017/11/1,屏東縣,瑪家鄉,2055,6740,3419,3321
2017/11/1,屏東縣,泰武鄉,1339,5270,2773,2497
2017/11/1,屏東縣,來義鄉,2237,7473,3778,3695
2017/11/1,屏東縣,春日鄉,1395,4863,2496,2367
2017/11/1,屏東縣,獅子鄉,1557,4810,2492,2318
2017/11/1,屏東縣,牡丹鄉,1923,4924,2517,2407
2017/11/1,臺東縣,臺東市,39742,106008,53097,52911
2017/11/1,臺東縣,成功鎮,5388,14231,7500,6731
2017/11/1,臺東縣,關山鎮,3179,8746,4552,4194
2017/11/1,臺東縣,卑南鄉,6718,17435,9195,8240
2017/11/1,臺東縣,大武鄉,2500,6117,3202,2915
2017/11/1,臺東縣,太麻里鄉,4677,11150,5947,5203
2017/11/1,臺東縣,東河鄉,3764,8528,4736,3792
2017/11/1,臺東縣,長濱鄉,2925,7270,4112,3158
2017/11/1,臺東縣,鹿野鄉,3043,7957,4234,3723
2017/11/1,臺東縣,池上鄉,3204,8266,4310,3956
2017/11/1,臺東縣,綠島鄉,1146,3894,2045,1849
2017/11/1,臺東縣,延平鄉,1067,3566,1906,1660
2017/11/1,臺東縣,海端鄉,1089,4215,2238,1977
2017/11/1,臺東縣,達仁鄉,1456,3521,1919,1602
2017/11/1,臺東縣,金峰鄉,1126,3655,1868,1787
2017/11/1,臺東縣,蘭嶼鄉,1845,5068,2554,2514
2017/11/1,花蓮縣,花蓮市,41523,104445,50414,54031
2017/11/1,花蓮縣,鳳林鎮,4412,10881,5649,5232
2017/11/1,花蓮縣,玉里鎮,8911,24391,12922,11469
2017/11/1,花蓮縣,新城鄉,7747,20210,10403,9807
2017/11/1,花蓮縣,吉安鄉,32008,83667,42113,41554
2017/11/1,花蓮縣,壽豐鄉,7210,18072,9623,8449
2017/11/1,花蓮縣,光復鄉,5004,12903,6863,6040
2017/11/1,花蓮縣,豐濱鄉,1709,4386,2434,1952
2017/11/1,花蓮縣,瑞穗鄉,4750,11660,6294,5366
2017/11/1,花蓮縣,富里鄉,4032,10432,5671,4761
2017/11/1,花蓮縣,秀林鄉,4805,15884,8191,7693
2017/11/1,花蓮縣,萬榮鄉,2094,6384,3371,3013
2017/11/1,花蓮縣,卓溪鄉,1696,6059,3340,2719
2017/11/1,澎湖縣,馬公市,24540,62242,31666,30576
2017/11/1,澎湖縣,湖西鄉,5547,14500,7634,6866
2017/11/1,澎湖縣,白沙鄉,3393,9809,5140,4669
2017/11/1,澎湖縣,西嶼鄉,3004,8408,4338,4070
2017/11/1,澎湖縣,望安鄉,2025,5188,2801,2387
2017/11/1,澎湖縣,七美鄉,1375,3858,2013,1845
2017/11/1,基隆市,中正區,22634,52163,26667,25496
2017/11/1,基隆市,七堵區,21461,54006,27132,26874
2017/11/1,基隆市,暖暖區,15669,38709,19428,19281
2017/11/1,基隆市,仁愛區,19198,44379,21987,22392
2017/11/1,基隆市,中山區,19276,47938,24285,23653
2017/11/1,基隆市,安樂區,33427,82338,40730,41608
2017/11/1,基隆市,信義區,21135,52027,25734,26293
2017/11/1,新竹市,東區,79249,212234,104430,107804
2017/11/1,新竹市,北區,56570,150572,73594,76978
2017/11/1,新竹市,香山區,27173,77911,39609,38302
2017/11/1,嘉義市,東區,45460,122057,58755,63302
2017/11/1,嘉義市,西區,53973,147281,72182,75099
2017/11/1,金門縣,金城鎮,12870,43228,21586,21642
2017/11/1,金門縣,金湖鎮,8896,29335,14750,14585
2017/11/1,金門縣,金沙鎮,6301,20515,10146,10369
2017/11/1,金門縣,金寧鄉,8560,30788,15527,15261
2017/11/1,金門縣,烈嶼鄉,3138,12704,6250,6454
2017/11/1,金門縣,烏坵鄉,134,685,346,339
2017/11/1,連江縣,南竿鄉,1658,7521,4218,3303
2017/11/1,連江縣,北竿鄉,563,2365,1317,1048
2017/11/1,連江縣,莒光鄉,291,1611,981,630
2017/11/1,連江縣,東引鄉,330,1344,805,539
2017/12/1,總計,新北市,1543098,3986689,1953397,2033292
2017/12/1,總計,臺北市,1050755,2683257,1281917,1401340
2017/12/1,總計,桃園市,790376,2188017,1089619,1098398
2017/12/1,總計,臺中市,959023,2787070,1374085,1412985
2017/12/1,總計,臺南市,683814,1886522,942278,944244
2017/12/1,總計,高雄市,1092219,2776912,1375515,1401397
2017/12/1,總計,臺灣省,2486938,7112424,3626698,3485726
2017/12/1,總計,宜蘭縣,168589,456607,230976,225631
2017/12/1,總計,新竹縣,191171,552169,282073,270096
2017/12/1,總計,苗栗縣,187846,553807,285844,267963
2017/12/1,總計,彰化縣,387166,1282458,653646,628812
2017/12/1,總計,南投縣,178012,501051,256732,244319
2017/12/1,總計,雲林縣,240290,690373,358179,332194
2017/12/1,總計,嘉義縣,182890,511182,265882,245300
2017/12/1,總計,屏東縣,286844,829939,424486,405453
2017/12/1,總計,臺東縣,82869,219540,113378,106162
2017/12/1,總計,花蓮縣,125936,329237,167179,162058
2017/12/1,總計,澎湖縣,39938,104073,53648,50425
2017/12/1,總計,基隆市,152781,371458,185870,185588
2017/12/1,總計,新竹市,163130,441132,217831,223301
2017/12/1,總計,嘉義市,99476,269398,130974,138424
2017/12/1,總計,福建省,42777,150336,76071,74265
2017/12/1,總計,金門縣,39923,137456,68722,68734
2017/12/1,總計,連江縣,2854,12880,7349,5531
2017/12/1,新北市,板橋區,208464,551480,269259,282221
2017/12/1,新北市,三重區,151065,387484,190698,196786
2017/12/1,新北市,中和區,165228,413590,201104,212486
2017/12/1,新北市,永和區,90938,222585,105658,116927
2017/12/1,新北市,新莊區,153253,416524,203329,213195
2017/12/1,新北市,新店區,126696,302089,145273,156816
2017/12/1,新北市,樹林區,66454,184149,91845,92304
2017/12/1,新北市,鶯歌區,29790,86593,43404,43189
2017/12/1,新北市,三峽區,42661,114926,57644,57282
2017/12/1,新北市,淡水區,74756,169597,81352,88245
2017/12/1,新北市,汐止區,86928,199321,97241,102080
2017/12/1,新北市,瑞芳區,16212,40353,20372,19981
2017/12/1,新北市,土城區,86953,238067,117517,120550
2017/12/1,新北市,蘆洲區,70961,201309,98873,102436
2017/12/1,新北市,五股區,31473,84919,42844,42075
2017/12/1,新北市,泰山區,28478,78911,39164,39747
2017/12/1,新北市,林口區,41953,106101,51647,54454
2017/12/1,新北市,深坑區,9605,23660,11837,11823
2017/12/1,新北市,石碇區,3379,7683,4223,3460
2017/12/1,新北市,坪林區,2514,6528,3620,2908
2017/12/1,新北市,三芝區,9483,23200,11946,11254
2017/12/1,新北市,石門區,4301,12286,6356,5930
2017/12/1,新北市,八里區,14581,38493,19195,19298
2017/12/1,新北市,平溪區,2302,4719,2612,2107
2017/12/1,新北市,雙溪區,3814,8939,4831,4108
2017/12/1,新北市,貢寮區,4405,12552,6375,6177
2017/12/1,新北市,金山區,7105,22015,10853,11162
2017/12/1,新北市,萬里區,7480,22296,11204,11092
2017/12/1,新北市,烏來區,1866,6320,3121,3199
2017/12/1,臺北市,松山區,80552,206988,97096,109892
2017/12/1,臺北市,信義區,89457,225753,107780,117973
2017/12/1,臺北市,大安區,120738,309969,144782,165187
2017/12/1,臺北市,中山區,100226,230710,107262,123448
2017/12/1,臺北市,中正區,65107,159608,76194,83414
2017/12/1,臺北市,大同區,51790,129278,63062,66216
2017/12/1,臺北市,萬華區,78633,191850,94234,97616
2017/12/1,臺北市,文山區,105480,274424,131716,142708
2017/12/1,臺北市,南港區,47052,122155,59705,62450
2017/12/1,臺北市,內湖區,107916,287771,137530,150241
2017/12/1,臺北市,士林區,107035,288295,139077,149218
2017/12/1,臺北市,北投區,96769,256456,123479,132977
2017/12/1,桃園市,桃園區,165916,440840,214093,226747
2017/12/1,桃園市,中壢區,149484,405216,199681,205535
2017/12/1,桃園市,大溪區,32377,94451,48156,46295
2017/12/1,桃園市,楊梅區,58089,167639,84468,83171
2017/12/1,桃園市,蘆竹區,58227,161912,80416,81496
2017/12/1,桃園市,大園區,32988,89281,45638,43643
2017/12/1,桃園市,龜山區,61323,157633,78557,79076
2017/12/1,桃園市,八德區,70481,198074,99214,98860
2017/12/1,桃園市,龍潭區,41726,121822,61019,60803
2017/12/1,桃園市,平鎮區,76977,224219,111472,112747
2017/12/1,桃園市,新屋區,16287,48953,26048,22905
2017/12/1,桃園市,觀音區,22713,66472,34609,31863
2017/12/1,桃園市,復興區,3788,11505,6248,5257
2017/12/1,臺中市,中區,7901,18450,9153,9297
2017/12/1,臺中市,東區,27904,75811,37737,38074
2017/12/1,臺中市,南區,48366,125067,60040,65027
2017/12/1,臺中市,西區,45669,115627,54906,60721
2017/12/1,臺中市,北區,59409,147653,70663,76990
2017/12/1,臺中市,西屯區,85896,227043,109002,118041
2017/12/1,臺中市,南屯區,62119,168760,80705,88055
2017/12/1,臺中市,北屯區,100185,274819,131931,142888
2017/12/1,臺中市,豐原區,53675,166879,82464,84415
2017/12/1,臺中市,東勢區,17431,50714,26040,24674
2017/12/1,臺中市,大甲區,23074,77761,39121,38640
2017/12/1,臺中市,清水區,27248,86420,44356,42064
2017/12/1,臺中市,沙鹿區,29533,92645,46731,45914
2017/12/1,臺中市,梧棲區,17761,57993,29133,28860
2017/12/1,臺中市,后里區,16247,54482,27670,26812
2017/12/1,臺中市,神岡區,19447,65553,33462,32091
2017/12/1,臺中市,潭子區,36350,108288,53484,54804
2017/12/1,臺中市,大雅區,29567,95203,47502,47701
2017/12/1,臺中市,新社區,7562,24754,12848,11906
2017/12/1,臺中市,石岡區,4894,15066,7808,7258
2017/12/1,臺中市,外埔區,9755,32185,16489,15696
2017/12/1,臺中市,大安區,5488,19303,10176,9127
2017/12/1,臺中市,烏日區,24586,74554,37447,37107
2017/12/1,臺中市,大肚區,17660,57322,29282,28040
2017/12/1,臺中市,龍井區,23101,77818,39203,38615
2017/12/1,臺中市,霧峰區,20251,65393,33159,32234
2017/12/1,臺中市,太平區,63823,189066,93727,95339
2017/12/1,臺中市,大里區,69547,211492,103959,107533
2017/12/1,臺中市,和平區,4574,10949,5887,5062
2017/12/1,臺南市,新營區,29016,77966,38552,39414
2017/12/1,臺南市,鹽水區,10035,25583,13368,12215
2017/12/1,臺南市,白河區,10839,28520,14904,13616
2017/12/1,臺南市,柳營區,7903,21365,11155,10210
2017/12/1,臺南市,後壁區,8877,23718,12343,11375
2017/12/1,臺南市,東山區,8387,21049,11183,9866
2017/12/1,臺南市,麻豆區,15806,44603,22677,21926
2017/12/1,臺南市,下營區,9085,24239,12521,11718
2017/12/1,臺南市,六甲區,7773,22275,11518,10757
2017/12/1,臺南市,官田區,7932,21448,10931,10517
2017/12/1,臺南市,大內區,3865,9761,5252,4509
2017/12/1,臺南市,佳里區,20685,59380,29472,29908
2017/12/1,臺南市,學甲區,9644,26078,13314,12764
2017/12/1,臺南市,西港區,8200,24758,12508,12250
2017/12/1,臺南市,七股區,8065,22974,11891,11083
2017/12/1,臺南市,將軍區,7284,19849,10111,9738
2017/12/1,臺南市,北門區,4255,11188,5672,5516
2017/12/1,臺南市,新化區,14448,43630,22241,21389
2017/12/1,臺南市,善化區,17688,48386,24352,24034
2017/12/1,臺南市,新市區,12295,36574,18341,18233
2017/12/1,臺南市,安定區,10112,30564,15711,14853
2017/12/1,臺南市,山上區,2716,7314,3816,3498
2017/12/1,臺南市,玉井區,5147,14151,7321,6830
2017/12/1,臺南市,楠西區,3515,9717,5138,4579
2017/12/1,臺南市,南化區,2878,8787,4745,4042
2017/12/1,臺南市,左鎮區,1976,4876,2734,2142
2017/12/1,臺南市,仁德區,27622,75518,38208,37310
2017/12/1,臺南市,歸仁區,22707,68424,34752,33672
2017/12/1,臺南市,關廟區,11143,34433,17769,16664
2017/12/1,臺南市,龍崎區,1537,4038,2162,1876
2017/12/1,臺南市,永康區,84060,233905,115238,118667
2017/12/1,臺南市,東區,71876,186841,89560,97281
2017/12/1,臺南市,南區,45710,125394,62105,63289
2017/12/1,臺南市,北區,50950,132726,64585,68141
2017/12/1,臺南市,安南區,62816,192224,96850,95374
2017/12/1,臺南市,安平區,25646,66496,31623,34873
2017/12/1,臺南市,中西區,31321,77770,37655,40115
2017/12/1,高雄市,鹽埕區,10777,24219,11995,12224
2017/12/1,高雄市,鼓山區,58160,139259,67203,72056
2017/12/1,高雄市,左營區,78968,197072,94803,102269
2017/12/1,高雄市,楠梓區,70468,183751,90241,93510
2017/12/1,高雄市,三民區,136797,343243,166078,177165
2017/12/1,高雄市,新興區,22806,51153,24588,26565
2017/12/1,高雄市,前金區,12616,26991,12879,14112
2017/12/1,高雄市,苓雅區,72188,171033,82375,88658
2017/12/1,高雄市,前鎮區,78766,189839,93276,96563
2017/12/1,高雄市,旗津區,11118,28763,14840,13923
2017/12/1,高雄市,小港區,68096,157475,78227,79248
2017/12/1,高雄市,鳳山區,140712,359120,176110,183010
2017/12/1,高雄市,林園區,25901,69990,35381,34609
2017/12/1,高雄市,大寮區,42214,112397,57463,54934
2017/12/1,高雄市,大樹區,13627,42757,21920,20837
2017/12/1,高雄市,大社區,13032,34577,17565,17012
2017/12/1,高雄市,仁武區,33111,85894,43613,42281
2017/12/1,高雄市,鳥松區,18308,44291,22443,21848
2017/12/1,高雄市,岡山區,34903,97329,48336,48993
2017/12/1,高雄市,橋頭區,13666,37579,19047,18532
2017/12/1,高雄市,燕巢區,10547,29922,15757,14165
2017/12/1,高雄市,田寮區,3270,7245,4003,3242
2017/12/1,高雄市,阿蓮區,9425,28844,14568,14276
2017/12/1,高雄市,路竹區,17077,52761,26924,25837
2017/12/1,高雄市,湖內區,10885,29803,15206,14597
2017/12/1,高雄市,茄萣區,10535,30217,15582,14635
2017/12/1,高雄市,永安區,5739,13980,7028,6952
2017/12/1,高雄市,彌陀區,6794,19383,9965,9418
2017/12/1,高雄市,梓官區,12628,36116,18563,17553
2017/12/1,高雄市,旗山區,13765,36940,19097,17843
2017/12/1,高雄市,美濃區,14726,39973,20964,19009
2017/12/1,高雄市,六龜區,5558,13016,7004,6012
2017/12/1,高雄市,甲仙區,2325,6107,3245,2862
2017/12/1,高雄市,杉林區,4811,12038,6565,5473
2017/12/1,高雄市,內門區,5116,14540,7873,6667
2017/12/1,高雄市,茂林區,592,1924,961,963
2017/12/1,高雄市,桃源區,1345,4246,2226,2020
2017/12/1,高雄市,那瑪夏區,847,3125,1601,1524
2017/12/1,宜蘭縣,宜蘭市,36325,95918,46794,49124
2017/12/1,宜蘭縣,羅東鎮,26380,72319,34267,38052
2017/12/1,宜蘭縣,蘇澳鎮,14181,40056,20373,19683
2017/12/1,宜蘭縣,頭城鎮,10264,29398,15161,14237
2017/12/1,宜蘭縣,礁溪鄉,14093,35777,18602,17175
2017/12/1,宜蘭縣,壯圍鄉,8850,24250,12816,11434
2017/12/1,宜蘭縣,員山鄉,11747,32458,17210,15248
2017/12/1,宜蘭縣,冬山鄉,19328,53289,27307,25982
2017/12/1,宜蘭縣,五結鄉,14980,39673,20505,19168
2017/12/1,宜蘭縣,三星鄉,8588,21467,11565,9902
2017/12/1,宜蘭縣,大同鄉,1901,6102,3292,2810
2017/12/1,宜蘭縣,南澳鄉,1952,5900,3084,2816
2017/12/1,新竹縣,竹北市,65648,181955,90569,91386
2017/12/1,新竹縣,關西鎮,9432,28896,15462,13434
2017/12/1,新竹縣,新埔鎮,10734,33415,17819,15596
2017/12/1,新竹縣,竹東鎮,33974,96918,48657,48261
2017/12/1,新竹縣,湖口鄉,26566,77444,39224,38220
2017/12/1,新竹縣,橫山鄉,4444,13064,7079,5985
2017/12/1,新竹縣,新豐鄉,18505,56836,29145,27691
2017/12/1,新竹縣,芎林鄉,6501,20061,10621,9440
2017/12/1,新竹縣,寶山鄉,5551,14550,7841,6709
2017/12/1,新竹縣,北埔鄉,3113,9390,5107,4283
2017/12/1,新竹縣,峨眉鄉,2077,5538,3047,2491
2017/12/1,新竹縣,尖石鄉,2870,9543,5035,4508
2017/12/1,新竹縣,五峰鄉,1756,4559,2467,2092
2017/12/1,苗栗縣,苗栗市,31358,89165,44524,44641
2017/12/1,苗栗縣,頭份市,34737,103147,52083,51064
2017/12/1,苗栗縣,苑裡鎮,14658,45976,23962,22014
2017/12/1,苗栗縣,通霄鎮,11605,34691,18328,16363
2017/12/1,苗栗縣,竹南鎮,29237,85587,43198,42389
2017/12/1,苗栗縣,後龍鎮,11915,36750,19419,17331
2017/12/1,苗栗縣,卓蘭鎮,6045,17134,8980,8154
2017/12/1,苗栗縣,大湖鄉,5414,14738,7831,6907
2017/12/1,苗栗縣,公館鄉,10741,33773,17635,16138
2017/12/1,苗栗縣,銅鑼鄉,6140,18138,9657,8481
2017/12/1,苗栗縣,南庄鄉,3933,10176,5594,4582
2017/12/1,苗栗縣,頭屋鄉,3642,10840,5763,5077
2017/12/1,苗栗縣,三義鄉,5570,16530,8735,7795
2017/12/1,苗栗縣,西湖鄉,2650,7154,3987,3167
2017/12/1,苗栗縣,造橋鄉,4118,12952,6829,6123
2017/12/1,苗栗縣,三灣鄉,2403,6756,3688,3068
2017/12/1,苗栗縣,獅潭鄉,1718,4417,2475,1942
2017/12/1,苗栗縣,泰安鄉,1962,5883,3156,2727
2017/12/1,彰化縣,彰化市,76417,233613,115405,118208
2017/12/1,彰化縣,員林市,39279,124632,61937,62695
2017/12/1,彰化縣,鹿港鎮,24518,86799,44125,42674
2017/12/1,彰化縣,和美鎮,26760,90986,46307,44679
2017/12/1,彰化縣,北斗鎮,10700,33355,16798,16557
2017/12/1,彰化縣,溪湖鎮,16346,55686,28221,27465
2017/12/1,彰化縣,田中鎮,13168,41890,21603,20287
2017/12/1,彰化縣,二林鎮,15063,50980,26230,24750
2017/12/1,彰化縣,線西鄉,4401,16928,8688,8240
2017/12/1,彰化縣,伸港鄉,9983,36957,18871,18086
2017/12/1,彰化縣,福興鄉,12816,47332,24651,22681
2017/12/1,彰化縣,秀水鄉,10777,39357,20314,19043
2017/12/1,彰化縣,花壇鄉,14091,45924,23551,22373
2017/12/1,彰化縣,芬園鄉,6834,23755,12477,11278
2017/12/1,彰化縣,大村鄉,11142,36870,19049,17821
2017/12/1,彰化縣,埔鹽鄉,9080,32587,17139,15448
2017/12/1,彰化縣,埔心鄉,10591,34836,17939,16897
2017/12/1,彰化縣,永靖鄉,10929,37334,19338,17996
2017/12/1,彰化縣,社頭鄉,12930,43144,22188,20956
2017/12/1,彰化縣,二水鄉,5286,15325,8029,7296
2017/12/1,彰化縣,田尾鄉,7990,27462,14158,13304
2017/12/1,彰化縣,埤頭鄉,9051,30642,15862,14780
2017/12/1,彰化縣,芳苑鄉,10137,33714,17839,15875
2017/12/1,彰化縣,大城鄉,5255,16987,9173,7814
2017/12/1,彰化縣,竹塘鄉,4619,15303,8055,7248
2017/12/1,彰化縣,溪州鄉,9003,30060,15699,14361
2017/12/1,南投縣,南投市,34725,100180,50150,50030
2017/12/1,南投縣,埔里鎮,29035,81033,40366,40667
2017/12/1,南投縣,草屯鎮,33264,97875,49504,48371
2017/12/1,南投縣,竹山鎮,20119,55060,28237,26823
2017/12/1,南投縣,集集鎮,4300,10904,5673,5231
2017/12/1,南投縣,名間鄉,12639,38796,20431,18365
2017/12/1,南投縣,鹿谷鄉,7947,17808,9511,8297
2017/12/1,南投縣,中寮鄉,5629,14842,8060,6782
2017/12/1,南投縣,魚池鄉,5776,15946,8419,7527
2017/12/1,南投縣,國姓鄉,7258,18803,10170,8633
2017/12/1,南投縣,水里鄉,7146,17803,9347,8456
2017/12/1,南投縣,信義鄉,5273,16253,8715,7538
2017/12/1,南投縣,仁愛鄉,4901,15748,8149,7599
2017/12/1,雲林縣,斗六市,38254,108567,53979,54588
2017/12/1,雲林縣,斗南鎮,15876,44941,22818,22123
2017/12/1,雲林縣,虎尾鎮,25021,70892,35897,34995
2017/12/1,雲林縣,西螺鎮,14660,46244,23402,22842
2017/12/1,雲林縣,土庫鎮,9382,28932,15111,13821
2017/12/1,雲林縣,北港鎮,15974,40278,20840,19438
2017/12/1,雲林縣,古坑鄉,10964,31708,16704,15004
2017/12/1,雲林縣,大埤鄉,6674,19263,10346,8917
2017/12/1,雲林縣,莿桐鄉,9343,28939,15180,13759
2017/12/1,雲林縣,林內鄉,6026,18230,9529,8701
2017/12/1,雲林縣,二崙鄉,8965,27255,14583,12672
2017/12/1,雲林縣,崙背鄉,8502,24678,13029,11649
2017/12/1,雲林縣,麥寮鄉,14345,45665,22953,22712
2017/12/1,雲林縣,東勢鄉,5732,14893,8231,6662
2017/12/1,雲林縣,褒忠鄉,4434,13010,6994,6016
2017/12/1,雲林縣,臺西鄉,8686,23954,12838,11116
2017/12/1,雲林縣,元長鄉,9284,25980,14196,11784
2017/12/1,雲林縣,四湖鄉,8780,23667,12819,10848
2017/12/1,雲林縣,口湖鄉,9473,27653,14719,12934
2017/12/1,雲林縣,水林鄉,9915,25624,14011,11613
2017/12/1,嘉義縣,太保市,12980,37781,19422,18359
2017/12/1,嘉義縣,朴子市,15707,42382,21419,20963
2017/12/1,嘉義縣,布袋鎮,9955,27143,13859,13284
2017/12/1,嘉義縣,大林鎮,11417,31198,15981,15217
2017/12/1,嘉義縣,民雄鄉,24916,71693,36706,34987
2017/12/1,嘉義縣,溪口鄉,5347,14751,7886,6865
2017/12/1,嘉義縣,新港鄉,10647,31935,16809,15126
2017/12/1,嘉義縣,六腳鄉,8862,23318,12380,10938
2017/12/1,嘉義縣,東石鄉,9230,24969,13213,11756
2017/12/1,嘉義縣,義竹鄉,7398,18486,9597,8889
2017/12/1,嘉義縣,鹿草鄉,5769,15577,8365,7212
2017/12/1,嘉義縣,水上鄉,18095,49744,25677,24067
2017/12/1,嘉義縣,中埔鄉,15981,44974,23442,21532
2017/12/1,嘉義縣,竹崎鄉,11700,35962,19168,16794
2017/12/1,嘉義縣,梅山鄉,6769,19475,10357,9118
2017/12/1,嘉義縣,番路鄉,4259,11599,6272,5327
2017/12/1,嘉義縣,大埔鄉,1928,4564,2365,2199
2017/12/1,嘉義縣,阿里山鄉,1930,5631,2964,2667
2017/12/1,屏東縣,屏東市,74302,200452,99114,101338
2017/12/1,屏東縣,潮州鎮,19463,54377,27157,27220
2017/12/1,屏東縣,東港鎮,16732,47866,24182,23684
2017/12/1,屏東縣,恆春鎮,11568,30726,15758,14968
2017/12/1,屏東縣,萬丹鄉,14969,50935,26391,24544
2017/12/1,屏東縣,長治鄉,10171,30008,15639,14369
2017/12/1,屏東縣,麟洛鄉,3802,11076,5753,5323
2017/12/1,屏東縣,九如鄉,7010,22110,11433,10677
2017/12/1,屏東縣,里港鄉,8203,26459,13465,12994
2017/12/1,屏東縣,鹽埔鄉,7864,25997,13531,12466
2017/12/1,屏東縣,高樹鄉,9293,24622,13136,11486
2017/12/1,屏東縣,萬巒鄉,6514,20556,10751,9805
2017/12/1,屏東縣,內埔鄉,18660,54707,28276,26431
2017/12/1,屏東縣,竹田鄉,5637,17158,9127,8031
2017/12/1,屏東縣,新埤鄉,3442,9936,5272,4664
2017/12/1,屏東縣,枋寮鄉,8537,24571,12864,11707
2017/12/1,屏東縣,新園鄉,11817,35321,18298,17023
2017/12/1,屏東縣,崁頂鄉,4491,15720,7987,7733
2017/12/1,屏東縣,林邊鄉,6734,18080,9264,8816
2017/12/1,屏東縣,南州鄉,3706,10670,5486,5184
2017/12/1,屏東縣,佳冬鄉,6967,19380,10067,9313
2017/12/1,屏東縣,琉球鄉,4484,12337,6766,5571
2017/12/1,屏東縣,車城鄉,3461,8586,4609,3977
2017/12/1,屏東縣,滿州鄉,3018,7840,4263,3577
2017/12/1,屏東縣,枋山鄉,2108,5478,2922,2556
2017/12/1,屏東縣,三地門鄉,2322,7644,3840,3804
2017/12/1,屏東縣,霧臺鄉,1060,3246,1664,1582
2017/12/1,屏東縣,瑪家鄉,2052,6746,3423,3323
2017/12/1,屏東縣,泰武鄉,1340,5271,2775,2496
2017/12/1,屏東縣,來義鄉,2235,7465,3773,3692
2017/12/1,屏東縣,春日鄉,1398,4867,2495,2372
2017/12/1,屏東縣,獅子鄉,1560,4806,2488,2318
2017/12/1,屏東縣,牡丹鄉,1924,4926,2517,2409
2017/12/1,臺東縣,臺東市,39741,105960,53079,52881
2017/12/1,臺東縣,成功鎮,5386,14238,7504,6734
2017/12/1,臺東縣,關山鎮,3179,8742,4542,4200
2017/12/1,臺東縣,卑南鄉,6716,17399,9180,8219
2017/12/1,臺東縣,大武鄉,2497,6117,3203,2914
2017/12/1,臺東縣,太麻里鄉,4682,11163,5956,5207
2017/12/1,臺東縣,東河鄉,3760,8517,4724,3793
2017/12/1,臺東縣,長濱鄉,2928,7260,4107,3153
2017/12/1,臺東縣,鹿野鄉,3044,7951,4232,3719
2017/12/1,臺東縣,池上鄉,3203,8248,4304,3944
2017/12/1,臺東縣,綠島鄉,1148,3926,2067,1859
2017/12/1,臺東縣,延平鄉,1067,3551,1895,1656
2017/12/1,臺東縣,海端鄉,1091,4222,2247,1975
2017/12/1,臺東縣,達仁鄉,1455,3518,1917,1601
2017/12/1,臺東縣,金峰鄉,1124,3653,1861,1792
2017/12/1,臺東縣,蘭嶼鄉,1848,5075,2560,2515
2017/12/1,花蓮縣,花蓮市,41526,104380,50367,54013
2017/12/1,花蓮縣,鳳林鎮,4406,10861,5642,5219
2017/12/1,花蓮縣,玉里鎮,8902,24345,12887,11458
2017/12/1,花蓮縣,新城鄉,7737,20185,10386,9799
2017/12/1,花蓮縣,吉安鄉,32048,83747,42121,41626
2017/12/1,花蓮縣,壽豐鄉,7226,18043,9611,8432
2017/12/1,花蓮縣,光復鄉,5009,12888,6865,6023
2017/12/1,花蓮縣,豐濱鄉,1709,4383,2430,1953
2017/12/1,花蓮縣,瑞穗鄉,4748,11653,6297,5356
2017/12/1,花蓮縣,富里鄉,4028,10413,5664,4749
2017/12/1,花蓮縣,秀林鄉,4803,15889,8189,7700
2017/12/1,花蓮縣,萬榮鄉,2098,6384,3372,3012
2017/12/1,花蓮縣,卓溪鄉,1696,6066,3348,2718
2017/12/1,澎湖縣,馬公市,24581,62308,31701,30607
2017/12/1,澎湖縣,湖西鄉,5558,14508,7653,6855
2017/12/1,澎湖縣,白沙鄉,3395,9817,5140,4677
2017/12/1,澎湖縣,西嶼鄉,3012,8408,4344,4064
2017/12/1,澎湖縣,望安鄉,2020,5176,2799,2377
2017/12/1,澎湖縣,七美鄉,1372,3856,2011,1845
2017/12/1,基隆市,中正區,22630,52163,26653,25510
2017/12/1,基隆市,七堵區,21452,53972,27114,26858
2017/12/1,基隆市,暖暖區,15670,38708,19424,19284
2017/12/1,基隆市,仁愛區,19186,44314,21967,22347
2017/12/1,基隆市,中山區,19262,47908,24272,23636
2017/12/1,基隆市,安樂區,33445,82358,40722,41636
2017/12/1,基隆市,信義區,21136,52035,25718,26317
2017/12/1,新竹市,東區,79337,212553,104590,107963
2017/12/1,新竹市,北區,56599,150636,73639,76997
2017/12/1,新竹市,香山區,27194,77943,39602,38341
2017/12/1,嘉義市,東區,45474,122103,58814,63289
2017/12/1,嘉義市,西區,54002,147295,72160,75135
2017/12/1,金門縣,金城鎮,12872,43285,21611,21674
2017/12/1,金門縣,金湖鎮,8911,29413,14780,14633
2017/12/1,金門縣,金沙鎮,6300,20535,10162,10373
2017/12/1,金門縣,金寧鄉,8570,30838,15571,15267
2017/12/1,金門縣,烈嶼鄉,3136,12700,6252,6448
2017/12/1,金門縣,烏坵鄉,134,685,346,339
2017/12/1,連江縣,南竿鄉,1666,7544,4232,3312
2017/12/1,連江縣,北竿鄉,566,2360,1315,1045
2017/12/1,連江縣,莒光鄉,291,1624,991,633
2017/12/1,連江縣,東引鄉,331,1352,811,541
2018/1/1,總計,新北市,1543736,3986348,1952979,2033369
2018/1/1,總計,臺北市,1051477,2682721,1281596,1401125
2018/1/1,總計,桃園市,791614,2191034,1090912,1100122
2018/1/1,總計,臺中市,960021,2788828,1374775,1414053
2018/1/1,總計,臺南市,684098,1886251,942064,944187
2018/1/1,總計,高雄市,1092682,2776786,1375196,1401590
2018/1/1,總計,臺灣省,2487875,7109598,3624940,3484658
2018/1/1,總計,宜蘭縣,168631,456362,230845,225517
2018/1/1,總計,新竹縣,191391,552334,282203,270131
2018/1/1,總計,苗栗縣,187941,553245,285557,267688
2018/1/1,總計,彰化縣,387319,1281940,653279,628661
2018/1/1,總計,南投縣,178037,500686,256509,244177
2018/1/1,總計,雲林縣,240338,689861,357856,332005
2018/1/1,總計,嘉義縣,182896,510806,265648,245158
2018/1/1,總計,屏東縣,286907,829475,424193,405282
2018/1/1,總計,臺東縣,82876,219467,113315,106152
2018/1/1,總計,花蓮縣,125937,329016,167039,161977
2018/1/1,總計,澎湖縣,39957,104105,53648,50457
2018/1/1,總計,基隆市,152815,371317,185819,185498
2018/1/1,總計,新竹市,163305,441639,218043,223596
2018/1/1,總計,嘉義市,99525,269345,130986,138359
2018/1/1,總計,福建省,42843,150483,76168,74315
2018/1/1,總計,金門縣,39974,137577,68802,68775
2018/1/1,總計,連江縣,2869,12906,7366,5540
2018/1/1,新北市,板橋區,208540,551452,269218,282234
2018/1/1,新北市,三重區,151043,387125,190458,196667
2018/1/1,新北市,中和區,165183,413291,200934,212357
2018/1/1,新北市,永和區,90950,222531,105628,116903
2018/1/1,新北市,新莊區,153411,416640,203340,213300
2018/1/1,新北市,新店區,126697,302070,145264,156806
2018/1/1,新北市,樹林區,66459,184105,91831,92274
2018/1/1,新北市,鶯歌區,29829,86577,43405,43172
2018/1/1,新北市,三峽區,42717,115001,57656,57345
2018/1/1,新北市,淡水區,74852,169741,81393,88348
2018/1/1,新北市,汐止區,86983,199457,97295,102162
2018/1/1,新北市,瑞芳區,16205,40310,20352,19958
2018/1/1,新北市,土城區,86936,237885,117420,120465
2018/1/1,新北市,蘆洲區,71004,201313,98853,102460
2018/1/1,新北市,五股區,31540,85042,42914,42128
2018/1/1,新北市,泰山區,28485,78883,39142,39741
2018/1/1,新北市,林口區,42046,106316,51734,54582
2018/1/1,新北市,深坑區,9607,23662,11838,11824
2018/1/1,新北市,石碇區,3375,7676,4218,3458
2018/1/1,新北市,坪林區,2511,6521,3616,2905
2018/1/1,新北市,三芝區,9488,23186,11925,11261
2018/1/1,新北市,石門區,4303,12284,6352,5932
2018/1/1,新北市,八里區,14599,38471,19196,19275
2018/1/1,新北市,平溪區,2298,4712,2615,2097
2018/1/1,新北市,雙溪區,3816,8932,4828,4104
2018/1/1,新北市,貢寮區,4398,12537,6375,6162
2018/1/1,新北市,金山區,7110,22028,10863,11165
2018/1/1,新北市,萬里區,7485,22275,11195,11080
2018/1/1,新北市,烏來區,1866,6325,3121,3204
2018/1/1,臺北市,松山區,80849,207107,97133,109974
2018/1/1,臺北市,信義區,89482,225561,107658,117903
2018/1/1,臺北市,大安區,120762,309835,144705,165130
2018/1/1,臺北市,中山區,100269,230558,107216,123342
2018/1/1,臺北市,中正區,65142,159598,76183,83415
2018/1/1,臺北市,大同區,51809,129208,63029,66179
2018/1/1,臺北市,萬華區,78630,191747,94192,97555
2018/1/1,臺北市,文山區,105573,274379,131659,142720
2018/1/1,臺北市,南港區,47069,122187,59729,62458
2018/1/1,臺北市,內湖區,108019,287842,137520,150322
2018/1/1,臺北市,士林區,107080,288340,139139,149201
2018/1/1,臺北市,北投區,96793,256359,123433,132926
2018/1/1,桃園市,桃園區,166115,441287,214265,227022
2018/1/1,桃園市,中壢區,149748,405828,199907,205921
2018/1/1,桃園市,大溪區,32425,94499,48172,46327
2018/1/1,桃園市,楊梅區,58221,167864,84558,83306
2018/1/1,桃園市,蘆竹區,58330,162219,80559,81660
2018/1/1,桃園市,大園區,33002,89373,45687,43686
2018/1/1,桃園市,龜山區,61435,157938,78698,79240
2018/1/1,桃園市,八德區,70595,198473,99369,99104
2018/1/1,桃園市,龍潭區,41786,121979,61120,60859
2018/1/1,桃園市,平鎮區,77083,224485,111579,112906
2018/1/1,桃園市,新屋區,16326,49020,26088,22932
2018/1/1,桃園市,觀音區,22753,66501,34632,31869
2018/1/1,桃園市,復興區,3795,11568,6278,5290
2018/1/1,臺中市,中區,7911,18470,9152,9318
2018/1/1,臺中市,東區,27941,75835,37741,38094
2018/1/1,臺中市,南區,48384,125140,60094,65046
2018/1/1,臺中市,西區,45670,115663,54926,60737
2018/1/1,臺中市,北區,59448,147647,70644,77003
2018/1/1,臺中市,西屯區,85939,227147,109052,118095
2018/1/1,臺中市,南屯區,62243,168978,80815,88163
2018/1/1,臺中市,北屯區,100324,275207,132108,143099
2018/1/1,臺中市,豐原區,53727,166956,82498,84458
2018/1/1,臺中市,東勢區,17432,50641,25993,24648
2018/1/1,臺中市,大甲區,23101,77790,39131,38659
2018/1/1,臺中市,清水區,27300,86481,44395,42086
2018/1/1,臺中市,沙鹿區,29565,92766,46769,45997
2018/1/1,臺中市,梧棲區,17788,58050,29128,28922
2018/1/1,臺中市,后里區,16271,54519,27667,26852
2018/1/1,臺中市,神岡區,19463,65528,33450,32078
2018/1/1,臺中市,潭子區,36366,108332,53508,54824
2018/1/1,臺中市,大雅區,29633,95365,47559,47806
2018/1/1,臺中市,新社區,7564,24723,12837,11886
2018/1/1,臺中市,石岡區,4895,15046,7801,7245
2018/1/1,臺中市,外埔區,9753,32151,16466,15685
2018/1/1,臺中市,大安區,5488,19282,10170,9112
2018/1/1,臺中市,烏日區,24597,74610,37450,37160
2018/1/1,臺中市,大肚區,17682,57299,29271,28028
2018/1/1,臺中市,龍井區,23135,77856,39240,38616
2018/1/1,臺中市,霧峰區,20293,65438,33174,32264
2018/1/1,臺中市,太平區,63967,189410,93883,95527
2018/1/1,臺中市,大里區,69571,211554,103966,107588
2018/1/1,臺中市,和平區,4570,10944,5887,5057
2018/1/1,臺南市,新營區,29013,78005,38575,39430
2018/1/1,臺南市,鹽水區,10038,25562,13357,12205
2018/1/1,臺南市,白河區,10827,28496,14891,13605
2018/1/1,臺南市,柳營區,7904,21334,11142,10192
2018/1/1,臺南市,後壁區,8879,23703,12329,11374
2018/1/1,臺南市,東山區,8385,21036,11177,9859
2018/1/1,臺南市,麻豆區,15797,44579,22650,21929
2018/1/1,臺南市,下營區,9082,24213,12499,11714
2018/1/1,臺南市,六甲區,7778,22260,11516,10744
2018/1/1,臺南市,官田區,7924,21418,10920,10498
2018/1/1,臺南市,大內區,3863,9750,5256,4494
2018/1/1,臺南市,佳里區,20696,59362,29464,29898
2018/1/1,臺南市,學甲區,9632,25995,13281,12714
2018/1/1,臺南市,西港區,8208,24759,12516,12243
2018/1/1,臺南市,七股區,8061,22986,11907,11079
2018/1/1,臺南市,將軍區,7287,19837,10102,9735
2018/1/1,臺南市,北門區,4258,11186,5659,5527
2018/1/1,臺南市,新化區,14451,43622,22231,21391
2018/1/1,臺南市,善化區,17721,48407,24343,24064
2018/1/1,臺南市,新市區,12314,36613,18359,18254
2018/1/1,臺南市,安定區,10116,30541,15715,14826
2018/1/1,臺南市,山上區,2720,7321,3817,3504
2018/1/1,臺南市,玉井區,5153,14136,7315,6821
2018/1/1,臺南市,楠西區,3519,9714,5142,4572
2018/1/1,臺南市,南化區,2880,8791,4744,4047
2018/1/1,臺南市,左鎮區,1973,4864,2725,2139
2018/1/1,臺南市,仁德區,27626,75485,38192,37293
2018/1/1,臺南市,歸仁區,22722,68444,34756,33688
2018/1/1,臺南市,關廟區,11140,34423,17763,16660
2018/1/1,臺南市,龍崎區,1539,4029,2160,1869
2018/1/1,臺南市,永康區,84134,233974,115298,118676
2018/1/1,臺南市,東區,71905,186813,89508,97305
2018/1/1,臺南市,南區,45724,125349,62073,63276
2018/1/1,臺南市,北區,50943,132602,64515,68087
2018/1/1,臺南市,安南區,62895,192327,96906,95421
2018/1/1,臺南市,安平區,25657,66542,31640,34902
2018/1/1,臺南市,中西區,31334,77773,37621,40152
2018/1/1,高雄市,鹽埕區,10779,24235,11996,12239
2018/1/1,高雄市,鼓山區,58208,139312,67198,72114
2018/1/1,高雄市,左營區,78955,197003,94786,102217
2018/1/1,高雄市,楠梓區,70532,183948,90301,93647
2018/1/1,高雄市,三民區,136889,343203,166048,177155
2018/1/1,高雄市,新興區,22834,51182,24592,26590
2018/1/1,高雄市,前金區,12609,26950,12858,14092
2018/1/1,高雄市,苓雅區,72150,170861,82251,88610
2018/1/1,高雄市,前鎮區,78736,189629,93160,96469
2018/1/1,高雄市,旗津區,11127,28733,14830,13903
2018/1/1,高雄市,小港區,68176,157583,78275,79308
2018/1/1,高雄市,鳳山區,140796,359125,176096,183029
2018/1/1,高雄市,林園區,25908,70008,35366,34642
2018/1/1,高雄市,大寮區,42231,112421,57477,54944
2018/1/1,高雄市,大樹區,13637,42795,21938,20857
2018/1/1,高雄市,大社區,13043,34611,17570,17041
2018/1/1,高雄市,仁武區,33191,86032,43655,42377
2018/1/1,高雄市,鳥松區,18314,44347,22456,21891
2018/1/1,高雄市,岡山區,34922,97345,48332,49013
2018/1/1,高雄市,橋頭區,13682,37614,19078,18536
2018/1/1,高雄市,燕巢區,10546,29875,15735,14140
2018/1/1,高雄市,田寮區,3268,7237,4001,3236
2018/1/1,高雄市,阿蓮區,9425,28820,14557,14263
2018/1/1,高雄市,路竹區,17075,52733,26911,25822
2018/1/1,高雄市,湖內區,10883,29807,15205,14602
2018/1/1,高雄市,茄萣區,10533,30171,15549,14622
2018/1/1,高雄市,永安區,5736,13960,7011,6949
2018/1/1,高雄市,彌陀區,6788,19361,9955,9406
2018/1/1,高雄市,梓官區,12627,36081,18547,17534
2018/1/1,高雄市,旗山區,13758,36947,19101,17846
2018/1/1,高雄市,美濃區,14738,39940,20935,19005
2018/1/1,高雄市,六龜區,5559,12999,6992,6007
2018/1/1,高雄市,甲仙區,2319,6091,3233,2858
2018/1/1,高雄市,杉林區,4804,11985,6540,5445
2018/1/1,高雄市,內門區,5115,14528,7865,6663
2018/1/1,高雄市,茂林區,594,1931,965,966
2018/1/1,高雄市,桃源區,1349,4257,2235,2022
2018/1/1,高雄市,那瑪夏區,846,3126,1596,1530
2018/1/1,宜蘭縣,宜蘭市,36347,95937,46817,49120
2018/1/1,宜蘭縣,羅東鎮,26405,72449,34325,38124
2018/1/1,宜蘭縣,蘇澳鎮,14174,40002,20340,19662
2018/1/1,宜蘭縣,頭城鎮,10261,29355,15123,14232
2018/1/1,宜蘭縣,礁溪鄉,14096,35758,18595,17163
2018/1/1,宜蘭縣,壯圍鄉,8850,24201,12789,11412
2018/1/1,宜蘭縣,員山鄉,11738,32408,17187,15221
2018/1/1,宜蘭縣,冬山鄉,19324,53175,27241,25934
2018/1/1,宜蘭縣,五結鄉,14990,39619,20486,19133
2018/1/1,宜蘭縣,三星鄉,8584,21428,11551,9877
2018/1/1,宜蘭縣,大同鄉,1906,6118,3302,2816
2018/1/1,宜蘭縣,南澳鄉,1956,5912,3089,2823
2018/1/1,新竹縣,竹北市,65803,182250,90737,91513
2018/1/1,新竹縣,關西鎮,9426,28847,15437,13410
2018/1/1,新竹縣,新埔鎮,10733,33372,17801,15571
2018/1/1,新竹縣,竹東鎮,33987,96940,48666,48274
2018/1/1,新竹縣,湖口鄉,26605,77472,39245,38227
2018/1/1,新竹縣,橫山鄉,4440,13029,7066,5963
2018/1/1,新竹縣,新豐鄉,18523,56806,29152,27654
2018/1/1,新竹縣,芎林鄉,6502,20065,10625,9440
2018/1/1,新竹縣,寶山鄉,5560,14548,7835,6713
2018/1/1,新竹縣,北埔鄉,3106,9358,5097,4261
2018/1/1,新竹縣,峨眉鄉,2075,5527,3038,2489
2018/1/1,新竹縣,尖石鄉,2875,9541,5034,4507
2018/1/1,新竹縣,五峰鄉,1756,4579,2470,2109
2018/1/1,苗栗縣,苗栗市,31371,89016,44461,44555
2018/1/1,苗栗縣,頭份市,34776,103126,52081,51045
2018/1/1,苗栗縣,苑裡鎮,14659,45912,23924,21988
2018/1/1,苗栗縣,通霄鎮,11595,34628,18298,16330
2018/1/1,苗栗縣,竹南鎮,29286,85644,43242,42402
2018/1/1,苗栗縣,後龍鎮,11922,36706,19399,17307
2018/1/1,苗栗縣,卓蘭鎮,6034,17087,8955,8132
2018/1/1,苗栗縣,大湖鄉,5419,14724,7811,6913
2018/1/1,苗栗縣,公館鄉,10735,33704,17591,16113
2018/1/1,苗栗縣,銅鑼鄉,6137,18113,9639,8474
2018/1/1,苗栗縣,南庄鄉,3935,10166,5581,4585
2018/1/1,苗栗縣,頭屋鄉,3647,10845,5759,5086
2018/1/1,苗栗縣,三義鄉,5570,16484,8713,7771
2018/1/1,苗栗縣,西湖鄉,2642,7124,3974,3150
2018/1/1,苗栗縣,造橋鄉,4122,12928,6820,6108
2018/1/1,苗栗縣,三灣鄉,2402,6738,3679,3059
2018/1/1,苗栗縣,獅潭鄉,1720,4415,2475,1940
2018/1/1,苗栗縣,泰安鄉,1969,5885,3155,2730
2018/1/1,彰化縣,彰化市,76452,233515,115334,118181
2018/1/1,彰化縣,員林市,39301,124606,61932,62674
2018/1/1,彰化縣,鹿港鎮,24516,86820,44140,42680
2018/1/1,彰化縣,和美鎮,26766,90982,46301,44681
2018/1/1,彰化縣,北斗鎮,10710,33337,16779,16558
2018/1/1,彰化縣,溪湖鎮,16347,55666,28217,27449
2018/1/1,彰化縣,田中鎮,13172,41896,21616,20280
2018/1/1,彰化縣,二林鎮,15065,50955,26206,24749
2018/1/1,彰化縣,線西鄉,4412,16923,8685,8238
2018/1/1,彰化縣,伸港鄉,9984,36944,18856,18088
2018/1/1,彰化縣,福興鄉,12823,47298,24627,22671
2018/1/1,彰化縣,秀水鄉,10790,39398,20342,19056
2018/1/1,彰化縣,花壇鄉,14088,45887,23538,22349
2018/1/1,彰化縣,芬園鄉,6838,23731,12469,11262
2018/1/1,彰化縣,大村鄉,11154,36857,19019,17838
2018/1/1,彰化縣,埔鹽鄉,9088,32557,17114,15443
2018/1/1,彰化縣,埔心鄉,10597,34791,17917,16874
2018/1/1,彰化縣,永靖鄉,10932,37324,19334,17990
2018/1/1,彰化縣,社頭鄉,12931,43135,22183,20952
2018/1/1,彰化縣,二水鄉,5284,15286,8007,7279
2018/1/1,彰化縣,田尾鄉,8004,27489,14159,13330
2018/1/1,彰化縣,埤頭鄉,9064,30650,15862,14788
2018/1/1,彰化縣,芳苑鄉,10139,33689,17799,15890
2018/1/1,彰化縣,大城鄉,5255,16957,9148,7809
2018/1/1,彰化縣,竹塘鄉,4614,15261,8031,7230
2018/1/1,彰化縣,溪州鄉,8993,29986,15664,14322
2018/1/1,南投縣,南投市,34743,100144,50116,50028
2018/1/1,南投縣,埔里鎮,29033,80942,40313,40629
2018/1/1,南投縣,草屯鎮,33272,97798,49460,48338
2018/1/1,南投縣,竹山鎮,20127,55043,28218,26825
2018/1/1,南投縣,集集鎮,4304,10896,5669,5227
2018/1/1,南投縣,名間鄉,12629,38735,20394,18341
2018/1/1,南投縣,鹿谷鄉,7961,17811,9512,8299
2018/1/1,南投縣,中寮鄉,5630,14833,8054,6779
2018/1/1,南投縣,魚池鄉,5775,15929,8418,7511
2018/1/1,南投縣,國姓鄉,7259,18786,10153,8633
2018/1/1,南投縣,水里鄉,7131,17767,9328,8439
2018/1/1,南投縣,信義鄉,5278,16250,8720,7530
2018/1/1,南投縣,仁愛鄉,4895,15752,8154,7598
2018/1/1,雲林縣,斗六市,38298,108602,53984,54618
2018/1/1,雲林縣,斗南鎮,15876,44883,22799,22084
2018/1/1,雲林縣,虎尾鎮,25031,70884,35906,34978
2018/1/1,雲林縣,西螺鎮,14670,46217,23381,22836
2018/1/1,雲林縣,土庫鎮,9380,28904,15099,13805
2018/1/1,雲林縣,北港鎮,15965,40202,20781,19421
2018/1/1,雲林縣,古坑鄉,10965,31673,16681,14992
2018/1/1,雲林縣,大埤鄉,6670,19232,10330,8902
2018/1/1,雲林縣,莿桐鄉,9349,28896,15157,13739
2018/1/1,雲林縣,林內鄉,6028,18198,9511,8687
2018/1/1,雲林縣,二崙鄉,8964,27234,14565,12669
2018/1/1,雲林縣,崙背鄉,8504,24641,13009,11632
2018/1/1,雲林縣,麥寮鄉,14359,45689,22951,22738
2018/1/1,雲林縣,東勢鄉,5727,14869,8217,6652
2018/1/1,雲林縣,褒忠鄉,4436,13004,6993,6011
2018/1/1,雲林縣,臺西鄉,8681,23948,12828,11120
2018/1/1,雲林縣,元長鄉,9284,25938,14168,11770
2018/1/1,雲林縣,四湖鄉,8780,23640,12805,10835
2018/1/1,雲林縣,口湖鄉,9468,27617,14711,12906
2018/1/1,雲林縣,水林鄉,9903,25590,13980,11610
2018/1/1,嘉義縣,太保市,13023,37830,19438,18392
2018/1/1,嘉義縣,朴子市,15704,42356,21397,20959
2018/1/1,嘉義縣,布袋鎮,9950,27111,13834,13277
2018/1/1,嘉義縣,大林鎮,11404,31172,15963,15209
2018/1/1,嘉義縣,民雄鄉,24924,71676,36677,34999
2018/1/1,嘉義縣,溪口鄉,5342,14723,7882,6841
2018/1/1,嘉義縣,新港鄉,10660,31919,16800,15119
2018/1/1,嘉義縣,六腳鄉,8849,23283,12373,10910
2018/1/1,嘉義縣,東石鄉,9227,24914,13185,11729
2018/1/1,嘉義縣,義竹鄉,7397,18479,9601,8878
2018/1/1,嘉義縣,鹿草鄉,5767,15551,8350,7201
2018/1/1,嘉義縣,水上鄉,18098,49674,25637,24037
2018/1/1,嘉義縣,中埔鄉,15983,44966,23416,21550
2018/1/1,嘉義縣,竹崎鄉,11694,35938,19166,16772
2018/1/1,嘉義縣,梅山鄉,6762,19453,10344,9109
2018/1/1,嘉義縣,番路鄉,4261,11586,6271,5315
2018/1/1,嘉義縣,大埔鄉,1928,4565,2362,2203
2018/1/1,嘉義縣,阿里山鄉,1923,5610,2952,2658
2018/1/1,屏東縣,屏東市,74308,200347,99069,101278
2018/1/1,屏東縣,潮州鎮,19472,54358,27128,27230
2018/1/1,屏東縣,東港鎮,16721,47838,24174,23664
2018/1/1,屏東縣,恆春鎮,11586,30730,15739,14991
2018/1/1,屏東縣,萬丹鄉,14971,50907,26380,24527
2018/1/1,屏東縣,長治鄉,10166,30002,15642,14360
2018/1/1,屏東縣,麟洛鄉,3811,11078,5753,5325
2018/1/1,屏東縣,九如鄉,7013,22110,11435,10675
2018/1/1,屏東縣,里港鄉,8204,26427,13448,12979
2018/1/1,屏東縣,鹽埔鄉,7864,25944,13499,12445
2018/1/1,屏東縣,高樹鄉,9290,24612,13121,11491
2018/1/1,屏東縣,萬巒鄉,6521,20547,10739,9808
2018/1/1,屏東縣,內埔鄉,18671,54674,28257,26417
2018/1/1,屏東縣,竹田鄉,5643,17156,9125,8031
2018/1/1,屏東縣,新埤鄉,3443,9931,5267,4664
2018/1/1,屏東縣,枋寮鄉,8540,24564,12855,11709
2018/1/1,屏東縣,新園鄉,11816,35284,18283,17001
2018/1/1,屏東縣,崁頂鄉,4488,15688,7972,7716
2018/1/1,屏東縣,林邊鄉,6734,18048,9252,8796
2018/1/1,屏東縣,南州鄉,3704,10661,5478,5183
2018/1/1,屏東縣,佳冬鄉,6967,19352,10048,9304
2018/1/1,屏東縣,琉球鄉,4486,12316,6753,5563
2018/1/1,屏東縣,車城鄉,3460,8579,4601,3978
2018/1/1,屏東縣,滿州鄉,3030,7861,4276,3585
2018/1/1,屏東縣,枋山鄉,2099,5466,2914,2552
2018/1/1,屏東縣,三地門鄉,2322,7652,3847,3805
2018/1/1,屏東縣,霧臺鄉,1058,3251,1668,1583
2018/1/1,屏東縣,瑪家鄉,2052,6745,3421,3324
2018/1/1,屏東縣,泰武鄉,1343,5273,2774,2499
2018/1/1,屏東縣,來義鄉,2234,7442,3763,3679
2018/1/1,屏東縣,春日鄉,1399,4873,2500,2373
2018/1/1,屏東縣,獅子鄉,1562,4818,2490,2328
2018/1/1,屏東縣,牡丹鄉,1929,4941,2522,2419
2018/1/1,臺東縣,臺東市,39735,105947,53045,52902
2018/1/1,臺東縣,成功鎮,5388,14213,7483,6730
2018/1/1,臺東縣,關山鎮,3175,8735,4538,4197
2018/1/1,臺東縣,卑南鄉,6715,17388,9181,8207
2018/1/1,臺東縣,大武鄉,2497,6111,3197,2914
2018/1/1,臺東縣,太麻里鄉,4692,11161,5954,5207
2018/1/1,臺東縣,東河鄉,3759,8497,4718,3779
2018/1/1,臺東縣,長濱鄉,2927,7250,4103,3147
2018/1/1,臺東縣,鹿野鄉,3048,7935,4228,3707
2018/1/1,臺東縣,池上鄉,3204,8222,4292,3930
2018/1/1,臺東縣,綠島鄉,1156,3964,2092,1872
2018/1/1,臺東縣,延平鄉,1068,3568,1900,1668
2018/1/1,臺東縣,海端鄉,1090,4219,2246,1973
2018/1/1,臺東縣,達仁鄉,1453,3515,1913,1602
2018/1/1,臺東縣,金峰鄉,1124,3663,1865,1798
2018/1/1,臺東縣,蘭嶼鄉,1845,5079,2560,2519
2018/1/1,花蓮縣,花蓮市,41539,104295,50303,53992
2018/1/1,花蓮縣,鳳林鎮,4406,10843,5636,5207
2018/1/1,花蓮縣,玉里鎮,8892,24308,12863,11445
2018/1/1,花蓮縣,新城鄉,7737,20170,10385,9785
2018/1/1,花蓮縣,吉安鄉,32053,83750,42117,41633
2018/1/1,花蓮縣,壽豐鄉,7227,18046,9612,8434
2018/1/1,花蓮縣,光復鄉,4999,12856,6841,6015
2018/1/1,花蓮縣,豐濱鄉,1704,4374,2423,1951
2018/1/1,花蓮縣,瑞穗鄉,4749,11669,6310,5359
2018/1/1,花蓮縣,富里鄉,4029,10390,5647,4743
2018/1/1,花蓮縣,秀林鄉,4810,15872,8182,7690
2018/1/1,花蓮縣,萬榮鄉,2096,6388,3375,3013
2018/1/1,花蓮縣,卓溪鄉,1696,6055,3345,2710
2018/1/1,澎湖縣,馬公市,24590,62304,31686,30618
2018/1/1,澎湖縣,湖西鄉,5563,14506,7650,6856
2018/1/1,澎湖縣,白沙鄉,3400,9836,5149,4687
2018/1/1,澎湖縣,西嶼鄉,3012,8414,4345,4069
2018/1/1,澎湖縣,望安鄉,2024,5191,2809,2382
2018/1/1,澎湖縣,七美鄉,1368,3854,2009,1845
2018/1/1,基隆市,中正區,22620,52101,26626,25475
2018/1/1,基隆市,七堵區,21464,53961,27122,26839
2018/1/1,基隆市,暖暖區,15672,38681,19397,19284
2018/1/1,基隆市,仁愛區,19198,44319,21972,22347
2018/1/1,基隆市,中山區,19256,47880,24257,23623
2018/1/1,基隆市,安樂區,33451,82368,40736,41632
2018/1/1,基隆市,信義區,21154,52007,25709,26298
2018/1/1,新竹市,東區,79446,212905,104773,108132
2018/1/1,新竹市,北區,56631,150719,73639,77080
2018/1/1,新竹市,香山區,27228,78015,39631,38384
2018/1/1,嘉義市,東區,45484,122018,58759,63259
2018/1/1,嘉義市,西區,54041,147327,72227,75100
2018/1/1,金門縣,金城鎮,12880,43296,21633,21663
2018/1/1,金門縣,金湖鎮,8930,29461,14815,14646
2018/1/1,金門縣,金沙鎮,6304,20537,10159,10378
2018/1/1,金門縣,金寧鄉,8589,30884,15587,15297
2018/1/1,金門縣,烈嶼鄉,3137,12712,6261,6451
2018/1/1,金門縣,烏坵鄉,134,687,347,340
2018/1/1,連江縣,南竿鄉,1671,7539,4231,3308
2018/1/1,連江縣,北竿鄉,576,2380,1326,1054
2018/1/1,連江縣,莒光鄉,292,1627,995,632
2018/1/1,連江縣,東引鄉,330,1360,814,546
2018/2/1,總計,新北市,1544255,3986501,1952839,2033662
2018/2/1,總計,臺北市,1051436,2681375,1280882,1400493
2018/2/1,總計,桃園市,792337,2193098,1091840,1101258
2018/2/1,總計,臺中市,960800,2790381,1375300,1415081
2018/2/1,總計,臺南市,684225,1886074,941905,944169
2018/2/1,總計,高雄市,1092766,2776366,1374786,1401580
2018/2/1,總計,臺灣省,2488001,7107086,3623376,3483710
2018/2/1,總計,宜蘭縣,168592,456259,230773,225486
2018/2/1,總計,新竹縣,191590,552488,282278,270210
2018/2/1,總計,苗栗縣,187946,552807,285324,267483
2018/2/1,總計,彰化縣,387326,1281304,652884,628420
2018/2/1,總計,南投縣,178027,500449,256407,244042
2018/2/1,總計,雲林縣,240269,689463,357579,331884
2018/2/1,總計,嘉義縣,182842,510498,265431,245067
2018/2/1,總計,屏東縣,286913,829094,423989,405105
2018/2/1,總計,臺東縣,82893,219436,113292,106144
2018/2/1,總計,花蓮縣,125871,328853,166956,161897
2018/2/1,總計,澎湖縣,39966,104087,53641,50446
2018/2/1,總計,基隆市,152804,371204,185740,185464
2018/2/1,總計,新竹市,163401,441817,218100,223717
2018/2/1,總計,嘉義市,99561,269327,130982,138345
2018/2/1,總計,福建省,42908,150527,76159,74368
2018/2/1,總計,金門縣,40011,137625,68814,68811
2018/2/1,總計,連江縣,2897,12902,7345,5557
2018/2/1,新北市,板橋區,208563,551473,269190,282283
2018/2/1,新北市,三重區,151041,387044,190368,196676
2018/2/1,新北市,中和區,165197,413201,200862,212339
2018/2/1,新北市,永和區,90936,222419,105553,116866
2018/2/1,新北市,新莊區,153561,416909,203452,213457
2018/2/1,新北市,新店區,126746,302030,145221,156809
2018/2/1,新北市,樹林區,66442,184055,91800,92255
2018/2/1,新北市,鶯歌區,29847,86580,43413,43167
2018/2/1,新北市,三峽區,42730,115049,57675,57374
2018/2/1,新北市,淡水區,74953,169996,81512,88484
2018/2/1,新北市,汐止區,87011,199473,97318,102155
2018/2/1,新北市,瑞芳區,16190,40256,20319,19937
2018/2/1,新北市,土城區,86941,237858,117394,120464
2018/2/1,新北市,蘆洲區,71024,201258,98833,102425
2018/2/1,新北市,五股區,31594,85121,42944,42177
2018/2/1,新北市,泰山區,28487,78872,39127,39745
2018/2/1,新北市,林口區,42130,106509,51830,54679
2018/2/1,新北市,深坑區,9600,23633,11819,11814
2018/2/1,新北市,石碇區,3378,7671,4213,3458
2018/2/1,新北市,坪林區,2511,6515,3610,2905
2018/2/1,新北市,三芝區,9490,23161,11914,11247
2018/2/1,新北市,石門區,4298,12263,6346,5917
2018/2/1,新北市,八里區,14616,38481,19210,19271
2018/2/1,新北市,平溪區,2297,4710,2612,2098
2018/2/1,新北市,雙溪區,3816,8913,4815,4098
2018/2/1,新北市,貢寮區,4397,12518,6367,6151
2018/2/1,新北市,金山區,7109,21987,10837,11150
2018/2/1,新北市,萬里區,7484,22227,11171,11056
2018/2/1,新北市,烏來區,1866,6319,3114,3205
2018/2/1,臺北市,松山區,80850,206966,97087,109879
2018/2/1,臺北市,信義區,89428,225235,107519,117716
2018/2/1,臺北市,大安區,120748,309734,144661,165073
2018/2/1,臺北市,中山區,100242,230495,107178,123317
2018/2/1,臺北市,中正區,65166,159587,76165,83422
2018/2/1,臺北市,大同區,51813,129098,62967,66131
2018/2/1,臺北市,萬華區,78595,191569,94081,97488
2018/2/1,臺北市,文山區,105582,274361,131613,142748
2018/2/1,臺北市,南港區,47088,122216,59755,62461
2018/2/1,臺北市,內湖區,108017,287743,137455,150288
2018/2/1,臺北市,士林區,107101,288157,139053,149104
2018/2/1,臺北市,北投區,96806,256214,123348,132866
2018/2/1,桃園市,桃園區,166246,441724,214473,227251
2018/2/1,桃園市,中壢區,149934,406325,200103,206222
2018/2/1,桃園市,大溪區,32479,94573,48195,46378
2018/2/1,桃園市,楊梅區,58256,168046,84655,83391
2018/2/1,桃園市,蘆竹區,58387,162374,80639,81735
2018/2/1,桃園市,大園區,33017,89407,45728,43679
2018/2/1,桃園市,龜山區,61516,158105,78784,79321
2018/2/1,桃園市,八德區,70665,198796,99487,99309
2018/2/1,桃園市,龍潭區,41819,122081,61169,60912
2018/2/1,桃園市,平鎮區,77127,224547,111614,112933
2018/2/1,桃園市,新屋區,16329,49015,26076,22939
2018/2/1,桃園市,觀音區,22762,66482,34614,31868
2018/2/1,桃園市,復興區,3800,11623,6303,5320
2018/2/1,臺中市,中區,7914,18476,9161,9315
2018/2/1,臺中市,東區,27981,75916,37789,38127
2018/2/1,臺中市,南區,48405,125211,60109,65102
2018/2/1,臺中市,西區,45677,115665,54932,60733
2018/2/1,臺中市,北區,59480,147755,70670,77085
2018/2/1,臺中市,西屯區,85988,227291,109102,118189
2018/2/1,臺中市,南屯區,62297,169103,80870,88233
2018/2/1,臺中市,北屯區,100466,275491,132200,143291
2018/2/1,臺中市,豐原區,53764,166969,82480,84489
2018/2/1,臺中市,東勢區,17430,50632,25984,24648
2018/2/1,臺中市,大甲區,23107,77826,39141,38685
2018/2/1,臺中市,清水區,27321,86522,44409,42113
2018/2/1,臺中市,沙鹿區,29599,92895,46835,46060
2018/2/1,臺中市,梧棲區,17799,58062,29125,28937
2018/2/1,臺中市,后里區,16276,54540,27676,26864
2018/2/1,臺中市,神岡區,19464,65570,33455,32115
2018/2/1,臺中市,潭子區,36389,108330,53498,54832
2018/2/1,臺中市,大雅區,29679,95433,47605,47828
2018/2/1,臺中市,新社區,7564,24718,12837,11881
2018/2/1,臺中市,石岡區,4893,15032,7785,7247
2018/2/1,臺中市,外埔區,9757,32150,16466,15684
2018/2/1,臺中市,大安區,5497,19270,10166,9104
2018/2/1,臺中市,烏日區,24643,74705,37483,37222
2018/2/1,臺中市,大肚區,17701,57366,29303,28063
2018/2/1,臺中市,龍井區,23144,77845,39215,38630
2018/2/1,臺中市,霧峰區,20294,65453,33169,32284
2018/2/1,臺中市,太平區,64062,189536,93934,95602
2018/2/1,臺中市,大里區,69634,211681,104015,107666
2018/2/1,臺中市,和平區,4575,10938,5886,5052
2018/2/1,臺南市,新營區,29010,78023,38591,39432
2018/2/1,臺南市,鹽水區,10035,25560,13356,12204
2018/2/1,臺南市,白河區,10816,28438,14862,13576
2018/2/1,臺南市,柳營區,7908,21334,11141,10193
2018/2/1,臺南市,後壁區,8871,23650,12298,11352
2018/2/1,臺南市,東山區,8373,21026,11171,9855
2018/2/1,臺南市,麻豆區,15810,44574,22642,21932
2018/2/1,臺南市,下營區,9075,24176,12483,11693
2018/2/1,臺南市,六甲區,7774,22276,11525,10751
2018/2/1,臺南市,官田區,7922,21380,10897,10483
2018/2/1,臺南市,大內區,3864,9738,5254,4484
2018/2/1,臺南市,佳里區,20713,59335,29444,29891
2018/2/1,臺南市,學甲區,9628,25965,13273,12692
2018/2/1,臺南市,西港區,8209,24752,12517,12235
2018/2/1,臺南市,七股區,8059,22983,11909,11074
2018/2/1,臺南市,將軍區,7289,19817,10094,9723
2018/2/1,臺南市,北門區,4255,11178,5648,5530
2018/2/1,臺南市,新化區,14454,43640,22234,21406
2018/2/1,臺南市,善化區,17741,48452,24355,24097
2018/2/1,臺南市,新市區,12338,36639,18371,18268
2018/2/1,臺南市,安定區,10120,30555,15721,14834
2018/2/1,臺南市,山上區,2720,7319,3815,3504
2018/2/1,臺南市,玉井區,5149,14135,7314,6821
2018/2/1,臺南市,楠西區,3517,9700,5136,4564
2018/2/1,臺南市,南化區,2873,8767,4731,4036
2018/2/1,臺南市,左鎮區,1971,4857,2722,2135
2018/2/1,臺南市,仁德區,27651,75524,38227,37297
2018/2/1,臺南市,歸仁區,22750,68460,34752,33708
2018/2/1,臺南市,關廟區,11153,34428,17760,16668
2018/2/1,臺南市,龍崎區,1536,4027,2156,1871
2018/2/1,臺南市,永康區,84179,234038,115328,118710
2018/2/1,臺南市,東區,71905,186762,89499,97263
2018/2/1,臺南市,南區,45734,125312,62034,63278
2018/2/1,臺南市,北區,50933,132577,64472,68105
2018/2/1,臺南市,安南區,62918,192363,96933,95430
2018/2/1,臺南市,安平區,25635,66521,31628,34893
2018/2/1,臺南市,中西區,31337,77793,37612,40181
2018/2/1,高雄市,鹽埕區,10777,24229,11998,12231
2018/2/1,高雄市,鼓山區,58241,139416,67219,72197
2018/2/1,高雄市,左營區,78959,197006,94768,102238
2018/2/1,高雄市,楠梓區,70561,184000,90306,93694
2018/2/1,高雄市,三民區,136871,343055,165988,177067
2018/2/1,高雄市,新興區,22836,51121,24571,26550
2018/2/1,高雄市,前金區,12605,26934,12852,14082
2018/2/1,高雄市,苓雅區,72137,170786,82190,88596
2018/2/1,高雄市,前鎮區,78738,189517,93092,96425
2018/2/1,高雄市,旗津區,11116,28723,14806,13917
2018/2/1,高雄市,小港區,68170,157552,78241,79311
2018/2/1,高雄市,鳳山區,140819,359068,176058,183010
2018/2/1,高雄市,林園區,25915,70023,35377,34646
2018/2/1,高雄市,大寮區,42238,112427,57466,54961
2018/2/1,高雄市,大樹區,13633,42795,21927,20868
2018/2/1,高雄市,大社區,13063,34668,17589,17079
2018/2/1,高雄市,仁武區,33231,86085,43673,42412
2018/2/1,高雄市,鳥松區,18318,44377,22467,21910
2018/2/1,高雄市,岡山區,34927,97336,48320,49016
2018/2/1,高雄市,橋頭區,13695,37618,19075,18543
2018/2/1,高雄市,燕巢區,10551,29878,15738,14140
2018/2/1,高雄市,田寮區,3265,7231,3992,3239
2018/2/1,高雄市,阿蓮區,9413,28801,14555,14246
2018/2/1,高雄市,路竹區,17066,52691,26892,25799
2018/2/1,高雄市,湖內區,10889,29800,15198,14602
2018/2/1,高雄市,茄萣區,10526,30150,15535,14615
2018/2/1,高雄市,永安區,5728,13944,6999,6945
2018/2/1,高雄市,彌陀區,6782,19351,9946,9405
2018/2/1,高雄市,梓官區,12625,36057,18528,17529
2018/2/1,高雄市,旗山區,13746,36922,19078,17844
2018/2/1,高雄市,美濃區,14743,39900,20918,18982
2018/2/1,高雄市,六龜區,5554,12984,6980,6004
2018/2/1,高雄市,甲仙區,2316,6079,3230,2849
2018/2/1,高雄市,杉林區,4806,11973,6532,5441
2018/2/1,高雄市,內門區,5113,14515,7861,6654
2018/2/1,高雄市,茂林區,595,1935,965,970
2018/2/1,高雄市,桃源區,1353,4283,2252,2031
2018/2/1,高雄市,那瑪夏區,845,3136,1604,1532
2018/2/1,宜蘭縣,宜蘭市,36330,95891,46776,49115
2018/2/1,宜蘭縣,羅東鎮,26411,72485,34339,38146
2018/2/1,宜蘭縣,蘇澳鎮,14165,39989,20344,19645
2018/2/1,宜蘭縣,頭城鎮,10257,29320,15103,14217
2018/2/1,宜蘭縣,礁溪鄉,14083,35738,18592,17146
2018/2/1,宜蘭縣,壯圍鄉,8847,24194,12783,11411
2018/2/1,宜蘭縣,員山鄉,11731,32393,17179,15214
2018/2/1,宜蘭縣,冬山鄉,19329,53171,27248,25923
2018/2/1,宜蘭縣,五結鄉,14987,39601,20460,19141
2018/2/1,宜蘭縣,三星鄉,8589,21412,11551,9861
2018/2/1,宜蘭縣,大同鄉,1906,6144,3306,2838
2018/2/1,宜蘭縣,南澳鄉,1957,5921,3092,2829
2018/2/1,新竹縣,竹北市,65939,182538,90878,91660
2018/2/1,新竹縣,關西鎮,9419,28827,15419,13408
2018/2/1,新竹縣,新埔鎮,10729,33351,17795,15556
2018/2/1,新竹縣,竹東鎮,33990,96843,48633,48210
2018/2/1,新竹縣,湖口鄉,26629,77477,39241,38236
2018/2/1,新竹縣,橫山鄉,4438,13008,7052,5956
2018/2/1,新竹縣,新豐鄉,18552,56793,29142,27651
2018/2/1,新竹縣,芎林鄉,6512,20080,10635,9445
2018/2/1,新竹縣,寶山鄉,5562,14560,7842,6718
2018/2/1,新竹縣,北埔鄉,3106,9355,5096,4259
2018/2/1,新竹縣,峨眉鄉,2073,5530,3037,2493
2018/2/1,新竹縣,尖石鄉,2884,9540,5032,4508
2018/2/1,新竹縣,五峰鄉,1757,4586,2476,2110
2018/2/1,苗栗縣,苗栗市,31358,88907,44408,44499
2018/2/1,苗栗縣,頭份市,34809,103127,52079,51048
2018/2/1,苗栗縣,苑裡鎮,14665,45870,23889,21981
2018/2/1,苗栗縣,通霄鎮,11590,34558,18258,16300
2018/2/1,苗栗縣,竹南鎮,29304,85640,43247,42393
2018/2/1,苗栗縣,後龍鎮,11919,36661,19384,17277
2018/2/1,苗栗縣,卓蘭鎮,6032,17030,8934,8096
2018/2/1,苗栗縣,大湖鄉,5410,14697,7790,6907
2018/2/1,苗栗縣,公館鄉,10728,33659,17567,16092
2018/2/1,苗栗縣,銅鑼鄉,6134,18097,9637,8460
2018/2/1,苗栗縣,南庄鄉,3935,10158,5574,4584
2018/2/1,苗栗縣,頭屋鄉,3646,10847,5755,5092
2018/2/1,苗栗縣,三義鄉,5565,16458,8697,7761
2018/2/1,苗栗縣,西湖鄉,2642,7112,3969,3143
2018/2/1,苗栗縣,造橋鄉,4123,12934,6822,6112
2018/2/1,苗栗縣,三灣鄉,2400,6741,3680,3061
2018/2/1,苗栗縣,獅潭鄉,1717,4414,2475,1939
2018/2/1,苗栗縣,泰安鄉,1969,5897,3159,2738
2018/2/1,彰化縣,彰化市,76457,233341,115262,118079
2018/2/1,彰化縣,員林市,39301,124562,61924,62638
2018/2/1,彰化縣,鹿港鎮,24519,86812,44132,42680
2018/2/1,彰化縣,和美鎮,26770,90946,46282,44664
2018/2/1,彰化縣,北斗鎮,10708,33335,16791,16544
2018/2/1,彰化縣,溪湖鎮,16358,55660,28208,27452
2018/2/1,彰化縣,田中鎮,13177,41867,21595,20272
2018/2/1,彰化縣,二林鎮,15069,50941,26195,24746
2018/2/1,彰化縣,線西鄉,4410,16925,8675,8250
2018/2/1,彰化縣,伸港鄉,9990,36964,18853,18111
2018/2/1,彰化縣,福興鄉,12828,47253,24602,22651
2018/2/1,彰化縣,秀水鄉,10789,39354,20314,19040
2018/2/1,彰化縣,花壇鄉,14087,45882,23531,22351
2018/2/1,彰化縣,芬園鄉,6837,23735,12470,11265
2018/2/1,彰化縣,大村鄉,11146,36857,19019,17838
2018/2/1,彰化縣,埔鹽鄉,9084,32543,17103,15440
2018/2/1,彰化縣,埔心鄉,10604,34787,17918,16869
2018/2/1,彰化縣,永靖鄉,10924,37255,19283,17972
2018/2/1,彰化縣,社頭鄉,12932,43112,22161,20951
2018/2/1,彰化縣,二水鄉,5286,15277,7999,7278
2018/2/1,彰化縣,田尾鄉,7992,27456,14139,13317
2018/2/1,彰化縣,埤頭鄉,9075,30669,15861,14808
2018/2/1,彰化縣,芳苑鄉,10133,33656,17785,15871
2018/2/1,彰化縣,大城鄉,5248,16936,9132,7804
2018/2/1,彰化縣,竹塘鄉,4613,15233,8010,7223
2018/2/1,彰化縣,溪州鄉,8989,29946,15640,14306
2018/2/1,南投縣,南投市,34751,100154,50112,50042
2018/2/1,南投縣,埔里鎮,29013,80859,40298,40561
2018/2/1,南投縣,草屯鎮,33262,97742,49430,48312
2018/2/1,南投縣,竹山鎮,20132,55032,28198,26834
2018/2/1,南投縣,集集鎮,4303,10890,5671,5219
2018/2/1,南投縣,名間鄉,12624,38684,20378,18306
2018/2/1,南投縣,鹿谷鄉,7974,17812,9518,8294
2018/2/1,南投縣,中寮鄉,5632,14816,8051,6765
2018/2/1,南投縣,魚池鄉,5773,15912,8411,7501
2018/2/1,南投縣,國姓鄉,7254,18769,10139,8630
2018/2/1,南投縣,水里鄉,7135,17755,9319,8436
2018/2/1,南投縣,信義鄉,5278,16238,8718,7520
2018/2/1,南投縣,仁愛鄉,4896,15786,8164,7622
2018/2/1,雲林縣,斗六市,38306,108644,53994,54650
2018/2/1,雲林縣,斗南鎮,15879,44886,22790,22096
2018/2/1,雲林縣,虎尾鎮,25041,70873,35905,34968
2018/2/1,雲林縣,西螺鎮,14684,46218,23371,22847
2018/2/1,雲林縣,土庫鎮,9380,28892,15088,13804
2018/2/1,雲林縣,北港鎮,15964,40182,20757,19425
2018/2/1,雲林縣,古坑鄉,10966,31647,16668,14979
2018/2/1,雲林縣,大埤鄉,6654,19195,10304,8891
2018/2/1,雲林縣,莿桐鄉,9340,28861,15146,13715
2018/2/1,雲林縣,林內鄉,6028,18176,9500,8676
2018/2/1,雲林縣,二崙鄉,8951,27193,14540,12653
2018/2/1,雲林縣,崙背鄉,8506,24632,13004,11628
2018/2/1,雲林縣,麥寮鄉,14362,45652,22913,22739
2018/2/1,雲林縣,東勢鄉,5721,14860,8221,6639
2018/2/1,雲林縣,褒忠鄉,4433,12975,6972,6003
2018/2/1,雲林縣,臺西鄉,8667,23916,12808,11108
2018/2/1,雲林縣,元長鄉,9271,25928,14164,11764
2018/2/1,雲林縣,四湖鄉,8770,23610,12792,10818
2018/2/1,雲林縣,口湖鄉,9455,27568,14681,12887
2018/2/1,雲林縣,水林鄉,9891,25555,13961,11594
2018/2/1,嘉義縣,太保市,13039,37907,19468,18439
2018/2/1,嘉義縣,朴子市,15704,42333,21386,20947
2018/2/1,嘉義縣,布袋鎮,9934,27068,13813,13255
2018/2/1,嘉義縣,大林鎮,11396,31153,15950,15203
2018/2/1,嘉義縣,民雄鄉,24940,71674,36676,34998
2018/2/1,嘉義縣,溪口鄉,5337,14702,7876,6826
2018/2/1,嘉義縣,新港鄉,10653,31900,16777,15123
2018/2/1,嘉義縣,六腳鄉,8841,23250,12355,10895
2018/2/1,嘉義縣,東石鄉,9218,24877,13170,11707
2018/2/1,嘉義縣,義竹鄉,7391,18443,9586,8857
2018/2/1,嘉義縣,鹿草鄉,5758,15520,8328,7192
2018/2/1,嘉義縣,水上鄉,18104,49676,25649,24027
2018/2/1,嘉義縣,中埔鄉,15986,44916,23370,21546
2018/2/1,嘉義縣,竹崎鄉,11688,35914,19135,16779
2018/2/1,嘉義縣,梅山鄉,6759,19434,10330,9104
2018/2/1,嘉義縣,番路鄉,4251,11560,6254,5306
2018/2/1,嘉義縣,大埔鄉,1928,4569,2362,2207
2018/2/1,嘉義縣,阿里山鄉,1915,5602,2946,2656
2018/2/1,屏東縣,屏東市,74310,200227,98991,101236
2018/2/1,屏東縣,潮州鎮,19464,54303,27104,27199
2018/2/1,屏東縣,東港鎮,16731,47844,24191,23653
2018/2/1,屏東縣,恆春鎮,11591,30741,15745,14996
2018/2/1,屏東縣,萬丹鄉,14977,50897,26393,24504
2018/2/1,屏東縣,長治鄉,10160,29972,15631,14341
2018/2/1,屏東縣,麟洛鄉,3813,11075,5746,5329
2018/2/1,屏東縣,九如鄉,7014,22096,11426,10670
2018/2/1,屏東縣,里港鄉,8212,26432,13453,12979
2018/2/1,屏東縣,鹽埔鄉,7856,25916,13484,12432
2018/2/1,屏東縣,高樹鄉,9286,24584,13106,11478
2018/2/1,屏東縣,萬巒鄉,6522,20523,10731,9792
2018/2/1,屏東縣,內埔鄉,18660,54620,28212,26408
2018/2/1,屏東縣,竹田鄉,5645,17157,9119,8038
2018/2/1,屏東縣,新埤鄉,3437,9939,5276,4663
2018/2/1,屏東縣,枋寮鄉,8546,24554,12854,11700
2018/2/1,屏東縣,新園鄉,11804,35230,18254,16976
2018/2/1,屏東縣,崁頂鄉,4486,15655,7952,7703
2018/2/1,屏東縣,林邊鄉,6725,18014,9234,8780
2018/2/1,屏東縣,南州鄉,3709,10680,5483,5197
2018/2/1,屏東縣,佳冬鄉,6961,19310,10032,9278
2018/2/1,屏東縣,琉球鄉,4488,12318,6757,5561
2018/2/1,屏東縣,車城鄉,3469,8586,4602,3984
2018/2/1,屏東縣,滿州鄉,3033,7871,4278,3593
2018/2/1,屏東縣,枋山鄉,2097,5466,2919,2547
2018/2/1,屏東縣,三地門鄉,2327,7661,3849,3812
2018/2/1,屏東縣,霧臺鄉,1061,3271,1677,1594
2018/2/1,屏東縣,瑪家鄉,2056,6761,3433,3328
2018/2/1,屏東縣,泰武鄉,1349,5292,2784,2508
2018/2/1,屏東縣,來義鄉,2228,7433,3753,3680
2018/2/1,屏東縣,春日鄉,1398,4877,2499,2378
2018/2/1,屏東縣,獅子鄉,1563,4850,2501,2349
2018/2/1,屏東縣,牡丹鄉,1935,4939,2520,2419
2018/2/1,臺東縣,臺東市,39746,105916,53017,52899
2018/2/1,臺東縣,成功鎮,5382,14197,7475,6722
2018/2/1,臺東縣,關山鎮,3174,8743,4543,4200
2018/2/1,臺東縣,卑南鄉,6709,17377,9167,8210
2018/2/1,臺東縣,大武鄉,2492,6093,3186,2907
2018/2/1,臺東縣,太麻里鄉,4700,11172,5965,5207
2018/2/1,臺東縣,東河鄉,3772,8501,4723,3778
2018/2/1,臺東縣,長濱鄉,2922,7235,4099,3136
2018/2/1,臺東縣,鹿野鄉,3047,7932,4223,3709
2018/2/1,臺東縣,池上鄉,3209,8228,4298,3930
2018/2/1,臺東縣,綠島鄉,1159,3991,2109,1882
2018/2/1,臺東縣,延平鄉,1069,3564,1904,1660
2018/2/1,臺東縣,海端鄉,1090,4220,2241,1979
2018/2/1,臺東縣,達仁鄉,1455,3521,1914,1607
2018/2/1,臺東縣,金峰鄉,1126,3676,1871,1805
2018/2/1,臺東縣,蘭嶼鄉,1841,5070,2557,2513
2018/2/1,花蓮縣,花蓮市,41474,104099,50216,53883
2018/2/1,花蓮縣,鳳林鎮,4413,10850,5640,5210
2018/2/1,花蓮縣,玉里鎮,8884,24261,12829,11432
2018/2/1,花蓮縣,新城鄉,7731,20161,10382,9779
2018/2/1,花蓮縣,吉安鄉,32068,83792,42135,41657
2018/2/1,花蓮縣,壽豐鄉,7215,18035,9609,8426
2018/2/1,花蓮縣,光復鄉,4991,12862,6842,6020
2018/2/1,花蓮縣,豐濱鄉,1704,4376,2429,1947
2018/2/1,花蓮縣,瑞穗鄉,4748,11675,6312,5363
2018/2/1,花蓮縣,富里鄉,4035,10394,5650,4744
2018/2/1,花蓮縣,秀林鄉,4813,15876,8178,7698
2018/2/1,花蓮縣,萬榮鄉,2100,6407,3380,3027
2018/2/1,花蓮縣,卓溪鄉,1695,6065,3354,2711
2018/2/1,澎湖縣,馬公市,24597,62339,31710,30629
2018/2/1,澎湖縣,湖西鄉,5560,14489,7649,6840
2018/2/1,澎湖縣,白沙鄉,3402,9816,5142,4674
2018/2/1,澎湖縣,西嶼鄉,3018,8421,4343,4078
2018/2/1,澎湖縣,望安鄉,2020,5179,2797,2382
2018/2/1,澎湖縣,七美鄉,1369,3843,2000,1843
2018/2/1,基隆市,中正區,22625,52060,26588,25472
2018/2/1,基隆市,七堵區,21467,53951,27119,26832
2018/2/1,基隆市,暖暖區,15660,38666,19371,19295
2018/2/1,基隆市,仁愛區,19169,44261,21928,22333
2018/2/1,基隆市,中山區,19246,47841,24232,23609
2018/2/1,基隆市,安樂區,33453,82387,40766,41621
2018/2/1,基隆市,信義區,21184,52038,25736,26302
2018/2/1,新竹市,東區,79494,213066,104841,108225
2018/2/1,新竹市,北區,56674,150735,73638,77097
2018/2/1,新竹市,香山區,27233,78016,39621,38395
2018/2/1,嘉義市,東區,45487,121978,58751,63227
2018/2/1,嘉義市,西區,54074,147349,72231,75118
2018/2/1,金門縣,金城鎮,12891,43330,21640,21690
2018/2/1,金門縣,金湖鎮,8940,29483,14834,14649
2018/2/1,金門縣,金沙鎮,6308,20532,10155,10377
2018/2/1,金門縣,金寧鄉,8597,30873,15577,15296
2018/2/1,金門縣,烈嶼鄉,3141,12718,6261,6457
2018/2/1,金門縣,烏坵鄉,134,689,347,342
2018/2/1,連江縣,南竿鄉,1689,7541,4218,3323
2018/2/1,連江縣,北竿鄉,583,2378,1322,1056
2018/2/1,連江縣,莒光鄉,293,1624,993,631
2018/2/1,連江縣,東引鄉,332,1359,812,547
2018/3/1,總計,新北市,1545804,3986382,1952555,2033827
2018/3/1,總計,臺北市,1052068,2680218,1280179,1400039
2018/3/1,總計,桃園市,793886,2196349,1093216,1103133
2018/3/1,總計,臺中市,962235,2792164,1375913,1416251
2018/3/1,總計,臺南市,684668,1885882,941658,944224
2018/3/1,總計,高雄市,1093552,2775935,1374442,1401493
2018/3/1,總計,臺灣省,2489319,7104495,3621684,3482811
2018/3/1,總計,宜蘭縣,168622,456068,230664,225404
2018/3/1,總計,新竹縣,191918,552877,282458,270419
2018/3/1,總計,苗栗縣,188070,552161,284981,267180
2018/3/1,總計,彰化縣,387556,1280528,652498,628030
2018/3/1,總計,南投縣,178086,500103,256247,243856
2018/3/1,總計,雲林縣,240350,689098,357359,331739
2018/3/1,總計,嘉義縣,182840,510018,265137,244881
2018/3/1,總計,屏東縣,286969,828654,423672,404982
2018/3/1,總計,臺東縣,82877,219466,113277,106189
2018/3/1,總計,花蓮縣,125847,328695,166830,161865
2018/3/1,總計,澎湖縣,39998,104086,53642,50444
2018/3/1,總計,基隆市,152891,371119,185696,185423
2018/3/1,總計,新竹市,163651,442315,218270,224045
2018/3/1,總計,嘉義市,99644,269307,130953,138354
2018/3/1,總計,福建省,42978,150565,76177,74388
2018/3/1,總計,金門縣,40058,137642,68810,68832
2018/3/1,總計,連江縣,2920,12923,7367,5556
2018/3/1,新北市,板橋區,208808,551503,269167,282336
2018/3/1,新北市,三重區,151091,386785,190248,196537
2018/3/1,新北市,中和區,165262,413010,200757,212253
2018/3/1,新北市,永和區,91028,222479,105568,116911
2018/3/1,新北市,新莊區,153825,417154,203597,213557
2018/3/1,新北市,新店區,126791,301892,145122,156770
2018/3/1,新北市,樹林區,66460,183936,91701,92235
2018/3/1,新北市,鶯歌區,29898,86457,43345,43112
2018/3/1,新北市,三峽區,42780,115185,57739,57446
2018/3/1,新北市,淡水區,75172,170312,81629,88683
2018/3/1,新北市,汐止區,87051,199511,97311,102200
2018/3/1,新北市,瑞芳區,16185,40208,20288,19920
2018/3/1,新北市,土城區,86981,237728,117329,120399
2018/3/1,新北市,蘆洲區,71086,201180,98784,102396
2018/3/1,新北市,五股區,31690,85217,42990,42227
2018/3/1,新北市,泰山區,28495,78840,39107,39733
2018/3/1,新北市,林口區,42328,106834,51970,54864
2018/3/1,新北市,深坑區,9597,23638,11827,11811
2018/3/1,新北市,石碇區,3376,7682,4214,3468
2018/3/1,新北市,坪林區,2511,6519,3600,2919
2018/3/1,新北市,三芝區,9491,23130,11905,11225
2018/3/1,新北市,石門區,4297,12205,6319,5886
2018/3/1,新北市,八里區,14637,38456,19193,19263
2018/3/1,新北市,平溪區,2300,4712,2607,2105
2018/3/1,新北市,雙溪區,3810,8895,4805,4090
2018/3/1,新北市,貢寮區,4392,12488,6354,6134
2018/3/1,新北市,金山區,7105,21937,10832,11105
2018/3/1,新北市,萬里區,7491,22169,11136,11033
2018/3/1,新北市,烏來區,1866,6320,3111,3209
2018/3/1,臺北市,松山區,80889,206770,97023,109747
2018/3/1,臺北市,信義區,89390,224893,107331,117562
2018/3/1,臺北市,大安區,120909,309936,144711,165225
2018/3/1,臺北市,中山區,100296,230324,107068,123256
2018/3/1,臺北市,中正區,65227,159641,76170,83471
2018/3/1,臺北市,大同區,51843,129020,62896,66124
2018/3/1,臺北市,萬華區,78601,191165,93873,97292
2018/3/1,臺北市,文山區,105658,274402,131613,142789
2018/3/1,臺北市,南港區,47105,122073,59672,62401
2018/3/1,臺北市,內湖區,108167,287843,137510,150333
2018/3/1,臺北市,士林區,107144,288066,139027,149039
2018/3/1,臺北市,北投區,96839,256085,123285,132800
2018/3/1,桃園市,桃園區,166592,442488,214820,227668
2018/3/1,桃園市,中壢區,150266,406949,200416,206533
2018/3/1,桃園市,大溪區,32520,94620,48213,46407
2018/3/1,桃園市,楊梅區,58386,168381,84793,83588
2018/3/1,桃園市,蘆竹區,58506,162637,80769,81868
2018/3/1,桃園市,大園區,33026,89505,45770,43735
2018/3/1,桃園市,龜山區,61666,158357,78885,79472
2018/3/1,桃園市,八德區,70835,199181,99622,99559
2018/3/1,桃園市,龍潭區,41860,122196,61199,60997
2018/3/1,桃園市,平鎮區,77229,224733,111667,113066
2018/3/1,桃園市,新屋區,16356,49038,26088,22950
2018/3/1,桃園市,觀音區,22846,66563,34637,31926
2018/3/1,桃園市,復興區,3798,11701,6337,5364
2018/3/1,臺中市,中區,7931,18558,9191,9367
2018/3/1,臺中市,東區,28036,75967,37803,38164
2018/3/1,臺中市,南區,48434,125218,60121,65097
2018/3/1,臺中市,西區,45717,115758,54955,60803
2018/3/1,臺中市,北區,59480,147788,70668,77120
2018/3/1,臺中市,西屯區,86129,227569,109249,118320
2018/3/1,臺中市,南屯區,62390,169222,80907,88315
2018/3/1,臺中市,北屯區,100693,275914,132318,143596
2018/3/1,臺中市,豐原區,53822,167007,82467,84540
2018/3/1,臺中市,東勢區,17430,50588,25958,24630
2018/3/1,臺中市,大甲區,23129,77847,39159,38688
2018/3/1,臺中市,清水區,27360,86506,44413,42093
2018/3/1,臺中市,沙鹿區,29668,93041,46910,46131
2018/3/1,臺中市,梧棲區,17831,58082,29108,28974
2018/3/1,臺中市,后里區,16301,54551,27674,26877
2018/3/1,臺中市,神岡區,19506,65613,33473,32140
2018/3/1,臺中市,潭子區,36399,108280,53494,54786
2018/3/1,臺中市,大雅區,29763,95507,47626,47881
2018/3/1,臺中市,新社區,7568,24695,12827,11868
2018/3/1,臺中市,石岡區,4892,15028,7780,7248
2018/3/1,臺中市,外埔區,9769,32152,16461,15691
2018/3/1,臺中市,大安區,5500,19252,10156,9096
2018/3/1,臺中市,烏日區,24697,74756,37494,37262
2018/3/1,臺中市,大肚區,17730,57340,29282,28058
2018/3/1,臺中市,龍井區,23171,77883,39213,38670
2018/3/1,臺中市,霧峰區,20329,65495,33188,32307
2018/3/1,臺中市,太平區,64216,189801,94081,95720
2018/3/1,臺中市,大里區,69756,211781,104034,107747
2018/3/1,臺中市,和平區,4588,10965,5903,5062
2018/3/1,臺南市,新營區,29010,78018,38590,39428
2018/3/1,臺南市,鹽水區,10035,25540,13343,12197
2018/3/1,臺南市,白河區,10815,28399,14844,13555
2018/3/1,臺南市,柳營區,7914,21309,11123,10186
2018/3/1,臺南市,後壁區,8863,23636,12287,11349
2018/3/1,臺南市,東山區,8367,21007,11161,9846
2018/3/1,臺南市,麻豆區,15804,44538,22633,21905
2018/3/1,臺南市,下營區,9070,24126,12446,11680
2018/3/1,臺南市,六甲區,7783,22269,11515,10754
2018/3/1,臺南市,官田區,7920,21347,10888,10459
2018/3/1,臺南市,大內區,3861,9711,5243,4468
2018/3/1,臺南市,佳里區,20713,59355,29451,29904
2018/3/1,臺南市,學甲區,9612,25936,13255,12681
2018/3/1,臺南市,西港區,8227,24764,12508,12256
2018/3/1,臺南市,七股區,8048,22947,11898,11049
2018/3/1,臺南市,將軍區,7287,19753,10072,9681
2018/3/1,臺南市,北門區,4247,11169,5636,5533
2018/3/1,臺南市,新化區,14457,43671,22241,21430
2018/3/1,臺南市,善化區,17760,48536,24395,24141
2018/3/1,臺南市,新市區,12392,36668,18374,18294
2018/3/1,臺南市,安定區,10135,30540,15718,14822
2018/3/1,臺南市,山上區,2720,7319,3816,3503
2018/3/1,臺南市,玉井區,5154,14138,7322,6816
2018/3/1,臺南市,楠西區,3511,9670,5116,4554
2018/3/1,臺南市,南化區,2871,8758,4712,4046
2018/3/1,臺南市,左鎮區,1969,4856,2723,2133
2018/3/1,臺南市,仁德區,27665,75490,38193,37297
2018/3/1,臺南市,歸仁區,22777,68536,34776,33760
2018/3/1,臺南市,關廟區,11150,34390,17740,16650
2018/3/1,臺南市,龍崎區,1538,4016,2157,1859
2018/3/1,臺南市,永康區,84331,234127,115348,118779
2018/3/1,臺南市,東區,71864,186703,89489,97214
2018/3/1,臺南市,南區,45736,125199,61976,63223
2018/3/1,臺南市,北區,51002,132613,64433,68180
2018/3/1,臺南市,安南區,62993,192401,96956,95445
2018/3/1,臺南市,安平區,25694,66615,31670,34945
2018/3/1,臺南市,中西區,31373,77812,37610,40202
2018/3/1,高雄市,鹽埕區,10767,24187,11978,12209
2018/3/1,高雄市,鼓山區,58299,139582,67304,72278
2018/3/1,高雄市,左營區,78988,197047,94761,102286
2018/3/1,高雄市,楠梓區,70690,184183,90363,93820
2018/3/1,高雄市,三民區,136904,342748,165840,176908
2018/3/1,高雄市,新興區,22871,51104,24530,26574
2018/3/1,高雄市,前金區,12611,26912,12829,14083
2018/3/1,高雄市,苓雅區,72141,170766,82154,88612
2018/3/1,高雄市,前鎮區,78737,189353,92994,96359
2018/3/1,高雄市,旗津區,11116,28699,14784,13915
2018/3/1,高雄市,小港區,68232,157522,78253,79269
2018/3/1,高雄市,鳳山區,140953,359125,176058,183067
2018/3/1,高雄市,林園區,25942,70015,35360,34655
2018/3/1,高雄市,大寮區,42302,112415,57473,54942
2018/3/1,高雄市,大樹區,13622,42707,21877,20830
2018/3/1,高雄市,大社區,13079,34646,17578,17068
2018/3/1,高雄市,仁武區,33319,86277,43796,42481
2018/3/1,高雄市,鳥松區,18341,44349,22435,21914
2018/3/1,高雄市,岡山區,34940,97302,48295,49007
2018/3/1,高雄市,橋頭區,13686,37583,19058,18525
2018/3/1,高雄市,燕巢區,10574,29901,15746,14155
2018/3/1,高雄市,田寮區,3261,7221,3989,3232
2018/3/1,高雄市,阿蓮區,9409,28767,14532,14235
2018/3/1,高雄市,路竹區,17077,52651,26865,25786
2018/3/1,高雄市,湖內區,10908,29837,15221,14616
2018/3/1,高雄市,茄萣區,10529,30094,15503,14591
2018/3/1,高雄市,永安區,5731,13915,6996,6919
2018/3/1,高雄市,彌陀區,6773,19334,9931,9403
2018/3/1,高雄市,梓官區,12654,36026,18520,17506
2018/3/1,高雄市,旗山區,13744,36872,19054,17818
2018/3/1,高雄市,美濃區,14764,39883,20913,18970
2018/3/1,高雄市,六龜區,5542,12956,6974,5982
2018/3/1,高雄市,甲仙區,2316,6077,3234,2843
2018/3/1,高雄市,杉林區,4813,11961,6528,5433
2018/3/1,高雄市,內門區,5120,14527,7865,6662
2018/3/1,高雄市,茂林區,596,1947,974,973
2018/3/1,高雄市,桃源區,1356,4302,2267,2035
2018/3/1,高雄市,那瑪夏區,845,3142,1610,1532
2018/3/1,宜蘭縣,宜蘭市,36345,95868,46752,49116
2018/3/1,宜蘭縣,羅東鎮,26429,72504,34346,38158
2018/3/1,宜蘭縣,蘇澳鎮,14173,39997,20354,19643
2018/3/1,宜蘭縣,頭城鎮,10242,29257,15070,14187
2018/3/1,宜蘭縣,礁溪鄉,14076,35673,18559,17114
2018/3/1,宜蘭縣,壯圍鄉,8853,24226,12810,11416
2018/3/1,宜蘭縣,員山鄉,11735,32365,17162,15203
2018/3/1,宜蘭縣,冬山鄉,19319,53087,27215,25872
2018/3/1,宜蘭縣,五結鄉,14988,39588,20458,19130
2018/3/1,宜蘭縣,三星鄉,8593,21390,11530,9860
2018/3/1,宜蘭縣,大同鄉,1904,6163,3304,2859
2018/3/1,宜蘭縣,南澳鄉,1965,5950,3104,2846
2018/3/1,新竹縣,竹北市,66188,182975,91094,91881
2018/3/1,新竹縣,關西鎮,9401,28829,15408,13421
2018/3/1,新竹縣,新埔鎮,10720,33289,17754,15535
2018/3/1,新竹縣,竹東鎮,33987,96729,48560,48169
2018/3/1,新竹縣,湖口鄉,26685,77517,39276,38241
2018/3/1,新竹縣,橫山鄉,4437,13004,7044,5960
2018/3/1,新竹縣,新豐鄉,18570,56802,29141,27661
2018/3/1,新竹縣,芎林鄉,6520,20093,10641,9452
2018/3/1,新竹縣,寶山鄉,5580,14591,7873,6718
2018/3/1,新竹縣,北埔鄉,3107,9354,5094,4260
2018/3/1,新竹縣,峨眉鄉,2077,5538,3039,2499
2018/3/1,新竹縣,尖石鄉,2884,9549,5039,4510
2018/3/1,新竹縣,五峰鄉,1762,4607,2495,2112
2018/3/1,苗栗縣,苗栗市,31367,88774,44346,44428
2018/3/1,苗栗縣,頭份市,34843,102988,52001,50987
2018/3/1,苗栗縣,苑裡鎮,14670,45751,23820,21931
2018/3/1,苗栗縣,通霄鎮,11572,34463,18221,16242
2018/3/1,苗栗縣,竹南鎮,29386,85757,43309,42448
2018/3/1,苗栗縣,後龍鎮,11930,36623,19362,17261
2018/3/1,苗栗縣,卓蘭鎮,6022,16951,8893,8058
2018/3/1,苗栗縣,大湖鄉,5409,14672,7775,6897
2018/3/1,苗栗縣,公館鄉,10735,33624,17558,16066
2018/3/1,苗栗縣,銅鑼鄉,6145,18080,9616,8464
2018/3/1,苗栗縣,南庄鄉,3933,10132,5559,4573
2018/3/1,苗栗縣,頭屋鄉,3646,10839,5754,5085
2018/3/1,苗栗縣,三義鄉,5555,16415,8670,7745
2018/3/1,苗栗縣,西湖鄉,2641,7112,3972,3140
2018/3/1,苗栗縣,造橋鄉,4129,12910,6805,6105
2018/3/1,苗栗縣,三灣鄉,2397,6720,3676,3044
2018/3/1,苗栗縣,獅潭鄉,1716,4401,2463,1938
2018/3/1,苗栗縣,泰安鄉,1974,5949,3181,2768
2018/3/1,彰化縣,彰化市,76482,233209,115206,118003
2018/3/1,彰化縣,員林市,39373,124634,61976,62658
2018/3/1,彰化縣,鹿港鎮,24542,86762,44102,42660
2018/3/1,彰化縣,和美鎮,26787,90865,46207,44658
2018/3/1,彰化縣,北斗鎮,10709,33325,16784,16541
2018/3/1,彰化縣,溪湖鎮,16368,55614,28190,27424
2018/3/1,彰化縣,田中鎮,13174,41836,21575,20261
2018/3/1,彰化縣,二林鎮,15069,50881,26163,24718
2018/3/1,彰化縣,線西鄉,4416,16934,8676,8258
2018/3/1,彰化縣,伸港鄉,10003,36959,18857,18102
2018/3/1,彰化縣,福興鄉,12842,47223,24606,22617
2018/3/1,彰化縣,秀水鄉,10798,39326,20307,19019
2018/3/1,彰化縣,花壇鄉,14112,45877,23527,22350
2018/3/1,彰化縣,芬園鄉,6830,23647,12430,11217
2018/3/1,彰化縣,大村鄉,11152,36841,19016,17825
2018/3/1,彰化縣,埔鹽鄉,9089,32536,17100,15436
2018/3/1,彰化縣,埔心鄉,10617,34762,17896,16866
2018/3/1,彰化縣,永靖鄉,10930,37241,19268,17973
2018/3/1,彰化縣,社頭鄉,12938,43041,22125,20916
2018/3/1,彰化縣,二水鄉,5286,15249,7984,7265
2018/3/1,彰化縣,田尾鄉,7996,27460,14135,13325
2018/3/1,彰化縣,埤頭鄉,9075,30674,15866,14808
2018/3/1,彰化縣,芳苑鄉,10123,33616,17771,15845
2018/3/1,彰化縣,大城鄉,5247,16902,9119,7783
2018/3/1,彰化縣,竹塘鄉,4614,15217,7992,7225
2018/3/1,彰化縣,溪州鄉,8984,29897,15620,14277
2018/3/1,南投縣,南投市,34769,100052,50083,49969
2018/3/1,南投縣,埔里鎮,29012,80829,40281,40548
2018/3/1,南投縣,草屯鎮,33258,97681,49403,48278
2018/3/1,南投縣,竹山鎮,20138,55000,28190,26810
2018/3/1,南投縣,集集鎮,4311,10901,5673,5228
2018/3/1,南投縣,名間鄉,12634,38625,20356,18269
2018/3/1,南投縣,鹿谷鄉,8005,17794,9502,8292
2018/3/1,南投縣,中寮鄉,5625,14791,8036,6755
2018/3/1,南投縣,魚池鄉,5762,15868,8384,7484
2018/3/1,南投縣,國姓鄉,7269,18777,10142,8635
2018/3/1,南投縣,水里鄉,7129,17733,9310,8423
2018/3/1,南投縣,信義鄉,5278,16236,8719,7517
2018/3/1,南投縣,仁愛鄉,4896,15816,8168,7648
2018/3/1,雲林縣,斗六市,38339,108685,54001,54684
2018/3/1,雲林縣,斗南鎮,15879,44851,22770,22081
2018/3/1,雲林縣,虎尾鎮,25058,70872,35895,34977
2018/3/1,雲林縣,西螺鎮,14699,46176,23363,22813
2018/3/1,雲林縣,土庫鎮,9378,28881,15079,13802
2018/3/1,雲林縣,北港鎮,15957,40146,20739,19407
2018/3/1,雲林縣,古坑鄉,10972,31601,16644,14957
2018/3/1,雲林縣,大埤鄉,6652,19156,10286,8870
2018/3/1,雲林縣,莿桐鄉,9346,28847,15135,13712
2018/3/1,雲林縣,林內鄉,6026,18171,9495,8676
2018/3/1,雲林縣,二崙鄉,8954,27161,14508,12653
2018/3/1,雲林縣,崙背鄉,8510,24617,12993,11624
2018/3/1,雲林縣,麥寮鄉,14394,45620,22907,22713
2018/3/1,雲林縣,東勢鄉,5740,14902,8242,6660
2018/3/1,雲林縣,褒忠鄉,4428,12984,6981,6003
2018/3/1,雲林縣,臺西鄉,8659,23879,12795,11084
2018/3/1,雲林縣,元長鄉,9262,25876,14143,11733
2018/3/1,雲林縣,四湖鄉,8762,23550,12759,10791
2018/3/1,雲林縣,口湖鄉,9455,27560,14676,12884
2018/3/1,雲林縣,水林鄉,9880,25563,13948,11615
2018/3/1,嘉義縣,太保市,13058,37951,19471,18480
2018/3/1,嘉義縣,朴子市,15701,42318,21368,20950
2018/3/1,嘉義縣,布袋鎮,9931,27038,13801,13237
2018/3/1,嘉義縣,大林鎮,11405,31141,15953,15188
2018/3/1,嘉義縣,民雄鄉,24941,71593,36651,34942
2018/3/1,嘉義縣,溪口鄉,5335,14674,7858,6816
2018/3/1,嘉義縣,新港鄉,10644,31882,16768,15114
2018/3/1,嘉義縣,六腳鄉,8836,23226,12327,10899
2018/3/1,嘉義縣,東石鄉,9217,24841,13136,11705
2018/3/1,嘉義縣,義竹鄉,7384,18418,9570,8848
2018/3/1,嘉義縣,鹿草鄉,5761,15503,8314,7189
2018/3/1,嘉義縣,水上鄉,18106,49618,25620,23998
2018/3/1,嘉義縣,中埔鄉,16005,44841,23327,21514
2018/3/1,嘉義縣,竹崎鄉,11678,35875,19117,16758
2018/3/1,嘉義縣,梅山鄉,6758,19398,10316,9082
2018/3/1,嘉義縣,番路鄉,4246,11532,6237,5295
2018/3/1,嘉義縣,大埔鄉,1923,4570,2358,2212
2018/3/1,嘉義縣,阿里山鄉,1911,5599,2945,2654
2018/3/1,屏東縣,屏東市,74353,200313,99003,101310
2018/3/1,屏東縣,潮州鎮,19453,54246,27092,27154
2018/3/1,屏東縣,東港鎮,16732,47872,24190,23682
2018/3/1,屏東縣,恆春鎮,11601,30761,15777,14984
2018/3/1,屏東縣,萬丹鄉,14978,50816,26356,24460
2018/3/1,屏東縣,長治鄉,10169,29892,15594,14298
2018/3/1,屏東縣,麟洛鄉,3815,11055,5722,5333
2018/3/1,屏東縣,九如鄉,7018,22093,11422,10671
2018/3/1,屏東縣,里港鄉,8210,26393,13432,12961
2018/3/1,屏東縣,鹽埔鄉,7860,25863,13462,12401
2018/3/1,屏東縣,高樹鄉,9279,24532,13070,11462
2018/3/1,屏東縣,萬巒鄉,6526,20542,10728,9814
2018/3/1,屏東縣,內埔鄉,18669,54534,28168,26366
2018/3/1,屏東縣,竹田鄉,5628,17114,9089,8025
2018/3/1,屏東縣,新埤鄉,3439,9947,5286,4661
2018/3/1,屏東縣,枋寮鄉,8530,24518,12832,11686
2018/3/1,屏東縣,新園鄉,11798,35148,18218,16930
2018/3/1,屏東縣,崁頂鄉,4486,15588,7916,7672
2018/3/1,屏東縣,林邊鄉,6732,18013,9224,8789
2018/3/1,屏東縣,南州鄉,3712,10673,5465,5208
2018/3/1,屏東縣,佳冬鄉,6965,19290,10021,9269
2018/3/1,屏東縣,琉球鄉,4489,12308,6744,5564
2018/3/1,屏東縣,車城鄉,3475,8597,4608,3989
2018/3/1,屏東縣,滿州鄉,3039,7912,4289,3623
2018/3/1,屏東縣,枋山鄉,2094,5458,2909,2549
2018/3/1,屏東縣,三地門鄉,2327,7663,3846,3817
2018/3/1,屏東縣,霧臺鄉,1059,3304,1688,1616
2018/3/1,屏東縣,瑪家鄉,2056,6758,3428,3330
2018/3/1,屏東縣,泰武鄉,1349,5306,2793,2513
2018/3/1,屏東縣,來義鄉,2228,7422,3750,3672
2018/3/1,屏東縣,春日鄉,1401,4885,2507,2378
2018/3/1,屏東縣,獅子鄉,1566,4896,2519,2377
2018/3/1,屏東縣,牡丹鄉,1933,4942,2524,2418
2018/3/1,臺東縣,臺東市,39720,105825,52970,52855
2018/3/1,臺東縣,成功鎮,5386,14187,7465,6722
2018/3/1,臺東縣,關山鎮,3176,8751,4549,4202
2018/3/1,臺東縣,卑南鄉,6711,17398,9179,8219
2018/3/1,臺東縣,大武鄉,2490,6087,3175,2912
2018/3/1,臺東縣,太麻里鄉,4705,11175,5969,5206
2018/3/1,臺東縣,東河鄉,3763,8492,4712,3780
2018/3/1,臺東縣,長濱鄉,2928,7240,4105,3135
2018/3/1,臺東縣,鹿野鄉,3040,7909,4204,3705
2018/3/1,臺東縣,池上鄉,3214,8213,4283,3930
2018/3/1,臺東縣,綠島鄉,1152,4040,2133,1907
2018/3/1,臺東縣,延平鄉,1071,3609,1929,1680
2018/3/1,臺東縣,海端鄉,1088,4211,2236,1975
2018/3/1,臺東縣,達仁鄉,1453,3568,1934,1634
2018/3/1,臺東縣,金峰鄉,1129,3695,1878,1817
2018/3/1,臺東縣,蘭嶼鄉,1851,5066,2556,2510
2018/3/1,花蓮縣,花蓮市,41458,104046,50193,53853
2018/3/1,花蓮縣,鳳林鎮,4407,10851,5646,5205
2018/3/1,花蓮縣,玉里鎮,8877,24235,12816,11419
2018/3/1,花蓮縣,新城鄉,7725,20155,10369,9786
2018/3/1,花蓮縣,吉安鄉,32053,83711,42079,41632
2018/3/1,花蓮縣,壽豐鄉,7214,18017,9590,8427
2018/3/1,花蓮縣,光復鄉,5004,12846,6820,6026
2018/3/1,花蓮縣,豐濱鄉,1711,4427,2455,1972
2018/3/1,花蓮縣,瑞穗鄉,4750,11665,6307,5358
2018/3/1,花蓮縣,富里鄉,4029,10367,5631,4736
2018/3/1,花蓮縣,秀林鄉,4816,15871,8176,7695
2018/3/1,花蓮縣,萬榮鄉,2104,6422,3391,3031
2018/3/1,花蓮縣,卓溪鄉,1699,6082,3357,2725
2018/3/1,澎湖縣,馬公市,24606,62323,31711,30612
2018/3/1,澎湖縣,湖西鄉,5583,14502,7661,6841
2018/3/1,澎湖縣,白沙鄉,3400,9811,5137,4674
2018/3/1,澎湖縣,西嶼鄉,3016,8411,4330,4081
2018/3/1,澎湖縣,望安鄉,2022,5198,2807,2391
2018/3/1,澎湖縣,七美鄉,1371,3841,1996,1845
2018/3/1,基隆市,中正區,22602,51986,26554,25432
2018/3/1,基隆市,七堵區,21475,53945,27115,26830
2018/3/1,基隆市,暖暖區,15662,38684,19388,19296
2018/3/1,基隆市,仁愛區,19173,44240,21901,22339
2018/3/1,基隆市,中山區,19257,47782,24189,23593
2018/3/1,基隆市,安樂區,33466,82414,40795,41619
2018/3/1,基隆市,信義區,21256,52068,25754,26314
2018/3/1,新竹市,東區,79651,213589,105068,108521
2018/3/1,新竹市,北區,56739,150713,73595,77118
2018/3/1,新竹市,香山區,27261,78013,39607,38406
2018/3/1,嘉義市,東區,45513,121930,58706,63224
2018/3/1,嘉義市,西區,54131,147377,72247,75130
2018/3/1,金門縣,金城鎮,12905,43276,21600,21676
2018/3/1,金門縣,金湖鎮,8945,29486,14833,14653
2018/3/1,金門縣,金沙鎮,6306,20522,10152,10370
2018/3/1,金門縣,金寧鄉,8626,30924,15594,15330
2018/3/1,金門縣,烈嶼鄉,3142,12745,6282,6463
2018/3/1,金門縣,烏坵鄉,134,689,349,340
2018/3/1,連江縣,南竿鄉,1703,7568,4245,3323
2018/3/1,連江縣,北竿鄉,592,2386,1327,1059
2018/3/1,連江縣,莒光鄉,293,1624,994,630
2018/3/1,連江縣,東引鄉,332,1345,801,544
2018/4/1,總計,新北市,1547000,3985915,1952088,2033827
2018/4/1,總計,臺北市,1052386,2678695,1279308,1399387
2018/4/1,總計,桃園市,795263,2198830,1094343,1104487
2018/4/1,總計,臺中市,963132,2793005,1376132,1416873
2018/4/1,總計,臺南市,684903,1885478,941381,944097
2018/4/1,總計,高雄市,1093948,2775318,1374031,1401287
2018/4/1,總計,臺灣省,2490404,7103568,3620887,3482681
2018/4/1,總計,宜蘭縣,168694,456066,230624,225442
2018/4/1,總計,新竹縣,192145,553250,282649,270601
2018/4/1,總計,苗栗縣,188204,551791,284813,266978
2018/4/1,總計,彰化縣,387711,1280038,652209,627829
2018/4/1,總計,南投縣,178075,499879,256074,243805
2018/4/1,總計,雲林縣,240399,689003,357305,331698
2018/4/1,總計,嘉義縣,182832,509677,264935,244742
2018/4/1,總計,屏東縣,287035,828524,423554,404970
2018/4/1,總計,臺東縣,82897,219628,113346,106282
2018/4/1,總計,花蓮縣,125851,328683,166778,161905
2018/4/1,總計,澎湖縣,40062,104121,53659,50462
2018/4/1,總計,基隆市,153028,371099,185660,185439
2018/4/1,總計,新竹市,163816,442570,218393,224177
2018/4/1,總計,嘉義市,99655,269239,130888,138351
2018/4/1,總計,福建省,43093,150688,76242,74446
2018/4/1,總計,金門縣,40143,137730,68849,68881
2018/4/1,總計,連江縣,2950,12958,7393,5565
2018/4/1,新北市,板橋區,209076,551703,269227,282476
2018/4/1,新北市,三重區,151111,386479,190071,196408
2018/4/1,新北市,中和區,165305,412857,200632,212225
2018/4/1,新北市,永和區,90993,222246,105496,116750
2018/4/1,新北市,新莊區,154032,417112,203553,213559
2018/4/1,新北市,新店區,126823,301758,145062,156696
2018/4/1,新北市,樹林區,66437,183805,91607,92198
2018/4/1,新北市,鶯歌區,29954,86408,43296,43112
2018/4/1,新北市,三峽區,42837,115249,57751,57498
2018/4/1,新北市,淡水區,75348,170530,81744,88786
2018/4/1,新北市,汐止區,87111,199512,97306,102206
2018/4/1,新北市,瑞芳區,16186,40167,20267,19900
2018/4/1,新北市,土城區,87038,237640,117248,120392
2018/4/1,新北市,蘆洲區,71135,201107,98749,102358
2018/4/1,新北市,五股區,31763,85325,43019,42306
2018/4/1,新北市,泰山區,28498,78854,39098,39756
2018/4/1,新北市,林口區,42428,107055,52062,54993
2018/4/1,新北市,深坑區,9603,23650,11834,11816
2018/4/1,新北市,石碇區,3375,7678,4214,3464
2018/4/1,新北市,坪林區,2515,6526,3605,2921
2018/4/1,新北市,三芝區,9494,23102,11899,11203
2018/4/1,新北市,石門區,4301,12215,6320,5895
2018/4/1,新北市,八里區,14671,38479,19216,19263
2018/4/1,新北市,平溪區,2299,4712,2602,2110
2018/4/1,新北市,雙溪區,3802,8897,4810,4087
2018/4/1,新北市,貢寮區,4390,12448,6335,6113
2018/4/1,新北市,金山區,7114,21912,10827,11085
2018/4/1,新北市,萬里區,7486,22155,11124,11031
2018/4/1,新北市,烏來區,1875,6334,3114,3220
2018/4/1,臺北市,松山區,80897,206577,96957,109620
2018/4/1,臺北市,信義區,89439,224844,107301,117543
2018/4/1,臺北市,大安區,120945,309856,144651,165205
2018/4/1,臺北市,中山區,100256,230105,106946,123159
2018/4/1,臺北市,中正區,65298,159627,76151,83476
2018/4/1,臺北市,大同區,51866,128916,62829,66087
2018/4/1,臺北市,萬華區,78620,191017,93793,97224
2018/4/1,臺北市,文山區,105660,274227,131522,142705
2018/4/1,臺北市,南港區,47121,121988,59602,62386
2018/4/1,臺北市,內湖區,108201,287674,137432,150242
2018/4/1,臺北市,士林區,107225,287969,138956,149013
2018/4/1,臺北市,北投區,96858,255895,123168,132727
2018/4/1,桃園市,桃園區,166943,443273,215177,228096
2018/4/1,桃園市,中壢區,150599,407486,200645,206841
2018/4/1,桃園市,大溪區,32548,94635,48219,46416
2018/4/1,桃園市,楊梅區,58469,168489,84852,83637
2018/4/1,桃園市,蘆竹區,58583,162685,80804,81881
2018/4/1,桃園市,大園區,33035,89529,45781,43748
2018/4/1,桃園市,龜山區,61732,158571,78977,79594
2018/4/1,桃園市,八德區,70948,199440,99763,99677
2018/4/1,桃園市,龍潭區,41924,122306,61234,61072
2018/4/1,桃園市,平鎮區,77383,224958,111758,113200
2018/4/1,桃園市,新屋區,16386,49072,26119,22953
2018/4/1,桃園市,觀音區,22909,66647,34654,31993
2018/4/1,桃園市,復興區,3804,11739,6360,5379
2018/4/1,臺中市,中區,7943,18568,9191,9377
2018/4/1,臺中市,東區,28045,75978,37817,38161
2018/4/1,臺中市,南區,48480,125267,60148,65119
2018/4/1,臺中市,西區,45727,115703,54930,60773
2018/4/1,臺中市,北區,59467,147766,70673,77093
2018/4/1,臺中市,西屯區,86227,227707,109261,118446
2018/4/1,臺中市,南屯區,62434,169308,80920,88388
2018/4/1,臺中市,北屯區,100846,276080,132369,143711
2018/4/1,臺中市,豐原區,53911,167002,82468,84534
2018/4/1,臺中市,東勢區,17418,50541,25928,24613
2018/4/1,臺中市,大甲區,23135,77799,39133,38666
2018/4/1,臺中市,清水區,27389,86541,44420,42121
2018/4/1,臺中市,沙鹿區,29715,93087,46938,46149
2018/4/1,臺中市,梧棲區,17843,58084,29107,28977
2018/4/1,臺中市,后里區,16317,54551,27670,26881
2018/4/1,臺中市,神岡區,19519,65660,33479,32181
2018/4/1,臺中市,潭子區,36429,108342,53514,54828
2018/4/1,臺中市,大雅區,29786,95525,47642,47883
2018/4/1,臺中市,新社區,7562,24657,12799,11858
2018/4/1,臺中市,石岡區,4898,15025,7780,7245
2018/4/1,臺中市,外埔區,9769,32140,16454,15686
2018/4/1,臺中市,大安區,5503,19261,10165,9096
2018/4/1,臺中市,烏日區,24745,74843,37527,37316
2018/4/1,臺中市,大肚區,17738,57363,29292,28071
2018/4/1,臺中市,龍井區,23199,77907,39213,38694
2018/4/1,臺中市,霧峰區,20343,65535,33186,32349
2018/4/1,臺中市,太平區,64335,190028,94203,95825
2018/4/1,臺中市,大里區,69807,211720,103979,107741
2018/4/1,臺中市,和平區,4602,11017,5926,5091
2018/4/1,臺南市,新營區,29011,78005,38594,39411
2018/4/1,臺南市,鹽水區,10037,25540,13337,12203
2018/4/1,臺南市,白河區,10809,28356,14816,13540
2018/4/1,臺南市,柳營區,7914,21281,11107,10174
2018/4/1,臺南市,後壁區,8848,23597,12266,11331
2018/4/1,臺南市,東山區,8362,20982,11145,9837
2018/4/1,臺南市,麻豆區,15812,44523,22624,21899
2018/4/1,臺南市,下營區,9060,24096,12425,11671
2018/4/1,臺南市,六甲區,7792,22278,11515,10763
2018/4/1,臺南市,官田區,7924,21343,10881,10462
2018/4/1,臺南市,大內區,3861,9712,5246,4466
2018/4/1,臺南市,佳里區,20736,59381,29475,29906
2018/4/1,臺南市,學甲區,9614,25920,13239,12681
2018/4/1,臺南市,西港區,8227,24733,12487,12246
2018/4/1,臺南市,七股區,8044,22915,11872,11043
2018/4/1,臺南市,將軍區,7281,19738,10068,9670
2018/4/1,臺南市,北門區,4241,11161,5631,5530
2018/4/1,臺南市,新化區,14452,43644,22228,21416
2018/4/1,臺南市,善化區,17791,48598,24423,24175
2018/4/1,臺南市,新市區,12410,36702,18381,18321
2018/4/1,臺南市,安定區,10138,30552,15723,14829
2018/4/1,臺南市,山上區,2722,7320,3815,3505
2018/4/1,臺南市,玉井區,5159,14134,7313,6821
2018/4/1,臺南市,楠西區,3508,9662,5105,4557
2018/4/1,臺南市,南化區,2867,8767,4723,4044
2018/4/1,臺南市,左鎮區,1971,4851,2719,2132
2018/4/1,臺南市,仁德區,27679,75545,38216,37329
2018/4/1,臺南市,歸仁區,22796,68535,34765,33770
2018/4/1,臺南市,關廟區,11149,34391,17738,16653
2018/4/1,臺南市,龍崎區,1536,4008,2157,1851
2018/4/1,臺南市,永康區,84393,234211,115378,118833
2018/4/1,臺南市,東區,71863,186596,89425,97171
2018/4/1,臺南市,南區,45760,125120,61936,63184
2018/4/1,臺南市,北區,50994,132524,64389,68135
2018/4/1,臺南市,安南區,63038,192346,96944,95402
2018/4/1,臺南市,安平區,25714,66625,31672,34953
2018/4/1,臺南市,中西區,31390,77786,37603,40183
2018/4/1,高雄市,鹽埕區,10772,24195,11989,12206
2018/4/1,高雄市,鼓山區,58334,139613,67309,72304
2018/4/1,高雄市,左營區,78958,196949,94704,102245
2018/4/1,高雄市,楠梓區,70816,184295,90434,93861
2018/4/1,高雄市,三民區,136910,342476,165641,176835
2018/4/1,高雄市,新興區,22893,51087,24535,26552
2018/4/1,高雄市,前金區,12610,26916,12824,14092
2018/4/1,高雄市,苓雅區,72146,170678,82110,88568
2018/4/1,高雄市,前鎮區,78722,189263,92973,96290
2018/4/1,高雄市,旗津區,11108,28685,14782,13903
2018/4/1,高雄市,小港區,68208,157530,78243,79287
2018/4/1,高雄市,鳳山區,141040,359049,176016,183033
2018/4/1,高雄市,林園區,25966,70055,35384,34671
2018/4/1,高雄市,大寮區,42328,112384,57457,54927
2018/4/1,高雄市,大樹區,13625,42688,21858,20830
2018/4/1,高雄市,大社區,13082,34656,17581,17075
2018/4/1,高雄市,仁武區,33412,86435,43867,42568
2018/4/1,高雄市,鳥松區,18336,44258,22384,21874
2018/4/1,高雄市,岡山區,34936,97249,48226,49023
2018/4/1,高雄市,橋頭區,13685,37625,19075,18550
2018/4/1,高雄市,燕巢區,10570,29844,15720,14124
2018/4/1,高雄市,田寮區,3259,7204,3979,3225
2018/4/1,高雄市,阿蓮區,9412,28750,14521,14229
2018/4/1,高雄市,路竹區,17080,52638,26857,25781
2018/4/1,高雄市,湖內區,10931,29835,15232,14603
2018/4/1,高雄市,茄萣區,10526,30082,15489,14593
2018/4/1,高雄市,永安區,5736,13916,6997,6919
2018/4/1,高雄市,彌陀區,6778,19320,9919,9401
2018/4/1,高雄市,梓官區,12652,35990,18508,17482
2018/4/1,高雄市,旗山區,13756,36835,19033,17802
2018/4/1,高雄市,美濃區,14772,39858,20899,18959
2018/4/1,高雄市,六龜區,5545,12965,6984,5981
2018/4/1,高雄市,甲仙區,2311,6085,3236,2849
2018/4/1,高雄市,杉林區,4809,11936,6515,5421
2018/4/1,高雄市,內門區,5125,14538,7865,6673
2018/4/1,高雄市,茂林區,597,1971,992,979
2018/4/1,高雄市,桃源區,1359,4326,2279,2047
2018/4/1,高雄市,那瑪夏區,843,3139,1614,1525
2018/4/1,宜蘭縣,宜蘭市,36384,95919,46753,49166
2018/4/1,宜蘭縣,羅東鎮,26440,72509,34361,38148
2018/4/1,宜蘭縣,蘇澳鎮,14179,39981,20356,19625
2018/4/1,宜蘭縣,頭城鎮,10236,29246,15069,14177
2018/4/1,宜蘭縣,礁溪鄉,14069,35653,18538,17115
2018/4/1,宜蘭縣,壯圍鄉,8863,24245,12816,11429
2018/4/1,宜蘭縣,員山鄉,11726,32371,17166,15205
2018/4/1,宜蘭縣,冬山鄉,19318,52990,27167,25823
2018/4/1,宜蘭縣,五結鄉,15007,39575,20443,19132
2018/4/1,宜蘭縣,三星鄉,8592,21405,11527,9878
2018/4/1,宜蘭縣,大同鄉,1906,6184,3314,2870
2018/4/1,宜蘭縣,南澳鄉,1974,5988,3114,2874
2018/4/1,新竹縣,竹北市,66346,183326,91269,92057
2018/4/1,新竹縣,關西鎮,9396,28832,15412,13420
2018/4/1,新竹縣,新埔鎮,10711,33264,17754,15510
2018/4/1,新竹縣,竹東鎮,33983,96627,48507,48120
2018/4/1,新竹縣,湖口鄉,26713,77491,39262,38229
2018/4/1,新竹縣,橫山鄉,4436,13000,7048,5952
2018/4/1,新竹縣,新豐鄉,18596,56826,29147,27679
2018/4/1,新竹縣,芎林鄉,6528,20072,10633,9439
2018/4/1,新竹縣,寶山鄉,5584,14618,7891,6727
2018/4/1,新竹縣,北埔鄉,3116,9362,5097,4265
2018/4/1,新竹縣,峨眉鄉,2078,5556,3050,2506
2018/4/1,新竹縣,尖石鄉,2892,9598,5061,4537
2018/4/1,新竹縣,五峰鄉,1766,4678,2518,2160
2018/4/1,苗栗縣,苗栗市,31380,88662,44300,44362
2018/4/1,苗栗縣,頭份市,34885,102986,52018,50968
2018/4/1,苗栗縣,苑裡鎮,14683,45711,23808,21903
2018/4/1,苗栗縣,通霄鎮,11580,34407,18190,16217
2018/4/1,苗栗縣,竹南鎮,29448,85731,43294,42437
2018/4/1,苗栗縣,後龍鎮,11939,36585,19353,17232
2018/4/1,苗栗縣,卓蘭鎮,6021,16912,8873,8039
2018/4/1,苗栗縣,大湖鄉,5411,14657,7765,6892
2018/4/1,苗栗縣,公館鄉,10718,33590,17529,16061
2018/4/1,苗栗縣,銅鑼鄉,6142,18058,9606,8452
2018/4/1,苗栗縣,南庄鄉,3932,10138,5556,4582
2018/4/1,苗栗縣,頭屋鄉,3648,10832,5751,5081
2018/4/1,苗栗縣,三義鄉,5556,16401,8657,7744
2018/4/1,苗栗縣,西湖鄉,2639,7114,3970,3144
2018/4/1,苗栗縣,造橋鄉,4128,12875,6788,6087
2018/4/1,苗栗縣,三灣鄉,2396,6705,3669,3036
2018/4/1,苗栗縣,獅潭鄉,1717,4412,2469,1943
2018/4/1,苗栗縣,泰安鄉,1981,6015,3217,2798
2018/4/1,彰化縣,彰化市,76514,233110,115131,117979
2018/4/1,彰化縣,員林市,39408,124613,61953,62660
2018/4/1,彰化縣,鹿港鎮,24555,86775,44086,42689
2018/4/1,彰化縣,和美鎮,26776,90798,46177,44621
2018/4/1,彰化縣,北斗鎮,10713,33306,16786,16520
2018/4/1,彰化縣,溪湖鎮,16378,55571,28162,27409
2018/4/1,彰化縣,田中鎮,13173,41794,21543,20251
2018/4/1,彰化縣,二林鎮,15066,50854,26150,24704
2018/4/1,彰化縣,線西鄉,4417,16923,8671,8252
2018/4/1,彰化縣,伸港鄉,10014,36953,18856,18097
2018/4/1,彰化縣,福興鄉,12864,47206,24605,22601
2018/4/1,彰化縣,秀水鄉,10792,39274,20284,18990
2018/4/1,彰化縣,花壇鄉,14117,45871,23531,22340
2018/4/1,彰化縣,芬園鄉,6835,23636,12424,11212
2018/4/1,彰化縣,大村鄉,11156,36849,19029,17820
2018/4/1,彰化縣,埔鹽鄉,9097,32526,17098,15428
2018/4/1,彰化縣,埔心鄉,10616,34718,17865,16853
2018/4/1,彰化縣,永靖鄉,10939,37229,19265,17964
2018/4/1,彰化縣,社頭鄉,12947,43058,22134,20924
2018/4/1,彰化縣,二水鄉,5291,15258,7991,7267
2018/4/1,彰化縣,田尾鄉,7988,27461,14142,13319
2018/4/1,彰化縣,埤頭鄉,9080,30661,15853,14808
2018/4/1,彰化縣,芳苑鄉,10124,33619,17767,15852
2018/4/1,彰化縣,大城鄉,5245,16871,9097,7774
2018/4/1,彰化縣,竹塘鄉,4620,15238,8008,7230
2018/4/1,彰化縣,溪州鄉,8986,29866,15601,14265
2018/4/1,南投縣,南投市,34790,99985,50035,49950
2018/4/1,南投縣,埔里鎮,28989,80786,40234,40552
2018/4/1,南投縣,草屯鎮,33245,97640,49396,48244
2018/4/1,南投縣,竹山鎮,20131,54955,28169,26786
2018/4/1,南投縣,集集鎮,4308,10911,5680,5231
2018/4/1,南投縣,名間鄉,12629,38586,20332,18254
2018/4/1,南投縣,鹿谷鄉,8020,17787,9489,8298
2018/4/1,南投縣,中寮鄉,5630,14783,8029,6754
2018/4/1,南投縣,魚池鄉,5757,15860,8375,7485
2018/4/1,南投縣,國姓鄉,7280,18757,10125,8632
2018/4/1,南投縣,水里鄉,7124,17714,9296,8418
2018/4/1,南投縣,信義鄉,5280,16262,8734,7528
2018/4/1,南投縣,仁愛鄉,4892,15853,8180,7673
2018/4/1,雲林縣,斗六市,38360,108666,53985,54681
2018/4/1,雲林縣,斗南鎮,15872,44836,22764,22072
2018/4/1,雲林縣,虎尾鎮,25060,70867,35887,34980
2018/4/1,雲林縣,西螺鎮,14713,46156,23361,22795
2018/4/1,雲林縣,土庫鎮,9377,28851,15058,13793
2018/4/1,雲林縣,北港鎮,15960,40153,20734,19419
2018/4/1,雲林縣,古坑鄉,10989,31590,16644,14946
2018/4/1,雲林縣,大埤鄉,6645,19137,10273,8864
2018/4/1,雲林縣,莿桐鄉,9344,28807,15104,13703
2018/4/1,雲林縣,林內鄉,6026,18201,9534,8667
2018/4/1,雲林縣,二崙鄉,8956,27170,14515,12655
2018/4/1,雲林縣,崙背鄉,8502,24608,12990,11618
2018/4/1,雲林縣,麥寮鄉,14401,45598,22886,22712
2018/4/1,雲林縣,東勢鄉,5749,14925,8258,6667
2018/4/1,雲林縣,褒忠鄉,4429,13027,6994,6033
2018/4/1,雲林縣,臺西鄉,8657,23916,12815,11101
2018/4/1,雲林縣,元長鄉,9269,25870,14138,11732
2018/4/1,雲林縣,四湖鄉,8758,23509,12737,10772
2018/4/1,雲林縣,口湖鄉,9451,27555,14690,12865
2018/4/1,雲林縣,水林鄉,9881,25561,13938,11623
2018/4/1,嘉義縣,太保市,13069,37908,19453,18455
2018/4/1,嘉義縣,朴子市,15705,42281,21334,20947
2018/4/1,嘉義縣,布袋鎮,9926,27026,13792,13234
2018/4/1,嘉義縣,大林鎮,11392,31085,15922,15163
2018/4/1,嘉義縣,民雄鄉,24961,71591,36654,34937
2018/4/1,嘉義縣,溪口鄉,5333,14698,7871,6827
2018/4/1,嘉義縣,新港鄉,10644,31874,16775,15099
2018/4/1,嘉義縣,六腳鄉,8834,23197,12307,10890
2018/4/1,嘉義縣,東石鄉,9215,24825,13130,11695
2018/4/1,嘉義縣,義竹鄉,7375,18385,9557,8828
2018/4/1,嘉義縣,鹿草鄉,5755,15504,8310,7194
2018/4/1,嘉義縣,水上鄉,18103,49592,25601,23991
2018/4/1,嘉義縣,中埔鄉,16007,44808,23311,21497
2018/4/1,嘉義縣,竹崎鄉,11679,35826,19094,16732
2018/4/1,嘉義縣,梅山鄉,6757,19395,10297,9098
2018/4/1,嘉義縣,番路鄉,4245,11517,6226,5291
2018/4/1,嘉義縣,大埔鄉,1921,4564,2355,2209
2018/4/1,嘉義縣,阿里山鄉,1911,5601,2946,2655
2018/4/1,屏東縣,屏東市,74392,200311,98985,101326
2018/4/1,屏東縣,潮州鎮,19451,54107,27021,27086
2018/4/1,屏東縣,東港鎮,16730,47840,24181,23659
2018/4/1,屏東縣,恆春鎮,11605,30765,15781,14984
2018/4/1,屏東縣,萬丹鄉,14980,50782,26340,24442
2018/4/1,屏東縣,長治鄉,10167,29835,15567,14268
2018/4/1,屏東縣,麟洛鄉,3824,11077,5731,5346
2018/4/1,屏東縣,九如鄉,7021,22101,11426,10675
2018/4/1,屏東縣,里港鄉,8209,26339,13404,12935
2018/4/1,屏東縣,鹽埔鄉,7862,25829,13438,12391
2018/4/1,屏東縣,高樹鄉,9271,24502,13062,11440
2018/4/1,屏東縣,萬巒鄉,6522,20530,10719,9811
2018/4/1,屏東縣,內埔鄉,18673,54491,28137,26354
2018/4/1,屏東縣,竹田鄉,5636,17116,9091,8025
2018/4/1,屏東縣,新埤鄉,3448,10115,5377,4738
2018/4/1,屏東縣,枋寮鄉,8529,24503,12819,11684
2018/4/1,屏東縣,新園鄉,11795,35122,18204,16918
2018/4/1,屏東縣,崁頂鄉,4487,15574,7906,7668
2018/4/1,屏東縣,林邊鄉,6717,17964,9195,8769
2018/4/1,屏東縣,南州鄉,3714,10656,5450,5206
2018/4/1,屏東縣,佳冬鄉,6967,19284,10023,9261
2018/4/1,屏東縣,琉球鄉,4497,12307,6749,5558
2018/4/1,屏東縣,車城鄉,3476,8628,4626,4002
2018/4/1,屏東縣,滿州鄉,3050,7964,4312,3652
2018/4/1,屏東縣,枋山鄉,2092,5467,2906,2561
2018/4/1,屏東縣,三地門鄉,2328,7678,3850,3828
2018/4/1,屏東縣,霧臺鄉,1060,3330,1704,1626
2018/4/1,屏東縣,瑪家鄉,2054,6758,3425,3333
2018/4/1,屏東縣,泰武鄉,1350,5352,2809,2543
2018/4/1,屏東縣,來義鄉,2230,7423,3752,3671
2018/4/1,屏東縣,春日鄉,1404,4891,2509,2382
2018/4/1,屏東縣,獅子鄉,1562,4918,2528,2390
2018/4/1,屏東縣,牡丹鄉,1932,4965,2527,2438
2018/4/1,臺東縣,臺東市,39716,105766,52940,52826
2018/4/1,臺東縣,成功鎮,5386,14197,7470,6727
2018/4/1,臺東縣,關山鎮,3177,8755,4549,4206
2018/4/1,臺東縣,卑南鄉,6719,17423,9189,8234
2018/4/1,臺東縣,大武鄉,2494,6099,3180,2919
2018/4/1,臺東縣,太麻里鄉,4706,11198,5966,5232
2018/4/1,臺東縣,東河鄉,3766,8511,4721,3790
2018/4/1,臺東縣,長濱鄉,2929,7254,4115,3139
2018/4/1,臺東縣,鹿野鄉,3045,7908,4201,3707
2018/4/1,臺東縣,池上鄉,3209,8218,4284,3934
2018/4/1,臺東縣,綠島鄉,1153,4083,2162,1921
2018/4/1,臺東縣,延平鄉,1073,3633,1939,1694
2018/4/1,臺東縣,海端鄉,1087,4189,2227,1962
2018/4/1,臺東縣,達仁鄉,1460,3608,1956,1652
2018/4/1,臺東縣,金峰鄉,1128,3713,1884,1829
2018/4/1,臺東縣,蘭嶼鄉,1849,5073,2563,2510
2018/4/1,花蓮縣,花蓮市,41435,104003,50149,53854
2018/4/1,花蓮縣,鳳林鎮,4408,10857,5649,5208
2018/4/1,花蓮縣,玉里鎮,8876,24212,12806,11406
2018/4/1,花蓮縣,新城鄉,7719,20104,10326,9778
2018/4/1,花蓮縣,吉安鄉,32045,83646,42065,41581
2018/4/1,花蓮縣,壽豐鄉,7222,18016,9581,8435
2018/4/1,花蓮縣,光復鄉,5011,12868,6819,6049
2018/4/1,花蓮縣,豐濱鄉,1717,4515,2504,2011
2018/4/1,花蓮縣,瑞穗鄉,4760,11694,6317,5377
2018/4/1,花蓮縣,富里鄉,4035,10366,5629,4737
2018/4/1,花蓮縣,秀林鄉,4824,15888,8182,7706
2018/4/1,花蓮縣,萬榮鄉,2104,6435,3397,3038
2018/4/1,花蓮縣,卓溪鄉,1695,6079,3354,2725
2018/4/1,澎湖縣,馬公市,24647,62408,31768,30640
2018/4/1,澎湖縣,湖西鄉,5591,14461,7628,6833
2018/4/1,澎湖縣,白沙鄉,3406,9809,5136,4673
2018/4/1,澎湖縣,西嶼鄉,3023,8392,4320,4072
2018/4/1,澎湖縣,望安鄉,2021,5199,2805,2394
2018/4/1,澎湖縣,七美鄉,1374,3852,2002,1850
2018/4/1,基隆市,中正區,22616,51952,26520,25432
2018/4/1,基隆市,七堵區,21485,53926,27094,26832
2018/4/1,基隆市,暖暖區,15659,38666,19381,19285
2018/4/1,基隆市,仁愛區,19197,44263,21892,22371
2018/4/1,基隆市,中山區,19261,47725,24175,23550
2018/4/1,基隆市,安樂區,33495,82436,40801,41635
2018/4/1,基隆市,信義區,21315,52131,25797,26334
2018/4/1,新竹市,東區,79745,213839,105194,108645
2018/4/1,新竹市,北區,56777,150666,73568,77098
2018/4/1,新竹市,香山區,27294,78065,39631,38434
2018/4/1,嘉義市,東區,45513,121877,58661,63216
2018/4/1,嘉義市,西區,54142,147362,72227,75135
2018/4/1,金門縣,金城鎮,12918,43246,21580,21666
2018/4/1,金門縣,金湖鎮,8965,29500,14824,14676
2018/4/1,金門縣,金沙鎮,6320,20517,10149,10368
2018/4/1,金門縣,金寧鄉,8657,31019,15651,15368
2018/4/1,金門縣,烈嶼鄉,3149,12762,6297,6465
2018/4/1,金門縣,烏坵鄉,134,686,348,338
2018/4/1,連江縣,南竿鄉,1719,7601,4261,3340
2018/4/1,連江縣,北竿鄉,603,2385,1332,1053
2018/4/1,連江縣,莒光鄉,293,1627,998,629
2018/4/1,連江縣,東引鄉,335,1345,802,543
2018/5/1,總計,新北市,1549370,3986911,1952344,2034567
2018/5/1,總計,臺北市,1053113,2676767,1278241,1398526
2018/5/1,總計,桃園市,797101,2202034,1095797,1106237
2018/5/1,總計,臺中市,964524,2793980,1376459,1417521
2018/5/1,總計,臺南市,685436,1884935,941100,943835
2018/5/1,總計,高雄市,1094674,2774323,1373428,1400895
2018/5/1,總計,臺灣省,2492313,7102602,3620031,3482571
2018/5/1,總計,宜蘭縣,168880,456047,230597,225450
2018/5/1,總計,新竹縣,192598,553978,282991,270987
2018/5/1,總計,苗栗縣,188408,551337,284593,266744
2018/5/1,總計,彰化縣,387910,1279460,651916,627544
2018/5/1,總計,南投縣,178138,499531,255848,243683
2018/5/1,總計,雲林縣,240553,688781,357178,331603
2018/5/1,總計,嘉義縣,182868,509360,264764,244596
2018/5/1,總計,屏東縣,287206,828463,423430,405033
2018/5/1,總計,臺東縣,82902,219744,113375,106369
2018/5/1,總計,花蓮縣,125833,328721,166771,161950
2018/5/1,總計,澎湖縣,40062,104107,53648,50459
2018/5/1,總計,基隆市,153129,370944,185538,185406
2018/5/1,總計,新竹市,164105,443038,218615,224423
2018/5/1,總計,嘉義市,99721,269091,130767,138324
2018/5/1,總計,福建省,43139,150863,76328,74535
2018/5/1,總計,金門縣,40181,137860,68896,68964
2018/5/1,總計,連江縣,2958,13003,7432,5571
2018/5/1,新北市,板橋區,209430,552025,269349,282676
2018/5/1,新北市,三重區,151249,386301,189935,196366
2018/5/1,新北市,中和區,165398,412829,200619,212210
2018/5/1,新北市,永和區,91045,222165,105453,116712
2018/5/1,新北市,新莊區,154392,417226,203612,213614
2018/5/1,新北市,新店區,126976,301812,145038,156774
2018/5/1,新北市,樹林區,66497,183732,91561,92171
2018/5/1,新北市,鶯歌區,30016,86315,43259,43056
2018/5/1,新北市,三峽區,42938,115430,57807,57623
2018/5/1,新北市,淡水區,75676,170952,81933,89019
2018/5/1,新北市,汐止區,87213,199531,97290,102241
2018/5/1,新北市,瑞芳區,16194,40178,20284,19894
2018/5/1,新北市,土城區,87031,237438,117088,120350
2018/5/1,新北市,蘆洲區,71206,201005,98703,102302
2018/5/1,新北市,五股區,31904,85520,43104,42416
2018/5/1,新北市,泰山區,28529,78813,39060,39753
2018/5/1,新北市,林口區,42679,107486,52309,55177
2018/5/1,新北市,深坑區,9601,23651,11840,11811
2018/5/1,新北市,石碇區,3371,7681,4217,3464
2018/5/1,新北市,坪林區,2516,6546,3612,2934
2018/5/1,新北市,三芝區,9501,23094,11894,11200
2018/5/1,新北市,石門區,4307,12203,6324,5879
2018/5/1,新北市,八里區,14715,38553,19256,19297
2018/5/1,新北市,平溪區,2306,4713,2601,2112
2018/5/1,新北市,雙溪區,3808,8906,4811,4095
2018/5/1,新北市,貢寮區,4385,12426,6333,6093
2018/5/1,新北市,金山區,7116,21872,10796,11076
2018/5/1,新北市,萬里區,7494,22160,11140,11020
2018/5/1,新北市,烏來區,1877,6348,3116,3232
2018/5/1,臺北市,松山區,80942,206520,96899,109621
2018/5/1,臺北市,信義區,89466,224558,107110,117448
2018/5/1,臺北市,大安區,121022,309683,144571,165112
2018/5/1,臺北市,中山區,100308,229893,106898,122995
2018/5/1,臺北市,中正區,65383,159695,76177,83518
2018/5/1,臺北市,大同區,51891,128732,62750,65982
2018/5/1,臺北市,萬華區,78664,190699,93601,97098
2018/5/1,臺北市,文山區,105805,274123,131487,142636
2018/5/1,臺北市,南港區,47165,121957,59580,62377
2018/5/1,臺北市,內湖區,108296,287512,137355,150157
2018/5/1,臺北市,士林區,107300,287803,138832,148971
2018/5/1,臺北市,北投區,96871,255592,122981,132611
2018/5/1,桃園市,桃園區,167273,443760,215387,228373
2018/5/1,桃園市,中壢區,151058,408292,201051,207241
2018/5/1,桃園市,大溪區,32566,94682,48233,46449
2018/5/1,桃園市,楊梅區,58617,168703,84962,83741
2018/5/1,桃園市,蘆竹區,58716,163029,80949,82080
2018/5/1,桃園市,大園區,33078,89695,45858,43837
2018/5/1,桃園市,龜山區,61916,158848,79090,79758
2018/5/1,桃園市,八德區,71141,199812,99957,99855
2018/5/1,桃園市,龍潭區,42022,122431,61297,61134
2018/5/1,桃園市,平鎮區,77507,225035,111758,113277
2018/5/1,桃園市,新屋區,16425,49130,26129,23001
2018/5/1,桃園市,觀音區,22964,66756,34712,32044
2018/5/1,桃園市,復興區,3818,11861,6414,5447
2018/5/1,臺中市,中區,7945,18544,9201,9343
2018/5/1,臺中市,東區,28093,76010,37836,38174
2018/5/1,臺中市,南區,48584,125372,60190,65182
2018/5/1,臺中市,西區,45723,115626,54890,60736
2018/5/1,臺中市,北區,59508,147751,70669,77082
2018/5/1,臺中市,西屯區,86349,227851,109328,118523
2018/5/1,臺中市,南屯區,62541,169376,80936,88440
2018/5/1,臺中市,北屯區,101023,276438,132525,143913
2018/5/1,臺中市,豐原區,53973,167022,82461,84561
2018/5/1,臺中市,東勢區,17424,50502,25910,24592
2018/5/1,臺中市,大甲區,23181,77776,39104,38672
2018/5/1,臺中市,清水區,27433,86544,44415,42129
2018/5/1,臺中市,沙鹿區,29785,93139,46991,46148
2018/5/1,臺中市,梧棲區,17882,58119,29102,29017
2018/5/1,臺中市,后里區,16333,54565,27686,26879
2018/5/1,臺中市,神岡區,19531,65629,33448,32181
2018/5/1,臺中市,潭子區,36483,108447,53569,54878
2018/5/1,臺中市,大雅區,29827,95526,47642,47884
2018/5/1,臺中市,新社區,7572,24644,12791,11853
2018/5/1,臺中市,石岡區,4897,15016,7763,7253
2018/5/1,臺中市,外埔區,9778,32143,16455,15688
2018/5/1,臺中市,大安區,5513,19265,10166,9099
2018/5/1,臺中市,烏日區,24830,74907,37550,37357
2018/5/1,臺中市,大肚區,17765,57359,29285,28074
2018/5/1,臺中市,龍井區,23233,77934,39203,38731
2018/5/1,臺中市,霧峰區,20362,65550,33191,32359
2018/5/1,臺中市,太平區,64473,190157,94262,95895
2018/5/1,臺中市,大里區,69867,211685,103937,107748
2018/5/1,臺中市,和平區,4616,11083,5953,5130
2018/5/1,臺南市,新營區,29011,77916,38555,39361
2018/5/1,臺南市,鹽水區,10025,25516,13314,12202
2018/5/1,臺南市,白河區,10801,28324,14799,13525
2018/5/1,臺南市,柳營區,7923,21273,11103,10170
2018/5/1,臺南市,後壁區,8844,23571,12250,11321
2018/5/1,臺南市,東山區,8350,20953,11127,9826
2018/5/1,臺南市,麻豆區,15820,44468,22594,21874
2018/5/1,臺南市,下營區,9050,24063,12411,11652
2018/5/1,臺南市,六甲區,7801,22284,11525,10759
2018/5/1,臺南市,官田區,7918,21312,10869,10443
2018/5/1,臺南市,大內區,3860,9712,5242,4470
2018/5/1,臺南市,佳里區,20726,59312,29422,29890
2018/5/1,臺南市,學甲區,9610,25872,13216,12656
2018/5/1,臺南市,西港區,8242,24735,12489,12246
2018/5/1,臺南市,七股區,8033,22935,11878,11057
2018/5/1,臺南市,將軍區,7287,19728,10068,9660
2018/5/1,臺南市,北門區,4235,11149,5625,5524
2018/5/1,臺南市,新化區,14448,43614,22218,21396
2018/5/1,臺南市,善化區,17820,48617,24442,24175
2018/5/1,臺南市,新市區,12451,36764,18409,18355
2018/5/1,臺南市,安定區,10139,30532,15713,14819
2018/5/1,臺南市,山上區,2715,7320,3814,3506
2018/5/1,臺南市,玉井區,5156,14110,7298,6812
2018/5/1,臺南市,楠西區,3509,9652,5098,4554
2018/5/1,臺南市,南化區,2866,8765,4726,4039
2018/5/1,臺南市,左鎮區,1969,4840,2712,2128
2018/5/1,臺南市,仁德區,27706,75539,38202,37337
2018/5/1,臺南市,歸仁區,22819,68476,34729,33747
2018/5/1,臺南市,關廟區,11158,34403,17741,16662
2018/5/1,臺南市,龍崎區,1536,4010,2156,1854
2018/5/1,臺南市,永康區,84531,234231,115414,118817
2018/5/1,臺南市,東區,71922,186575,89389,97186
2018/5/1,臺南市,南區,45825,125055,61905,63150
2018/5/1,臺南市,北區,51005,132403,64319,68084
2018/5/1,臺南市,安南區,63201,192535,97064,95471
2018/5/1,臺南市,安平區,25764,66671,31693,34978
2018/5/1,臺南市,中西區,31360,77700,37571,40129
2018/5/1,高雄市,鹽埕區,10780,24212,11997,12215
2018/5/1,高雄市,鼓山區,58384,139619,67291,72328
2018/5/1,高雄市,左營區,78991,196839,94627,102212
2018/5/1,高雄市,楠梓區,71009,184410,90455,93955
2018/5/1,高雄市,三民區,136878,342176,165513,176663
2018/5/1,高雄市,新興區,22874,51020,24519,26501
2018/5/1,高雄市,前金區,12613,26888,12811,14077
2018/5/1,高雄市,苓雅區,72156,170457,81982,88475
2018/5/1,高雄市,前鎮區,78750,189115,92896,96219
2018/5/1,高雄市,旗津區,11108,28665,14776,13889
2018/5/1,高雄市,小港區,68265,157508,78221,79287
2018/5/1,高雄市,鳳山區,141158,359071,176001,183070
2018/5/1,高雄市,林園區,26008,69995,35339,34656
2018/5/1,高雄市,大寮區,42347,112395,57450,54945
2018/5/1,高雄市,大樹區,13637,42650,21842,20808
2018/5/1,高雄市,大社區,13112,34644,17567,17077
2018/5/1,高雄市,仁武區,33531,86582,43950,42632
2018/5/1,高雄市,鳥松區,18385,44262,22389,21873
2018/5/1,高雄市,岡山區,34943,97168,48178,48990
2018/5/1,高雄市,橋頭區,13693,37619,19083,18536
2018/5/1,高雄市,燕巢區,10577,29823,15704,14119
2018/5/1,高雄市,田寮區,3257,7205,3975,3230
2018/5/1,高雄市,阿蓮區,9412,28746,14512,14234
2018/5/1,高雄市,路竹區,17082,52603,26838,25765
2018/5/1,高雄市,湖內區,10935,29861,15242,14619
2018/5/1,高雄市,茄萣區,10524,30081,15479,14602
2018/5/1,高雄市,永安區,5740,13910,6999,6911
2018/5/1,高雄市,彌陀區,6783,19315,9910,9405
2018/5/1,高雄市,梓官區,12635,35919,18497,17422
2018/5/1,高雄市,旗山區,13738,36816,19034,17782
2018/5/1,高雄市,美濃區,14773,39811,20876,18935
2018/5/1,高雄市,六龜區,5551,12971,6992,5979
2018/5/1,高雄市,甲仙區,2308,6073,3229,2844
2018/5/1,高雄市,杉林區,4807,11918,6512,5406
2018/5/1,高雄市,內門區,5129,14526,7855,6671
2018/5/1,高雄市,茂林區,598,1987,998,989
2018/5/1,高雄市,桃源區,1359,4326,2275,2051
2018/5/1,高雄市,那瑪夏區,844,3137,1614,1523
2018/5/1,宜蘭縣,宜蘭市,36435,95928,46764,49164
2018/5/1,宜蘭縣,羅東鎮,26448,72477,34327,38150
2018/5/1,宜蘭縣,蘇澳鎮,14212,39967,20347,19620
2018/5/1,宜蘭縣,頭城鎮,10243,29239,15071,14168
2018/5/1,宜蘭縣,礁溪鄉,14086,35636,18524,17112
2018/5/1,宜蘭縣,壯圍鄉,8876,24268,12840,11428
2018/5/1,宜蘭縣,員山鄉,11715,32351,17148,15203
2018/5/1,宜蘭縣,冬山鄉,19333,52956,27157,25799
2018/5/1,宜蘭縣,五結鄉,15026,39577,20440,19137
2018/5/1,宜蘭縣,三星鄉,8624,21436,11530,9906
2018/5/1,宜蘭縣,大同鄉,1911,6207,3325,2882
2018/5/1,宜蘭縣,南澳鄉,1971,6005,3124,2881
2018/5/1,新竹縣,竹北市,66705,184014,91586,92428
2018/5/1,新竹縣,關西鎮,9399,28816,15412,13404
2018/5/1,新竹縣,新埔鎮,10722,33231,17746,15485
2018/5/1,新竹縣,竹東鎮,33978,96477,48457,48020
2018/5/1,新竹縣,湖口鄉,26768,77596,39292,38304
2018/5/1,新竹縣,橫山鄉,4441,13001,7052,5949
2018/5/1,新竹縣,新豐鄉,18615,56782,29136,27646
2018/5/1,新竹縣,芎林鄉,6539,20088,10636,9452
2018/5/1,新竹縣,寶山鄉,5586,14650,7908,6742
2018/5/1,新竹縣,北埔鄉,3114,9362,5094,4268
2018/5/1,新竹縣,峨眉鄉,2079,5581,3058,2523
2018/5/1,新竹縣,尖石鄉,2886,9607,5055,4552
2018/5/1,新竹縣,五峰鄉,1766,4773,2559,2214
2018/5/1,苗栗縣,苗栗市,31391,88569,44256,44313
2018/5/1,苗栗縣,頭份市,34946,102949,51998,50951
2018/5/1,苗栗縣,苑裡鎮,14690,45640,23782,21858
2018/5/1,苗栗縣,通霄鎮,11587,34369,18170,16199
2018/5/1,苗栗縣,竹南鎮,29517,85750,43286,42464
2018/5/1,苗栗縣,後龍鎮,11943,36508,19322,17186
2018/5/1,苗栗縣,卓蘭鎮,6019,16896,8859,8037
2018/5/1,苗栗縣,大湖鄉,5406,14627,7754,6873
2018/5/1,苗栗縣,公館鄉,10724,33525,17504,16021
2018/5/1,苗栗縣,銅鑼鄉,6154,18044,9605,8439
2018/5/1,苗栗縣,南庄鄉,3939,10138,5563,4575
2018/5/1,苗栗縣,頭屋鄉,3652,10814,5741,5073
2018/5/1,苗栗縣,三義鄉,5566,16387,8647,7740
2018/5/1,苗栗縣,西湖鄉,2642,7117,3975,3142
2018/5/1,苗栗縣,造橋鄉,4131,12842,6771,6071
2018/5/1,苗栗縣,三灣鄉,2401,6711,3674,3037
2018/5/1,苗栗縣,獅潭鄉,1714,4403,2462,1941
2018/5/1,苗栗縣,泰安鄉,1986,6048,3224,2824
2018/5/1,彰化縣,彰化市,76528,232965,115071,117894
2018/5/1,彰化縣,員林市,39466,124603,61939,62664
2018/5/1,彰化縣,鹿港鎮,24570,86732,44062,42670
2018/5/1,彰化縣,和美鎮,26797,90792,46167,44625
2018/5/1,彰化縣,北斗鎮,10712,33281,16766,16515
2018/5/1,彰化縣,溪湖鎮,16401,55532,28145,27387
2018/5/1,彰化縣,田中鎮,13167,41743,21521,20222
2018/5/1,彰化縣,二林鎮,15059,50816,26120,24696
2018/5/1,彰化縣,線西鄉,4420,16923,8670,8253
2018/5/1,彰化縣,伸港鄉,10038,36981,18863,18118
2018/5/1,彰化縣,福興鄉,12881,47201,24613,22588
2018/5/1,彰化縣,秀水鄉,10799,39268,20266,19002
2018/5/1,彰化縣,花壇鄉,14120,45861,23526,22335
2018/5/1,彰化縣,芬園鄉,6843,23637,12419,11218
2018/5/1,彰化縣,大村鄉,11164,36825,19033,17792
2018/5/1,彰化縣,埔鹽鄉,9103,32530,17104,15426
2018/5/1,彰化縣,埔心鄉,10620,34712,17879,16833
2018/5/1,彰化縣,永靖鄉,10940,37176,19230,17946
2018/5/1,彰化縣,社頭鄉,12941,43012,22112,20900
2018/5/1,彰化縣,二水鄉,5294,15236,7973,7263
2018/5/1,彰化縣,田尾鄉,7998,27459,14139,13320
2018/5/1,彰化縣,埤頭鄉,9081,30615,15833,14782
2018/5/1,彰化縣,芳苑鄉,10130,33605,17754,15851
2018/5/1,彰化縣,大城鄉,5245,16861,9098,7763
2018/5/1,彰化縣,竹塘鄉,4616,15223,8002,7221
2018/5/1,彰化縣,溪州鄉,8977,29871,15611,14260
2018/5/1,南投縣,南投市,34811,99850,49951,49899
2018/5/1,南投縣,埔里鎮,28980,80737,40220,40517
2018/5/1,南投縣,草屯鎮,33259,97580,49354,48226
2018/5/1,南投縣,竹山鎮,20136,54901,28130,26771
2018/5/1,南投縣,集集鎮,4312,10913,5679,5234
2018/5/1,南投縣,名間鄉,12629,38547,20314,18233
2018/5/1,南投縣,鹿谷鄉,8027,17778,9486,8292
2018/5/1,南投縣,中寮鄉,5638,14810,8043,6767
2018/5/1,南投縣,魚池鄉,5755,15885,8387,7498
2018/5/1,南投縣,國姓鄉,7290,18741,10107,8634
2018/5/1,南投縣,水里鄉,7128,17680,9278,8402
2018/5/1,南投縣,信義鄉,5282,16252,8718,7534
2018/5/1,南投縣,仁愛鄉,4891,15857,8181,7676
2018/5/1,雲林縣,斗六市,38385,108590,53942,54648
2018/5/1,雲林縣,斗南鎮,15877,44796,22743,22053
2018/5/1,雲林縣,虎尾鎮,25069,70858,35872,34986
2018/5/1,雲林縣,西螺鎮,14728,46129,23333,22796
2018/5/1,雲林縣,土庫鎮,9394,28837,15048,13789
2018/5/1,雲林縣,北港鎮,16000,40130,20714,19416
2018/5/1,雲林縣,古坑鄉,11011,31589,16645,14944
2018/5/1,雲林縣,大埤鄉,6652,19140,10271,8869
2018/5/1,雲林縣,莿桐鄉,9366,28806,15100,13706
2018/5/1,雲林縣,林內鄉,6022,18259,9571,8688
2018/5/1,雲林縣,二崙鄉,8949,27102,14494,12608
2018/5/1,雲林縣,崙背鄉,8505,24563,12967,11596
2018/5/1,雲林縣,麥寮鄉,14417,45638,22897,22741
2018/5/1,雲林縣,東勢鄉,5756,14942,8269,6673
2018/5/1,雲林縣,褒忠鄉,4428,13035,7001,6034
2018/5/1,雲林縣,臺西鄉,8671,23952,12830,11122
2018/5/1,雲林縣,元長鄉,9264,25864,14142,11722
2018/5/1,雲林縣,四湖鄉,8746,23464,12723,10741
2018/5/1,雲林縣,口湖鄉,9438,27524,14672,12852
2018/5/1,雲林縣,水林鄉,9875,25563,13944,11619
2018/5/1,嘉義縣,太保市,13103,37951,19471,18480
2018/5/1,嘉義縣,朴子市,15699,42255,21315,20940
2018/5/1,嘉義縣,布袋鎮,9933,27008,13784,13224
2018/5/1,嘉義縣,大林鎮,11381,31026,15889,15137
2018/5/1,嘉義縣,民雄鄉,24984,71524,36626,34898
2018/5/1,嘉義縣,溪口鄉,5323,14707,7877,6830
2018/5/1,嘉義縣,新港鄉,10657,31858,16772,15086
2018/5/1,嘉義縣,六腳鄉,8838,23183,12301,10882
2018/5/1,嘉義縣,東石鄉,9207,24804,13126,11678
2018/5/1,嘉義縣,義竹鄉,7376,18383,9555,8828
2018/5/1,嘉義縣,鹿草鄉,5753,15514,8306,7208
2018/5/1,嘉義縣,水上鄉,18106,49547,25585,23962
2018/5/1,嘉義縣,中埔鄉,15995,44733,23276,21457
2018/5/1,嘉義縣,竹崎鄉,11682,35786,19054,16732
2018/5/1,嘉義縣,梅山鄉,6763,19404,10305,9099
2018/5/1,嘉義縣,番路鄉,4242,11521,6224,5297
2018/5/1,嘉義縣,大埔鄉,1919,4567,2360,2207
2018/5/1,嘉義縣,阿里山鄉,1907,5589,2938,2651
2018/5/1,屏東縣,屏東市,74435,200235,98904,101331
2018/5/1,屏東縣,潮州鎮,19449,54036,26990,27046
2018/5/1,屏東縣,東港鎮,16748,47832,24168,23664
2018/5/1,屏東縣,恆春鎮,11623,30803,15799,15004
2018/5/1,屏東縣,萬丹鄉,15013,50753,26330,24423
2018/5/1,屏東縣,長治鄉,10159,29803,15549,14254
2018/5/1,屏東縣,麟洛鄉,3828,11100,5738,5362
2018/5/1,屏東縣,九如鄉,7033,22107,11426,10681
2018/5/1,屏東縣,里港鄉,8213,26278,13372,12906
2018/5/1,屏東縣,鹽埔鄉,7865,25832,13438,12394
2018/5/1,屏東縣,高樹鄉,9271,24515,13068,11447
2018/5/1,屏東縣,萬巒鄉,6522,20553,10726,9827
2018/5/1,屏東縣,內埔鄉,18670,54376,28083,26293
2018/5/1,屏東縣,竹田鄉,5643,17134,9103,8031
2018/5/1,屏東縣,新埤鄉,3458,10100,5359,4741
2018/5/1,屏東縣,枋寮鄉,8537,24506,12814,11692
2018/5/1,屏東縣,新園鄉,11799,35113,18178,16935
2018/5/1,屏東縣,崁頂鄉,4486,15562,7895,7667
2018/5/1,屏東縣,林邊鄉,6713,17930,9172,8758
2018/5/1,屏東縣,南州鄉,3711,10643,5442,5201
2018/5/1,屏東縣,佳冬鄉,6958,19264,10020,9244
2018/5/1,屏東縣,琉球鄉,4503,12347,6766,5581
2018/5/1,屏東縣,車城鄉,3485,8677,4654,4023
2018/5/1,屏東縣,滿州鄉,3051,8008,4337,3671
2018/5/1,屏東縣,枋山鄉,2095,5517,2931,2586
2018/5/1,屏東縣,三地門鄉,2326,7676,3852,3824
2018/5/1,屏東縣,霧臺鄉,1062,3335,1711,1624
2018/5/1,屏東縣,瑪家鄉,2057,6776,3435,3341
2018/5/1,屏東縣,泰武鄉,1352,5394,2832,2562
2018/5/1,屏東縣,來義鄉,2234,7429,3751,3678
2018/5/1,屏東縣,春日鄉,1406,4893,2511,2382
2018/5/1,屏東縣,獅子鄉,1567,4943,2532,2411
2018/5/1,屏東縣,牡丹鄉,1934,4993,2544,2449
2018/5/1,臺東縣,臺東市,39711,105778,52933,52845
2018/5/1,臺東縣,成功鎮,5385,14203,7464,6739
2018/5/1,臺東縣,關山鎮,3172,8747,4545,4202
2018/5/1,臺東縣,卑南鄉,6718,17394,9163,8231
2018/5/1,臺東縣,大武鄉,2496,6123,3188,2935
2018/5/1,臺東縣,太麻里鄉,4716,11210,5972,5238
2018/5/1,臺東縣,東河鄉,3759,8518,4720,3798
2018/5/1,臺東縣,長濱鄉,2921,7246,4113,3133
2018/5/1,臺東縣,鹿野鄉,3042,7915,4203,3712
2018/5/1,臺東縣,池上鄉,3209,8234,4295,3939
2018/5/1,臺東縣,綠島鄉,1155,4107,2189,1918
2018/5/1,臺東縣,延平鄉,1079,3649,1941,1708
2018/5/1,臺東縣,海端鄉,1088,4195,2231,1964
2018/5/1,臺東縣,達仁鄉,1456,3616,1961,1655
2018/5/1,臺東縣,金峰鄉,1136,3723,1884,1839
2018/5/1,臺東縣,蘭嶼鄉,1859,5086,2573,2513
2018/5/1,花蓮縣,花蓮市,41393,103890,50098,53792
2018/5/1,花蓮縣,鳳林鎮,4404,10889,5657,5232
2018/5/1,花蓮縣,玉里鎮,8872,24209,12800,11409
2018/5/1,花蓮縣,新城鄉,7707,20106,10323,9783
2018/5/1,花蓮縣,吉安鄉,32054,83537,42017,41520
2018/5/1,花蓮縣,壽豐鄉,7237,18041,9582,8459
2018/5/1,花蓮縣,光復鄉,5008,12872,6824,6048
2018/5/1,花蓮縣,豐濱鄉,1723,4648,2576,2072
2018/5/1,花蓮縣,瑞穗鄉,4762,11719,6329,5390
2018/5/1,花蓮縣,富里鄉,4038,10362,5629,4733
2018/5/1,花蓮縣,秀林鄉,4831,15904,8176,7728
2018/5/1,花蓮縣,萬榮鄉,2108,6448,3403,3045
2018/5/1,花蓮縣,卓溪鄉,1696,6096,3357,2739
2018/5/1,澎湖縣,馬公市,24600,62345,31713,30632
2018/5/1,澎湖縣,湖西鄉,5620,14471,7641,6830
2018/5/1,澎湖縣,白沙鄉,3410,9809,5139,4670
2018/5/1,澎湖縣,西嶼鄉,3029,8404,4330,4074
2018/5/1,澎湖縣,望安鄉,2028,5225,2824,2401
2018/5/1,澎湖縣,七美鄉,1375,3853,2001,1852
2018/5/1,基隆市,中正區,22627,51881,26485,25396
2018/5/1,基隆市,七堵區,21511,53957,27095,26862
2018/5/1,基隆市,暖暖區,15658,38645,19370,19275
2018/5/1,基隆市,仁愛區,19202,44199,21859,22340
2018/5/1,基隆市,中山區,19254,47625,24128,23497
2018/5/1,基隆市,安樂區,33484,82430,40789,41641
2018/5/1,基隆市,信義區,21393,52207,25812,26395
2018/5/1,新竹市,東區,79898,214148,105357,108791
2018/5/1,新竹市,北區,56846,150766,73597,77169
2018/5/1,新竹市,香山區,27361,78124,39661,38463
2018/5/1,嘉義市,東區,45537,121807,58619,63188
2018/5/1,嘉義市,西區,54184,147284,72148,75136
2018/5/1,金門縣,金城鎮,12922,43255,21578,21677
2018/5/1,金門縣,金湖鎮,8954,29466,14786,14680
2018/5/1,金門縣,金沙鎮,6327,20573,10182,10391
2018/5/1,金門縣,金寧鄉,8685,31087,15691,15396
2018/5/1,金門縣,烈嶼鄉,3159,12793,6311,6482
2018/5/1,金門縣,烏坵鄉,134,686,348,338
2018/5/1,連江縣,南竿鄉,1726,7629,4296,3333
2018/5/1,連江縣,北竿鄉,604,2394,1332,1062
2018/5/1,連江縣,莒光鄉,294,1633,1001,632
2018/5/1,連江縣,東引鄉,334,1347,803,544
2018/6/1,總計,新北市,1551017,3987520,1952383,2035137
2018/6/1,總計,臺北市,1053741,2675713,1277544,1398169
2018/6/1,總計,桃園市,798391,2204824,1097086,1107738
2018/6/1,總計,臺中市,965455,2794933,1376790,1418143
2018/6/1,總計,臺南市,685873,1884717,940901,943816
2018/6/1,總計,高雄市,1095318,2773932,1373055,1400877
2018/6/1,總計,臺灣省,2493345,7101754,3619239,3482515
2018/6/1,總計,宜蘭縣,168959,456006,230545,225461
2018/6/1,總計,新竹縣,192993,554541,283256,271285
2018/6/1,總計,苗栗縣,188522,551082,284434,266648
2018/6/1,總計,彰化縣,388042,1279276,651800,627476
2018/6/1,總計,南投縣,178155,499194,255685,243509
2018/6/1,總計,雲林縣,240634,688717,357103,331614
2018/6/1,總計,嘉義縣,182905,509161,264652,244509
2018/6/1,總計,屏東縣,287294,828275,423325,404950
2018/6/1,總計,臺東縣,82896,219643,113304,106339
2018/6/1,總計,花蓮縣,125851,328749,166743,162006
2018/6/1,總計,澎湖縣,39883,104013,53579,50434
2018/6/1,總計,基隆市,153191,370795,185428,185367
2018/6/1,總計,新竹市,164283,443351,218722,224629
2018/6/1,總計,嘉義市,99737,268951,130663,138288
2018/6/1,總計,福建省,43236,150881,76364,74517
2018/6/1,總計,金門縣,40250,137837,68909,68928
2018/6/1,總計,連江縣,2986,13044,7455,5589
2018/6/1,新北市,板橋區,209822,552451,269540,282911
2018/6/1,新北市,三重區,151271,386144,189835,196309
2018/6/1,新北市,中和區,165494,412754,200481,212273
2018/6/1,新北市,永和區,91011,222001,105381,116620
2018/6/1,新北市,新莊區,154560,417185,203544,213641
2018/6/1,新北市,新店區,127006,301880,145065,156815
2018/6/1,新北市,樹林區,66531,183622,91483,92139
2018/6/1,新北市,鶯歌區,30051,86272,43235,43037
2018/6/1,新北市,三峽區,43006,115530,57882,57648
2018/6/1,新北市,淡水區,75867,171339,82111,89228
2018/6/1,新北市,汐止區,87323,199638,97315,102323
2018/6/1,新北市,瑞芳區,16193,40151,20267,19884
2018/6/1,新北市,土城區,87084,237316,116999,120317
2018/6/1,新北市,蘆洲區,71317,201021,98722,102299
2018/6/1,新北市,五股區,31987,85559,43143,42416
2018/6/1,新北市,泰山區,28530,78812,39040,39772
2018/6/1,新北市,林口區,42885,107734,52428,55306
2018/6/1,新北市,深坑區,9616,23663,11848,11815
2018/6/1,新北市,石碇區,3379,7690,4220,3470
2018/6/1,新北市,坪林區,2518,6539,3603,2936
2018/6/1,新北市,三芝區,9506,23084,11885,11199
2018/6/1,新北市,石門區,4314,12176,6307,5869
2018/6/1,新北市,八里區,14754,38610,19289,19321
2018/6/1,新北市,平溪區,2307,4707,2598,2109
2018/6/1,新北市,雙溪區,3808,8889,4806,4083
2018/6/1,新北市,貢寮區,4381,12413,6326,6087
2018/6/1,新北市,金山區,7124,21851,10788,11063
2018/6/1,新北市,萬里區,7493,22151,11130,11021
2018/6/1,新北市,烏來區,1879,6338,3112,3226
2018/6/1,臺北市,松山區,81067,206563,96902,109661
2018/6/1,臺北市,信義區,89477,224297,106994,117303
2018/6/1,臺北市,大安區,121092,309543,144472,165071
2018/6/1,臺北市,中山區,100321,229856,106859,122997
2018/6/1,臺北市,中正區,65487,159752,76174,83578
2018/6/1,臺北市,大同區,51891,128578,62674,65904
2018/6/1,臺北市,萬華區,78667,190543,93512,97031
2018/6/1,臺北市,文山區,105883,274129,131462,142667
2018/6/1,臺北市,南港區,47166,121858,59513,62345
2018/6/1,臺北市,內湖區,108393,287437,137276,150161
2018/6/1,臺北市,士林區,107354,287545,138703,148842
2018/6/1,臺北市,北投區,96943,255612,123003,132609
2018/6/1,桃園市,桃園區,167470,444078,215497,228581
2018/6/1,桃園市,中壢區,151324,408883,201320,207563
2018/6/1,桃園市,大溪區,32594,94741,48266,46475
2018/6/1,桃園市,楊梅區,58756,169059,85111,83948
2018/6/1,桃園市,蘆竹區,58810,163232,81031,82201
2018/6/1,桃園市,大園區,33110,89845,45921,43924
2018/6/1,桃園市,龜山區,62043,159087,79222,79865
2018/6/1,桃園市,八德區,71278,200114,100103,100011
2018/6/1,桃園市,龍潭區,42121,122649,61407,61242
2018/6/1,桃園市,平鎮區,77607,225230,111872,113358
2018/6/1,桃園市,新屋區,16454,49162,26132,23030
2018/6/1,桃園市,觀音區,23000,66821,34755,32066
2018/6/1,桃園市,復興區,3824,11923,6449,5474
2018/6/1,臺中市,中區,7956,18562,9205,9357
2018/6/1,臺中市,東區,28127,76067,37852,38215
2018/6/1,臺中市,南區,48627,125422,60228,65194
2018/6/1,臺中市,西區,45724,115599,54874,60725
2018/6/1,臺中市,北區,59524,147662,70637,77025
2018/6/1,臺中市,西屯區,86370,227756,109262,118494
2018/6/1,臺中市,南屯區,62665,169580,81047,88533
2018/6/1,臺中市,北屯區,101181,276725,132627,144098
2018/6/1,臺中市,豐原區,54012,167047,82459,84588
2018/6/1,臺中市,東勢區,17432,50477,25891,24586
2018/6/1,臺中市,大甲區,23185,77734,39079,38655
2018/6/1,臺中市,清水區,27453,86544,44410,42134
2018/6/1,臺中市,沙鹿區,29822,93225,47035,46190
2018/6/1,臺中市,梧棲區,17907,58145,29104,29041
2018/6/1,臺中市,后里區,16358,54613,27714,26899
2018/6/1,臺中市,神岡區,19555,65649,33461,32188
2018/6/1,臺中市,潭子區,36508,108548,53624,54924
2018/6/1,臺中市,大雅區,29837,95571,47650,47921
2018/6/1,臺中市,新社區,7573,24619,12779,11840
2018/6/1,臺中市,石岡區,4900,15000,7761,7239
2018/6/1,臺中市,外埔區,9791,32153,16455,15698
2018/6/1,臺中市,大安區,5522,19275,10159,9116
2018/6/1,臺中市,烏日區,24888,74977,37588,37389
2018/6/1,臺中市,大肚區,17774,57383,29299,28084
2018/6/1,臺中市,龍井區,23260,77891,39178,38713
2018/6/1,臺中市,霧峰區,20383,65599,33200,32399
2018/6/1,臺中市,太平區,64569,190264,94304,95960
2018/6/1,臺中市,大里區,69928,211749,103953,107796
2018/6/1,臺中市,和平區,4624,11097,5955,5142
2018/6/1,臺南市,新營區,29016,77858,38535,39323
2018/6/1,臺南市,鹽水區,10010,25487,13300,12187
2018/6/1,臺南市,白河區,10799,28294,14791,13503
2018/6/1,臺南市,柳營區,7921,21271,11104,10167
2018/6/1,臺南市,後壁區,8838,23532,12230,11302
2018/6/1,臺南市,東山區,8345,20942,11116,9826
2018/6/1,臺南市,麻豆區,15815,44440,22581,21859
2018/6/1,臺南市,下營區,9064,24056,12402,11654
2018/6/1,臺南市,六甲區,7803,22260,11514,10746
2018/6/1,臺南市,官田區,7929,21322,10877,10445
2018/6/1,臺南市,大內區,3858,9688,5236,4452
2018/6/1,臺南市,佳里區,20739,59317,29415,29902
2018/6/1,臺南市,學甲區,9611,25828,13202,12626
2018/6/1,臺南市,西港區,8245,24747,12490,12257
2018/6/1,臺南市,七股區,8025,22892,11852,11040
2018/6/1,臺南市,將軍區,7285,19715,10060,9655
2018/6/1,臺南市,北門區,4231,11146,5627,5519
2018/6/1,臺南市,新化區,14459,43606,22204,21402
2018/6/1,臺南市,善化區,17841,48656,24456,24200
2018/6/1,臺南市,新市區,12466,36757,18392,18365
2018/6/1,臺南市,安定區,10150,30544,15712,14832
2018/6/1,臺南市,山上區,2721,7325,3820,3505
2018/6/1,臺南市,玉井區,5155,14097,7294,6803
2018/6/1,臺南市,楠西區,3512,9638,5099,4539
2018/6/1,臺南市,南化區,2862,8761,4720,4041
2018/6/1,臺南市,左鎮區,1965,4829,2703,2126
2018/6/1,臺南市,仁德區,27718,75520,38189,37331
2018/6/1,臺南市,歸仁區,22831,68464,34699,33765
2018/6/1,臺南市,關廟區,11175,34411,17751,16660
2018/6/1,臺南市,龍崎區,1535,4003,2153,1850
2018/6/1,臺南市,永康區,84650,234313,115408,118905
2018/6/1,臺南市,東區,71963,186563,89381,97182
2018/6/1,臺南市,南區,45853,125034,61882,63152
2018/6/1,臺南市,北區,50956,132144,64220,67924
2018/6/1,臺南市,安南區,63319,192759,97182,95577
2018/6/1,臺南市,安平區,25792,66653,31683,34970
2018/6/1,臺南市,中西區,31416,77845,37621,40224
2018/6/1,高雄市,鹽埕區,10779,24199,11988,12211
2018/6/1,高雄市,鼓山區,58452,139693,67327,72366
2018/6/1,高雄市,左營區,79012,196753,94551,102202
2018/6/1,高雄市,楠梓區,71133,184479,90516,93963
2018/6/1,高雄市,三民區,136912,341985,165341,176644
2018/6/1,高雄市,新興區,22883,51058,24539,26519
2018/6/1,高雄市,前金區,12617,26859,12801,14058
2018/6/1,高雄市,苓雅區,72165,170348,81899,88449
2018/6/1,高雄市,前鎮區,78754,188967,92840,96127
2018/6/1,高雄市,旗津區,11105,28617,14749,13868
2018/6/1,高雄市,小港區,68287,157482,78179,79303
2018/6/1,高雄市,鳳山區,141294,359140,175979,183161
2018/6/1,高雄市,林園區,26047,69987,35338,34649
2018/6/1,高雄市,大寮區,42369,112369,57444,54925
2018/6/1,高雄市,大樹區,13639,42637,21841,20796
2018/6/1,高雄市,大社區,13124,34651,17557,17094
2018/6/1,高雄市,仁武區,33599,86727,44005,42722
2018/6/1,高雄市,鳥松區,18391,44279,22402,21877
2018/6/1,高雄市,岡山區,34969,97145,48179,48966
2018/6/1,高雄市,橋頭區,13707,37619,19070,18549
2018/6/1,高雄市,燕巢區,10580,29807,15689,14118
2018/6/1,高雄市,田寮區,3259,7217,3985,3232
2018/6/1,高雄市,阿蓮區,9417,28736,14509,14227
2018/6/1,高雄市,路竹區,17085,52605,26848,25757
2018/6/1,高雄市,湖內區,10935,29835,15237,14598
2018/6/1,高雄市,茄萣區,10531,30082,15480,14602
2018/6/1,高雄市,永安區,5745,13922,7004,6918
2018/6/1,高雄市,彌陀區,6775,19304,9905,9399
2018/6/1,高雄市,梓官區,12638,35888,18477,17411
2018/6/1,高雄市,旗山區,13737,36814,19023,17791
2018/6/1,高雄市,美濃區,14770,39759,20854,18905
2018/6/1,高雄市,六龜區,5562,13008,7013,5995
2018/6/1,高雄市,甲仙區,2310,6083,3239,2844
2018/6/1,高雄市,杉林區,4805,11892,6499,5393
2018/6/1,高雄市,內門區,5132,14535,7860,6675
2018/6/1,高雄市,茂林區,598,1993,1003,990
2018/6/1,高雄市,桃源區,1358,4317,2271,2046
2018/6/1,高雄市,那瑪夏區,843,3141,1614,1527
2018/6/1,宜蘭縣,宜蘭市,36448,95938,46744,49194
2018/6/1,宜蘭縣,羅東鎮,26453,72490,34328,38162
2018/6/1,宜蘭縣,蘇澳鎮,14223,39944,20351,19593
2018/6/1,宜蘭縣,頭城鎮,10247,29207,15058,14149
2018/6/1,宜蘭縣,礁溪鄉,14107,35630,18523,17107
2018/6/1,宜蘭縣,壯圍鄉,8888,24283,12856,11427
2018/6/1,宜蘭縣,員山鄉,11718,32297,17125,15172
2018/6/1,宜蘭縣,冬山鄉,19340,52943,27152,25791
2018/6/1,宜蘭縣,五結鄉,15028,39591,20432,19159
2018/6/1,宜蘭縣,三星鄉,8622,21437,11532,9905
2018/6/1,宜蘭縣,大同鄉,1915,6224,3326,2898
2018/6/1,宜蘭縣,南澳鄉,1970,6022,3118,2904
2018/6/1,新竹縣,竹北市,66971,184586,91891,92695
2018/6/1,新竹縣,關西鎮,9403,28788,15394,13394
2018/6/1,新竹縣,新埔鎮,10729,33211,17736,15475
2018/6/1,新竹縣,竹東鎮,33996,96458,48425,48033
2018/6/1,新竹縣,湖口鄉,26788,77584,39279,38305
2018/6/1,新竹縣,橫山鄉,4435,13010,7053,5957
2018/6/1,新竹縣,新豐鄉,18655,56764,29128,27636
2018/6/1,新竹縣,芎林鄉,6545,20072,10634,9438
2018/6/1,新竹縣,寶山鄉,5610,14678,7924,6754
2018/6/1,新竹縣,北埔鄉,3118,9365,5093,4272
2018/6/1,新竹縣,峨眉鄉,2085,5608,3074,2534
2018/6/1,新竹縣,尖石鄉,2895,9638,5067,4571
2018/6/1,新竹縣,五峰鄉,1763,4779,2558,2221
2018/6/1,苗栗縣,苗栗市,31403,88459,44184,44275
2018/6/1,苗栗縣,頭份市,34992,102964,51991,50973
2018/6/1,苗栗縣,苑裡鎮,14691,45587,23756,21831
2018/6/1,苗栗縣,通霄鎮,11580,34299,18134,16165
2018/6/1,苗栗縣,竹南鎮,29580,85847,43341,42506
2018/6/1,苗栗縣,後龍鎮,11955,36501,19330,17171
2018/6/1,苗栗縣,卓蘭鎮,6020,16893,8856,8037
2018/6/1,苗栗縣,大湖鄉,5399,14603,7742,6861
2018/6/1,苗栗縣,公館鄉,10729,33480,17488,15992
2018/6/1,苗栗縣,銅鑼鄉,6151,18029,9599,8430
2018/6/1,苗栗縣,南庄鄉,3939,10142,5562,4580
2018/6/1,苗栗縣,頭屋鄉,3651,10815,5738,5077
2018/6/1,苗栗縣,三義鄉,5563,16365,8635,7730
2018/6/1,苗栗縣,西湖鄉,2639,7102,3966,3136
2018/6/1,苗栗縣,造橋鄉,4129,12817,6756,6061
2018/6/1,苗栗縣,三灣鄉,2404,6719,3674,3045
2018/6/1,苗栗縣,獅潭鄉,1712,4386,2450,1936
2018/6/1,苗栗縣,泰安鄉,1985,6074,3232,2842
2018/6/1,彰化縣,彰化市,76523,232861,115018,117843
2018/6/1,彰化縣,員林市,39474,124618,61968,62650
2018/6/1,彰化縣,鹿港鎮,24586,86736,44060,42676
2018/6/1,彰化縣,和美鎮,26799,90776,46139,44637
2018/6/1,彰化縣,北斗鎮,10721,33278,16761,16517
2018/6/1,彰化縣,溪湖鎮,16404,55515,28124,27391
2018/6/1,彰化縣,田中鎮,13180,41739,21509,20230
2018/6/1,彰化縣,二林鎮,15071,50806,26128,24678
2018/6/1,彰化縣,線西鄉,4420,16910,8664,8246
2018/6/1,彰化縣,伸港鄉,10053,36994,18882,18112
2018/6/1,彰化縣,福興鄉,12890,47197,24615,22582
2018/6/1,彰化縣,秀水鄉,10812,39242,20251,18991
2018/6/1,彰化縣,花壇鄉,14129,45867,23536,22331
2018/6/1,彰化縣,芬園鄉,6844,23626,12416,11210
2018/6/1,彰化縣,大村鄉,11174,36850,19041,17809
2018/6/1,彰化縣,埔鹽鄉,9106,32544,17111,15433
2018/6/1,彰化縣,埔心鄉,10629,34734,17881,16853
2018/6/1,彰化縣,永靖鄉,10926,37158,19226,17932
2018/6/1,彰化縣,社頭鄉,12948,43006,22109,20897
2018/6/1,彰化縣,二水鄉,5295,15236,7975,7261
2018/6/1,彰化縣,田尾鄉,8000,27469,14147,13322
2018/6/1,彰化縣,埤頭鄉,9090,30578,15820,14758
2018/6/1,彰化縣,芳苑鄉,10129,33594,17741,15853
2018/6/1,彰化縣,大城鄉,5242,16862,9085,7777
2018/6/1,彰化縣,竹塘鄉,4614,15207,7989,7218
2018/6/1,彰化縣,溪州鄉,8983,29873,15604,14269
2018/6/1,南投縣,南投市,34838,99781,49935,49846
2018/6/1,南投縣,埔里鎮,28971,80688,40191,40497
2018/6/1,南投縣,草屯鎮,33252,97477,49308,48169
2018/6/1,南投縣,竹山鎮,20133,54880,28117,26763
2018/6/1,南投縣,集集鎮,4312,10910,5676,5234
2018/6/1,南投縣,名間鄉,12619,38484,20293,18191
2018/6/1,南投縣,鹿谷鄉,8031,17761,9467,8294
2018/6/1,南投縣,中寮鄉,5637,14792,8030,6762
2018/6/1,南投縣,魚池鄉,5762,15868,8378,7490
2018/6/1,南投縣,國姓鄉,7303,18745,10107,8638
2018/6/1,南投縣,水里鄉,7122,17663,9272,8391
2018/6/1,南投縣,信義鄉,5279,16254,8715,7539
2018/6/1,南投縣,仁愛鄉,4896,15891,8196,7695
2018/6/1,雲林縣,斗六市,38390,108566,53931,54635
2018/6/1,雲林縣,斗南鎮,15876,44775,22740,22035
2018/6/1,雲林縣,虎尾鎮,25088,70874,35889,34985
2018/6/1,雲林縣,西螺鎮,14758,46175,23338,22837
2018/6/1,雲林縣,土庫鎮,9408,28873,15063,13810
2018/6/1,雲林縣,北港鎮,16019,40141,20718,19423
2018/6/1,雲林縣,古坑鄉,11008,31597,16646,14951
2018/6/1,雲林縣,大埤鄉,6646,19126,10264,8862
2018/6/1,雲林縣,莿桐鄉,9371,28796,15079,13717
2018/6/1,雲林縣,林內鄉,6026,18263,9579,8684
2018/6/1,雲林縣,二崙鄉,8944,27092,14490,12602
2018/6/1,雲林縣,崙背鄉,8510,24543,12958,11585
2018/6/1,雲林縣,麥寮鄉,14433,45675,22912,22763
2018/6/1,雲林縣,東勢鄉,5752,14928,8261,6667
2018/6/1,雲林縣,褒忠鄉,4431,13031,6996,6035
2018/6/1,雲林縣,臺西鄉,8664,23933,12823,11110
2018/6/1,雲林縣,元長鄉,9257,25851,14141,11710
2018/6/1,雲林縣,四湖鄉,8748,23453,12711,10742
2018/6/1,雲林縣,口湖鄉,9436,27499,14651,12848
2018/6/1,雲林縣,水林鄉,9869,25526,13913,11613
2018/6/1,嘉義縣,太保市,13117,37963,19475,18488
2018/6/1,嘉義縣,朴子市,15705,42252,21321,20931
2018/6/1,嘉義縣,布袋鎮,9921,26982,13767,13215
2018/6/1,嘉義縣,大林鎮,11382,31001,15876,15125
2018/6/1,嘉義縣,民雄鄉,25011,71463,36587,34876
2018/6/1,嘉義縣,溪口鄉,5318,14707,7874,6833
2018/6/1,嘉義縣,新港鄉,10666,31842,16754,15088
2018/6/1,嘉義縣,六腳鄉,8843,23169,12292,10877
2018/6/1,嘉義縣,東石鄉,9199,24793,13122,11671
2018/6/1,嘉義縣,義竹鄉,7378,18377,9556,8821
2018/6/1,嘉義縣,鹿草鄉,5753,15515,8315,7200
2018/6/1,嘉義縣,水上鄉,18114,49520,25577,23943
2018/6/1,嘉義縣,中埔鄉,15991,44721,23270,21451
2018/6/1,嘉義縣,竹崎鄉,11673,35781,19047,16734
2018/6/1,嘉義縣,梅山鄉,6768,19383,10299,9084
2018/6/1,嘉義縣,番路鄉,4245,11523,6219,5304
2018/6/1,嘉義縣,大埔鄉,1917,4571,2358,2213
2018/6/1,嘉義縣,阿里山鄉,1904,5598,2943,2655
2018/6/1,屏東縣,屏東市,74437,200124,98835,101289
2018/6/1,屏東縣,潮州鎮,19456,54024,26985,27039
2018/6/1,屏東縣,東港鎮,16757,47800,24150,23650
2018/6/1,屏東縣,恆春鎮,11624,30780,15802,14978
2018/6/1,屏東縣,萬丹鄉,15033,50739,26341,24398
2018/6/1,屏東縣,長治鄉,10161,29806,15534,14272
2018/6/1,屏東縣,麟洛鄉,3827,11090,5737,5353
2018/6/1,屏東縣,九如鄉,7047,22133,11434,10699
2018/6/1,屏東縣,里港鄉,8212,26280,13368,12912
2018/6/1,屏東縣,鹽埔鄉,7862,25817,13428,12389
2018/6/1,屏東縣,高樹鄉,9267,24487,13059,11428
2018/6/1,屏東縣,萬巒鄉,6517,20580,10736,9844
2018/6/1,屏東縣,內埔鄉,18671,54382,28081,26301
2018/6/1,屏東縣,竹田鄉,5654,17181,9137,8044
2018/6/1,屏東縣,新埤鄉,3459,10090,5350,4740
2018/6/1,屏東縣,枋寮鄉,8539,24486,12797,11689
2018/6/1,屏東縣,新園鄉,11807,35068,18166,16902
2018/6/1,屏東縣,崁頂鄉,4490,15556,7882,7674
2018/6/1,屏東縣,林邊鄉,6705,17908,9167,8741
2018/6/1,屏東縣,南州鄉,3710,10645,5442,5203
2018/6/1,屏東縣,佳冬鄉,6963,19228,9999,9229
2018/6/1,屏東縣,琉球鄉,4506,12372,6776,5596
2018/6/1,屏東縣,車城鄉,3484,8681,4654,4027
2018/6/1,屏東縣,滿州鄉,3047,8013,4336,3677
2018/6/1,屏東縣,枋山鄉,2103,5520,2936,2584
2018/6/1,屏東縣,三地門鄉,2329,7673,3858,3815
2018/6/1,屏東縣,霧臺鄉,1061,3346,1713,1633
2018/6/1,屏東縣,瑪家鄉,2062,6798,3445,3353
2018/6/1,屏東縣,泰武鄉,1353,5389,2826,2563
2018/6/1,屏東縣,來義鄉,2234,7428,3744,3684
2018/6/1,屏東縣,春日鄉,1409,4894,2514,2380
2018/6/1,屏東縣,獅子鄉,1572,4960,2550,2410
2018/6/1,屏東縣,牡丹鄉,1936,4997,2543,2454
2018/6/1,臺東縣,臺東市,39717,105734,52895,52839
2018/6/1,臺東縣,成功鎮,5376,14201,7455,6746
2018/6/1,臺東縣,關山鎮,3171,8739,4538,4201
2018/6/1,臺東縣,卑南鄉,6712,17334,9140,8194
2018/6/1,臺東縣,大武鄉,2497,6118,3180,2938
2018/6/1,臺東縣,太麻里鄉,4725,11187,5960,5227
2018/6/1,臺東縣,東河鄉,3762,8529,4729,3800
2018/6/1,臺東縣,長濱鄉,2920,7252,4117,3135
2018/6/1,臺東縣,鹿野鄉,3047,7917,4198,3719
2018/6/1,臺東縣,池上鄉,3206,8232,4292,3940
2018/6/1,臺東縣,綠島鄉,1152,4112,2185,1927
2018/6/1,臺東縣,延平鄉,1076,3659,1952,1707
2018/6/1,臺東縣,海端鄉,1091,4195,2233,1962
2018/6/1,臺東縣,達仁鄉,1454,3620,1962,1658
2018/6/1,臺東縣,金峰鄉,1136,3733,1893,1840
2018/6/1,臺東縣,蘭嶼鄉,1854,5081,2575,2506
2018/6/1,花蓮縣,花蓮市,41372,103871,50061,53810
2018/6/1,花蓮縣,鳳林鎮,4408,10910,5670,5240
2018/6/1,花蓮縣,玉里鎮,8870,24213,12798,11415
2018/6/1,花蓮縣,新城鄉,7704,20098,10320,9778
2018/6/1,花蓮縣,吉安鄉,32077,83442,41982,41460
2018/6/1,花蓮縣,壽豐鄉,7244,18044,9585,8459
2018/6/1,花蓮縣,光復鄉,5010,12867,6819,6048
2018/6/1,花蓮縣,豐濱鄉,1725,4760,2637,2123
2018/6/1,花蓮縣,瑞穗鄉,4764,11721,6320,5401
2018/6/1,花蓮縣,富里鄉,4044,10358,5616,4742
2018/6/1,花蓮縣,秀林鄉,4828,15902,8180,7722
2018/6/1,花蓮縣,萬榮鄉,2111,6459,3405,3054
2018/6/1,花蓮縣,卓溪鄉,1694,6104,3350,2754
2018/6/1,澎湖縣,馬公市,24405,62185,31619,30566
2018/6/1,澎湖縣,湖西鄉,5631,14474,7641,6833
2018/6/1,澎湖縣,白沙鄉,3415,9835,5145,4690
2018/6/1,澎湖縣,西嶼鄉,3030,8417,4339,4078
2018/6/1,澎湖縣,望安鄉,2025,5236,2833,2403
2018/6/1,澎湖縣,七美鄉,1377,3866,2002,1864
2018/6/1,基隆市,中正區,22622,51834,26451,25383
2018/6/1,基隆市,七堵區,21517,53909,27070,26839
2018/6/1,基隆市,暖暖區,15666,38631,19349,19282
2018/6/1,基隆市,仁愛區,19202,44194,21867,22327
2018/6/1,基隆市,中山區,19265,47628,24116,23512
2018/6/1,基隆市,安樂區,33503,82394,40775,41619
2018/6/1,基隆市,信義區,21416,52205,25800,26405
2018/6/1,新竹市,東區,80010,214339,105440,108899
2018/6/1,新竹市,北區,56906,150881,73635,77246
2018/6/1,新竹市,香山區,27367,78131,39647,38484
2018/6/1,嘉義市,東區,45528,121689,58549,63140
2018/6/1,嘉義市,西區,54209,147262,72114,75148
2018/6/1,金門縣,金城鎮,12939,43303,21609,21694
2018/6/1,金門縣,金湖鎮,8960,29491,14802,14689
2018/6/1,金門縣,金沙鎮,6335,20627,10217,10410
2018/6/1,金門縣,金寧鄉,8717,30917,15617,15300
2018/6/1,金門縣,烈嶼鄉,3165,12813,6317,6496
2018/6/1,金門縣,烏坵鄉,134,686,347,339
2018/6/1,連江縣,南竿鄉,1740,7652,4310,3342
2018/6/1,連江縣,北竿鄉,615,2404,1338,1066
2018/6/1,連江縣,莒光鄉,294,1638,1002,636
2018/6/1,連江縣,東引鄉,337,1350,805,545
2018/7/1,總計,新北市,1553182,3988906,1952867,2036039
2018/7/1,總計,臺北市,1053885,2674063,1276592,1397471
2018/7/1,總計,桃園市,800115,2208035,1098469,1109566
2018/7/1,總計,臺中市,966775,2796081,1377139,1418942
2018/7/1,總計,臺南市,686530,1884596,940721,943875
2018/7/1,總計,高雄市,1096071,2773506,1372742,1400764
2018/7/1,總計,臺灣省,2494857,7100490,3618280,3482210
2018/7/1,總計,宜蘭縣,169005,455924,230479,225445
2018/7/1,總計,新竹縣,193367,555074,283556,271518
2018/7/1,總計,苗栗縣,188601,550825,284299,266526
2018/7/1,總計,彰化縣,388300,1278945,651546,627399
2018/7/1,總計,南投縣,178167,498851,255490,243361
2018/7/1,總計,雲林縣,240798,688559,356996,331563
2018/7/1,總計,嘉義縣,182922,508729,264426,244303
2018/7/1,總計,屏東縣,287415,828083,423148,404935
2018/7/1,總計,臺東縣,82878,219584,113262,106322
2018/7/1,總計,花蓮縣,125906,328709,166706,162003
2018/7/1,總計,澎湖縣,39911,104041,53572,50469
2018/7/1,總計,基隆市,153283,370612,185319,185293
2018/7/1,總計,新竹市,164473,443581,218854,224727
2018/7/1,總計,嘉義市,99831,268973,130627,138346
2018/7/1,總計,福建省,43335,151028,76421,74607
2018/7/1,總計,金門縣,40328,137952,68938,69014
2018/7/1,總計,連江縣,3007,13076,7483,5593
2018/7/1,新北市,板橋區,210578,552954,269780,283174
2018/7/1,新北市,三重區,151385,386260,189878,196382
2018/7/1,新北市,中和區,165576,412765,200453,212312
2018/7/1,新北市,永和區,91026,221693,105222,116471
2018/7/1,新北市,新莊區,154739,417199,203553,213646
2018/7/1,新北市,新店區,127118,301983,145095,156888
2018/7/1,新北市,樹林區,66569,183669,91524,92145
2018/7/1,新北市,鶯歌區,30092,86218,43192,43026
2018/7/1,新北市,三峽區,43023,115630,57915,57715
2018/7/1,新北市,淡水區,76122,171738,82290,89448
2018/7/1,新北市,汐止區,87396,199736,97340,102396
2018/7/1,新北市,瑞芳區,16188,40095,20233,19862
2018/7/1,新北市,土城區,87111,237223,116948,120275
2018/7/1,新北市,蘆洲區,71379,201044,98728,102316
2018/7/1,新北市,五股區,32106,85772,43237,42535
2018/7/1,新北市,泰山區,28566,78791,39016,39775
2018/7/1,新北市,林口區,43119,108064,52580,55484
2018/7/1,新北市,深坑區,9601,23600,11826,11774
2018/7/1,新北市,石碇區,3383,7702,4225,3477
2018/7/1,新北市,坪林區,2518,6535,3596,2939
2018/7/1,新北市,三芝區,9515,23072,11884,11188
2018/7/1,新北市,石門區,4317,12185,6305,5880
2018/7/1,新北市,八里區,14776,38662,19308,19354
2018/7/1,新北市,平溪區,2305,4705,2595,2110
2018/7/1,新北市,雙溪區,3804,8881,4801,4080
2018/7/1,新北市,貢寮區,4371,12392,6315,6077
2018/7/1,新北市,金山區,7134,21856,10791,11065
2018/7/1,新北市,萬里區,7481,22121,11114,11007
2018/7/1,新北市,烏來區,1884,6361,3123,3238
2018/7/1,臺北市,松山區,81045,206330,96791,109539
2018/7/1,臺北市,信義區,89510,224199,106946,117253
2018/7/1,臺北市,大安區,121067,309198,144249,164949
2018/7/1,臺北市,中山區,100341,229893,106855,123038
2018/7/1,臺北市,中正區,65464,159557,76090,83467
2018/7/1,臺北市,大同區,51830,128258,62527,65731
2018/7/1,臺北市,萬華區,78679,190443,93448,96995
2018/7/1,臺北市,文山區,105948,274032,131379,142653
2018/7/1,臺北市,南港區,47223,121880,59510,62370
2018/7/1,臺北市,內湖區,108395,287346,137238,150108
2018/7/1,臺北市,士林區,107376,287214,138493,148721
2018/7/1,臺北市,北投區,97007,255713,123066,132647
2018/7/1,桃園市,桃園區,167763,444620,215794,228826
2018/7/1,桃園市,中壢區,151757,409569,201594,207975
2018/7/1,桃園市,大溪區,32628,94822,48301,46521
2018/7/1,桃園市,楊梅區,58891,169379,85247,84132
2018/7/1,桃園市,蘆竹區,58937,163501,81147,82354
2018/7/1,桃園市,大園區,33204,89999,45968,44031
2018/7/1,桃園市,龜山區,62200,159477,79367,80110
2018/7/1,桃園市,八德區,71490,200485,100249,100236
2018/7/1,桃園市,龍潭區,42183,122744,61442,61302
2018/7/1,桃園市,平鎮區,77723,225403,111941,113462
2018/7/1,桃園市,新屋區,16476,49140,26138,23002
2018/7/1,桃園市,觀音區,23034,66922,34809,32113
2018/7/1,桃園市,復興區,3829,11974,6472,5502
2018/7/1,臺中市,中區,7956,18526,9183,9343
2018/7/1,臺中市,東區,28161,76060,37836,38224
2018/7/1,臺中市,南區,48730,125501,60240,65261
2018/7/1,臺中市,西區,45754,115588,54837,60751
2018/7/1,臺中市,北區,59584,147687,70625,77062
2018/7/1,臺中市,西屯區,86473,227880,109283,118597
2018/7/1,臺中市,南屯區,62782,169707,81115,88592
2018/7/1,臺中市,北屯區,101386,277151,132824,144327
2018/7/1,臺中市,豐原區,54051,167010,82438,84572
2018/7/1,臺中市,東勢區,17428,50455,25875,24580
2018/7/1,臺中市,大甲區,23219,77712,39059,38653
2018/7/1,臺中市,清水區,27499,86579,44410,42169
2018/7/1,臺中市,沙鹿區,29870,93321,47082,46239
2018/7/1,臺中市,梧棲區,17932,58165,29117,29048
2018/7/1,臺中市,后里區,16377,54653,27724,26929
2018/7/1,臺中市,神岡區,19569,65613,33440,32173
2018/7/1,臺中市,潭子區,36576,108670,53686,54984
2018/7/1,臺中市,大雅區,29873,95558,47646,47912
2018/7/1,臺中市,新社區,7582,24608,12780,11828
2018/7/1,臺中市,石岡區,4901,14983,7753,7230
2018/7/1,臺中市,外埔區,9797,32166,16456,15710
2018/7/1,臺中市,大安區,5533,19276,10153,9123
2018/7/1,臺中市,烏日區,24941,75066,37622,37444
2018/7/1,臺中市,大肚區,17785,57331,29270,28061
2018/7/1,臺中市,龍井區,23305,77923,39201,38722
2018/7/1,臺中市,霧峰區,20389,65567,33179,32388
2018/7/1,臺中市,太平區,64709,190463,94401,96062
2018/7/1,臺中市,大里區,69992,211757,103956,107801
2018/7/1,臺中市,和平區,4621,11105,5948,5157
2018/7/1,臺南市,新營區,29034,77792,38492,39300
2018/7/1,臺南市,鹽水區,10025,25515,13320,12195
2018/7/1,臺南市,白河區,10803,28246,14756,13490
2018/7/1,臺南市,柳營區,7923,21260,11097,10163
2018/7/1,臺南市,後壁區,8827,23495,12206,11289
2018/7/1,臺南市,東山區,8348,20932,11119,9813
2018/7/1,臺南市,麻豆區,15812,44420,22566,21854
2018/7/1,臺南市,下營區,9075,24033,12399,11634
2018/7/1,臺南市,六甲區,7803,22254,11516,10738
2018/7/1,臺南市,官田區,7927,21339,10879,10460
2018/7/1,臺南市,大內區,3850,9668,5223,4445
2018/7/1,臺南市,佳里區,20745,59230,29369,29861
2018/7/1,臺南市,學甲區,9613,25801,13192,12609
2018/7/1,臺南市,西港區,8251,24745,12482,12263
2018/7/1,臺南市,七股區,8029,22882,11851,11031
2018/7/1,臺南市,將軍區,7273,19703,10058,9645
2018/7/1,臺南市,北門區,4228,11141,5622,5519
2018/7/1,臺南市,新化區,14463,43582,22184,21398
2018/7/1,臺南市,善化區,17884,48702,24485,24217
2018/7/1,臺南市,新市區,12481,36770,18396,18374
2018/7/1,臺南市,安定區,10166,30586,15731,14855
2018/7/1,臺南市,山上區,2725,7318,3813,3505
2018/7/1,臺南市,玉井區,5157,14089,7287,6802
2018/7/1,臺南市,楠西區,3514,9627,5093,4534
2018/7/1,臺南市,南化區,2861,8765,4732,4033
2018/7/1,臺南市,左鎮區,1960,4825,2707,2118
2018/7/1,臺南市,仁德區,27744,75615,38236,37379
2018/7/1,臺南市,歸仁區,22843,68463,34695,33768
2018/7/1,臺南市,關廟區,11191,34419,17750,16669
2018/7/1,臺南市,龍崎區,1536,4006,2154,1852
2018/7/1,臺南市,永康區,84796,234449,115483,118966
2018/7/1,臺南市,東區,72000,186396,89265,97131
2018/7/1,臺南市,南區,45902,125004,61836,63168
2018/7/1,臺南市,北區,50986,132042,64163,67879
2018/7/1,臺南市,安南區,63450,192887,97223,95664
2018/7/1,臺南市,安平區,25828,66613,31643,34970
2018/7/1,臺南市,中西區,31477,77982,37698,40284
2018/7/1,高雄市,鹽埕區,10786,24178,11986,12192
2018/7/1,高雄市,鼓山區,58492,139756,67357,72399
2018/7/1,高雄市,左營區,79079,196712,94522,102190
2018/7/1,高雄市,楠梓區,71351,184735,90625,94110
2018/7/1,高雄市,三民區,136910,341713,165210,176503
2018/7/1,高雄市,新興區,22898,51070,24551,26519
2018/7/1,高雄市,前金區,12606,26801,12768,14033
2018/7/1,高雄市,苓雅區,72202,170227,81826,88401
2018/7/1,高雄市,前鎮區,78744,188835,92758,96077
2018/7/1,高雄市,旗津區,11103,28569,14713,13856
2018/7/1,高雄市,小港區,68357,157533,78206,79327
2018/7/1,高雄市,鳳山區,141387,359122,175919,183203
2018/7/1,高雄市,林園區,26049,69942,35324,34618
2018/7/1,高雄市,大寮區,42387,112339,57425,54914
2018/7/1,高雄市,大樹區,13633,42586,21818,20768
2018/7/1,高雄市,大社區,13125,34641,17566,17075
2018/7/1,高雄市,仁武區,33697,86902,44057,42845
2018/7/1,高雄市,鳥松區,18424,44284,22414,21870
2018/7/1,高雄市,岡山區,35007,97084,48153,48931
2018/7/1,高雄市,橋頭區,13712,37614,19064,18550
2018/7/1,高雄市,燕巢區,10593,29803,15685,14118
2018/7/1,高雄市,田寮區,3256,7222,3986,3236
2018/7/1,高雄市,阿蓮區,9420,28718,14497,14221
2018/7/1,高雄市,路竹區,17091,52581,26829,25752
2018/7/1,高雄市,湖內區,10942,29818,15252,14566
2018/7/1,高雄市,茄萣區,10535,30077,15467,14610
2018/7/1,高雄市,永安區,5740,13927,7008,6919
2018/7/1,高雄市,彌陀區,6779,19294,9904,9390
2018/7/1,高雄市,梓官區,12660,35947,18512,17435
2018/7/1,高雄市,旗山區,13723,36785,19009,17776
2018/7/1,高雄市,美濃區,14774,39735,20838,18897
2018/7/1,高雄市,六龜區,5569,13010,7016,5994
2018/7/1,高雄市,甲仙區,2306,6088,3239,2849
2018/7/1,高雄市,杉林區,4803,11862,6482,5380
2018/7/1,高雄市,內門區,5133,14521,7853,6668
2018/7/1,高雄市,茂林區,598,2004,1006,998
2018/7/1,高雄市,桃源區,1357,4320,2279,2041
2018/7/1,高雄市,那瑪夏區,843,3151,1618,1533
2018/7/1,宜蘭縣,宜蘭市,36456,95905,46727,49178
2018/7/1,宜蘭縣,羅東鎮,26442,72483,34318,38165
2018/7/1,宜蘭縣,蘇澳鎮,14212,39921,20333,19588
2018/7/1,宜蘭縣,頭城鎮,10259,29187,15049,14138
2018/7/1,宜蘭縣,礁溪鄉,14120,35620,18516,17104
2018/7/1,宜蘭縣,壯圍鄉,8899,24299,12853,11446
2018/7/1,宜蘭縣,員山鄉,11710,32263,17106,15157
2018/7/1,宜蘭縣,冬山鄉,19342,52957,27172,25785
2018/7/1,宜蘭縣,五結鄉,15039,39574,20428,19146
2018/7/1,宜蘭縣,三星鄉,8634,21438,11524,9914
2018/7/1,宜蘭縣,大同鄉,1918,6230,3330,2900
2018/7/1,宜蘭縣,南澳鄉,1974,6047,3123,2924
2018/7/1,新竹縣,竹北市,67205,185028,92122,92906
2018/7/1,新竹縣,關西鎮,9409,28784,15405,13379
2018/7/1,新竹縣,新埔鎮,10728,33168,17703,15465
2018/7/1,新竹縣,竹東鎮,33999,96437,48412,48025
2018/7/1,新竹縣,湖口鄉,26824,77567,39285,38282
2018/7/1,新竹縣,橫山鄉,4440,13038,7062,5976
2018/7/1,新竹縣,新豐鄉,18701,56831,29152,27679
2018/7/1,新竹縣,芎林鄉,6545,20061,10624,9437
2018/7/1,新竹縣,寶山鄉,5640,14711,7963,6748
2018/7/1,新竹縣,北埔鄉,3121,9358,5087,4271
2018/7/1,新竹縣,峨眉鄉,2086,5645,3096,2549
2018/7/1,新竹縣,尖石鄉,2898,9648,5079,4569
2018/7/1,新竹縣,五峰鄉,1771,4798,2566,2232
2018/7/1,苗栗縣,苗栗市,31397,88415,44134,44281
2018/7/1,苗栗縣,頭份市,35024,102971,51979,50992
2018/7/1,苗栗縣,苑裡鎮,14685,45516,23713,21803
2018/7/1,苗栗縣,通霄鎮,11570,34276,18136,16140
2018/7/1,苗栗縣,竹南鎮,29635,85896,43389,42507
2018/7/1,苗栗縣,後龍鎮,11957,36457,19313,17144
2018/7/1,苗栗縣,卓蘭鎮,6023,16896,8852,8044
2018/7/1,苗栗縣,大湖鄉,5391,14564,7725,6839
2018/7/1,苗栗縣,公館鄉,10733,33444,17475,15969
2018/7/1,苗栗縣,銅鑼鄉,6155,18002,9588,8414
2018/7/1,苗栗縣,南庄鄉,3945,10156,5568,4588
2018/7/1,苗栗縣,頭屋鄉,3654,10792,5715,5077
2018/7/1,苗栗縣,三義鄉,5567,16345,8631,7714
2018/7/1,苗栗縣,西湖鄉,2637,7101,3965,3136
2018/7/1,苗栗縣,造橋鄉,4132,12806,6757,6049
2018/7/1,苗栗縣,三灣鄉,2404,6700,3668,3032
2018/7/1,苗栗縣,獅潭鄉,1711,4389,2450,1939
2018/7/1,苗栗縣,泰安鄉,1981,6099,3241,2858
2018/7/1,彰化縣,彰化市,76554,232772,114918,117854
2018/7/1,彰化縣,員林市,39519,124612,61954,62658
2018/7/1,彰化縣,鹿港鎮,24589,86732,44054,42678
2018/7/1,彰化縣,和美鎮,26826,90713,46116,44597
2018/7/1,彰化縣,北斗鎮,10733,33262,16755,16507
2018/7/1,彰化縣,溪湖鎮,16393,55441,28082,27359
2018/7/1,彰化縣,田中鎮,13179,41693,21492,20201
2018/7/1,彰化縣,二林鎮,15085,50772,26127,24645
2018/7/1,彰化縣,線西鄉,4427,16898,8659,8239
2018/7/1,彰化縣,伸港鄉,10067,36985,18878,18107
2018/7/1,彰化縣,福興鄉,12922,47211,24606,22605
2018/7/1,彰化縣,秀水鄉,10815,39271,20270,19001
2018/7/1,彰化縣,花壇鄉,14151,45907,23552,22355
2018/7/1,彰化縣,芬園鄉,6846,23634,12416,11218
2018/7/1,彰化縣,大村鄉,11181,36887,19048,17839
2018/7/1,彰化縣,埔鹽鄉,9119,32547,17107,15440
2018/7/1,彰化縣,埔心鄉,10629,34726,17885,16841
2018/7/1,彰化縣,永靖鄉,10929,37148,19227,17921
2018/7/1,彰化縣,社頭鄉,12952,43006,22099,20907
2018/7/1,彰化縣,二水鄉,5297,15240,7977,7263
2018/7/1,彰化縣,田尾鄉,7990,27415,14119,13296
2018/7/1,彰化縣,埤頭鄉,9107,30593,15824,14769
2018/7/1,彰化縣,芳苑鄉,10137,33583,17732,15851
2018/7/1,彰化縣,大城鄉,5239,16835,9076,7759
2018/7/1,彰化縣,竹塘鄉,4621,15195,7978,7217
2018/7/1,彰化縣,溪州鄉,8993,29867,15595,14272
2018/7/1,南投縣,南投市,34843,99645,49855,49790
2018/7/1,南投縣,埔里鎮,28966,80682,40176,40506
2018/7/1,南投縣,草屯鎮,33269,97387,49272,48115
2018/7/1,南投縣,竹山鎮,20134,54870,28118,26752
2018/7/1,南投縣,集集鎮,4310,10877,5664,5213
2018/7/1,南投縣,名間鄉,12618,38443,20277,18166
2018/7/1,南投縣,鹿谷鄉,8035,17746,9457,8289
2018/7/1,南投縣,中寮鄉,5640,14793,8029,6764
2018/7/1,南投縣,魚池鄉,5765,15857,8359,7498
2018/7/1,南投縣,國姓鄉,7302,18719,10083,8636
2018/7/1,南投縣,水里鄉,7112,17648,9265,8383
2018/7/1,南投縣,信義鄉,5281,16270,8720,7550
2018/7/1,南投縣,仁愛鄉,4892,15914,8215,7699
2018/7/1,雲林縣,斗六市,38435,108535,53919,54616
2018/7/1,雲林縣,斗南鎮,15879,44730,22713,22017
2018/7/1,雲林縣,虎尾鎮,25137,70928,35911,35017
2018/7/1,雲林縣,西螺鎮,14785,46153,23322,22831
2018/7/1,雲林縣,土庫鎮,9416,28872,15072,13800
2018/7/1,雲林縣,北港鎮,16037,40118,20716,19402
2018/7/1,雲林縣,古坑鄉,11009,31562,16632,14930
2018/7/1,雲林縣,大埤鄉,6653,19141,10268,8873
2018/7/1,雲林縣,莿桐鄉,9383,28786,15072,13714
2018/7/1,雲林縣,林內鄉,6025,18242,9565,8677
2018/7/1,雲林縣,二崙鄉,8938,27054,14464,12590
2018/7/1,雲林縣,崙背鄉,8510,24529,12948,11581
2018/7/1,雲林縣,麥寮鄉,14452,45721,22923,22798
2018/7/1,雲林縣,東勢鄉,5750,14921,8256,6665
2018/7/1,雲林縣,褒忠鄉,4434,13026,6994,6032
2018/7/1,雲林縣,臺西鄉,8672,23931,12827,11104
2018/7/1,雲林縣,元長鄉,9247,25840,14143,11697
2018/7/1,雲林縣,四湖鄉,8743,23432,12694,10738
2018/7/1,雲林縣,口湖鄉,9432,27491,14648,12843
2018/7/1,雲林縣,水林鄉,9861,25547,13909,11638
2018/7/1,嘉義縣,太保市,13144,37998,19489,18509
2018/7/1,嘉義縣,朴子市,15699,42176,21283,20893
2018/7/1,嘉義縣,布袋鎮,9922,26968,13761,13207
2018/7/1,嘉義縣,大林鎮,11379,30968,15866,15102
2018/7/1,嘉義縣,民雄鄉,25025,71373,36540,34833
2018/7/1,嘉義縣,溪口鄉,5315,14700,7871,6829
2018/7/1,嘉義縣,新港鄉,10671,31826,16745,15081
2018/7/1,嘉義縣,六腳鄉,8839,23157,12279,10878
2018/7/1,嘉義縣,東石鄉,9191,24755,13094,11661
2018/7/1,嘉義縣,義竹鄉,7364,18355,9543,8812
2018/7/1,嘉義縣,鹿草鄉,5753,15475,8295,7180
2018/7/1,嘉義縣,水上鄉,18120,49479,25573,23906
2018/7/1,嘉義縣,中埔鄉,15988,44691,23240,21451
2018/7/1,嘉義縣,竹崎鄉,11679,35737,19026,16711
2018/7/1,嘉義縣,梅山鄉,6766,19377,10300,9077
2018/7/1,嘉義縣,番路鄉,4240,11510,6212,5298
2018/7/1,嘉義縣,大埔鄉,1923,4582,2365,2217
2018/7/1,嘉義縣,阿里山鄉,1904,5602,2944,2658
2018/7/1,屏東縣,屏東市,74455,200024,98763,101261
2018/7/1,屏東縣,潮州鎮,19471,53969,26969,27000
2018/7/1,屏東縣,東港鎮,16766,47746,24127,23619
2018/7/1,屏東縣,恆春鎮,11634,30794,15807,14987
2018/7/1,屏東縣,萬丹鄉,15043,50695,26321,24374
2018/7/1,屏東縣,長治鄉,10162,29792,15533,14259
2018/7/1,屏東縣,麟洛鄉,3832,11115,5747,5368
2018/7/1,屏東縣,九如鄉,7044,22110,11425,10685
2018/7/1,屏東縣,里港鄉,8207,26241,13349,12892
2018/7/1,屏東縣,鹽埔鄉,7866,25796,13417,12379
2018/7/1,屏東縣,高樹鄉,9265,24475,13052,11423
2018/7/1,屏東縣,萬巒鄉,6531,20595,10738,9857
2018/7/1,屏東縣,內埔鄉,18671,54293,28035,26258
2018/7/1,屏東縣,竹田鄉,5662,17209,9137,8072
2018/7/1,屏東縣,新埤鄉,3458,10070,5344,4726
2018/7/1,屏東縣,枋寮鄉,8548,24486,12795,11691
2018/7/1,屏東縣,新園鄉,11804,35047,18155,16892
2018/7/1,屏東縣,崁頂鄉,4495,15544,7864,7680
2018/7/1,屏東縣,林邊鄉,6698,17889,9147,8742
2018/7/1,屏東縣,南州鄉,3714,10659,5447,5212
2018/7/1,屏東縣,佳冬鄉,6964,19211,9987,9224
2018/7/1,屏東縣,琉球鄉,4517,12399,6790,5609
2018/7/1,屏東縣,車城鄉,3480,8671,4646,4025
2018/7/1,屏東縣,滿州鄉,3057,8077,4363,3714
2018/7/1,屏東縣,枋山鄉,2107,5543,2948,2595
2018/7/1,屏東縣,三地門鄉,2330,7678,3852,3826
2018/7/1,屏東縣,霧臺鄉,1062,3383,1730,1653
2018/7/1,屏東縣,瑪家鄉,2061,6820,3450,3370
2018/7/1,屏東縣,泰武鄉,1355,5405,2832,2573
2018/7/1,屏東縣,來義鄉,2232,7441,3752,3689
2018/7/1,屏東縣,春日鄉,1409,4887,2506,2381
2018/7/1,屏東縣,獅子鄉,1577,5008,2572,2436
2018/7/1,屏東縣,牡丹鄉,1938,5011,2548,2463
2018/7/1,臺東縣,臺東市,39710,105656,52858,52798
2018/7/1,臺東縣,成功鎮,5374,14187,7448,6739
2018/7/1,臺東縣,關山鎮,3166,8748,4541,4207
2018/7/1,臺東縣,卑南鄉,6705,17322,9137,8185
2018/7/1,臺東縣,大武鄉,2493,6136,3183,2953
2018/7/1,臺東縣,太麻里鄉,4725,11192,5966,5226
2018/7/1,臺東縣,東河鄉,3754,8521,4718,3803
2018/7/1,臺東縣,長濱鄉,2923,7240,4118,3122
2018/7/1,臺東縣,鹿野鄉,3040,7909,4191,3718
2018/7/1,臺東縣,池上鄉,3213,8233,4287,3946
2018/7/1,臺東縣,綠島鄉,1156,4105,2184,1921
2018/7/1,臺東縣,延平鄉,1077,3668,1955,1713
2018/7/1,臺東縣,海端鄉,1092,4200,2236,1964
2018/7/1,臺東縣,達仁鄉,1451,3639,1975,1664
2018/7/1,臺東縣,金峰鄉,1142,3746,1892,1854
2018/7/1,臺東縣,蘭嶼鄉,1857,5082,2573,2509
2018/7/1,花蓮縣,花蓮市,41374,103837,50029,53808
2018/7/1,花蓮縣,鳳林鎮,4415,10936,5678,5258
2018/7/1,花蓮縣,玉里鎮,8866,24151,12775,11376
2018/7/1,花蓮縣,新城鄉,7720,20108,10327,9781
2018/7/1,花蓮縣,吉安鄉,32074,83334,41935,41399
2018/7/1,花蓮縣,壽豐鄉,7249,18057,9572,8485
2018/7/1,花蓮縣,光復鄉,5020,12864,6828,6036
2018/7/1,花蓮縣,豐濱鄉,1725,4824,2675,2149
2018/7/1,花蓮縣,瑞穗鄉,4771,11754,6340,5414
2018/7/1,花蓮縣,富里鄉,4052,10377,5628,4749
2018/7/1,花蓮縣,秀林鄉,4838,15909,8169,7740
2018/7/1,花蓮縣,萬榮鄉,2106,6454,3397,3057
2018/7/1,花蓮縣,卓溪鄉,1696,6104,3353,2751
2018/7/1,澎湖縣,馬公市,24400,62128,31565,30563
2018/7/1,澎湖縣,湖西鄉,5654,14527,7673,6854
2018/7/1,澎湖縣,白沙鄉,3421,9851,5149,4702
2018/7/1,澎湖縣,西嶼鄉,3033,8428,4347,4081
2018/7/1,澎湖縣,望安鄉,2023,5229,2829,2400
2018/7/1,澎湖縣,七美鄉,1380,3878,2009,1869
2018/7/1,基隆市,中正區,22633,51777,26438,25339
2018/7/1,基隆市,七堵區,21531,53848,27033,26815
2018/7/1,基隆市,暖暖區,15683,38658,19352,19306
2018/7/1,基隆市,仁愛區,19177,44128,21820,22308
2018/7/1,基隆市,中山區,19271,47589,24106,23483
2018/7/1,基隆市,安樂區,33510,82302,40734,41568
2018/7/1,基隆市,信義區,21478,52310,25836,26474
2018/7/1,新竹市,東區,80064,214333,105441,108892
2018/7/1,新竹市,北區,56997,151037,73737,77300
2018/7/1,新竹市,香山區,27412,78211,39676,38535
2018/7/1,嘉義市,東區,45500,121556,58471,63085
2018/7/1,嘉義市,西區,54331,147417,72156,75261
2018/7/1,金門縣,金城鎮,12946,43312,21592,21720
2018/7/1,金門縣,金湖鎮,8971,29531,14833,14698
2018/7/1,金門縣,金沙鎮,6350,20697,10236,10461
2018/7/1,金門縣,金寧鄉,8757,30870,15592,15278
2018/7/1,金門縣,烈嶼鄉,3170,12857,6338,6519
2018/7/1,金門縣,烏坵鄉,134,685,347,338
2018/7/1,連江縣,南竿鄉,1753,7682,4339,3343
2018/7/1,連江縣,北竿鄉,624,2406,1343,1063
2018/7/1,連江縣,莒光鄉,294,1643,1001,642
2018/7/1,連江縣,東引鄉,336,1345,800,545
2018/8/1,總計,新北市,1556199,3990211,1953210,2037001
2018/8/1,總計,臺北市,1055497,2672092,1275635,1396457
2018/8/1,總計,桃園市,802493,2211127,1099941,1111186
2018/8/1,總計,臺中市,968374,2797223,1377643,1419580
2018/8/1,總計,臺南市,687418,1884327,940516,943811
2018/8/1,總計,高雄市,1097301,2773093,1372374,1400719
2018/8/1,總計,臺灣省,2497520,7098098,3616624,3481474
2018/8/1,總計,宜蘭縣,169223,455758,230382,225376
2018/8/1,總計,新竹縣,193932,555604,283806,271798
2018/8/1,總計,苗栗縣,188801,550386,284072,266314
2018/8/1,總計,彰化縣,388736,1278568,651298,627270
2018/8/1,總計,南投縣,178223,498425,255238,243187
2018/8/1,總計,雲林縣,240971,688081,356692,331389
2018/8/1,總計,嘉義縣,183065,508372,264204,244168
2018/8/1,總計,屏東縣,287585,827599,422807,404792
2018/8/1,總計,臺東縣,82936,219489,113189,106300
2018/8/1,總計,花蓮縣,125982,328601,166623,161978
2018/8/1,總計,澎湖縣,39945,103976,53518,50458
2018/8/1,總計,基隆市,153482,370461,185222,185239
2018/8/1,總計,新竹市,164784,443969,219035,224934
2018/8/1,總計,嘉義市,99855,268809,130538,138271
2018/8/1,總計,福建省,43415,151100,76421,74679
2018/8/1,總計,金門縣,40401,138026,68946,69080
2018/8/1,總計,連江縣,3014,13074,7475,5599
2018/8/1,新北市,板橋區,211317,553565,270025,283540
2018/8/1,新北市,三重區,151625,386273,189863,196410
2018/8/1,新北市,中和區,165734,412453,200238,212215
2018/8/1,新北市,永和區,91088,221418,105066,116352
2018/8/1,新北市,新莊區,154982,417237,203537,213700
2018/8/1,新北市,新店區,127318,301956,145081,156875
2018/8/1,新北市,樹林區,66653,183734,91570,92164
2018/8/1,新北市,鶯歌區,30158,86245,43204,43041
2018/8/1,新北市,三峽區,43080,115635,57912,57723
2018/8/1,新北市,淡水區,76416,172184,82495,89689
2018/8/1,新北市,汐止區,87617,199950,97452,102498
2018/8/1,新北市,瑞芳區,16169,40074,20227,19847
2018/8/1,新北市,土城區,87234,237123,116855,120268
2018/8/1,新北市,蘆洲區,71501,201167,98777,102390
2018/8/1,新北市,五股區,32239,85983,43347,42636
2018/8/1,新北市,泰山區,28581,78775,38997,39778
2018/8/1,新北市,林口區,43344,108400,52694,55706
2018/8/1,新北市,深坑區,9610,23582,11824,11758
2018/8/1,新北市,石碇區,3391,7711,4227,3484
2018/8/1,新北市,坪林區,2523,6541,3599,2942
2018/8/1,新北市,三芝區,9531,23060,11873,11187
2018/8/1,新北市,石門區,4322,12171,6297,5874
2018/8/1,新北市,八里區,14793,38699,19321,19378
2018/8/1,新北市,平溪區,2300,4709,2602,2107
2018/8/1,新北市,雙溪區,3799,8868,4792,4076
2018/8/1,新北市,貢寮區,4368,12377,6312,6065
2018/8/1,新北市,金山區,7133,21858,10785,11073
2018/8/1,新北市,萬里區,7486,22108,11114,10994
2018/8/1,新北市,烏來區,1887,6355,3124,3231
2018/8/1,臺北市,松山區,81112,206118,96655,109463
2018/8/1,臺北市,信義區,89566,223823,106749,117074
2018/8/1,臺北市,大安區,121263,309025,144167,164858
2018/8/1,臺北市,中山區,100430,229743,106804,122939
2018/8/1,臺北市,中正區,65541,159360,76031,83329
2018/8/1,臺北市,大同區,51878,128100,62441,65659
2018/8/1,臺北市,萬華區,78756,190198,93334,96864
2018/8/1,臺北市,文山區,106465,274109,131390,142719
2018/8/1,臺北市,南港區,47288,121817,59515,62302
2018/8/1,臺北市,內湖區,108551,287278,137209,150069
2018/8/1,臺北市,士林區,107492,286935,138348,148587
2018/8/1,臺北市,北投區,97155,255586,122992,132594
2018/8/1,桃園市,桃園區,168364,445294,216113,229181
2018/8/1,桃園市,中壢區,152284,410242,201926,208316
2018/8/1,桃園市,大溪區,32711,94869,48313,46556
2018/8/1,桃園市,楊梅區,59039,169611,85397,84214
2018/8/1,桃園市,蘆竹區,59069,163643,81224,82419
2018/8/1,桃園市,大園區,33297,90145,46041,44104
2018/8/1,桃園市,龜山區,62378,159885,79554,80331
2018/8/1,桃園市,八德區,71744,200838,100408,100430
2018/8/1,桃園市,龍潭區,42313,122844,61475,61369
2018/8/1,桃園市,平鎮區,77888,225635,112029,113606
2018/8/1,桃園市,新屋區,16486,49139,26132,23007
2018/8/1,桃園市,觀音區,23088,67034,34864,32170
2018/8/1,桃園市,復興區,3832,11948,6465,5483
2018/8/1,臺中市,中區,7963,18538,9192,9346
2018/8/1,臺中市,東區,28197,76064,37831,38233
2018/8/1,臺中市,南區,48835,125637,60299,65338
2018/8/1,臺中市,西區,45770,115506,54795,60711
2018/8/1,臺中市,北區,59649,147602,70559,77043
2018/8/1,臺中市,西屯區,86611,227972,109363,118609
2018/8/1,臺中市,南屯區,62917,169841,81198,88643
2018/8/1,臺中市,北屯區,101678,277470,132984,144486
2018/8/1,臺中市,豐原區,54130,166964,82430,84534
2018/8/1,臺中市,東勢區,17424,50409,25850,24559
2018/8/1,臺中市,大甲區,23251,77706,39041,38665
2018/8/1,臺中市,清水區,27571,86558,44412,42146
2018/8/1,臺中市,沙鹿區,29946,93458,47162,46296
2018/8/1,臺中市,梧棲區,17971,58199,29131,29068
2018/8/1,臺中市,后里區,16409,54668,27741,26927
2018/8/1,臺中市,神岡區,19598,65627,33441,32186
2018/8/1,臺中市,潭子區,36601,108702,53705,54997
2018/8/1,臺中市,大雅區,29909,95629,47645,47984
2018/8/1,臺中市,新社區,7589,24610,12782,11828
2018/8/1,臺中市,石岡區,4913,14988,7750,7238
2018/8/1,臺中市,外埔區,9811,32189,16458,15731
2018/8/1,臺中市,大安區,5537,19284,10161,9123
2018/8/1,臺中市,烏日區,24992,75165,37649,37516
2018/8/1,臺中市,大肚區,17802,57327,29274,28053
2018/8/1,臺中市,龍井區,23343,77885,39186,38699
2018/8/1,臺中市,霧峰區,20399,65587,33203,32384
2018/8/1,臺中市,太平區,64855,190715,94515,96200
2018/8/1,臺中市,大里區,70085,211824,103943,107881
2018/8/1,臺中市,和平區,4618,11099,5943,5156
2018/8/1,臺南市,新營區,29060,77728,38466,39262
2018/8/1,臺南市,鹽水區,10029,25461,13290,12171
2018/8/1,臺南市,白河區,10800,28194,14742,13452
2018/8/1,臺南市,柳營區,7931,21254,11085,10169
2018/8/1,臺南市,後壁區,8825,23475,12194,11281
2018/8/1,臺南市,東山區,8346,20905,11103,9802
2018/8/1,臺南市,麻豆區,15821,44383,22559,21824
2018/8/1,臺南市,下營區,9075,24013,12387,11626
2018/8/1,臺南市,六甲區,7811,22235,11498,10737
2018/8/1,臺南市,官田區,7934,21340,10871,10469
2018/8/1,臺南市,大內區,3845,9663,5218,4445
2018/8/1,臺南市,佳里區,20772,59154,29332,29822
2018/8/1,臺南市,學甲區,9625,25758,13185,12573
2018/8/1,臺南市,西港區,8257,24745,12479,12266
2018/8/1,臺南市,七股區,8038,22872,11855,11017
2018/8/1,臺南市,將軍區,7272,19706,10048,9658
2018/8/1,臺南市,北門區,4229,11120,5615,5505
2018/8/1,臺南市,新化區,14463,43542,22171,21371
2018/8/1,臺南市,善化區,17944,48826,24545,24281
2018/8/1,臺南市,新市區,12507,36773,18399,18374
2018/8/1,臺南市,安定區,10180,30587,15733,14854
2018/8/1,臺南市,山上區,2725,7325,3816,3509
2018/8/1,臺南市,玉井區,5152,14046,7261,6785
2018/8/1,臺南市,楠西區,3515,9608,5080,4528
2018/8/1,臺南市,南化區,2859,8750,4720,4030
2018/8/1,臺南市,左鎮區,1960,4814,2708,2106
2018/8/1,臺南市,仁德區,27795,75703,38285,37418
2018/8/1,臺南市,歸仁區,22853,68430,34676,33754
2018/8/1,臺南市,關廟區,11223,34401,17734,16667
2018/8/1,臺南市,龍崎區,1534,4001,2152,1849
2018/8/1,臺南市,永康區,85002,234739,115594,119145
2018/8/1,臺南市,東區,72044,186253,89205,97048
2018/8/1,臺南市,南區,45948,124940,61823,63117
2018/8/1,臺南市,北區,51034,131972,64093,67879
2018/8/1,臺南市,安南區,63587,193009,97306,95703
2018/8/1,臺南市,安平區,25894,66660,31644,35016
2018/8/1,臺南市,中西區,31529,77942,37644,40298
2018/8/1,高雄市,鹽埕區,10794,24128,11969,12159
2018/8/1,高雄市,鼓山區,58577,139728,67338,72390
2018/8/1,高雄市,左營區,79154,196682,94516,102166
2018/8/1,高雄市,楠梓區,71586,184975,90738,94237
2018/8/1,高雄市,三民區,137017,341548,165094,176454
2018/8/1,高雄市,新興區,22934,51021,24517,26504
2018/8/1,高雄市,前金區,12610,26762,12737,14025
2018/8/1,高雄市,苓雅區,72257,170128,81735,88393
2018/8/1,高雄市,前鎮區,78786,188706,92689,96017
2018/8/1,高雄市,旗津區,11091,28522,14685,13837
2018/8/1,高雄市,小港區,68411,157536,78208,79328
2018/8/1,高雄市,鳳山區,141527,359081,175885,183196
2018/8/1,高雄市,林園區,26074,69892,35302,34590
2018/8/1,高雄市,大寮區,42441,112364,57447,54917
2018/8/1,高雄市,大樹區,13640,42518,21781,20737
2018/8/1,高雄市,大社區,13132,34639,17558,17081
2018/8/1,高雄市,仁武區,33839,87171,44195,42976
2018/8/1,高雄市,鳥松區,18468,44342,22452,21890
2018/8/1,高雄市,岡山區,35022,97031,48120,48911
2018/8/1,高雄市,橋頭區,13743,37652,19077,18575
2018/8/1,高雄市,燕巢區,10587,29796,15667,14129
2018/8/1,高雄市,田寮區,3256,7221,3991,3230
2018/8/1,高雄市,阿蓮區,9420,28705,14489,14216
2018/8/1,高雄市,路竹區,17113,52596,26843,25753
2018/8/1,高雄市,湖內區,10952,29820,15253,14567
2018/8/1,高雄市,茄萣區,10543,30059,15456,14603
2018/8/1,高雄市,永安區,5736,13902,7001,6901
2018/8/1,高雄市,彌陀區,6787,19294,9901,9393
2018/8/1,高雄市,梓官區,12691,35970,18503,17467
2018/8/1,高雄市,旗山區,13724,36760,18989,17771
2018/8/1,高雄市,美濃區,14784,39687,20810,18877
2018/8/1,高雄市,六龜區,5573,12997,7013,5984
2018/8/1,高雄市,甲仙區,2303,6077,3231,2846
2018/8/1,高雄市,杉林區,4801,11846,6469,5377
2018/8/1,高雄市,內門區,5132,14486,7827,6659
2018/8/1,高雄市,茂林區,599,1998,1007,991
2018/8/1,高雄市,桃源區,1356,4314,2272,2042
2018/8/1,高雄市,那瑪夏區,841,3139,1609,1530
2018/8/1,宜蘭縣,宜蘭市,36507,95836,46715,49121
2018/8/1,宜蘭縣,羅東鎮,26481,72508,34298,38210
2018/8/1,宜蘭縣,蘇澳鎮,14209,39851,20312,19539
2018/8/1,宜蘭縣,頭城鎮,10268,29204,15058,14146
2018/8/1,宜蘭縣,礁溪鄉,14139,35621,18518,17103
2018/8/1,宜蘭縣,壯圍鄉,8917,24320,12854,11466
2018/8/1,宜蘭縣,員山鄉,11725,32271,17108,15163
2018/8/1,宜蘭縣,冬山鄉,19374,52879,27132,25747
2018/8/1,宜蘭縣,五結鄉,15064,39583,20431,19152
2018/8/1,宜蘭縣,三星鄉,8642,21414,11507,9907
2018/8/1,宜蘭縣,大同鄉,1921,6235,3333,2902
2018/8/1,宜蘭縣,南澳鄉,1976,6036,3116,2920
2018/8/1,新竹縣,竹北市,67531,185596,92382,93214
2018/8/1,新竹縣,關西鎮,9407,28741,15398,13343
2018/8/1,新竹縣,新埔鎮,10750,33139,17680,15459
2018/8/1,新竹縣,竹東鎮,34066,96446,48407,48039
2018/8/1,新竹縣,湖口鄉,26883,77537,39264,38273
2018/8/1,新竹縣,橫山鄉,4442,13035,7058,5977
2018/8/1,新竹縣,新豐鄉,18749,56903,29208,27695
2018/8/1,新竹縣,芎林鄉,6562,20033,10617,9416
2018/8/1,新竹縣,寶山鄉,5665,14728,7972,6756
2018/8/1,新竹縣,北埔鄉,3127,9362,5091,4271
2018/8/1,新竹縣,峨眉鄉,2087,5636,3092,2544
2018/8/1,新竹縣,尖石鄉,2893,9646,5068,4578
2018/8/1,新竹縣,五峰鄉,1770,4802,2569,2233
2018/8/1,苗栗縣,苗栗市,31446,88367,44099,44268
2018/8/1,苗栗縣,頭份市,35115,102986,51963,51023
2018/8/1,苗栗縣,苑裡鎮,14691,45469,23692,21777
2018/8/1,苗栗縣,通霄鎮,11564,34197,18091,16106
2018/8/1,苗栗縣,竹南鎮,29705,85985,43440,42545
2018/8/1,苗栗縣,後龍鎮,11953,36389,19282,17107
2018/8/1,苗栗縣,卓蘭鎮,6020,16855,8830,8025
2018/8/1,苗栗縣,大湖鄉,5391,14551,7717,6834
2018/8/1,苗栗縣,公館鄉,10737,33388,17446,15942
2018/8/1,苗栗縣,銅鑼鄉,6154,17975,9578,8397
2018/8/1,苗栗縣,南庄鄉,3947,10141,5565,4576
2018/8/1,苗栗縣,頭屋鄉,3653,10772,5706,5066
2018/8/1,苗栗縣,三義鄉,5564,16311,8617,7694
2018/8/1,苗栗縣,西湖鄉,2636,7092,3962,3130
2018/8/1,苗栗縣,造橋鄉,4131,12756,6735,6021
2018/8/1,苗栗縣,三灣鄉,2400,6683,3660,3023
2018/8/1,苗栗縣,獅潭鄉,1710,4383,2449,1934
2018/8/1,苗栗縣,泰安鄉,1984,6086,3240,2846
2018/8/1,彰化縣,彰化市,76606,232634,114813,117821
2018/8/1,彰化縣,員林市,39616,124627,61956,62671
2018/8/1,彰化縣,鹿港鎮,24630,86761,44074,42687
2018/8/1,彰化縣,和美鎮,26897,90747,46127,44620
2018/8/1,彰化縣,北斗鎮,10751,33286,16774,16512
2018/8/1,彰化縣,溪湖鎮,16403,55451,28070,27381
2018/8/1,彰化縣,田中鎮,13187,41624,21450,20174
2018/8/1,彰化縣,二林鎮,15104,50760,26110,24650
2018/8/1,彰化縣,線西鄉,4429,16887,8653,8234
2018/8/1,彰化縣,伸港鄉,10091,37009,18889,18120
2018/8/1,彰化縣,福興鄉,12939,47200,24600,22600
2018/8/1,彰化縣,秀水鄉,10817,39271,20268,19003
2018/8/1,彰化縣,花壇鄉,14183,45965,23574,22391
2018/8/1,彰化縣,芬園鄉,6843,23615,12411,11204
2018/8/1,彰化縣,大村鄉,11184,36912,19047,17865
2018/8/1,彰化縣,埔鹽鄉,9122,32533,17098,15435
2018/8/1,彰化縣,埔心鄉,10650,34712,17871,16841
2018/8/1,彰化縣,永靖鄉,10933,37113,19214,17899
2018/8/1,彰化縣,社頭鄉,12962,42949,22083,20866
2018/8/1,彰化縣,二水鄉,5296,15215,7967,7248
2018/8/1,彰化縣,田尾鄉,7985,27366,14098,13268
2018/8/1,彰化縣,埤頭鄉,9117,30573,15824,14749
2018/8/1,彰化縣,芳苑鄉,10136,33572,17730,15842
2018/8/1,彰化縣,大城鄉,5246,16812,9071,7741
2018/8/1,彰化縣,竹塘鄉,4618,15166,7960,7206
2018/8/1,彰化縣,溪州鄉,8991,29808,15566,14242
2018/8/1,南投縣,南投市,34870,99626,49831,49795
2018/8/1,南投縣,埔里鎮,28958,80555,40100,40455
2018/8/1,南投縣,草屯鎮,33289,97297,49230,48067
2018/8/1,南投縣,竹山鎮,20139,54796,28083,26713
2018/8/1,南投縣,集集鎮,4313,10864,5653,5211
2018/8/1,南投縣,名間鄉,12625,38413,20249,18164
2018/8/1,南投縣,鹿谷鄉,8034,17718,9446,8272
2018/8/1,南投縣,中寮鄉,5644,14780,8022,6758
2018/8/1,南投縣,魚池鄉,5763,15828,8340,7488
2018/8/1,南投縣,國姓鄉,7306,18711,10083,8628
2018/8/1,南投縣,水里鄉,7117,17629,9251,8378
2018/8/1,南投縣,信義鄉,5272,16268,8715,7553
2018/8/1,南投縣,仁愛鄉,4893,15940,8235,7705
2018/8/1,雲林縣,斗六市,38498,108545,53914,54631
2018/8/1,雲林縣,斗南鎮,15901,44680,22702,21978
2018/8/1,雲林縣,虎尾鎮,25179,70932,35907,35025
2018/8/1,雲林縣,西螺鎮,14793,46127,23319,22808
2018/8/1,雲林縣,土庫鎮,9427,28840,15043,13797
2018/8/1,雲林縣,北港鎮,16052,40042,20667,19375
2018/8/1,雲林縣,古坑鄉,11021,31512,16590,14922
2018/8/1,雲林縣,大埤鄉,6652,19117,10250,8867
2018/8/1,雲林縣,莿桐鄉,9383,28764,15049,13715
2018/8/1,雲林縣,林內鄉,6032,18225,9546,8679
2018/8/1,雲林縣,二崙鄉,8932,26996,14444,12552
2018/8/1,雲林縣,崙背鄉,8516,24498,12931,11567
2018/8/1,雲林縣,麥寮鄉,14464,45785,22959,22826
2018/8/1,雲林縣,東勢鄉,5744,14890,8237,6653
2018/8/1,雲林縣,褒忠鄉,4436,13014,6991,6023
2018/8/1,雲林縣,臺西鄉,8671,23890,12803,11087
2018/8/1,雲林縣,元長鄉,9242,25824,14131,11693
2018/8/1,雲林縣,四湖鄉,8735,23399,12672,10727
2018/8/1,雲林縣,口湖鄉,9429,27475,14641,12834
2018/8/1,雲林縣,水林鄉,9864,25526,13896,11630
2018/8/1,嘉義縣,太保市,13174,38052,19497,18555
2018/8/1,嘉義縣,朴子市,15712,42147,21266,20881
2018/8/1,嘉義縣,布袋鎮,9917,26927,13743,13184
2018/8/1,嘉義縣,大林鎮,11387,30958,15861,15097
2018/8/1,嘉義縣,民雄鄉,25074,71334,36499,34835
2018/8/1,嘉義縣,溪口鄉,5311,14672,7855,6817
2018/8/1,嘉義縣,新港鄉,10673,31788,16736,15052
2018/8/1,嘉義縣,六腳鄉,8834,23112,12247,10865
2018/8/1,嘉義縣,東石鄉,9190,24715,13073,11642
2018/8/1,嘉義縣,義竹鄉,7351,18332,9540,8792
2018/8/1,嘉義縣,鹿草鄉,5752,15450,8282,7168
2018/8/1,嘉義縣,水上鄉,18150,49447,25551,23896
2018/8/1,嘉義縣,中埔鄉,16022,44686,23233,21453
2018/8/1,嘉義縣,竹崎鄉,11680,35693,19004,16689
2018/8/1,嘉義縣,梅山鄉,6771,19360,10294,9066
2018/8/1,嘉義縣,番路鄉,4240,11506,6213,5293
2018/8/1,嘉義縣,大埔鄉,1922,4590,2367,2223
2018/8/1,嘉義縣,阿里山鄉,1905,5603,2943,2660
2018/8/1,屏東縣,屏東市,74505,199994,98710,101284
2018/8/1,屏東縣,潮州鎮,19500,53978,26979,26999
2018/8/1,屏東縣,東港鎮,16786,47735,24121,23614
2018/8/1,屏東縣,恆春鎮,11642,30793,15804,14989
2018/8/1,屏東縣,萬丹鄉,15054,50646,26296,24350
2018/8/1,屏東縣,長治鄉,10163,29741,15495,14246
2018/8/1,屏東縣,麟洛鄉,3841,11116,5748,5368
2018/8/1,屏東縣,九如鄉,7044,22086,11416,10670
2018/8/1,屏東縣,里港鄉,8212,26171,13316,12855
2018/8/1,屏東縣,鹽埔鄉,7869,25785,13405,12380
2018/8/1,屏東縣,高樹鄉,9271,24471,13051,11420
2018/8/1,屏東縣,萬巒鄉,6532,20592,10725,9867
2018/8/1,屏東縣,內埔鄉,18670,54263,28017,26246
2018/8/1,屏東縣,竹田鄉,5663,17183,9133,8050
2018/8/1,屏東縣,新埤鄉,3459,10048,5336,4712
2018/8/1,屏東縣,枋寮鄉,8548,24456,12781,11675
2018/8/1,屏東縣,新園鄉,11812,35028,18146,16882
2018/8/1,屏東縣,崁頂鄉,4496,15528,7840,7688
2018/8/1,屏東縣,林邊鄉,6702,17874,9138,8736
2018/8/1,屏東縣,南州鄉,3717,10659,5448,5211
2018/8/1,屏東縣,佳冬鄉,6976,19183,9971,9212
2018/8/1,屏東縣,琉球鄉,4521,12389,6785,5604
2018/8/1,屏東縣,車城鄉,3478,8651,4638,4013
2018/8/1,屏東縣,滿州鄉,3056,8071,4360,3711
2018/8/1,屏東縣,枋山鄉,2103,5545,2944,2601
2018/8/1,屏東縣,三地門鄉,2334,7666,3848,3818
2018/8/1,屏東縣,霧臺鄉,1063,3381,1727,1654
2018/8/1,屏東縣,瑪家鄉,2061,6831,3449,3382
2018/8/1,屏東縣,泰武鄉,1352,5381,2814,2567
2018/8/1,屏東縣,來義鄉,2232,7452,3758,3694
2018/8/1,屏東縣,春日鄉,1407,4890,2501,2389
2018/8/1,屏東縣,獅子鄉,1576,5007,2569,2438
2018/8/1,屏東縣,牡丹鄉,1940,5005,2538,2467
2018/8/1,臺東縣,臺東市,39764,105609,52817,52792
2018/8/1,臺東縣,成功鎮,5368,14152,7437,6715
2018/8/1,臺東縣,關山鎮,3162,8747,4546,4201
2018/8/1,臺東縣,卑南鄉,6710,17328,9150,8178
2018/8/1,臺東縣,大武鄉,2489,6126,3177,2949
2018/8/1,臺東縣,太麻里鄉,4731,11196,5968,5228
2018/8/1,臺東縣,東河鄉,3752,8516,4716,3800
2018/8/1,臺東縣,長濱鄉,2922,7236,4112,3124
2018/8/1,臺東縣,鹿野鄉,3046,7911,4182,3729
2018/8/1,臺東縣,池上鄉,3211,8229,4282,3947
2018/8/1,臺東縣,綠島鄉,1155,4093,2176,1917
2018/8/1,臺東縣,延平鄉,1075,3669,1957,1712
2018/8/1,臺東縣,海端鄉,1092,4201,2230,1971
2018/8/1,臺東縣,達仁鄉,1448,3631,1972,1659
2018/8/1,臺東縣,金峰鄉,1141,3739,1886,1853
2018/8/1,臺東縣,蘭嶼鄉,1870,5106,2581,2525
2018/8/1,花蓮縣,花蓮市,41369,103750,50004,53746
2018/8/1,花蓮縣,鳳林鎮,4412,10918,5669,5249
2018/8/1,花蓮縣,玉里鎮,8864,24128,12763,11365
2018/8/1,花蓮縣,新城鄉,7725,20138,10322,9816
2018/8/1,花蓮縣,吉安鄉,32145,83383,41963,41420
2018/8/1,花蓮縣,壽豐鄉,7258,18048,9558,8490
2018/8/1,花蓮縣,光復鄉,5024,12868,6826,6042
2018/8/1,花蓮縣,豐濱鄉,1726,4819,2666,2153
2018/8/1,花蓮縣,瑞穗鄉,4775,11757,6350,5407
2018/8/1,花蓮縣,富里鄉,4049,10354,5616,4738
2018/8/1,花蓮縣,秀林鄉,4839,15884,8147,7737
2018/8/1,花蓮縣,萬榮鄉,2102,6451,3391,3060
2018/8/1,花蓮縣,卓溪鄉,1694,6103,3348,2755
2018/8/1,澎湖縣,馬公市,24395,62062,31519,30543
2018/8/1,澎湖縣,湖西鄉,5662,14540,7676,6864
2018/8/1,澎湖縣,白沙鄉,3432,9846,5151,4695
2018/8/1,澎湖縣,西嶼鄉,3038,8417,4341,4076
2018/8/1,澎湖縣,望安鄉,2031,5239,2830,2409
2018/8/1,澎湖縣,七美鄉,1387,3872,2001,1871
2018/8/1,基隆市,中正區,22669,51784,26410,25374
2018/8/1,基隆市,七堵區,21577,53861,27050,26811
2018/8/1,基隆市,暖暖區,15700,38629,19341,19288
2018/8/1,基隆市,仁愛區,19156,44037,21799,22238
2018/8/1,基隆市,中山區,19272,47497,24067,23430
2018/8/1,基隆市,安樂區,33553,82267,40707,41560
2018/8/1,基隆市,信義區,21555,52386,25848,26538
2018/8/1,新竹市,東區,80224,214540,105531,109009
2018/8/1,新竹市,北區,57096,151167,73809,77358
2018/8/1,新竹市,香山區,27464,78262,39695,38567
2018/8/1,嘉義市,東區,45497,121439,58422,63017
2018/8/1,嘉義市,西區,54358,147370,72116,75254
2018/8/1,金門縣,金城鎮,12970,43294,21581,21713
2018/8/1,金門縣,金湖鎮,8986,29592,14840,14752
2018/8/1,金門縣,金沙鎮,6347,20701,10237,10464
2018/8/1,金門縣,金寧鄉,8782,30903,15607,15296
2018/8/1,金門縣,烈嶼鄉,3181,12851,6334,6517
2018/8/1,金門縣,烏坵鄉,135,685,347,338
2018/8/1,連江縣,南竿鄉,1755,7667,4319,3348
2018/8/1,連江縣,北竿鄉,627,2418,1350,1068
2018/8/1,連江縣,莒光鄉,295,1641,1001,640
2018/8/1,連江縣,東引鄉,337,1348,805,543
2018/9/1,總計,新北市,1559432,3991411,1953636,2037775
2018/9/1,總計,臺北市,1056715,2669639,1274341,1395298
2018/9/1,總計,桃園市,804716,2213379,1100862,1112517
2018/9/1,總計,臺中市,969943,2797874,1377838,1420036
2018/9/1,總計,臺南市,688535,1884036,940312,943724
2018/9/1,總計,高雄市,1098983,2772820,1372006,1400814
2018/9/1,總計,臺灣省,2501210,7096547,3615642,3480905
2018/9/1,總計,宜蘭縣,169424,455592,230277,225315
2018/9/1,總計,新竹縣,194570,556056,284039,272017
2018/9/1,總計,苗栗縣,189108,550085,283885,266200
2018/9/1,總計,彰化縣,389250,1278311,651137,627174
2018/9/1,總計,南投縣,178309,498117,255081,243036
2018/9/1,總計,雲林縣,241125,687646,356423,331223
2018/9/1,總計,嘉義縣,183216,508038,264026,244012
2018/9/1,總計,屏東縣,287807,827051,422504,404547
2018/9/1,總計,臺東縣,82988,219342,113127,106215
2018/9/1,總計,花蓮縣,126084,328444,166538,161906
2018/9/1,總計,澎湖縣,40444,104392,53766,50626
2018/9/1,總計,基隆市,153685,370368,185140,185228
2018/9/1,總計,新竹市,165221,444406,219235,225171
2018/9/1,總計,嘉義市,99979,268699,130464,138235
2018/9/1,總計,福建省,43463,151782,76710,75072
2018/9/1,總計,金門縣,40442,138724,69248,69476
2018/9/1,總計,連江縣,3021,13058,7462,5596
2018/9/1,新北市,板橋區,212163,554236,270274,283962
2018/9/1,新北市,三重區,151829,386138,189787,196351
2018/9/1,新北市,中和區,166001,412439,200198,212241
2018/9/1,新北市,永和區,91158,221197,104969,116228
2018/9/1,新北市,新莊區,155234,417225,203534,213691
2018/9/1,新北市,新店區,127613,302090,145141,156949
2018/9/1,新北市,樹林區,66690,183678,91564,92114
2018/9/1,新北市,鶯歌區,30221,86233,43216,43017
2018/9/1,新北市,三峽區,43144,115670,57912,57758
2018/9/1,新北市,淡水區,76685,172376,82598,89778
2018/9/1,新北市,汐止區,87808,200146,97517,102629
2018/9/1,新北市,瑞芳區,16181,40053,20201,19852
2018/9/1,新北市,土城區,87299,236992,116782,120210
2018/9/1,新北市,蘆洲區,71611,201221,98804,102417
2018/9/1,新北市,五股區,32386,86119,43402,42717
2018/9/1,新北市,泰山區,28604,78712,38968,39744
2018/9/1,新北市,林口區,43583,108737,52854,55883
2018/9/1,新北市,深坑區,9625,23600,11825,11775
2018/9/1,新北市,石碇區,3391,7715,4225,3490
2018/9/1,新北市,坪林區,2522,6557,3609,2948
2018/9/1,新北市,三芝區,9526,23037,11868,11169
2018/9/1,新北市,石門區,4322,12160,6293,5867
2018/9/1,新北市,八里區,14848,38806,19371,19435
2018/9/1,新北市,平溪區,2299,4701,2599,2102
2018/9/1,新北市,雙溪區,3802,8869,4795,4074
2018/9/1,新北市,貢寮區,4364,12367,6303,6064
2018/9/1,新北市,金山區,7140,21845,10776,11069
2018/9/1,新北市,萬里區,7490,22116,11120,10996
2018/9/1,新北市,烏來區,1893,6376,3131,3245
2018/9/1,臺北市,松山區,81167,205807,96516,109291
2018/9/1,臺北市,信義區,89661,223551,106618,116933
2018/9/1,臺北市,大安區,121393,308628,143909,164719
2018/9/1,臺北市,中山區,100616,229686,106792,122894
2018/9/1,臺北市,中正區,65557,159066,75900,83166
2018/9/1,臺北市,大同區,51890,127926,62338,65588
2018/9/1,臺北市,萬華區,78823,190006,93237,96769
2018/9/1,臺北市,文山區,106608,273934,131286,142648
2018/9/1,臺北市,南港區,47337,121698,59459,62239
2018/9/1,臺北市,內湖區,108726,287118,137139,149979
2018/9/1,臺北市,士林區,107588,286725,138217,148508
2018/9/1,臺北市,北投區,97349,255494,122930,132564
2018/9/1,桃園市,桃園區,168929,445832,216320,229512
2018/9/1,桃園市,中壢區,152790,410676,202114,208562
2018/9/1,桃園市,大溪區,32755,94875,48306,46569
2018/9/1,桃園市,楊梅區,59178,169790,85474,84316
2018/9/1,桃園市,蘆竹區,59256,163882,81319,82563
2018/9/1,桃園市,大園區,33381,90241,46073,44168
2018/9/1,桃園市,龜山區,62491,160067,79606,80461
2018/9/1,桃園市,八德區,71953,201184,100562,100622
2018/9/1,桃園市,龍潭區,42425,122905,61494,61411
2018/9/1,桃園市,平鎮區,78082,225714,112081,113633
2018/9/1,桃園市,新屋區,16491,49122,26130,22992
2018/9/1,桃園市,觀音區,23150,67120,34902,32218
2018/9/1,桃園市,復興區,3835,11971,6481,5490
2018/9/1,臺中市,中區,7984,18532,9183,9349
2018/9/1,臺中市,東區,28248,76081,37829,38252
2018/9/1,臺中市,南區,48911,125677,60332,65345
2018/9/1,臺中市,西區,45803,115506,54793,60713
2018/9/1,臺中市,北區,59718,147521,70514,77007
2018/9/1,臺中市,西屯區,86767,227982,109365,118617
2018/9/1,臺中市,南屯區,63073,170008,81274,88734
2018/9/1,臺中市,北屯區,101947,277777,133115,144662
2018/9/1,臺中市,豐原區,54227,166922,82415,84507
2018/9/1,臺中市,東勢區,17408,50369,25825,24544
2018/9/1,臺中市,大甲區,23286,77659,38996,38663
2018/9/1,臺中市,清水區,27642,86609,44428,42181
2018/9/1,臺中市,沙鹿區,30039,93606,47206,46400
2018/9/1,臺中市,梧棲區,17995,58190,29161,29029
2018/9/1,臺中市,后里區,16440,54674,27726,26948
2018/9/1,臺中市,神岡區,19614,65623,33437,32186
2018/9/1,臺中市,潭子區,36639,108737,53707,55030
2018/9/1,臺中市,大雅區,29931,95617,47641,47976
2018/9/1,臺中市,新社區,7604,24599,12769,11830
2018/9/1,臺中市,石岡區,4913,14973,7744,7229
2018/9/1,臺中市,外埔區,9818,32197,16455,15742
2018/9/1,臺中市,大安區,5538,19269,10160,9109
2018/9/1,臺中市,烏日區,25045,75201,37669,37532
2018/9/1,臺中市,大肚區,17814,57294,29248,28046
2018/9/1,臺中市,龍井區,23359,77894,39179,38715
2018/9/1,臺中市,霧峰區,20413,65582,33199,32383
2018/9/1,臺中市,太平區,64984,190891,94610,96281
2018/9/1,臺中市,大里區,70168,211805,103931,107874
2018/9/1,臺中市,和平區,4615,11079,5927,5152
2018/9/1,臺南市,新營區,29079,77666,38430,39236
2018/9/1,臺南市,鹽水區,10029,25427,13269,12158
2018/9/1,臺南市,白河區,10800,28175,14727,13448
2018/9/1,臺南市,柳營區,7924,21219,11067,10152
2018/9/1,臺南市,後壁區,8823,23470,12195,11275
2018/9/1,臺南市,東山區,8341,20883,11086,9797
2018/9/1,臺南市,麻豆區,15835,44337,22538,21799
2018/9/1,臺南市,下營區,9060,23969,12366,11603
2018/9/1,臺南市,六甲區,7806,22202,11475,10727
2018/9/1,臺南市,官田區,7949,21355,10874,10481
2018/9/1,臺南市,大內區,3840,9652,5213,4439
2018/9/1,臺南市,佳里區,20815,59128,29321,29807
2018/9/1,臺南市,學甲區,9634,25743,13172,12571
2018/9/1,臺南市,西港區,8268,24735,12472,12263
2018/9/1,臺南市,七股區,8046,22849,11835,11014
2018/9/1,臺南市,將軍區,7278,19697,10044,9653
2018/9/1,臺南市,北門區,4223,11100,5608,5492
2018/9/1,臺南市,新化區,14479,43539,22156,21383
2018/9/1,臺南市,善化區,17983,48857,24562,24295
2018/9/1,臺南市,新市區,12540,36821,18425,18396
2018/9/1,臺南市,安定區,10200,30545,15711,14834
2018/9/1,臺南市,山上區,2730,7337,3821,3516
2018/9/1,臺南市,玉井區,5150,14038,7250,6788
2018/9/1,臺南市,楠西區,3523,9595,5071,4524
2018/9/1,臺南市,南化區,2858,8747,4713,4034
2018/9/1,臺南市,左鎮區,1955,4813,2708,2105
2018/9/1,臺南市,仁德區,27881,75773,38303,37470
2018/9/1,臺南市,歸仁區,22887,68404,34672,33732
2018/9/1,臺南市,關廟區,11236,34391,17734,16657
2018/9/1,臺南市,龍崎區,1533,4000,2150,1850
2018/9/1,臺南市,永康區,85225,234907,115679,119228
2018/9/1,臺南市,東區,72166,186114,89135,96979
2018/9/1,臺南市,南區,46029,124845,61730,63115
2018/9/1,臺南市,北區,51105,131940,64079,67861
2018/9/1,臺南市,安南區,63741,193102,97374,95728
2018/9/1,臺南市,安平區,25952,66669,31660,35009
2018/9/1,臺南市,中西區,31612,77992,37687,40305
2018/9/1,高雄市,鹽埕區,10797,24108,11967,12141
2018/9/1,高雄市,鼓山區,58743,139790,67359,72431
2018/9/1,高雄市,左營區,79311,196745,94516,102229
2018/9/1,高雄市,楠梓區,71867,185171,90815,94356
2018/9/1,高雄市,三民區,137194,341431,165006,176425
2018/9/1,高雄市,新興區,22959,50950,24477,26473
2018/9/1,高雄市,前金區,12638,26737,12706,14031
2018/9/1,高雄市,苓雅區,72290,169956,81604,88352
2018/9/1,高雄市,前鎮區,78850,188587,92627,95960
2018/9/1,高雄市,旗津區,11097,28526,14679,13847
2018/9/1,高雄市,小港區,68528,157614,78243,79371
2018/9/1,高雄市,鳳山區,141726,359004,175813,183191
2018/9/1,高雄市,林園區,26079,69870,35287,34583
2018/9/1,高雄市,大寮區,42484,112399,57449,54950
2018/9/1,高雄市,大樹區,13663,42486,21763,20723
2018/9/1,高雄市,大社區,13133,34595,17517,17078
2018/9/1,高雄市,仁武區,34018,87377,44302,43075
2018/9/1,高雄市,鳥松區,18511,44379,22488,21891
2018/9/1,高雄市,岡山區,35054,97039,48115,48924
2018/9/1,高雄市,橋頭區,13782,37651,19085,18566
2018/9/1,高雄市,燕巢區,10599,29795,15674,14121
2018/9/1,高雄市,田寮區,3254,7203,3977,3226
2018/9/1,高雄市,阿蓮區,9423,28662,14464,14198
2018/9/1,高雄市,路竹區,17141,52553,26819,25734
2018/9/1,高雄市,湖內區,10958,29837,15255,14582
2018/9/1,高雄市,茄萣區,10535,30052,15443,14609
2018/9/1,高雄市,永安區,5737,13899,7003,6896
2018/9/1,高雄市,彌陀區,6793,19285,9894,9391
2018/9/1,高雄市,梓官區,12691,35924,18491,17433
2018/9/1,高雄市,旗山區,13721,36713,18969,17744
2018/9/1,高雄市,美濃區,14801,39649,20785,18864
2018/9/1,高雄市,六龜區,5571,12989,7008,5981
2018/9/1,高雄市,甲仙區,2301,6065,3220,2845
2018/9/1,高雄市,杉林區,4809,11843,6474,5369
2018/9/1,高雄市,內門區,5129,14489,7829,6660
2018/9/1,高雄市,茂林區,600,1996,1006,990
2018/9/1,高雄市,桃源區,1355,4310,2269,2041
2018/9/1,高雄市,那瑪夏區,841,3141,1608,1533
2018/9/1,宜蘭縣,宜蘭市,36558,95770,46662,49108
2018/9/1,宜蘭縣,羅東鎮,26509,72468,34293,38175
2018/9/1,宜蘭縣,蘇澳鎮,14219,39808,20278,19530
2018/9/1,宜蘭縣,頭城鎮,10279,29200,15045,14155
2018/9/1,宜蘭縣,礁溪鄉,14174,35644,18535,17109
2018/9/1,宜蘭縣,壯圍鄉,8922,24322,12848,11474
2018/9/1,宜蘭縣,員山鄉,11741,32282,17122,15160
2018/9/1,宜蘭縣,冬山鄉,19403,52859,27122,25737
2018/9/1,宜蘭縣,五結鄉,15079,39573,20437,19136
2018/9/1,宜蘭縣,三星鄉,8648,21402,11494,9908
2018/9/1,宜蘭縣,大同鄉,1920,6238,3333,2905
2018/9/1,宜蘭縣,南澳鄉,1972,6026,3108,2918
2018/9/1,新竹縣,竹北市,67954,186069,92635,93434
2018/9/1,新竹縣,關西鎮,9417,28687,15374,13313
2018/9/1,新竹縣,新埔鎮,10762,33128,17669,15459
2018/9/1,新竹縣,竹東鎮,34122,96384,48380,48004
2018/9/1,新竹縣,湖口鄉,26946,77613,39283,38330
2018/9/1,新竹縣,橫山鄉,4444,13027,7059,5968
2018/9/1,新竹縣,新豐鄉,18771,56897,29206,27691
2018/9/1,新竹縣,芎林鄉,6594,20054,10625,9429
2018/9/1,新竹縣,寶山鄉,5682,14714,7972,6742
2018/9/1,新竹縣,北埔鄉,3129,9352,5080,4272
2018/9/1,新竹縣,峨眉鄉,2090,5645,3099,2546
2018/9/1,新竹縣,尖石鄉,2890,9667,5080,4587
2018/9/1,新竹縣,五峰鄉,1769,4819,2577,2242
2018/9/1,苗栗縣,苗栗市,31515,88340,44065,44275
2018/9/1,苗栗縣,頭份市,35210,103012,51976,51036
2018/9/1,苗栗縣,苑裡鎮,14706,45420,23674,21746
2018/9/1,苗栗縣,通霄鎮,11583,34148,18067,16081
2018/9/1,苗栗縣,竹南鎮,29799,86029,43457,42572
2018/9/1,苗栗縣,後龍鎮,11969,36353,19261,17092
2018/9/1,苗栗縣,卓蘭鎮,6019,16833,8820,8013
2018/9/1,苗栗縣,大湖鄉,5388,14546,7718,6828
2018/9/1,苗栗縣,公館鄉,10750,33352,17432,15920
2018/9/1,苗栗縣,銅鑼鄉,6158,17951,9559,8392
2018/9/1,苗栗縣,南庄鄉,3941,10127,5553,4574
2018/9/1,苗栗縣,頭屋鄉,3648,10725,5679,5046
2018/9/1,苗栗縣,三義鄉,5559,16284,8603,7681
2018/9/1,苗栗縣,西湖鄉,2635,7089,3958,3131
2018/9/1,苗栗縣,造橋鄉,4138,12740,6724,6016
2018/9/1,苗栗縣,三灣鄉,2394,6675,3652,3023
2018/9/1,苗栗縣,獅潭鄉,1713,4378,2447,1931
2018/9/1,苗栗縣,泰安鄉,1983,6083,3240,2843
2018/9/1,彰化縣,彰化市,76697,232622,114816,117806
2018/9/1,彰化縣,員林市,39764,124717,62013,62704
2018/9/1,彰化縣,鹿港鎮,24658,86718,44036,42682
2018/9/1,彰化縣,和美鎮,26962,90774,46146,44628
2018/9/1,彰化縣,北斗鎮,10756,33296,16775,16521
2018/9/1,彰化縣,溪湖鎮,16394,55402,28043,27359
2018/9/1,彰化縣,田中鎮,13199,41598,21430,20168
2018/9/1,彰化縣,二林鎮,15127,50737,26091,24646
2018/9/1,彰化縣,線西鄉,4435,16881,8648,8233
2018/9/1,彰化縣,伸港鄉,10116,37034,18904,18130
2018/9/1,彰化縣,福興鄉,12963,47183,24579,22604
2018/9/1,彰化縣,秀水鄉,10831,39271,20272,18999
2018/9/1,彰化縣,花壇鄉,14206,45938,23546,22392
2018/9/1,彰化縣,芬園鄉,6841,23585,12404,11181
2018/9/1,彰化縣,大村鄉,11185,36901,19054,17847
2018/9/1,彰化縣,埔鹽鄉,9142,32541,17109,15432
2018/9/1,彰化縣,埔心鄉,10689,34743,17869,16874
2018/9/1,彰化縣,永靖鄉,10936,37072,19193,17879
2018/9/1,彰化縣,社頭鄉,12970,42943,22079,20864
2018/9/1,彰化縣,二水鄉,5299,15197,7964,7233
2018/9/1,彰化縣,田尾鄉,7984,27325,14077,13248
2018/9/1,彰化縣,埤頭鄉,9113,30555,15823,14732
2018/9/1,彰化縣,芳苑鄉,10132,33552,17708,15844
2018/9/1,彰化縣,大城鄉,5239,16792,9064,7728
2018/9/1,彰化縣,竹塘鄉,4619,15136,7935,7201
2018/9/1,彰化縣,溪州鄉,8993,29798,15559,14239
2018/9/1,南投縣,南投市,34914,99568,49834,49734
2018/9/1,南投縣,埔里鎮,28965,80466,40057,40409
2018/9/1,南投縣,草屯鎮,33329,97273,49202,48071
2018/9/1,南投縣,竹山鎮,20143,54726,28058,26668
2018/9/1,南投縣,集集鎮,4314,10863,5653,5210
2018/9/1,南投縣,名間鄉,12620,38384,20227,18157
2018/9/1,南投縣,鹿谷鄉,8039,17700,9432,8268
2018/9/1,南投縣,中寮鄉,5635,14745,8001,6744
2018/9/1,南投縣,魚池鄉,5758,15822,8337,7485
2018/9/1,南投縣,國姓鄉,7305,18713,10081,8632
2018/9/1,南投縣,水里鄉,7123,17623,9243,8380
2018/9/1,南投縣,信義鄉,5274,16273,8711,7562
2018/9/1,南投縣,仁愛鄉,4890,15961,8245,7716
2018/9/1,雲林縣,斗六市,38533,108487,53892,54595
2018/9/1,雲林縣,斗南鎮,15912,44650,22682,21968
2018/9/1,雲林縣,虎尾鎮,25220,70902,35895,35007
2018/9/1,雲林縣,西螺鎮,14817,46112,23300,22812
2018/9/1,雲林縣,土庫鎮,9436,28834,15042,13792
2018/9/1,雲林縣,北港鎮,16065,40031,20650,19381
2018/9/1,雲林縣,古坑鄉,11036,31490,16574,14916
2018/9/1,雲林縣,大埤鄉,6648,19116,10252,8864
2018/9/1,雲林縣,莿桐鄉,9387,28747,15036,13711
2018/9/1,雲林縣,林內鄉,6035,18192,9525,8667
2018/9/1,雲林縣,二崙鄉,8924,26940,14402,12538
2018/9/1,雲林縣,崙背鄉,8525,24472,12915,11557
2018/9/1,雲林縣,麥寮鄉,14468,45859,22992,22867
2018/9/1,雲林縣,東勢鄉,5742,14868,8221,6647
2018/9/1,雲林縣,褒忠鄉,4440,12992,6980,6012
2018/9/1,雲林縣,臺西鄉,8665,23862,12793,11069
2018/9/1,雲林縣,元長鄉,9242,25817,14124,11693
2018/9/1,雲林縣,四湖鄉,8733,23375,12659,10716
2018/9/1,雲林縣,口湖鄉,9431,27410,14609,12801
2018/9/1,雲林縣,水林鄉,9866,25490,13880,11610
2018/9/1,嘉義縣,太保市,13187,38068,19504,18564
2018/9/1,嘉義縣,朴子市,15752,42135,21259,20876
2018/9/1,嘉義縣,布袋鎮,9924,26879,13719,13160
2018/9/1,嘉義縣,大林鎮,11395,30953,15852,15101
2018/9/1,嘉義縣,民雄鄉,25120,71330,36497,34833
2018/9/1,嘉義縣,溪口鄉,5309,14670,7853,6817
2018/9/1,嘉義縣,新港鄉,10700,31782,16730,15052
2018/9/1,嘉義縣,六腳鄉,8831,23075,12237,10838
2018/9/1,嘉義縣,東石鄉,9188,24673,13054,11619
2018/9/1,嘉義縣,義竹鄉,7342,18302,9521,8781
2018/9/1,嘉義縣,鹿草鄉,5751,15442,8276,7166
2018/9/1,嘉義縣,水上鄉,18159,49443,25553,23890
2018/9/1,嘉義縣,中埔鄉,16037,44626,23214,21412
2018/9/1,嘉義縣,竹崎鄉,11685,35658,18974,16684
2018/9/1,嘉義縣,梅山鄉,6770,19317,10275,9042
2018/9/1,嘉義縣,番路鄉,4239,11490,6205,5285
2018/9/1,嘉義縣,大埔鄉,1922,4588,2365,2223
2018/9/1,嘉義縣,阿里山鄉,1905,5607,2938,2669
2018/9/1,屏東縣,屏東市,74565,199830,98623,101207
2018/9/1,屏東縣,潮州鎮,19517,53946,26951,26995
2018/9/1,屏東縣,東港鎮,16811,47692,24110,23582
2018/9/1,屏東縣,恆春鎮,11663,30801,15803,14998
2018/9/1,屏東縣,萬丹鄉,15068,50591,26279,24312
2018/9/1,屏東縣,長治鄉,10171,29729,15493,14236
2018/9/1,屏東縣,麟洛鄉,3850,11095,5743,5352
2018/9/1,屏東縣,九如鄉,7063,22099,11420,10679
2018/9/1,屏東縣,里港鄉,8210,26122,13290,12832
2018/9/1,屏東縣,鹽埔鄉,7881,25770,13393,12377
2018/9/1,屏東縣,高樹鄉,9271,24466,13048,11418
2018/9/1,屏東縣,萬巒鄉,6530,20590,10726,9864
2018/9/1,屏東縣,內埔鄉,18684,54200,27978,26222
2018/9/1,屏東縣,竹田鄉,5661,17172,9125,8047
2018/9/1,屏東縣,新埤鄉,3462,10043,5332,4711
2018/9/1,屏東縣,枋寮鄉,8549,24407,12766,11641
2018/9/1,屏東縣,新園鄉,11829,34988,18114,16874
2018/9/1,屏東縣,崁頂鄉,4497,15521,7828,7693
2018/9/1,屏東縣,林邊鄉,6696,17852,9123,8729
2018/9/1,屏東縣,南州鄉,3714,10656,5443,5213
2018/9/1,屏東縣,佳冬鄉,6974,19186,9973,9213
2018/9/1,屏東縣,琉球鄉,4525,12396,6791,5605
2018/9/1,屏東縣,車城鄉,3484,8640,4638,4002
2018/9/1,屏東縣,滿州鄉,3052,8067,4358,3709
2018/9/1,屏東縣,枋山鄉,2101,5536,2939,2597
2018/9/1,屏東縣,三地門鄉,2332,7695,3859,3836
2018/9/1,屏東縣,霧臺鄉,1062,3385,1728,1657
2018/9/1,屏東縣,瑪家鄉,2063,6835,3451,3384
2018/9/1,屏東縣,泰武鄉,1355,5382,2817,2565
2018/9/1,屏東縣,來義鄉,2230,7440,3753,3687
2018/9/1,屏東縣,春日鄉,1411,4890,2499,2391
2018/9/1,屏東縣,獅子鄉,1579,5019,2573,2446
2018/9/1,屏東縣,牡丹鄉,1947,5010,2537,2473
2018/9/1,臺東縣,臺東市,39822,105589,52814,52775
2018/9/1,臺東縣,成功鎮,5368,14137,7438,6699
2018/9/1,臺東縣,關山鎮,3164,8738,4548,4190
2018/9/1,臺東縣,卑南鄉,6713,17316,9144,8172
2018/9/1,臺東縣,大武鄉,2483,6108,3169,2939
2018/9/1,臺東縣,太麻里鄉,4733,11197,5961,5236
2018/9/1,臺東縣,東河鄉,3762,8515,4716,3799
2018/9/1,臺東縣,長濱鄉,2918,7216,4102,3114
2018/9/1,臺東縣,鹿野鄉,3039,7899,4180,3719
2018/9/1,臺東縣,池上鄉,3207,8219,4274,3945
2018/9/1,臺東縣,綠島鄉,1153,4086,2174,1912
2018/9/1,臺東縣,延平鄉,1074,3659,1952,1707
2018/9/1,臺東縣,海端鄉,1092,4200,2229,1971
2018/9/1,臺東縣,達仁鄉,1445,3624,1966,1658
2018/9/1,臺東縣,金峰鄉,1143,3738,1884,1854
2018/9/1,臺東縣,蘭嶼鄉,1872,5101,2576,2525
2018/9/1,花蓮縣,花蓮市,41421,103761,50002,53759
2018/9/1,花蓮縣,鳳林鎮,4409,10901,5664,5237
2018/9/1,花蓮縣,玉里鎮,8864,24091,12739,11352
2018/9/1,花蓮縣,新城鄉,7736,20143,10320,9823
2018/9/1,花蓮縣,吉安鄉,32179,83314,41934,41380
2018/9/1,花蓮縣,壽豐鄉,7262,18034,9542,8492
2018/9/1,花蓮縣,光復鄉,5025,12844,6817,6027
2018/9/1,花蓮縣,豐濱鄉,1726,4815,2664,2151
2018/9/1,花蓮縣,瑞穗鄉,4776,11735,6344,5391
2018/9/1,花蓮縣,富里鄉,4043,10340,5611,4729
2018/9/1,花蓮縣,秀林鄉,4839,15913,8161,7752
2018/9/1,花蓮縣,萬榮鄉,2110,6450,3390,3060
2018/9/1,花蓮縣,卓溪鄉,1694,6103,3350,2753
2018/9/1,澎湖縣,馬公市,24877,62527,31797,30730
2018/9/1,澎湖縣,湖西鄉,5666,14517,7663,6854
2018/9/1,澎湖縣,白沙鄉,3442,9839,5145,4694
2018/9/1,澎湖縣,西嶼鄉,3042,8405,4331,4074
2018/9/1,澎湖縣,望安鄉,2031,5237,2831,2406
2018/9/1,澎湖縣,七美鄉,1386,3867,1999,1868
2018/9/1,基隆市,中正區,22699,51734,26384,25350
2018/9/1,基隆市,七堵區,21597,53842,27040,26802
2018/9/1,基隆市,暖暖區,15716,38630,19345,19285
2018/9/1,基隆市,仁愛區,19144,43970,21756,22214
2018/9/1,基隆市,中山區,19289,47460,24047,23413
2018/9/1,基隆市,安樂區,33611,82269,40708,41561
2018/9/1,基隆市,信義區,21629,52463,25860,26603
2018/9/1,新竹市,東區,80478,214812,105629,109183
2018/9/1,新竹市,北區,57237,151344,73885,77459
2018/9/1,新竹市,香山區,27506,78250,39721,38529
2018/9/1,嘉義市,東區,45533,121314,58345,62969
2018/9/1,嘉義市,西區,54446,147385,72119,75266
2018/9/1,金門縣,金城鎮,12977,43287,21561,21726
2018/9/1,金門縣,金湖鎮,9011,29623,14847,14776
2018/9/1,金門縣,金沙鎮,6348,20732,10254,10478
2018/9/1,金門縣,金寧鄉,8791,31550,15905,15645
2018/9/1,金門縣,烈嶼鄉,3180,12848,6334,6514
2018/9/1,金門縣,烏坵鄉,135,684,347,337
2018/9/1,連江縣,南竿鄉,1757,7654,4309,3345
2018/9/1,連江縣,北竿鄉,632,2422,1354,1068
2018/9/1,連江縣,莒光鄉,295,1632,996,636
2018/9/1,連江縣,東引鄉,337,1350,803,547
2018/10/1,總計,新北市,1559659,3992291,1953850,2038441
2018/10/1,總計,臺北市,1056354,2669874,1274295,1395579
2018/10/1,總計,桃園市,805264,2215615,1101810,1113805
2018/10/1,總計,臺中市,970332,2799254,1378353,1420901
2018/10/1,總計,臺南市,688573,1883804,940121,943683
2018/10/1,總計,高雄市,1098892,2772624,1371823,1400801
2018/10/1,總計,臺灣省,2501221,7095464,3614627,3480837
2018/10/1,總計,宜蘭縣,169380,455508,230191,225317
2018/10/1,總計,新竹縣,194694,556307,284125,272182
2018/10/1,總計,苗栗縣,189130,549798,283700,266098
2018/10/1,總計,彰化縣,389335,1278437,651107,627330
2018/10/1,總計,南投縣,178270,497876,254993,242883
2018/10/1,總計,雲林縣,241069,687195,356130,331065
2018/10/1,總計,嘉義縣,183173,507780,263870,243910
2018/10/1,總計,屏東縣,287794,826779,422287,404492
2018/10/1,總計,臺東縣,82994,219268,113066,106202
2018/10/1,總計,花蓮縣,126075,328331,166450,161881
2018/10/1,總計,澎湖縣,40467,104400,53777,50623
2018/10/1,總計,基隆市,153615,370269,185037,185232
2018/10/1,總計,新竹市,165264,444775,219393,225382
2018/10/1,總計,嘉義市,99961,268741,130501,138240
2018/10/1,總計,福建省,43505,151907,76730,75177
2018/10/1,總計,金門縣,40473,138845,69269,69576
2018/10/1,總計,連江縣,3032,13062,7461,5601
2018/10/1,新北市,板橋區,212204,554357,270304,284053
2018/10/1,新北市,三重區,151808,386077,189724,196353
2018/10/1,新北市,中和區,165998,412545,200192,212353
2018/10/1,新北市,永和區,91109,221123,104916,116207
2018/10/1,新北市,新莊區,155293,417405,203633,213772
2018/10/1,新北市,新店區,127571,302055,145090,156965
2018/10/1,新北市,樹林區,66682,183780,91624,92156
2018/10/1,新北市,鶯歌區,30238,86223,43218,43005
2018/10/1,新北市,三峽區,43163,115712,57928,57784
2018/10/1,新北市,淡水區,76832,172677,82720,89957
2018/10/1,新北市,汐止區,87824,200217,97570,102647
2018/10/1,新北市,瑞芳區,16172,40022,20184,19838
2018/10/1,新北市,土城區,87249,236964,116737,120227
2018/10/1,新北市,蘆洲區,71619,201173,98785,102388
2018/10/1,新北市,五股區,32438,86156,43418,42738
2018/10/1,新北市,泰山區,28586,78683,38923,39760
2018/10/1,新北市,林口區,43628,108950,52967,55983
2018/10/1,新北市,深坑區,9632,23617,11832,11785
2018/10/1,新北市,石碇區,3399,7727,4227,3500
2018/10/1,新北市,坪林區,2522,6570,3612,2958
2018/10/1,新北市,三芝區,9527,23010,11847,11163
2018/10/1,新北市,石門區,4320,12158,6292,5866
2018/10/1,新北市,八里區,14857,38861,19403,19458
2018/10/1,新北市,平溪區,2294,4687,2594,2093
2018/10/1,新北市,雙溪區,3804,8872,4796,4076
2018/10/1,新北市,貢寮區,4367,12364,6299,6065
2018/10/1,新北市,金山區,7134,21821,10754,11067
2018/10/1,新北市,萬里區,7491,22102,11124,10978
2018/10/1,新北市,烏來區,1898,6383,3137,3246
2018/10/1,臺北市,松山區,81128,205826,96504,109322
2018/10/1,臺北市,信義區,89625,223594,106595,116999
2018/10/1,臺北市,大安區,121422,308835,143978,164857
2018/10/1,臺北市,中山區,100583,229680,106777,122903
2018/10/1,臺北市,中正區,65494,159026,75899,83127
2018/10/1,臺北市,大同區,51833,127833,62298,65535
2018/10/1,臺北市,萬華區,78780,189875,93143,96732
2018/10/1,臺北市,文山區,106542,273883,131260,142623
2018/10/1,臺北市,南港區,47358,121769,59479,62290
2018/10/1,臺北市,內湖區,108673,287227,137158,150069
2018/10/1,臺北市,士林區,107554,286695,138206,148489
2018/10/1,臺北市,北投區,97362,255631,122998,132633
2018/10/1,桃園市,桃園區,169037,446246,216540,229706
2018/10/1,桃園市,中壢區,152844,411135,202258,208877
2018/10/1,桃園市,大溪區,32760,94862,48302,46560
2018/10/1,桃園市,楊梅區,59220,169991,85559,84432
2018/10/1,桃園市,蘆竹區,59313,164057,81391,82666
2018/10/1,桃園市,大園區,33456,90407,46160,44247
2018/10/1,桃園市,龜山區,62522,160182,79670,80512
2018/10/1,桃園市,八德區,71996,201493,100687,100806
2018/10/1,桃園市,龍潭區,42444,122981,61517,61464
2018/10/1,桃園市,平鎮區,78150,225897,112159,113738
2018/10/1,桃園市,新屋區,16509,49159,26144,23015
2018/10/1,桃園市,觀音區,23176,67208,34928,32280
2018/10/1,桃園市,復興區,3837,11997,6495,5502
2018/10/1,臺中市,中區,7982,18557,9189,9368
2018/10/1,臺中市,東區,28255,76070,37809,38261
2018/10/1,臺中市,南區,48949,125726,60334,65392
2018/10/1,臺中市,西區,45793,115551,54821,60730
2018/10/1,臺中市,北區,59702,147528,70519,77009
2018/10/1,臺中市,西屯區,86810,228128,109414,118714
2018/10/1,臺中市,南屯區,63123,170160,81336,88824
2018/10/1,臺中市,北屯區,101998,278096,133243,144853
2018/10/1,臺中市,豐原區,54213,166867,82391,84476
2018/10/1,臺中市,東勢區,17391,50308,25800,24508
2018/10/1,臺中市,大甲區,23301,77697,39018,38679
2018/10/1,臺中市,清水區,27661,86659,44437,42222
2018/10/1,臺中市,沙鹿區,30079,93720,47275,46445
2018/10/1,臺中市,梧棲區,18001,58189,29153,29036
2018/10/1,臺中市,后里區,16441,54682,27749,26933
2018/10/1,臺中市,神岡區,19642,65692,33460,32232
2018/10/1,臺中市,潭子區,36649,108777,53728,55049
2018/10/1,臺中市,大雅區,29952,95703,47654,48049
2018/10/1,臺中市,新社區,7611,24605,12763,11842
2018/10/1,臺中市,石岡區,4914,14968,7745,7223
2018/10/1,臺中市,外埔區,9807,32202,16449,15753
2018/10/1,臺中市,大安區,5533,19250,10158,9092
2018/10/1,臺中市,烏日區,25071,75275,37701,37574
2018/10/1,臺中市,大肚區,17814,57267,29236,28031
2018/10/1,臺中市,龍井區,23361,77922,39191,38731
2018/10/1,臺中市,霧峰區,20442,65632,33215,32417
2018/10/1,臺中市,太平區,65072,191097,94717,96380
2018/10/1,臺中市,大里區,70157,211860,103929,107931
2018/10/1,臺中市,和平區,4608,11066,5919,5147
2018/10/1,臺南市,新營區,29074,77651,38446,39205
2018/10/1,臺南市,鹽水區,10029,25397,13258,12139
2018/10/1,臺南市,白河區,10793,28152,14702,13450
2018/10/1,臺南市,柳營區,7923,21212,11061,10151
2018/10/1,臺南市,後壁區,8812,23424,12168,11256
2018/10/1,臺南市,東山區,8337,20870,11071,9799
2018/10/1,臺南市,麻豆區,15834,44306,22520,21786
2018/10/1,臺南市,下營區,9051,23938,12354,11584
2018/10/1,臺南市,六甲區,7806,22196,11476,10720
2018/10/1,臺南市,官田區,7946,21329,10863,10466
2018/10/1,臺南市,大內區,3834,9643,5209,4434
2018/10/1,臺南市,佳里區,20819,59087,29290,29797
2018/10/1,臺南市,學甲區,9629,25725,13163,12562
2018/10/1,臺南市,西港區,8270,24724,12471,12253
2018/10/1,臺南市,七股區,8034,22810,11809,11001
2018/10/1,臺南市,將軍區,7280,19691,10037,9654
2018/10/1,臺南市,北門區,4222,11099,5612,5487
2018/10/1,臺南市,新化區,14473,43516,22142,21374
2018/10/1,臺南市,善化區,17982,48870,24549,24321
2018/10/1,臺南市,新市區,12547,36824,18421,18403
2018/10/1,臺南市,安定區,10203,30522,15701,14821
2018/10/1,臺南市,山上區,2729,7328,3824,3504
2018/10/1,臺南市,玉井區,5152,14021,7238,6783
2018/10/1,臺南市,楠西區,3523,9572,5060,4512
2018/10/1,臺南市,南化區,2853,8741,4707,4034
2018/10/1,臺南市,左鎮區,1952,4801,2699,2102
2018/10/1,臺南市,仁德區,27891,75797,38315,37482
2018/10/1,臺南市,歸仁區,22895,68391,34681,33710
2018/10/1,臺南市,關廟區,11236,34387,17734,16653
2018/10/1,臺南市,龍崎區,1537,3999,2148,1851
2018/10/1,臺南市,永康區,85246,234921,115666,119255
2018/10/1,臺南市,東區,72151,186117,89132,96985
2018/10/1,臺南市,南區,46007,124790,61702,63088
2018/10/1,臺南市,北區,51117,132020,64122,67898
2018/10/1,臺南市,安南區,63746,193163,97401,95762
2018/10/1,臺南市,安平區,25971,66677,31656,35021
2018/10/1,臺南市,中西區,31669,78093,37713,40380
2018/10/1,高雄市,鹽埕區,10799,24098,11961,12137
2018/10/1,高雄市,鼓山區,58742,139894,67424,72470
2018/10/1,高雄市,左營區,79302,196749,94497,102252
2018/10/1,高雄市,楠梓區,71929,185318,90885,94433
2018/10/1,高雄市,三民區,137118,341230,164892,176338
2018/10/1,高雄市,新興區,22939,50942,24465,26477
2018/10/1,高雄市,前金區,12634,26732,12699,14033
2018/10/1,高雄市,苓雅區,72270,169840,81575,88265
2018/10/1,高雄市,前鎮區,78776,188516,92613,95903
2018/10/1,高雄市,旗津區,11103,28533,14689,13844
2018/10/1,高雄市,小港區,68531,157685,78272,79413
2018/10/1,高雄市,鳳山區,141761,359100,175825,183275
2018/10/1,高雄市,林園區,26073,69829,35253,34576
2018/10/1,高雄市,大寮區,42482,112334,57425,54909
2018/10/1,高雄市,大樹區,13656,42431,21731,20700
2018/10/1,高雄市,大社區,13134,34591,17511,17080
2018/10/1,高雄市,仁武區,34048,87415,44326,43089
2018/10/1,高雄市,鳥松區,18503,44387,22479,21908
2018/10/1,高雄市,岡山區,35056,97072,48146,48926
2018/10/1,高雄市,橋頭區,13776,37647,19066,18581
2018/10/1,高雄市,燕巢區,10620,29809,15680,14129
2018/10/1,高雄市,田寮區,3252,7196,3975,3221
2018/10/1,高雄市,阿蓮區,9427,28676,14466,14210
2018/10/1,高雄市,路竹區,17138,52578,26829,25749
2018/10/1,高雄市,湖內區,10953,29812,15245,14567
2018/10/1,高雄市,茄萣區,10545,30055,15449,14606
2018/10/1,高雄市,永安區,5736,13888,6997,6891
2018/10/1,高雄市,彌陀區,6789,19266,9883,9383
2018/10/1,高雄市,梓官區,12681,35896,18471,17425
2018/10/1,高雄市,旗山區,13722,36695,18954,17741
2018/10/1,高雄市,美濃區,14791,39630,20765,18865
2018/10/1,高雄市,六龜區,5573,12984,7002,5982
2018/10/1,高雄市,甲仙區,2300,6051,3208,2843
2018/10/1,高雄市,杉林區,4811,11828,6466,5362
2018/10/1,高雄市,內門區,5123,14465,7816,6649
2018/10/1,高雄市,茂林區,600,1999,1008,991
2018/10/1,高雄市,桃源區,1358,4310,2266,2044
2018/10/1,高雄市,那瑪夏區,841,3143,1609,1534
2018/10/1,宜蘭縣,宜蘭市,36553,95747,46628,49119
2018/10/1,宜蘭縣,羅東鎮,26482,72457,34292,38165
2018/10/1,宜蘭縣,蘇澳鎮,14223,39785,20266,19519
2018/10/1,宜蘭縣,頭城鎮,10270,29173,15033,14140
2018/10/1,宜蘭縣,礁溪鄉,14182,35668,18556,17112
2018/10/1,宜蘭縣,壯圍鄉,8919,24315,12835,11480
2018/10/1,宜蘭縣,員山鄉,11736,32281,17111,15170
2018/10/1,宜蘭縣,冬山鄉,19399,52843,27107,25736
2018/10/1,宜蘭縣,五結鄉,15081,39577,20430,19147
2018/10/1,宜蘭縣,三星鄉,8641,21391,11492,9899
2018/10/1,宜蘭縣,大同鄉,1922,6247,3338,2909
2018/10/1,宜蘭縣,南澳鄉,1972,6024,3103,2921
2018/10/1,新竹縣,竹北市,68049,186411,92823,93588
2018/10/1,新竹縣,關西鎮,9416,28659,15359,13300
2018/10/1,新竹縣,新埔鎮,10761,33106,17651,15455
2018/10/1,新竹縣,竹東鎮,34118,96358,48350,48008
2018/10/1,新竹縣,湖口鄉,26953,77604,39287,38317
2018/10/1,新竹縣,橫山鄉,4439,13013,7048,5965
2018/10/1,新竹縣,新豐鄉,18794,56957,29217,27740
2018/10/1,新竹縣,芎林鄉,6594,20043,10608,9435
2018/10/1,新竹縣,寶山鄉,5683,14681,7957,6724
2018/10/1,新竹縣,北埔鄉,3131,9352,5075,4277
2018/10/1,新竹縣,峨眉鄉,2093,5638,3094,2544
2018/10/1,新竹縣,尖石鄉,2889,9683,5088,4595
2018/10/1,新竹縣,五峰鄉,1774,4802,2568,2234
2018/10/1,苗栗縣,苗栗市,31511,88300,44065,44235
2018/10/1,苗栗縣,頭份市,35248,103007,51956,51051
2018/10/1,苗栗縣,苑裡鎮,14703,45367,23641,21726
2018/10/1,苗栗縣,通霄鎮,11579,34122,18046,16076
2018/10/1,苗栗縣,竹南鎮,29813,86056,43459,42597
2018/10/1,苗栗縣,後龍鎮,11975,36332,19254,17078
2018/10/1,苗栗縣,卓蘭鎮,6020,16818,8807,8011
2018/10/1,苗栗縣,大湖鄉,5381,14521,7705,6816
2018/10/1,苗栗縣,公館鄉,10748,33327,17405,15922
2018/10/1,苗栗縣,銅鑼鄉,6149,17922,9545,8377
2018/10/1,苗栗縣,南庄鄉,3946,10130,5551,4579
2018/10/1,苗栗縣,頭屋鄉,3645,10711,5675,5036
2018/10/1,苗栗縣,三義鄉,5559,16277,8602,7675
2018/10/1,苗栗縣,西湖鄉,2631,7072,3950,3122
2018/10/1,苗栗縣,造橋鄉,4134,12728,6715,6013
2018/10/1,苗栗縣,三灣鄉,2391,6662,3646,3016
2018/10/1,苗栗縣,獅潭鄉,1716,4370,2441,1929
2018/10/1,苗栗縣,泰安鄉,1981,6076,3237,2839
2018/10/1,彰化縣,彰化市,76700,232709,114845,117864
2018/10/1,彰化縣,員林市,39774,124755,62016,62739
2018/10/1,彰化縣,鹿港鎮,24679,86762,44057,42705
2018/10/1,彰化縣,和美鎮,26961,90786,46144,44642
2018/10/1,彰化縣,北斗鎮,10756,33335,16797,16538
2018/10/1,彰化縣,溪湖鎮,16399,55412,28046,27366
2018/10/1,彰化縣,田中鎮,13207,41599,21416,20183
2018/10/1,彰化縣,二林鎮,15117,50709,26084,24625
2018/10/1,彰化縣,線西鄉,4440,16872,8651,8221
2018/10/1,彰化縣,伸港鄉,10126,37062,18912,18150
2018/10/1,彰化縣,福興鄉,12976,47166,24568,22598
2018/10/1,彰化縣,秀水鄉,10844,39300,20276,19024
2018/10/1,彰化縣,花壇鄉,14200,45922,23538,22384
2018/10/1,彰化縣,芬園鄉,6840,23594,12407,11187
2018/10/1,彰化縣,大村鄉,11183,36907,19066,17841
2018/10/1,彰化縣,埔鹽鄉,9137,32517,17089,15428
2018/10/1,彰化縣,埔心鄉,10706,34739,17878,16861
2018/10/1,彰化縣,永靖鄉,10936,37055,19183,17872
2018/10/1,彰化縣,社頭鄉,12974,42917,22068,20849
2018/10/1,彰化縣,二水鄉,5299,15193,7961,7232
2018/10/1,彰化縣,田尾鄉,7991,27346,14086,13260
2018/10/1,彰化縣,埤頭鄉,9106,30536,15806,14730
2018/10/1,彰化縣,芳苑鄉,10135,33549,17693,15856
2018/10/1,彰化縣,大城鄉,5239,16781,9049,7732
2018/10/1,彰化縣,竹塘鄉,4618,15117,7924,7193
2018/10/1,彰化縣,溪州鄉,8992,29797,15547,14250
2018/10/1,南投縣,南投市,34902,99538,49816,49722
2018/10/1,南投縣,埔里鎮,28952,80408,40019,40389
2018/10/1,南投縣,草屯鎮,33320,97223,49203,48020
2018/10/1,南投縣,竹山鎮,20141,54689,28031,26658
2018/10/1,南投縣,集集鎮,4318,10871,5661,5210
2018/10/1,南投縣,名間鄉,12623,38376,20226,18150
2018/10/1,南投縣,鹿谷鄉,8039,17698,9436,8262
2018/10/1,南投縣,中寮鄉,5629,14734,7998,6736
2018/10/1,南投縣,魚池鄉,5756,15823,8340,7483
2018/10/1,南投縣,國姓鄉,7304,18699,10084,8615
2018/10/1,南投縣,水里鄉,7119,17582,9224,8358
2018/10/1,南投縣,信義鄉,5276,16281,8710,7571
2018/10/1,南投縣,仁愛鄉,4891,15954,8245,7709
2018/10/1,雲林縣,斗六市,38537,108487,53901,54586
2018/10/1,雲林縣,斗南鎮,15902,44608,22653,21955
2018/10/1,雲林縣,虎尾鎮,25222,70892,35886,35006
2018/10/1,雲林縣,西螺鎮,14818,46135,23298,22837
2018/10/1,雲林縣,土庫鎮,9439,28827,15025,13802
2018/10/1,雲林縣,北港鎮,16050,39975,20616,19359
2018/10/1,雲林縣,古坑鄉,11032,31464,16572,14892
2018/10/1,雲林縣,大埤鄉,6638,19083,10228,8855
2018/10/1,雲林縣,莿桐鄉,9383,28727,15019,13708
2018/10/1,雲林縣,林內鄉,6034,18089,9451,8638
2018/10/1,雲林縣,二崙鄉,8927,26906,14384,12522
2018/10/1,雲林縣,崙背鄉,8521,24427,12900,11527
2018/10/1,雲林縣,麥寮鄉,14485,46004,23048,22956
2018/10/1,雲林縣,東勢鄉,5736,14845,8206,6639
2018/10/1,雲林縣,褒忠鄉,4442,12992,6983,6009
2018/10/1,雲林縣,臺西鄉,8658,23824,12772,11052
2018/10/1,雲林縣,元長鄉,9240,25784,14112,11672
2018/10/1,雲林縣,四湖鄉,8720,23317,12629,10688
2018/10/1,雲林縣,口湖鄉,9429,27383,14592,12791
2018/10/1,雲林縣,水林鄉,9856,25426,13855,11571
2018/10/1,嘉義縣,太保市,13183,38048,19488,18560
2018/10/1,嘉義縣,朴子市,15752,42143,21254,20889
2018/10/1,嘉義縣,布袋鎮,9925,26846,13710,13136
2018/10/1,嘉義縣,大林鎮,11389,30954,15853,15101
2018/10/1,嘉義縣,民雄鄉,25115,71327,36492,34835
2018/10/1,嘉義縣,溪口鄉,5313,14670,7845,6825
2018/10/1,嘉義縣,新港鄉,10704,31755,16712,15043
2018/10/1,嘉義縣,六腳鄉,8822,23049,12220,10829
2018/10/1,嘉義縣,東石鄉,9194,24658,13050,11608
2018/10/1,嘉義縣,義竹鄉,7338,18297,9513,8784
2018/10/1,嘉義縣,鹿草鄉,5748,15422,8275,7147
2018/10/1,嘉義縣,水上鄉,18152,49406,25523,23883
2018/10/1,嘉義縣,中埔鄉,16031,44605,23212,21393
2018/10/1,嘉義縣,竹崎鄉,11687,35625,18955,16670
2018/10/1,嘉義縣,梅山鄉,6767,19303,10271,9032
2018/10/1,嘉義縣,番路鄉,4231,11470,6193,5277
2018/10/1,嘉義縣,大埔鄉,1921,4592,2365,2227
2018/10/1,嘉義縣,阿里山鄉,1901,5610,2939,2671
2018/10/1,屏東縣,屏東市,74564,199807,98591,101216
2018/10/1,屏東縣,潮州鎮,19519,53924,26930,26994
2018/10/1,屏東縣,東港鎮,16827,47654,24084,23570
2018/10/1,屏東縣,恆春鎮,11663,30812,15803,15009
2018/10/1,屏東縣,萬丹鄉,15069,50595,26276,24319
2018/10/1,屏東縣,長治鄉,10172,29714,15493,14221
2018/10/1,屏東縣,麟洛鄉,3846,11068,5728,5340
2018/10/1,屏東縣,九如鄉,7056,22095,11409,10686
2018/10/1,屏東縣,里港鄉,8211,26092,13276,12816
2018/10/1,屏東縣,鹽埔鄉,7881,25740,13366,12374
2018/10/1,屏東縣,高樹鄉,9262,24444,13041,11403
2018/10/1,屏東縣,萬巒鄉,6524,20585,10717,9868
2018/10/1,屏東縣,內埔鄉,18687,54167,27974,26193
2018/10/1,屏東縣,竹田鄉,5657,17181,9125,8056
2018/10/1,屏東縣,新埤鄉,3461,10035,5332,4703
2018/10/1,屏東縣,枋寮鄉,8550,24413,12759,11654
2018/10/1,屏東縣,新園鄉,11820,34961,18095,16866
2018/10/1,屏東縣,崁頂鄉,4499,15524,7830,7694
2018/10/1,屏東縣,林邊鄉,6691,17842,9116,8726
2018/10/1,屏東縣,南州鄉,3715,10650,5442,5208
2018/10/1,屏東縣,佳冬鄉,6971,19172,9963,9209
2018/10/1,屏東縣,琉球鄉,4527,12395,6783,5612
2018/10/1,屏東縣,車城鄉,3488,8619,4625,3994
2018/10/1,屏東縣,滿州鄉,3048,8068,4357,3711
2018/10/1,屏東縣,枋山鄉,2101,5547,2946,2601
2018/10/1,屏東縣,三地門鄉,2330,7694,3856,3838
2018/10/1,屏東縣,霧臺鄉,1060,3376,1719,1657
2018/10/1,屏東縣,瑪家鄉,2063,6833,3450,3383
2018/10/1,屏東縣,泰武鄉,1357,5403,2827,2576
2018/10/1,屏東縣,來義鄉,2233,7445,3758,3687
2018/10/1,屏東縣,春日鄉,1413,4903,2509,2394
2018/10/1,屏東縣,獅子鄉,1580,5018,2575,2443
2018/10/1,屏東縣,牡丹鄉,1949,5003,2532,2471
2018/10/1,臺東縣,臺東市,39841,105587,52805,52782
2018/10/1,臺東縣,成功鎮,5361,14105,7420,6685
2018/10/1,臺東縣,關山鎮,3159,8727,4540,4187
2018/10/1,臺東縣,卑南鄉,6712,17314,9128,8186
2018/10/1,臺東縣,大武鄉,2483,6100,3165,2935
2018/10/1,臺東縣,太麻里鄉,4738,11186,5960,5226
2018/10/1,臺東縣,東河鄉,3758,8518,4717,3801
2018/10/1,臺東縣,長濱鄉,2915,7196,4087,3109
2018/10/1,臺東縣,鹿野鄉,3046,7891,4177,3714
2018/10/1,臺東縣,池上鄉,3202,8207,4269,3938
2018/10/1,臺東縣,綠島鄉,1155,4097,2184,1913
2018/10/1,臺東縣,延平鄉,1070,3656,1945,1711
2018/10/1,臺東縣,海端鄉,1091,4207,2232,1975
2018/10/1,臺東縣,達仁鄉,1446,3615,1963,1652
2018/10/1,臺東縣,金峰鄉,1146,3748,1891,1857
2018/10/1,臺東縣,蘭嶼鄉,1871,5114,2583,2531
2018/10/1,花蓮縣,花蓮市,41450,103798,49995,53803
2018/10/1,花蓮縣,鳳林鎮,4404,10902,5665,5237
2018/10/1,花蓮縣,玉里鎮,8865,24066,12714,11352
2018/10/1,花蓮縣,新城鄉,7730,20112,10308,9804
2018/10/1,花蓮縣,吉安鄉,32164,83262,41901,41361
2018/10/1,花蓮縣,壽豐鄉,7263,18006,9523,8483
2018/10/1,花蓮縣,光復鄉,5024,12847,6823,6024
2018/10/1,花蓮縣,豐濱鄉,1725,4811,2662,2149
2018/10/1,花蓮縣,瑞穗鄉,4771,11716,6336,5380
2018/10/1,花蓮縣,富里鄉,4040,10331,5611,4720
2018/10/1,花蓮縣,秀林鄉,4838,15937,8174,7763
2018/10/1,花蓮縣,萬榮鄉,2109,6439,3386,3053
2018/10/1,花蓮縣,卓溪鄉,1692,6104,3352,2752
2018/10/1,澎湖縣,馬公市,24891,62523,31795,30728
2018/10/1,澎湖縣,湖西鄉,5670,14533,7677,6856
2018/10/1,澎湖縣,白沙鄉,3450,9856,5153,4703
2018/10/1,澎湖縣,西嶼鄉,3040,8396,4327,4069
2018/10/1,澎湖縣,望安鄉,2029,5237,2829,2408
2018/10/1,澎湖縣,七美鄉,1387,3855,1996,1859
2018/10/1,基隆市,中正區,22679,51716,26357,25359
2018/10/1,基隆市,七堵區,21580,53819,27019,26800
2018/10/1,基隆市,暖暖區,15709,38606,19316,19290
2018/10/1,基隆市,仁愛區,19118,43950,21749,22201
2018/10/1,基隆市,中山區,19282,47428,24027,23401
2018/10/1,基隆市,安樂區,33614,82263,40696,41567
2018/10/1,基隆市,信義區,21633,52487,25873,26614
2018/10/1,新竹市,東區,80487,215079,105731,109348
2018/10/1,新竹市,北區,57248,151391,73908,77483
2018/10/1,新竹市,香山區,27529,78305,39754,38551
2018/10/1,嘉義市,東區,45515,121279,58335,62944
2018/10/1,嘉義市,西區,54446,147462,72166,75296
2018/10/1,金門縣,金城鎮,12984,43315,21553,21762
2018/10/1,金門縣,金湖鎮,9018,29658,14855,14803
2018/10/1,金門縣,金沙鎮,6353,20751,10265,10486
2018/10/1,金門縣,金寧鄉,8801,31588,15914,15674
2018/10/1,金門縣,烈嶼鄉,3182,12847,6334,6513
2018/10/1,金門縣,烏坵鄉,135,686,348,338
2018/10/1,連江縣,南竿鄉,1762,7657,4311,3346
2018/10/1,連江縣,北竿鄉,638,2430,1357,1073
2018/10/1,連江縣,莒光鄉,295,1627,993,634
2018/10/1,連江縣,東引鄉,337,1348,800,548
2018/11/1,總計,新北市,1560489,3993872,1954395,2039477
2018/11/1,總計,臺北市,1056190,2669634,1274089,1395545
2018/11/1,總計,桃園市,806071,2217776,1102746,1115030
2018/11/1,總計,臺中市,971054,2801238,1378998,1422240
2018/11/1,總計,臺南市,688692,1883760,939972,943788
2018/11/1,總計,高雄市,1099109,2773001,1371881,1401120
2018/11/1,總計,臺灣省,2501677,7093579,3613424,3480155
2018/11/1,總計,宜蘭縣,169417,455376,230110,225266
2018/11/1,總計,新竹縣,194905,556622,284277,272345
2018/11/1,總計,苗栗縣,189168,549405,283454,265951
2018/11/1,總計,彰化縣,389424,1278371,651016,627355
2018/11/1,總計,南投縣,178253,497486,254763,242723
2018/11/1,總計,雲林縣,241015,686674,355889,330785
2018/11/1,總計,嘉義縣,183134,507462,263681,243781
2018/11/1,總計,屏東縣,287798,826323,422004,404319
2018/11/1,總計,臺東縣,83016,219145,112979,106166
2018/11/1,總計,花蓮縣,126162,328264,166421,161843
2018/11/1,總計,澎湖縣,40529,104441,53807,50634
2018/11/1,總計,基隆市,153524,370206,185019,185187
2018/11/1,總計,新竹市,165379,445107,219547,225560
2018/11/1,總計,嘉義市,99953,268697,130457,138240
2018/11/1,總計,福建省,43566,152005,76764,75241
2018/11/1,總計,金門縣,40523,138963,69326,69637
2018/11/1,總計,連江縣,3043,13042,7438,5604
2018/11/1,新北市,板橋區,212393,554528,270340,284188
2018/11/1,新北市,三重區,151803,385983,189695,196288
2018/11/1,新北市,中和區,166016,412618,200163,212455
2018/11/1,新北市,永和區,91098,221076,104853,116223
2018/11/1,新北市,新莊區,155384,417639,203699,213940
2018/11/1,新北市,新店區,127568,302075,145077,156998
2018/11/1,新北市,樹林區,66693,183881,91673,92208
2018/11/1,新北市,鶯歌區,30295,86271,43244,43027
2018/11/1,新北市,三峽區,43179,115766,57936,57830
2018/11/1,新北市,淡水區,76992,172982,82848,90134
2018/11/1,新北市,汐止區,87886,200339,97628,102711
2018/11/1,新北市,瑞芳區,16153,40002,20164,19838
2018/11/1,新北市,土城區,87236,236965,116760,120205
2018/11/1,新北市,蘆洲區,71662,201236,98805,102431
2018/11/1,新北市,五股區,32470,86209,43462,42747
2018/11/1,新北市,泰山區,28599,78662,38914,39748
2018/11/1,新北市,林口區,43819,109533,53240,56293
2018/11/1,新北市,深坑區,9635,23626,11838,11788
2018/11/1,新北市,石碇區,3395,7716,4219,3497
2018/11/1,新北市,坪林區,2520,6579,3618,2961
2018/11/1,新北市,三芝區,9531,23012,11853,11159
2018/11/1,新北市,石門區,4316,12126,6274,5852
2018/11/1,新北市,八里區,14871,38896,19421,19475
2018/11/1,新北市,平溪區,2289,4674,2591,2083
2018/11/1,新北市,雙溪區,3801,8872,4797,4075
2018/11/1,新北市,貢寮區,4370,12328,6283,6045
2018/11/1,新北市,金山區,7130,21781,10738,11043
2018/11/1,新北市,萬里區,7484,22093,11118,10975
2018/11/1,新北市,烏來區,1901,6404,3144,3260
2018/11/1,臺北市,松山區,81083,205688,96419,109269
2018/11/1,臺北市,信義區,89598,223530,106537,116993
2018/11/1,臺北市,大安區,121376,308887,144007,164880
2018/11/1,臺北市,中山區,100531,229654,106776,122878
2018/11/1,臺北市,中正區,65473,159002,75927,83075
2018/11/1,臺北市,大同區,51814,127774,62247,65527
2018/11/1,臺北市,萬華區,78761,189729,93047,96682
2018/11/1,臺北市,文山區,106562,273872,131240,142632
2018/11/1,臺北市,南港區,47340,121705,59438,62267
2018/11/1,臺北市,內湖區,108711,287374,137219,150155
2018/11/1,臺北市,士林區,107545,286701,138170,148531
2018/11/1,臺北市,北投區,97396,255718,123062,132656
2018/11/1,桃園市,桃園區,169234,446671,216738,229933
2018/11/1,桃園市,中壢區,152973,411555,202430,209125
2018/11/1,桃園市,大溪區,32779,94845,48296,46549
2018/11/1,桃園市,楊梅區,59302,170160,85643,84517
2018/11/1,桃園市,蘆竹區,59351,164205,81482,82723
2018/11/1,桃園市,大園區,33514,90583,46231,44352
2018/11/1,桃園市,龜山區,62556,160324,79760,80564
2018/11/1,桃園市,八德區,72076,201730,100775,100955
2018/11/1,桃園市,龍潭區,42473,123081,61551,61530
2018/11/1,桃園市,平鎮區,78212,226146,112242,113904
2018/11/1,桃園市,新屋區,16540,49187,26151,23036
2018/11/1,桃園市,觀音區,23223,67281,34952,32329
2018/11/1,桃園市,復興區,3838,12008,6495,5513
2018/11/1,臺中市,中區,7971,18533,9158,9375
2018/11/1,臺中市,東區,28257,76088,37812,38276
2018/11/1,臺中市,南區,48989,125823,60364,65459
2018/11/1,臺中市,西區,45774,115576,54813,60763
2018/11/1,臺中市,北區,59701,147586,70539,77047
2018/11/1,臺中市,西屯區,86887,228332,109473,118859
2018/11/1,臺中市,南屯區,63189,170377,81410,88967
2018/11/1,臺中市,北屯區,102155,278605,133449,145156
2018/11/1,臺中市,豐原區,54229,166954,82437,84517
2018/11/1,臺中市,東勢區,17395,50291,25783,24508
2018/11/1,臺中市,大甲區,23309,77670,38995,38675
2018/11/1,臺中市,清水區,27710,86763,44498,42265
2018/11/1,臺中市,沙鹿區,30112,93884,47331,46553
2018/11/1,臺中市,梧棲區,17998,58166,29130,29036
2018/11/1,臺中市,后里區,16455,54717,27763,26954
2018/11/1,臺中市,神岡區,19669,65695,33456,32239
2018/11/1,臺中市,潭子區,36665,108840,53741,55099
2018/11/1,臺中市,大雅區,29974,95759,47657,48102
2018/11/1,臺中市,新社區,7611,24597,12758,11839
2018/11/1,臺中市,石岡區,4917,14967,7740,7227
2018/11/1,臺中市,外埔區,9806,32218,16449,15769
2018/11/1,臺中市,大安區,5538,19263,10159,9104
2018/11/1,臺中市,烏日區,25056,75272,37693,37579
2018/11/1,臺中市,大肚區,17839,57330,29274,28056
2018/11/1,臺中市,龍井區,23363,77941,39191,38750
2018/11/1,臺中市,霧峰區,20450,65649,33242,32407
2018/11/1,臺中市,太平區,65220,191378,94837,96541
2018/11/1,臺中市,大里區,70213,211924,103941,107983
2018/11/1,臺中市,和平區,4602,11040,5905,5135
2018/11/1,臺南市,新營區,29082,77632,38430,39202
2018/11/1,臺南市,鹽水區,10039,25393,13253,12140
2018/11/1,臺南市,白河區,10790,28140,14696,13444
2018/11/1,臺南市,柳營區,7926,21215,11064,10151
2018/11/1,臺南市,後壁區,8814,23397,12151,11246
2018/11/1,臺南市,東山區,8339,20836,11049,9787
2018/11/1,臺南市,麻豆區,15826,44295,22508,21787
2018/11/1,臺南市,下營區,9052,23919,12343,11576
2018/11/1,臺南市,六甲區,7800,22172,11457,10715
2018/11/1,臺南市,官田區,7953,21315,10859,10456
2018/11/1,臺南市,大內區,3832,9631,5205,4426
2018/11/1,臺南市,佳里區,20815,59065,29263,29802
2018/11/1,臺南市,學甲區,9619,25704,13147,12557
2018/11/1,臺南市,西港區,8276,24713,12472,12241
2018/11/1,臺南市,七股區,8033,22755,11785,10970
2018/11/1,臺南市,將軍區,7274,19679,10026,9653
2018/11/1,臺南市,北門區,4221,11064,5592,5472
2018/11/1,臺南市,新化區,14471,43477,22125,21352
2018/11/1,臺南市,善化區,17997,48919,24566,24353
2018/11/1,臺南市,新市區,12566,36868,18441,18427
2018/11/1,臺南市,安定區,10208,30510,15707,14803
2018/11/1,臺南市,山上區,2726,7319,3818,3501
2018/11/1,臺南市,玉井區,5153,14020,7231,6789
2018/11/1,臺南市,楠西區,3523,9554,5047,4507
2018/11/1,臺南市,南化區,2852,8742,4705,4037
2018/11/1,臺南市,左鎮區,1950,4787,2690,2097
2018/11/1,臺南市,仁德區,27896,75849,38328,37521
2018/11/1,臺南市,歸仁區,22897,68406,34697,33709
2018/11/1,臺南市,關廟區,11247,34386,17724,16662
2018/11/1,臺南市,龍崎區,1536,4002,2146,1856
2018/11/1,臺南市,永康區,85255,234940,115673,119267
2018/11/1,臺南市,東區,72089,186082,89087,96995
2018/11/1,臺南市,南區,46033,124770,61700,63070
2018/11/1,臺南市,北區,51136,132035,64089,67946
2018/11/1,臺南市,安南區,63802,193313,97481,95832
2018/11/1,臺南市,安平區,25995,66730,31697,35033
2018/11/1,臺南市,中西區,31669,78126,37720,40406
2018/11/1,高雄市,鹽埕區,10803,24094,11961,12133
2018/11/1,高雄市,鼓山區,58746,140035,67492,72543
2018/11/1,高雄市,左營區,79305,196782,94501,102281
2018/11/1,高雄市,楠梓區,71968,185433,90937,94496
2018/11/1,高雄市,三民區,137102,341128,164844,176284
2018/11/1,高雄市,新興區,22916,50963,24467,26496
2018/11/1,高雄市,前金區,12667,26771,12713,14058
2018/11/1,高雄市,苓雅區,72261,169733,81509,88224
2018/11/1,高雄市,前鎮區,78757,188441,92578,95863
2018/11/1,高雄市,旗津區,11107,28523,14687,13836
2018/11/1,高雄市,小港區,68525,157710,78277,79433
2018/11/1,高雄市,鳳山區,141819,359236,175866,183370
2018/11/1,高雄市,林園區,26091,69851,35257,34594
2018/11/1,高雄市,大寮區,42499,112341,57418,54923
2018/11/1,高雄市,大樹區,13661,42422,21735,20687
2018/11/1,高雄市,大社區,13145,34589,17501,17088
2018/11/1,高雄市,仁武區,34118,87565,44399,43166
2018/11/1,高雄市,鳥松區,18533,44431,22487,21944
2018/11/1,高雄市,岡山區,35062,97092,48142,48950
2018/11/1,高雄市,橋頭區,13782,37658,19089,18569
2018/11/1,高雄市,燕巢區,10609,29794,15663,14131
2018/11/1,高雄市,田寮區,3245,7179,3969,3210
2018/11/1,高雄市,阿蓮區,9432,28658,14454,14204
2018/11/1,高雄市,路竹區,17147,52573,26816,25757
2018/11/1,高雄市,湖內區,10947,29788,15233,14555
2018/11/1,高雄市,茄萣區,10545,30076,15454,14622
2018/11/1,高雄市,永安區,5741,13906,7009,6897
2018/11/1,高雄市,彌陀區,6793,19275,9886,9389
2018/11/1,高雄市,梓官區,12670,35889,18463,17426
2018/11/1,高雄市,旗山區,13711,36653,18934,17719
2018/11/1,高雄市,美濃區,14803,39636,20772,18864
2018/11/1,高雄市,六龜區,5576,12982,7001,5981
2018/11/1,高雄市,甲仙區,2293,6039,3204,2835
2018/11/1,高雄市,杉林區,4808,11818,6464,5354
2018/11/1,高雄市,內門區,5122,14473,7813,6660
2018/11/1,高雄市,茂林區,601,1996,1006,990
2018/11/1,高雄市,桃源區,1358,4315,2268,2047
2018/11/1,高雄市,那瑪夏區,841,3153,1612,1541
2018/11/1,宜蘭縣,宜蘭市,36553,95732,46626,49106
2018/11/1,宜蘭縣,羅東鎮,26501,72450,34295,38155
2018/11/1,宜蘭縣,蘇澳鎮,14219,39701,20226,19475
2018/11/1,宜蘭縣,頭城鎮,10272,29155,15026,14129
2018/11/1,宜蘭縣,礁溪鄉,14190,35647,18539,17108
2018/11/1,宜蘭縣,壯圍鄉,8918,24316,12832,11484
2018/11/1,宜蘭縣,員山鄉,11735,32285,17119,15166
2018/11/1,宜蘭縣,冬山鄉,19394,52829,27097,25732
2018/11/1,宜蘭縣,五結鄉,15089,39575,20417,19158
2018/11/1,宜蘭縣,三星鄉,8644,21406,11490,9916
2018/11/1,宜蘭縣,大同鄉,1923,6252,3337,2915
2018/11/1,宜蘭縣,南澳鄉,1979,6028,3106,2922
2018/11/1,新竹縣,竹北市,68200,186752,93005,93747
2018/11/1,新竹縣,關西鎮,9417,28632,15353,13279
2018/11/1,新竹縣,新埔鎮,10771,33143,17668,15475
2018/11/1,新竹縣,竹東鎮,34127,96400,48356,48044
2018/11/1,新竹縣,湖口鄉,26977,77616,39295,38321
2018/11/1,新竹縣,橫山鄉,4434,12973,7026,5947
2018/11/1,新竹縣,新豐鄉,18809,56977,29214,27763
2018/11/1,新竹縣,芎林鄉,6603,20030,10608,9422
2018/11/1,新竹縣,寶山鄉,5687,14669,7943,6726
2018/11/1,新竹縣,北埔鄉,3131,9340,5069,4271
2018/11/1,新竹縣,峨眉鄉,2089,5609,3081,2528
2018/11/1,新竹縣,尖石鄉,2888,9684,5090,4594
2018/11/1,新竹縣,五峰鄉,1772,4797,2569,2228
2018/11/1,苗栗縣,苗栗市,31521,88226,44026,44200
2018/11/1,苗栗縣,頭份市,35295,103040,51971,51069
2018/11/1,苗栗縣,苑裡鎮,14713,45282,23591,21691
2018/11/1,苗栗縣,通霄鎮,11565,34076,18008,16068
2018/11/1,苗栗縣,竹南鎮,29836,86109,43470,42639
2018/11/1,苗栗縣,後龍鎮,11981,36310,19239,17071
2018/11/1,苗栗縣,卓蘭鎮,6003,16779,8782,7997
2018/11/1,苗栗縣,大湖鄉,5378,14498,7695,6803
2018/11/1,苗栗縣,公館鄉,10738,33308,17398,15910
2018/11/1,苗栗縣,銅鑼鄉,6147,17891,9529,8362
2018/11/1,苗栗縣,南庄鄉,3942,10112,5544,4568
2018/11/1,苗栗縣,頭屋鄉,3648,10699,5666,5033
2018/11/1,苗栗縣,三義鄉,5557,16250,8588,7662
2018/11/1,苗栗縣,西湖鄉,2632,7053,3940,3113
2018/11/1,苗栗縣,造橋鄉,4135,12723,6714,6009
2018/11/1,苗栗縣,三灣鄉,2382,6633,3632,3001
2018/11/1,苗栗縣,獅潭鄉,1714,4356,2432,1924
2018/11/1,苗栗縣,泰安鄉,1981,6060,3229,2831
2018/11/1,彰化縣,彰化市,76730,232739,114876,117863
2018/11/1,彰化縣,員林市,39787,124782,62027,62755
2018/11/1,彰化縣,鹿港鎮,24678,86772,44065,42707
2018/11/1,彰化縣,和美鎮,26975,90830,46155,44675
2018/11/1,彰化縣,北斗鎮,10773,33351,16799,16552
2018/11/1,彰化縣,溪湖鎮,16403,55382,28024,27358
2018/11/1,彰化縣,田中鎮,13209,41582,21402,20180
2018/11/1,彰化縣,二林鎮,15108,50652,26059,24593
2018/11/1,彰化縣,線西鄉,4443,16869,8647,8222
2018/11/1,彰化縣,伸港鄉,10129,37099,18927,18172
2018/11/1,彰化縣,福興鄉,12980,47139,24565,22574
2018/11/1,彰化縣,秀水鄉,10853,39303,20276,19027
2018/11/1,彰化縣,花壇鄉,14209,45904,23540,22364
2018/11/1,彰化縣,芬園鄉,6837,23608,12418,11190
2018/11/1,彰化縣,大村鄉,11188,36942,19073,17869
2018/11/1,彰化縣,埔鹽鄉,9132,32497,17077,15420
2018/11/1,彰化縣,埔心鄉,10702,34742,17871,16871
2018/11/1,彰化縣,永靖鄉,10935,37035,19165,17870
2018/11/1,彰化縣,社頭鄉,12975,42909,22066,20843
2018/11/1,彰化縣,二水鄉,5296,15159,7947,7212
2018/11/1,彰化縣,田尾鄉,7995,27356,14079,13277
2018/11/1,彰化縣,埤頭鄉,9110,30520,15788,14732
2018/11/1,彰化縣,芳苑鄉,10132,33539,17670,15869
2018/11/1,彰化縣,大城鄉,5236,16756,9035,7721
2018/11/1,彰化縣,竹塘鄉,4612,15105,7918,7187
2018/11/1,彰化縣,溪州鄉,8997,29799,15547,14252
2018/11/1,南投縣,南投市,34905,99513,49810,49703
2018/11/1,南投縣,埔里鎮,28943,80358,39971,40387
2018/11/1,南投縣,草屯鎮,33333,97170,49155,48015
2018/11/1,南投縣,竹山鎮,20137,54645,28005,26640
2018/11/1,南投縣,集集鎮,4315,10842,5650,5192
2018/11/1,南投縣,名間鄉,12623,38323,20209,18114
2018/11/1,南投縣,鹿谷鄉,8034,17692,9432,8260
2018/11/1,南投縣,中寮鄉,5624,14713,7987,6726
2018/11/1,南投縣,魚池鄉,5755,15807,8336,7471
2018/11/1,南投縣,國姓鄉,7299,18648,10066,8582
2018/11/1,南投縣,水里鄉,7118,17546,9203,8343
2018/11/1,南投縣,信義鄉,5274,16264,8697,7567
2018/11/1,南投縣,仁愛鄉,4893,15965,8242,7723
2018/11/1,雲林縣,斗六市,38533,108502,53905,54597
2018/11/1,雲林縣,斗南鎮,15895,44577,22644,21933
2018/11/1,雲林縣,虎尾鎮,25211,70870,35867,35003
2018/11/1,雲林縣,西螺鎮,14816,46107,23294,22813
2018/11/1,雲林縣,土庫鎮,9451,28793,15006,13787
2018/11/1,雲林縣,北港鎮,16048,39946,20614,19332
2018/11/1,雲林縣,古坑鄉,11031,31438,16567,14871
2018/11/1,雲林縣,大埤鄉,6637,19052,10207,8845
2018/11/1,雲林縣,莿桐鄉,9383,28722,15019,13703
2018/11/1,雲林縣,林內鄉,6032,18037,9424,8613
2018/11/1,雲林縣,二崙鄉,8928,26915,14383,12532
2018/11/1,雲林縣,崙背鄉,8507,24402,12886,11516
2018/11/1,雲林縣,麥寮鄉,14501,46050,23075,22975
2018/11/1,雲林縣,東勢鄉,5730,14817,8185,6632
2018/11/1,雲林縣,褒忠鄉,4437,12966,6978,5988
2018/11/1,雲林縣,臺西鄉,8651,23795,12754,11041
2018/11/1,雲林縣,元長鄉,9234,25709,14074,11635
2018/11/1,雲林縣,四湖鄉,8714,23269,12612,10657
2018/11/1,雲林縣,口湖鄉,9425,27342,14570,12772
2018/11/1,雲林縣,水林鄉,9851,25365,13825,11540
2018/11/1,嘉義縣,太保市,13179,38043,19479,18564
2018/11/1,嘉義縣,朴子市,15758,42123,21251,20872
2018/11/1,嘉義縣,布袋鎮,9911,26821,13701,13120
2018/11/1,嘉義縣,大林鎮,11387,30917,15825,15092
2018/11/1,嘉義縣,民雄鄉,25116,71350,36508,34842
2018/11/1,嘉義縣,溪口鄉,5309,14627,7828,6799
2018/11/1,嘉義縣,新港鄉,10695,31756,16708,15048
2018/11/1,嘉義縣,六腳鄉,8824,23033,12204,10829
2018/11/1,嘉義縣,東石鄉,9196,24620,13028,11592
2018/11/1,嘉義縣,義竹鄉,7331,18274,9501,8773
2018/11/1,嘉義縣,鹿草鄉,5751,15400,8261,7139
2018/11/1,嘉義縣,水上鄉,18152,49375,25505,23870
2018/11/1,嘉義縣,中埔鄉,16037,44593,23212,21381
2018/11/1,嘉義縣,竹崎鄉,11671,35599,18935,16664
2018/11/1,嘉義縣,梅山鄉,6766,19283,10256,9027
2018/11/1,嘉義縣,番路鄉,4229,11450,6179,5271
2018/11/1,嘉義縣,大埔鄉,1920,4597,2366,2231
2018/11/1,嘉義縣,阿里山鄉,1902,5601,2934,2667
2018/11/1,屏東縣,屏東市,74586,199742,98538,101204
2018/11/1,屏東縣,潮州鎮,19520,53909,26928,26981
2018/11/1,屏東縣,東港鎮,16831,47621,24060,23561
2018/11/1,屏東縣,恆春鎮,11663,30792,15803,14989
2018/11/1,屏東縣,萬丹鄉,15072,50572,26261,24311
2018/11/1,屏東縣,長治鄉,10169,29714,15499,14215
2018/11/1,屏東縣,麟洛鄉,3850,11063,5731,5332
2018/11/1,屏東縣,九如鄉,7060,22102,11406,10696
2018/11/1,屏東縣,里港鄉,8207,26062,13250,12812
2018/11/1,屏東縣,鹽埔鄉,7882,25732,13365,12367
2018/11/1,屏東縣,高樹鄉,9257,24435,13042,11393
2018/11/1,屏東縣,萬巒鄉,6522,20582,10719,9863
2018/11/1,屏東縣,內埔鄉,18690,54157,27951,26206
2018/11/1,屏東縣,竹田鄉,5653,17152,9103,8049
2018/11/1,屏東縣,新埤鄉,3459,10019,5322,4697
2018/11/1,屏東縣,枋寮鄉,8553,24378,12737,11641
2018/11/1,屏東縣,新園鄉,11817,34939,18092,16847
2018/11/1,屏東縣,崁頂鄉,4501,15532,7829,7703
2018/11/1,屏東縣,林邊鄉,6687,17817,9099,8718
2018/11/1,屏東縣,南州鄉,3715,10650,5448,5202
2018/11/1,屏東縣,佳冬鄉,6971,19155,9949,9206
2018/11/1,屏東縣,琉球鄉,4528,12383,6781,5602
2018/11/1,屏東縣,車城鄉,3492,8615,4616,3999
2018/11/1,屏東縣,滿州鄉,3042,8039,4337,3702
2018/11/1,屏東縣,枋山鄉,2097,5523,2928,2595
2018/11/1,屏東縣,三地門鄉,2329,7706,3859,3847
2018/11/1,屏東縣,霧臺鄉,1060,3372,1717,1655
2018/11/1,屏東縣,瑪家鄉,2061,6831,3450,3381
2018/11/1,屏東縣,泰武鄉,1358,5399,2824,2575
2018/11/1,屏東縣,來義鄉,2234,7443,3761,3682
2018/11/1,屏東縣,春日鄉,1412,4903,2507,2396
2018/11/1,屏東縣,獅子鄉,1576,4994,2563,2431
2018/11/1,屏東縣,牡丹鄉,1944,4990,2529,2461
2018/11/1,臺東縣,臺東市,39855,105571,52791,52780
2018/11/1,臺東縣,成功鎮,5356,14084,7411,6673
2018/11/1,臺東縣,關山鎮,3158,8708,4528,4180
2018/11/1,臺東縣,卑南鄉,6718,17304,9121,8183
2018/11/1,臺東縣,大武鄉,2478,6082,3158,2924
2018/11/1,臺東縣,太麻里鄉,4735,11179,5949,5230
2018/11/1,臺東縣,東河鄉,3759,8503,4710,3793
2018/11/1,臺東縣,長濱鄉,2917,7197,4085,3112
2018/11/1,臺東縣,鹿野鄉,3049,7890,4176,3714
2018/11/1,臺東縣,池上鄉,3197,8202,4262,3940
2018/11/1,臺東縣,綠島鄉,1161,4095,2178,1917
2018/11/1,臺東縣,延平鄉,1071,3647,1940,1707
2018/11/1,臺東縣,海端鄉,1090,4196,2230,1966
2018/11/1,臺東縣,達仁鄉,1445,3609,1958,1651
2018/11/1,臺東縣,金峰鄉,1147,3739,1889,1850
2018/11/1,臺東縣,蘭嶼鄉,1880,5139,2593,2546
2018/11/1,花蓮縣,花蓮市,41512,103830,50011,53819
2018/11/1,花蓮縣,鳳林鎮,4397,10879,5657,5222
2018/11/1,花蓮縣,玉里鎮,8875,24054,12723,11331
2018/11/1,花蓮縣,新城鄉,7737,20130,10309,9821
2018/11/1,花蓮縣,吉安鄉,32185,83256,41895,41361
2018/11/1,花蓮縣,壽豐鄉,7259,17990,9512,8478
2018/11/1,花蓮縣,光復鄉,5023,12840,6825,6015
2018/11/1,花蓮縣,豐濱鄉,1719,4790,2651,2139
2018/11/1,花蓮縣,瑞穗鄉,4776,11701,6329,5372
2018/11/1,花蓮縣,富里鄉,4035,10306,5598,4708
2018/11/1,花蓮縣,秀林鄉,4840,15949,8180,7769
2018/11/1,花蓮縣,萬榮鄉,2111,6440,3387,3053
2018/11/1,花蓮縣,卓溪鄉,1693,6099,3344,2755
2018/11/1,澎湖縣,馬公市,24945,62549,31811,30738
2018/11/1,澎湖縣,湖西鄉,5675,14567,7698,6869
2018/11/1,澎湖縣,白沙鄉,3458,9859,5150,4709
2018/11/1,澎湖縣,西嶼鄉,3036,8370,4321,4049
2018/11/1,澎湖縣,望安鄉,2030,5248,2837,2411
2018/11/1,澎湖縣,七美鄉,1385,3848,1990,1858
2018/11/1,基隆市,中正區,22670,51715,26344,25371
2018/11/1,基隆市,七堵區,21567,53787,26992,26795
2018/11/1,基隆市,暖暖區,15704,38602,19320,19282
2018/11/1,基隆市,仁愛區,19077,43821,21696,22125
2018/11/1,基隆市,中山區,19264,47450,24052,23398
2018/11/1,基隆市,安樂區,33590,82262,40697,41565
2018/11/1,基隆市,信義區,21652,52569,25918,26651
2018/11/1,新竹市,東區,80542,215276,105808,109468
2018/11/1,新竹市,北區,57292,151502,73995,77507
2018/11/1,新竹市,香山區,27545,78329,39744,38585
2018/11/1,嘉義市,東區,45495,121196,58282,62914
2018/11/1,嘉義市,西區,54458,147501,72175,75326
2018/11/1,金門縣,金城鎮,12991,43321,21555,21766
2018/11/1,金門縣,金湖鎮,9041,29732,14892,14840
2018/11/1,金門縣,金沙鎮,6362,20750,10263,10487
2018/11/1,金門縣,金寧鄉,8807,31608,15924,15684
2018/11/1,金門縣,烈嶼鄉,3187,12871,6347,6524
2018/11/1,金門縣,烏坵鄉,135,681,345,336
2018/11/1,連江縣,南竿鄉,1763,7655,4301,3354
2018/11/1,連江縣,北竿鄉,641,2426,1356,1070
2018/11/1,連江縣,莒光鄉,299,1617,985,632
2018/11/1,連江縣,東引鄉,340,1344,796,548
2018/12/1,總計,新北市,1562037,3995717,1954968,2040749
2018/12/1,總計,臺北市,1056233,2668572,1273375,1395197
2018/12/1,總計,桃園市,807471,2220872,1104073,1116799
2018/12/1,總計,臺中市,972652,2803894,1380106,1423788
2018/12/1,總計,臺南市,689258,1883831,939967,943864
2018/12/1,總計,高雄市,1099955,2773533,1371957,1401576
2018/12/1,總計,臺灣省,2503195,7090184,3611525,3478659
2018/12/1,總計,宜蘭縣,169511,455221,230027,225194
2018/12/1,總計,新竹縣,195271,557010,284385,272625
2018/12/1,總計,苗栗縣,189324,548863,283174,265689
2018/12/1,總計,彰化縣,389666,1277824,650677,627147
2018/12/1,總計,南投縣,178260,497031,254549,242482
2018/12/1,總計,雲林縣,241047,686022,355578,330444
2018/12/1,總計,嘉義縣,183224,507068,263451,243617
2018/12/1,總計,屏東縣,287915,825406,421534,403872
2018/12/1,總計,臺東縣,83037,218919,112845,106074
2018/12/1,總計,花蓮縣,126222,327968,166258,161710
2018/12/1,總計,澎湖縣,40574,104440,53807,50633
2018/12/1,總計,基隆市,153580,370155,184978,185177
2018/12/1,總計,新竹市,165639,445635,219846,225789
2018/12/1,總計,嘉義市,99925,268622,130416,138206
2018/12/1,總計,福建省,43676,152329,76942,75387
2018/12/1,總計,金門縣,40616,139273,69494,69779
2018/12/1,總計,連江縣,3060,13056,7448,5608
2018/12/1,新北市,板橋區,212630,554742,270394,284348
2018/12/1,新北市,三重區,151788,385826,189559,196267
2018/12/1,新北市,中和區,166066,412486,200054,212432
2018/12/1,新北市,永和區,91130,221098,104839,116259
2018/12/1,新北市,新莊區,155540,417754,203713,214041
2018/12/1,新北市,新店區,127675,302231,145142,157089
2018/12/1,新北市,樹林區,66723,183946,91732,92214
2018/12/1,新北市,鶯歌區,30373,86361,43281,43080
2018/12/1,新北市,三峽區,43228,115820,57947,57873
2018/12/1,新北市,淡水區,77282,173502,83082,90420
2018/12/1,新北市,汐止區,88004,200535,97696,102839
2018/12/1,新北市,瑞芳區,16160,39982,20168,19814
2018/12/1,新北市,土城區,87234,236901,116707,120194
2018/12/1,新北市,蘆洲區,71720,201332,98883,102449
2018/12/1,新北市,五股區,32551,86329,43507,42822
2018/12/1,新北市,泰山區,28641,78708,38925,39783
2018/12/1,新北市,林口區,44031,110081,53500,56581
2018/12/1,新北市,深坑區,9633,23634,11841,11793
2018/12/1,新北市,石碇區,3402,7731,4220,3511
2018/12/1,新北市,坪林區,2521,6612,3633,2979
2018/12/1,新北市,三芝區,9530,22978,11839,11139
2018/12/1,新北市,石門區,4313,12115,6266,5849
2018/12/1,新北市,八里區,14880,38906,19410,19496
2018/12/1,新北市,平溪區,2292,4666,2583,2083
2018/12/1,新北市,雙溪區,3803,8860,4788,4072
2018/12/1,新北市,貢寮區,4368,12301,6263,6038
2018/12/1,新北市,金山區,7132,21774,10730,11044
2018/12/1,新北市,萬里區,7489,22068,11107,10961
2018/12/1,新北市,烏來區,1898,6438,3159,3279
2018/12/1,臺北市,松山區,81128,205702,96393,109309
2018/12/1,臺北市,信義區,89574,223406,106457,116949
2018/12/1,臺北市,大安區,121344,308843,144007,164836
2018/12/1,臺北市,中山區,100494,229456,106664,122792
2018/12/1,臺北市,中正區,65474,159000,75898,83102
2018/12/1,臺北市,大同區,51781,127625,62148,65477
2018/12/1,臺北市,萬華區,78770,189603,92969,96634
2018/12/1,臺北市,文山區,106640,273762,131145,142617
2018/12/1,臺北市,南港區,47386,121670,59439,62231
2018/12/1,臺北市,內湖區,108739,287429,137196,150233
2018/12/1,臺北市,士林區,107521,286544,138079,148465
2018/12/1,臺北市,北投區,97382,255532,122980,132552
2018/12/1,桃園市,桃園區,169481,447302,216999,230303
2018/12/1,桃園市,中壢區,153223,412063,202613,209450
2018/12/1,桃園市,大溪區,32821,94885,48298,46587
2018/12/1,桃園市,楊梅區,59375,170380,85737,84643
2018/12/1,桃園市,蘆竹區,59426,164384,81577,82807
2018/12/1,桃園市,大園區,33661,90888,46359,44529
2018/12/1,桃園市,龜山區,62660,160591,79879,80712
2018/12/1,桃園市,八德區,72220,202198,100989,101209
2018/12/1,桃園市,龍潭區,42550,123175,61617,61558
2018/12/1,桃園市,平鎮區,78341,226412,112352,114060
2018/12/1,桃園市,新屋區,16585,49210,26183,23027
2018/12/1,桃園市,觀音區,23294,67358,34972,32386
2018/12/1,桃園市,復興區,3834,12026,6498,5528
2018/12/1,臺中市,中區,7978,18514,9145,9369
2018/12/1,臺中市,東區,28300,76175,37846,38329
2018/12/1,臺中市,南區,49029,125874,60362,65512
2018/12/1,臺中市,西區,45820,115698,54875,60823
2018/12/1,臺中市,北區,59750,147557,70509,77048
2018/12/1,臺中市,西屯區,87041,228630,109646,118984
2018/12/1,臺中市,南屯區,63334,170618,81489,89129
2018/12/1,臺中市,北屯區,102443,279297,133744,145553
2018/12/1,臺中市,豐原區,54261,167025,82473,84552
2018/12/1,臺中市,東勢區,17396,50256,25774,24482
2018/12/1,臺中市,大甲區,23324,77625,38964,38661
2018/12/1,臺中市,清水區,27783,86862,44538,42324
2018/12/1,臺中市,沙鹿區,30196,94079,47403,46676
2018/12/1,臺中市,梧棲區,18049,58218,29161,29057
2018/12/1,臺中市,后里區,16489,54775,27790,26985
2018/12/1,臺中市,神岡區,19706,65711,33469,32242
2018/12/1,臺中市,潭子區,36700,108952,53774,55178
2018/12/1,臺中市,大雅區,30012,95815,47684,48131
2018/12/1,臺中市,新社區,7617,24576,12741,11835
2018/12/1,臺中市,石岡區,4915,14956,7727,7229
2018/12/1,臺中市,外埔區,9811,32230,16458,15772
2018/12/1,臺中市,大安區,5534,19267,10157,9110
2018/12/1,臺中市,烏日區,25119,75372,37737,37635
2018/12/1,臺中市,大肚區,17864,57324,29276,28048
2018/12/1,臺中市,龍井區,23406,77998,39221,38777
2018/12/1,臺中市,霧峰區,20458,65619,33229,32390
2018/12/1,臺中市,太平區,65380,191752,95014,96738
2018/12/1,臺中市,大里區,70333,212104,104003,108101
2018/12/1,臺中市,和平區,4604,11015,5897,5118
2018/12/1,臺南市,新營區,29089,77617,38417,39200
2018/12/1,臺南市,鹽水區,10038,25395,13246,12149
2018/12/1,臺南市,白河區,10791,28105,14677,13428
2018/12/1,臺南市,柳營區,7932,21205,11067,10138
2018/12/1,臺南市,後壁區,8808,23346,12115,11231
2018/12/1,臺南市,東山區,8335,20788,11022,9766
2018/12/1,臺南市,麻豆區,15838,44260,22484,21776
2018/12/1,臺南市,下營區,9064,23916,12335,11581
2018/12/1,臺南市,六甲區,7811,22148,11459,10689
2018/12/1,臺南市,官田區,7969,21314,10857,10457
2018/12/1,臺南市,大內區,3826,9605,5192,4413
2018/12/1,臺南市,佳里區,20835,59083,29263,29820
2018/12/1,臺南市,學甲區,9622,25665,13137,12528
2018/12/1,臺南市,西港區,8276,24690,12466,12224
2018/12/1,臺南市,七股區,8031,22732,11773,10959
2018/12/1,臺南市,將軍區,7278,19664,10022,9642
2018/12/1,臺南市,北門區,4218,11051,5581,5470
2018/12/1,臺南市,新化區,14479,43456,22124,21332
2018/12/1,臺南市,善化區,18027,48968,24593,24375
2018/12/1,臺南市,新市區,12585,36898,18462,18436
2018/12/1,臺南市,安定區,10217,30483,15673,14810
2018/12/1,臺南市,山上區,2726,7317,3813,3504
2018/12/1,臺南市,玉井區,5161,13997,7222,6775
2018/12/1,臺南市,楠西區,3525,9537,5043,4494
2018/12/1,臺南市,南化區,2851,8724,4698,4026
2018/12/1,臺南市,左鎮區,1947,4781,2686,2095
2018/12/1,臺南市,仁德區,27920,75878,38350,37528
2018/12/1,臺南市,歸仁區,22917,68403,34696,33707
2018/12/1,臺南市,關廟區,11253,34353,17705,16648
2018/12/1,臺南市,龍崎區,1534,3995,2140,1855
2018/12/1,臺南市,永康區,85297,234891,115623,119268
2018/12/1,臺南市,東區,72175,186250,89167,97083
2018/12/1,臺南市,南區,46099,124824,61713,63111
2018/12/1,臺南市,北區,51203,132112,64131,67981
2018/12/1,臺南市,安南區,63875,193438,97539,95899
2018/12/1,臺南市,安平區,26016,66775,31743,35032
2018/12/1,臺南市,中西區,31690,78167,37733,40434
2018/12/1,高雄市,鹽埕區,10807,24059,11956,12103
2018/12/1,高雄市,鼓山區,58784,140133,67529,72604
2018/12/1,高雄市,左營區,79346,196872,94535,102337
2018/12/1,高雄市,楠梓區,72051,185687,91043,94644
2018/12/1,高雄市,三民區,137131,340913,164742,176171
2018/12/1,高雄市,新興區,22950,51032,24481,26551
2018/12/1,高雄市,前金區,12706,26831,12739,14092
2018/12/1,高雄市,苓雅區,72286,169648,81449,88199
2018/12/1,高雄市,前鎮區,78774,188340,92530,95810
2018/12/1,高雄市,旗津區,11120,28506,14680,13826
2018/12/1,高雄市,小港區,68529,157742,78262,79480
2018/12/1,高雄市,鳳山區,141987,359519,175929,183590
2018/12/1,高雄市,林園區,26147,69870,35278,34592
2018/12/1,高雄市,大寮區,42534,112421,57421,55000
2018/12/1,高雄市,大樹區,13670,42390,21719,20671
2018/12/1,高雄市,大社區,13154,34604,17498,17106
2018/12/1,高雄市,仁武區,34233,87694,44499,43195
2018/12/1,高雄市,鳥松區,18567,44469,22501,21968
2018/12/1,高雄市,岡山區,35079,97103,48145,48958
2018/12/1,高雄市,橋頭區,13799,37650,19086,18564
2018/12/1,高雄市,燕巢區,10635,29820,15676,14144
2018/12/1,高雄市,田寮區,3235,7159,3963,3196
2018/12/1,高雄市,阿蓮區,9422,28658,14459,14199
2018/12/1,高雄市,路竹區,17158,52538,26784,25754
2018/12/1,高雄市,湖內區,10952,29794,15247,14547
2018/12/1,高雄市,茄萣區,10554,30089,15457,14632
2018/12/1,高雄市,永安區,5751,13909,7006,6903
2018/12/1,高雄市,彌陀區,6794,19252,9866,9386
2018/12/1,高雄市,梓官區,12684,35940,18490,17450
2018/12/1,高雄市,旗山區,13723,36652,18917,17735
2018/12/1,高雄市,美濃區,14807,39589,20754,18835
2018/12/1,高雄市,六龜區,5573,12939,6982,5957
2018/12/1,高雄市,甲仙區,2288,6026,3201,2825
2018/12/1,高雄市,杉林區,4803,11795,6448,5347
2018/12/1,高雄市,內門區,5120,14437,7798,6639
2018/12/1,高雄市,茂林區,600,1994,1004,990
2018/12/1,高雄市,桃源區,1359,4311,2270,2041
2018/12/1,高雄市,那瑪夏區,843,3148,1613,1535
2018/12/1,宜蘭縣,宜蘭市,36569,95732,46612,49120
2018/12/1,宜蘭縣,羅東鎮,26522,72433,34281,38152
2018/12/1,宜蘭縣,蘇澳鎮,14222,39682,20222,19460
2018/12/1,宜蘭縣,頭城鎮,10275,29133,15018,14115
2018/12/1,宜蘭縣,礁溪鄉,14195,35619,18516,17103
2018/12/1,宜蘭縣,壯圍鄉,8916,24302,12829,11473
2018/12/1,宜蘭縣,員山鄉,11740,32281,17113,15168
2018/12/1,宜蘭縣,冬山鄉,19420,52880,27122,25758
2018/12/1,宜蘭縣,五結鄉,15105,39543,20398,19145
2018/12/1,宜蘭縣,三星鄉,8642,21359,11481,9878
2018/12/1,宜蘭縣,大同鄉,1926,6242,3334,2908
2018/12/1,宜蘭縣,南澳鄉,1979,6015,3101,2914
2018/12/1,新竹縣,竹北市,68474,187336,93241,94095
2018/12/1,新竹縣,關西鎮,9408,28537,15308,13229
2018/12/1,新竹縣,新埔鎮,10777,33104,17641,15463
2018/12/1,新竹縣,竹東鎮,34116,96380,48351,48029
2018/12/1,新竹縣,湖口鄉,27032,77668,39306,38362
2018/12/1,新竹縣,橫山鄉,4438,12942,7005,5937
2018/12/1,新竹縣,新豐鄉,18820,56980,29221,27759
2018/12/1,新竹縣,芎林鄉,6619,20025,10604,9421
2018/12/1,新竹縣,寶山鄉,5690,14647,7939,6708
2018/12/1,新竹縣,北埔鄉,3141,9335,5060,4275
2018/12/1,新竹縣,峨眉鄉,2086,5587,3064,2523
2018/12/1,新竹縣,尖石鄉,2895,9695,5091,4604
2018/12/1,新竹縣,五峰鄉,1775,4774,2554,2220
2018/12/1,苗栗縣,苗栗市,31554,88216,44006,44210
2018/12/1,苗栗縣,頭份市,35401,103081,52016,51065
2018/12/1,苗栗縣,苑裡鎮,14722,45211,23553,21658
2018/12/1,苗栗縣,通霄鎮,11554,33992,17971,16021
2018/12/1,苗栗縣,竹南鎮,29882,86130,43455,42675
2018/12/1,苗栗縣,後龍鎮,11984,36257,19212,17045
2018/12/1,苗栗縣,卓蘭鎮,6003,16732,8759,7973
2018/12/1,苗栗縣,大湖鄉,5375,14482,7684,6798
2018/12/1,苗栗縣,公館鄉,10722,33261,17371,15890
2018/12/1,苗栗縣,銅鑼鄉,6139,17871,9529,8342
2018/12/1,苗栗縣,南庄鄉,3932,10042,5511,4531
2018/12/1,苗栗縣,頭屋鄉,3648,10667,5650,5017
2018/12/1,苗栗縣,三義鄉,5561,16204,8570,7634
2018/12/1,苗栗縣,西湖鄉,2639,7033,3921,3112
2018/12/1,苗栗縣,造橋鄉,4136,12701,6707,5994
2018/12/1,苗栗縣,三灣鄉,2380,6613,3620,2993
2018/12/1,苗栗縣,獅潭鄉,1708,4331,2425,1906
2018/12/1,苗栗縣,泰安鄉,1984,6039,3214,2825
2018/12/1,彰化縣,彰化市,76791,232729,114838,117891
2018/12/1,彰化縣,員林市,39845,124890,62026,62864
2018/12/1,彰化縣,鹿港鎮,24732,86818,44101,42717
2018/12/1,彰化縣,和美鎮,26999,90782,46132,44650
2018/12/1,彰化縣,北斗鎮,10771,33321,16786,16535
2018/12/1,彰化縣,溪湖鎮,16408,55365,28009,27356
2018/12/1,彰化縣,田中鎮,13211,41541,21379,20162
2018/12/1,彰化縣,二林鎮,15112,50536,25987,24549
2018/12/1,彰化縣,線西鄉,4441,16860,8645,8215
2018/12/1,彰化縣,伸港鄉,10130,37121,18940,18181
2018/12/1,彰化縣,福興鄉,12982,47059,24530,22529
2018/12/1,彰化縣,秀水鄉,10864,39291,20270,19021
2018/12/1,彰化縣,花壇鄉,14208,45853,23510,22343
2018/12/1,彰化縣,芬園鄉,6828,23583,12406,11177
2018/12/1,彰化縣,大村鄉,11199,36968,19087,17881
2018/12/1,彰化縣,埔鹽鄉,9135,32460,17067,15393
2018/12/1,彰化縣,埔心鄉,10717,34745,17883,16862
2018/12/1,彰化縣,永靖鄉,10937,36962,19127,17835
2018/12/1,彰化縣,社頭鄉,12969,42882,22044,20838
2018/12/1,彰化縣,二水鄉,5302,15153,7950,7203
2018/12/1,彰化縣,田尾鄉,8006,27336,14073,13263
2018/12/1,彰化縣,埤頭鄉,9105,30508,15774,14734
2018/12/1,彰化縣,芳苑鄉,10125,33489,17655,15834
2018/12/1,彰化縣,大城鄉,5232,16717,9018,7699
2018/12/1,彰化縣,竹塘鄉,4608,15095,7909,7186
2018/12/1,彰化縣,溪州鄉,9009,29760,15531,14229
2018/12/1,南投縣,南投市,34912,99519,49805,49714
2018/12/1,南投縣,埔里鎮,28958,80340,39970,40370
2018/12/1,南投縣,草屯鎮,33344,97119,49131,47988
2018/12/1,南投縣,竹山鎮,20134,54540,27947,26593
2018/12/1,南投縣,集集鎮,4304,10804,5636,5168
2018/12/1,南投縣,名間鄉,12623,38265,20201,18064
2018/12/1,南投縣,鹿谷鄉,8041,17687,9428,8259
2018/12/1,南投縣,中寮鄉,5629,14680,7969,6711
2018/12/1,南投縣,魚池鄉,5752,15753,8312,7441
2018/12/1,南投縣,國姓鄉,7292,18629,10058,8571
2018/12/1,南投縣,水里鄉,7104,17496,9173,8323
2018/12/1,南投縣,信義鄉,5272,16230,8674,7556
2018/12/1,南投縣,仁愛鄉,4895,15969,8245,7724
2018/12/1,雲林縣,斗六市,38567,108542,53930,54612
2018/12/1,雲林縣,斗南鎮,15901,44547,22628,21919
2018/12/1,雲林縣,虎尾鎮,25208,70844,35856,34988
2018/12/1,雲林縣,西螺鎮,14802,46064,23279,22785
2018/12/1,雲林縣,土庫鎮,9478,28794,15017,13777
2018/12/1,雲林縣,北港鎮,16056,39905,20586,19319
2018/12/1,雲林縣,古坑鄉,11032,31358,16530,14828
2018/12/1,雲林縣,大埤鄉,6638,19030,10194,8836
2018/12/1,雲林縣,莿桐鄉,9373,28703,15005,13698
2018/12/1,雲林縣,林內鄉,6030,17995,9403,8592
2018/12/1,雲林縣,二崙鄉,8930,26855,14366,12489
2018/12/1,雲林縣,崙背鄉,8501,24345,12859,11486
2018/12/1,雲林縣,麥寮鄉,14547,46196,23131,23065
2018/12/1,雲林縣,東勢鄉,5720,14766,8157,6609
2018/12/1,雲林縣,褒忠鄉,4434,12912,6955,5957
2018/12/1,雲林縣,臺西鄉,8639,23730,12725,11005
2018/12/1,雲林縣,元長鄉,9233,25643,14041,11602
2018/12/1,雲林縣,四湖鄉,8698,23209,12580,10629
2018/12/1,雲林縣,口湖鄉,9421,27276,14541,12735
2018/12/1,雲林縣,水林鄉,9839,25308,13795,11513
2018/12/1,嘉義縣,太保市,13205,38069,19478,18591
2018/12/1,嘉義縣,朴子市,15769,42112,21241,20871
2018/12/1,嘉義縣,布袋鎮,9909,26773,13675,13098
2018/12/1,嘉義縣,大林鎮,11394,30896,15799,15097
2018/12/1,嘉義縣,民雄鄉,25151,71367,36504,34863
2018/12/1,嘉義縣,溪口鄉,5306,14592,7803,6789
2018/12/1,嘉義縣,新港鄉,10691,31723,16705,15018
2018/12/1,嘉義縣,六腳鄉,8814,22960,12169,10791
2018/12/1,嘉義縣,東石鄉,9197,24580,13017,11563
2018/12/1,嘉義縣,義竹鄉,7332,18242,9479,8763
2018/12/1,嘉義縣,鹿草鄉,5746,15358,8236,7122
2018/12/1,嘉義縣,水上鄉,18163,49316,25482,23834
2018/12/1,嘉義縣,中埔鄉,16044,44584,23206,21378
2018/12/1,嘉義縣,竹崎鄉,11676,35584,18926,16658
2018/12/1,嘉義縣,梅山鄉,6771,19282,10251,9031
2018/12/1,嘉義縣,番路鄉,4231,11430,6175,5255
2018/12/1,嘉義縣,大埔鄉,1924,4603,2373,2230
2018/12/1,嘉義縣,阿里山鄉,1901,5597,2932,2665
2018/12/1,屏東縣,屏東市,74621,199606,98469,101137
2018/12/1,屏東縣,潮州鎮,19539,53893,26931,26962
2018/12/1,屏東縣,東港鎮,16848,47613,24033,23580
2018/12/1,屏東縣,恆春鎮,11676,30818,15821,14997
2018/12/1,屏東縣,萬丹鄉,15078,50514,26229,24285
2018/12/1,屏東縣,長治鄉,10165,29677,15482,14195
2018/12/1,屏東縣,麟洛鄉,3848,11036,5710,5326
2018/12/1,屏東縣,九如鄉,7060,22061,11389,10672
2018/12/1,屏東縣,里港鄉,8209,26044,13241,12803
2018/12/1,屏東縣,鹽埔鄉,7890,25719,13348,12371
2018/12/1,屏東縣,高樹鄉,9258,24384,13009,11375
2018/12/1,屏東縣,萬巒鄉,6524,20593,10724,9869
2018/12/1,屏東縣,內埔鄉,18703,54115,27938,26177
2018/12/1,屏東縣,竹田鄉,5660,17119,9093,8026
2018/12/1,屏東縣,新埤鄉,3454,9981,5305,4676
2018/12/1,屏東縣,枋寮鄉,8554,24323,12706,11617
2018/12/1,屏東縣,新園鄉,11817,34880,18060,16820
2018/12/1,屏東縣,崁頂鄉,4508,15519,7814,7705
2018/12/1,屏東縣,林邊鄉,6688,17795,9096,8699
2018/12/1,屏東縣,南州鄉,3719,10639,5456,5183
2018/12/1,屏東縣,佳冬鄉,6968,19121,9926,9195
2018/12/1,屏東縣,琉球鄉,4540,12364,6773,5591
2018/12/1,屏東縣,車城鄉,3484,8577,4595,3982
2018/12/1,屏東縣,滿州鄉,3046,7968,4306,3662
2018/12/1,屏東縣,枋山鄉,2089,5498,2915,2583
2018/12/1,屏東縣,三地門鄉,2329,7697,3860,3837
2018/12/1,屏東縣,霧臺鄉,1061,3354,1707,1647
2018/12/1,屏東縣,瑪家鄉,2058,6829,3443,3386
2018/12/1,屏東縣,泰武鄉,1361,5392,2823,2569
2018/12/1,屏東縣,來義鄉,2232,7433,3755,3678
2018/12/1,屏東縣,春日鄉,1412,4909,2512,2397
2018/12/1,屏東縣,獅子鄉,1573,4954,2541,2413
2018/12/1,屏東縣,牡丹鄉,1943,4981,2524,2457
2018/12/1,臺東縣,臺東市,39899,105573,52775,52798
2018/12/1,臺東縣,成功鎮,5355,14059,7400,6659
2018/12/1,臺東縣,關山鎮,3157,8703,4522,4181
2018/12/1,臺東縣,卑南鄉,6714,17269,9101,8168
2018/12/1,臺東縣,大武鄉,2472,6046,3142,2904
2018/12/1,臺東縣,太麻里鄉,4733,11147,5930,5217
2018/12/1,臺東縣,東河鄉,3762,8479,4700,3779
2018/12/1,臺東縣,長濱鄉,2914,7182,4077,3105
2018/12/1,臺東縣,鹿野鄉,3049,7875,4165,3710
2018/12/1,臺東縣,池上鄉,3194,8199,4259,3940
2018/12/1,臺東縣,綠島鄉,1159,4097,2179,1918
2018/12/1,臺東縣,延平鄉,1071,3628,1932,1696
2018/12/1,臺東縣,海端鄉,1089,4186,2226,1960
2018/12/1,臺東縣,達仁鄉,1443,3580,1943,1637
2018/12/1,臺東縣,金峰鄉,1147,3739,1890,1849
2018/12/1,臺東縣,蘭嶼鄉,1879,5157,2604,2553
2018/12/1,花蓮縣,花蓮市,41499,103841,50023,53818
2018/12/1,花蓮縣,鳳林鎮,4393,10846,5638,5208
2018/12/1,花蓮縣,玉里鎮,8875,24007,12696,11311
2018/12/1,花蓮縣,新城鄉,7758,20159,10318,9841
2018/12/1,花蓮縣,吉安鄉,32228,83221,41870,41351
2018/12/1,花蓮縣,壽豐鄉,7248,17949,9490,8459
2018/12/1,花蓮縣,光復鄉,5031,12789,6803,5986
2018/12/1,花蓮縣,豐濱鄉,1718,4752,2629,2123
2018/12/1,花蓮縣,瑞穗鄉,4787,11668,6308,5360
2018/12/1,花蓮縣,富里鄉,4035,10277,5590,4687
2018/12/1,花蓮縣,秀林鄉,4844,15939,8175,7764
2018/12/1,花蓮縣,萬榮鄉,2110,6419,3377,3042
2018/12/1,花蓮縣,卓溪鄉,1696,6101,3341,2760
2018/12/1,澎湖縣,馬公市,24963,62610,31848,30762
2018/12/1,澎湖縣,湖西鄉,5697,14594,7714,6880
2018/12/1,澎湖縣,白沙鄉,3463,9827,5126,4701
2018/12/1,澎湖縣,西嶼鄉,3035,8349,4311,4038
2018/12/1,澎湖縣,望安鄉,2035,5235,2830,2405
2018/12/1,澎湖縣,七美鄉,1381,3825,1978,1847
2018/12/1,基隆市,中正區,22652,51670,26324,25346
2018/12/1,基隆市,七堵區,21563,53782,26990,26792
2018/12/1,基隆市,暖暖區,15723,38619,19333,19286
2018/12/1,基隆市,仁愛區,19064,43730,21648,22082
2018/12/1,基隆市,中山區,19259,47398,24036,23362
2018/12/1,基隆市,安樂區,33625,82294,40694,41600
2018/12/1,基隆市,信義區,21694,52662,25953,26709
2018/12/1,新竹市,東區,80691,215566,105954,109612
2018/12/1,新竹市,北區,57377,151679,74116,77563
2018/12/1,新竹市,香山區,27571,78390,39776,38614
2018/12/1,嘉義市,東區,45490,121162,58271,62891
2018/12/1,嘉義市,西區,54435,147460,72145,75315
2018/12/1,金門縣,金城鎮,13003,43325,21565,21760
2018/12/1,金門縣,金湖鎮,9076,29856,14966,14890
2018/12/1,金門縣,金沙鎮,6372,20784,10279,10505
2018/12/1,金門縣,金寧鄉,8844,31765,15997,15768
2018/12/1,金門縣,烈嶼鄉,3186,12861,6340,6521
2018/12/1,金門縣,烏坵鄉,135,682,347,335
2018/12/1,連江縣,南竿鄉,1772,7663,4304,3359
2018/12/1,連江縣,北竿鄉,646,2425,1353,1072
2018/12/1,連江縣,莒光鄉,302,1618,989,629
2018/12/1,連江縣,東引鄉,340,1350,802,548
2019/1/1,總計,新北市,1563295,3997189,1955305,2041884
2019/1/1,總計,臺北市,1056328,2666908,1272385,1394523
2019/1/1,總計,桃園市,808934,2223733,1105418,1118315
2019/1/1,總計,臺中市,974103,2806406,1381171,1425235
2019/1/1,總計,臺南市,689651,1883723,939785,943938
2019/1/1,總計,高雄市,1100604,2773607,1371768,1401839
2019/1/1,總計,臺灣省,2504272,7086615,3609351,3477264
2019/1/1,總計,宜蘭縣,169554,455035,229890,225145
2019/1/1,總計,新竹縣,195604,557349,284509,272840
2019/1/1,總計,苗栗縣,189421,548403,282953,265450
2019/1/1,總計,彰化縣,389814,1277176,650277,626899
2019/1/1,總計,南投縣,178266,496606,254316,242290
2019/1/1,總計,雲林縣,240993,685354,355220,330134
2019/1/1,總計,嘉義縣,183222,506559,263214,243345
2019/1/1,總計,屏東縣,288019,824587,421035,403552
2019/1/1,總計,臺東縣,83025,218691,112719,105972
2019/1/1,總計,花蓮縣,126231,327788,166132,161656
2019/1/1,總計,澎湖縣,40648,104511,53844,50667
2019/1/1,總計,基隆市,153630,369987,184905,185082
2019/1/1,總計,新竹市,165875,445990,219958,226032
2019/1/1,總計,嘉義市,99970,268579,130379,138200
2019/1/1,總計,福建省,43790,152563,77053,75510
2019/1/1,總計,金門縣,40706,139484,69588,69896
2019/1/1,總計,連江縣,3084,13079,7465,5614
2019/1/1,新北市,板橋區,212784,554854,270352,284502
2019/1/1,新北市,三重區,151843,385725,189504,196221
2019/1/1,新北市,中和區,166138,412326,199932,212394
2019/1/1,新北市,永和區,91143,221101,104840,116261
2019/1/1,新北市,新莊區,155690,417968,203805,214163
2019/1/1,新北市,新店區,127781,302231,145098,157133
2019/1/1,新北市,樹林區,66705,183880,91674,92206
2019/1/1,新北市,鶯歌區,30438,86438,43334,43104
2019/1/1,新北市,三峽區,43271,115896,57979,57917
2019/1/1,新北市,淡水區,77508,173979,83283,90696
2019/1/1,新北市,汐止區,88070,200775,97779,102996
2019/1/1,新北市,瑞芳區,16152,39952,20152,19800
2019/1/1,新北市,土城區,87223,236872,116678,120194
2019/1/1,新北市,蘆洲區,71750,201363,98886,102477
2019/1/1,新北市,五股區,32614,86452,43550,42902
2019/1/1,新北市,泰山區,28669,78716,38921,39795
2019/1/1,新北市,林口區,44255,110688,53770,56918
2019/1/1,新北市,深坑區,9632,23656,11832,11824
2019/1/1,新北市,石碇區,3403,7734,4221,3513
2019/1/1,新北市,坪林區,2527,6631,3646,2985
2019/1/1,新北市,三芝區,9511,22941,11816,11125
2019/1/1,新北市,石門區,4313,12092,6252,5840
2019/1/1,新北市,八里區,14896,38897,19411,19486
2019/1/1,新北市,平溪區,2290,4665,2589,2076
2019/1/1,新北市,雙溪區,3797,8843,4777,4066
2019/1/1,新北市,貢寮區,4361,12268,6246,6022
2019/1/1,新北市,金山區,7137,21746,10720,11026
2019/1/1,新北市,萬里區,7497,22042,11086,10956
2019/1/1,新北市,烏來區,1897,6458,3172,3286
2019/1/1,臺北市,松山區,81155,205633,96357,109276
2019/1/1,臺北市,信義區,89553,223113,106330,116783
2019/1/1,臺北市,大安區,121333,308686,143905,164781
2019/1/1,臺北市,中山區,100485,229309,106562,122747
2019/1/1,臺北市,中正區,65464,158903,75840,83063
2019/1/1,臺北市,大同區,51853,127651,62124,65527
2019/1/1,臺北市,萬華區,78768,189387,92825,96562
2019/1/1,臺北市,文山區,106712,273686,131114,142572
2019/1/1,臺北市,南港區,47391,121576,59392,62184
2019/1/1,臺北市,內湖區,108732,287442,137196,150246
2019/1/1,臺北市,士林區,107515,286339,137965,148374
2019/1/1,臺北市,北投區,97367,255183,122775,132408
2019/1/1,桃園市,桃園區,169724,447811,217250,230561
2019/1/1,桃園市,中壢區,153498,412652,202901,209751
2019/1/1,桃園市,大溪區,32881,94956,48332,46624
2019/1/1,桃園市,楊梅區,59510,170639,85899,84740
2019/1/1,桃園市,蘆竹區,59477,164510,81627,82883
2019/1/1,桃園市,大園區,33746,91067,46439,44628
2019/1/1,桃園市,龜山區,62785,160837,79986,80851
2019/1/1,桃園市,八德區,72415,202633,101177,101456
2019/1/1,桃園市,龍潭區,42652,123338,61686,61652
2019/1/1,桃園市,平鎮區,78450,226559,112403,114156
2019/1/1,桃園市,新屋區,16611,49224,26203,23021
2019/1/1,桃園市,觀音區,23354,67451,35004,32447
2019/1/1,桃園市,復興區,3831,12056,6511,5545
2019/1/1,臺中市,中區,7969,18480,9141,9339
2019/1/1,臺中市,東區,28332,76198,37846,38352
2019/1/1,臺中市,南區,49085,126017,60428,65589
2019/1/1,臺中市,西區,45874,115774,54942,60832
2019/1/1,臺中市,北區,59730,147480,70470,77010
2019/1/1,臺中市,西屯區,87200,229005,109767,119238
2019/1/1,臺中市,南屯區,63474,170902,81643,89259
2019/1/1,臺中市,北屯區,102677,279969,134012,145957
2019/1/1,臺中市,豐原區,54321,167057,82473,84584
2019/1/1,臺中市,東勢區,17398,50235,25768,24467
2019/1/1,臺中市,大甲區,23355,77620,38956,38664
2019/1/1,臺中市,清水區,27840,86924,44569,42355
2019/1/1,臺中市,沙鹿區,30240,94178,47455,46723
2019/1/1,臺中市,梧棲區,18133,58331,29238,29093
2019/1/1,臺中市,后里區,16514,54824,27799,27025
2019/1/1,臺中市,神岡區,19705,65705,33459,32246
2019/1/1,臺中市,潭子區,36736,109050,53824,55226
2019/1/1,臺中市,大雅區,30067,95887,47725,48162
2019/1/1,臺中市,新社區,7620,24568,12742,11826
2019/1/1,臺中市,石岡區,4915,14930,7720,7210
2019/1/1,臺中市,外埔區,9840,32256,16470,15786
2019/1/1,臺中市,大安區,5539,19239,10141,9098
2019/1/1,臺中市,烏日區,25196,75495,37803,37692
2019/1/1,臺中市,大肚區,17876,57279,29252,28027
2019/1/1,臺中市,龍井區,23431,77975,39212,38763
2019/1/1,臺中市,霧峰區,20484,65623,33216,32407
2019/1/1,臺中市,太平區,65551,192115,95167,96948
2019/1/1,臺中市,大里區,70399,212284,104038,108246
2019/1/1,臺中市,和平區,4602,11006,5895,5111
2019/1/1,臺南市,新營區,29087,77622,38416,39206
2019/1/1,臺南市,鹽水區,10042,25377,13238,12139
2019/1/1,臺南市,白河區,10788,28073,14665,13408
2019/1/1,臺南市,柳營區,7934,21173,11050,10123
2019/1/1,臺南市,後壁區,8798,23305,12092,11213
2019/1/1,臺南市,東山區,8333,20746,11005,9741
2019/1/1,臺南市,麻豆區,15825,44221,22456,21765
2019/1/1,臺南市,下營區,9066,23876,12317,11559
2019/1/1,臺南市,六甲區,7805,22120,11450,10670
2019/1/1,臺南市,官田區,7968,21299,10846,10453
2019/1/1,臺南市,大內區,3818,9576,5175,4401
2019/1/1,臺南市,佳里區,20842,59114,29284,29830
2019/1/1,臺南市,學甲區,9626,25658,13138,12520
2019/1/1,臺南市,西港區,8274,24680,12466,12214
2019/1/1,臺南市,七股區,8036,22713,11776,10937
2019/1/1,臺南市,將軍區,7279,19640,10004,9636
2019/1/1,臺南市,北門區,4217,11038,5568,5470
2019/1/1,臺南市,新化區,14495,43439,22112,21327
2019/1/1,臺南市,善化區,18069,49040,24641,24399
2019/1/1,臺南市,新市區,12623,37007,18515,18492
2019/1/1,臺南市,安定區,10215,30463,15673,14790
2019/1/1,臺南市,山上區,2726,7305,3806,3499
2019/1/1,臺南市,玉井區,5164,13971,7209,6762
2019/1/1,臺南市,楠西區,3528,9519,5037,4482
2019/1/1,臺南市,南化區,2850,8711,4685,4026
2019/1/1,臺南市,左鎮區,1949,4776,2688,2088
2019/1/1,臺南市,仁德區,27930,75925,38365,37560
2019/1/1,臺南市,歸仁區,22913,68396,34695,33701
2019/1/1,臺南市,關廟區,11253,34321,17687,16634
2019/1/1,臺南市,龍崎區,1535,3989,2138,1851
2019/1/1,臺南市,永康區,85321,234817,115534,119283
2019/1/1,臺南市,東區,72241,186362,89226,97136
2019/1/1,臺南市,南區,46148,124841,61706,63135
2019/1/1,臺南市,北區,51232,132049,64104,67945
2019/1/1,臺南市,安南區,63993,193628,97570,96058
2019/1/1,臺南市,安平區,26023,66721,31711,35010
2019/1/1,臺南市,中西區,31705,78212,37737,40475
2019/1/1,高雄市,鹽埕區,10820,24048,11939,12109
2019/1/1,高雄市,鼓山區,58823,140211,67560,72651
2019/1/1,高雄市,左營區,79412,196974,94545,102429
2019/1/1,高雄市,楠梓區,72145,185947,91146,94801
2019/1/1,高雄市,三民區,137143,340730,164620,176110
2019/1/1,高雄市,新興區,22970,51040,24480,26560
2019/1/1,高雄市,前金區,12717,26843,12740,14103
2019/1/1,高雄市,苓雅區,72316,169584,81406,88178
2019/1/1,高雄市,前鎮區,78753,188181,92431,95750
2019/1/1,高雄市,旗津區,11120,28462,14644,13818
2019/1/1,高雄市,小港區,68570,157744,78244,79500
2019/1/1,高雄市,鳳山區,142120,359630,175960,183670
2019/1/1,高雄市,林園區,26186,69858,35270,34588
2019/1/1,高雄市,大寮區,42562,112413,57410,55003
2019/1/1,高雄市,大樹區,13677,42382,21709,20673
2019/1/1,高雄市,大社區,13159,34623,17506,17117
2019/1/1,高雄市,仁武區,34355,87940,44609,43331
2019/1/1,高雄市,鳥松區,18597,44538,22536,22002
2019/1/1,高雄市,岡山區,35088,97091,48151,48940
2019/1/1,高雄市,橋頭區,13796,37644,19083,18561
2019/1/1,高雄市,燕巢區,10648,29795,15665,14130
2019/1/1,高雄市,田寮區,3230,7148,3961,3187
2019/1/1,高雄市,阿蓮區,9419,28661,14457,14204
2019/1/1,高雄市,路竹區,17153,52531,26769,25762
2019/1/1,高雄市,湖內區,10942,29783,15246,14537
2019/1/1,高雄市,茄萣區,10540,30041,15431,14610
2019/1/1,高雄市,永安區,5758,13901,7003,6898
2019/1/1,高雄市,彌陀區,6795,19247,9866,9381
2019/1/1,高雄市,梓官區,12675,35906,18476,17430
2019/1/1,高雄市,旗山區,13719,36630,18900,17730
2019/1/1,高雄市,美濃區,14810,39560,20744,18816
2019/1/1,高雄市,六龜區,5567,12900,6960,5940
2019/1/1,高雄市,甲仙區,2288,6005,3190,2815
2019/1/1,高雄市,杉林區,4806,11773,6440,5333
2019/1/1,高雄市,內門區,5117,14402,7784,6618
2019/1/1,高雄市,茂林區,601,1982,999,983
2019/1/1,高雄市,桃源區,1363,4308,2272,2036
2019/1/1,高雄市,那瑪夏區,844,3151,1616,1535
2019/1/1,宜蘭縣,宜蘭市,36557,95686,46578,49108
2019/1/1,宜蘭縣,羅東鎮,26534,72449,34268,38181
2019/1/1,宜蘭縣,蘇澳鎮,14216,39595,20183,19412
2019/1/1,宜蘭縣,頭城鎮,10271,29095,15000,14095
2019/1/1,宜蘭縣,礁溪鄉,14195,35576,18493,17083
2019/1/1,宜蘭縣,壯圍鄉,8927,24328,12844,11484
2019/1/1,宜蘭縣,員山鄉,11745,32283,17107,15176
2019/1/1,宜蘭縣,冬山鄉,19437,52876,27116,25760
2019/1/1,宜蘭縣,五結鄉,15114,39514,20373,19141
2019/1/1,宜蘭縣,三星鄉,8653,21385,11496,9889
2019/1/1,宜蘭縣,大同鄉,1928,6235,3335,2900
2019/1/1,宜蘭縣,南澳鄉,1977,6013,3097,2916
2019/1/1,新竹縣,竹北市,68719,187867,93472,94395
2019/1/1,新竹縣,關西鎮,9390,28441,15260,13181
2019/1/1,新竹縣,新埔鎮,10787,33078,17627,15451
2019/1/1,新竹縣,竹東鎮,34139,96379,48358,48021
2019/1/1,新竹縣,湖口鄉,27077,77669,39310,38359
2019/1/1,新竹縣,橫山鄉,4432,12921,6992,5929
2019/1/1,新竹縣,新豐鄉,18838,57033,29231,27802
2019/1/1,新竹縣,芎林鄉,6622,19995,10589,9406
2019/1/1,新竹縣,寶山鄉,5700,14645,7933,6712
2019/1/1,新竹縣,北埔鄉,3133,9301,5044,4257
2019/1/1,新竹縣,峨眉鄉,2087,5581,3066,2515
2019/1/1,新竹縣,尖石鄉,2901,9678,5080,4598
2019/1/1,新竹縣,五峰鄉,1779,4761,2547,2214
2019/1/1,苗栗縣,苗栗市,31556,88159,43976,44183
2019/1/1,苗栗縣,頭份市,35465,103083,52035,51048
2019/1/1,苗栗縣,苑裡鎮,14714,45148,23522,21626
2019/1/1,苗栗縣,通霄鎮,11556,33937,17942,15995
2019/1/1,苗栗縣,竹南鎮,29951,86185,43477,42708
2019/1/1,苗栗縣,後龍鎮,11974,36199,19183,17016
2019/1/1,苗栗縣,卓蘭鎮,5999,16687,8740,7947
2019/1/1,苗栗縣,大湖鄉,5375,14451,7676,6775
2019/1/1,苗栗縣,公館鄉,10719,33230,17347,15883
2019/1/1,苗栗縣,銅鑼鄉,6137,17848,9513,8335
2019/1/1,苗栗縣,南庄鄉,3930,10005,5493,4512
2019/1/1,苗栗縣,頭屋鄉,3644,10645,5639,5006
2019/1/1,苗栗縣,三義鄉,5547,16169,8548,7621
2019/1/1,苗栗縣,西湖鄉,2637,7023,3920,3103
2019/1/1,苗栗縣,造橋鄉,4144,12689,6700,5989
2019/1/1,苗栗縣,三灣鄉,2378,6603,3614,2989
2019/1/1,苗栗縣,獅潭鄉,1712,4318,2420,1898
2019/1/1,苗栗縣,泰安鄉,1983,6024,3208,2816
2019/1/1,彰化縣,彰化市,76809,232637,114777,117860
2019/1/1,彰化縣,員林市,39880,124933,62066,62867
2019/1/1,彰化縣,鹿港鎮,24754,86819,44110,42709
2019/1/1,彰化縣,和美鎮,27015,90735,46102,44633
2019/1/1,彰化縣,北斗鎮,10781,33310,16781,16529
2019/1/1,彰化縣,溪湖鎮,16401,55329,27996,27333
2019/1/1,彰化縣,田中鎮,13207,41536,21367,20169
2019/1/1,彰化縣,二林鎮,15115,50499,25980,24519
2019/1/1,彰化縣,線西鄉,4442,16843,8639,8204
2019/1/1,彰化縣,伸港鄉,10146,37143,18951,18192
2019/1/1,彰化縣,福興鄉,12983,47026,24485,22541
2019/1/1,彰化縣,秀水鄉,10871,39261,20241,19020
2019/1/1,彰化縣,花壇鄉,14221,45859,23517,22342
2019/1/1,彰化縣,芬園鄉,6837,23573,12393,11180
2019/1/1,彰化縣,大村鄉,11204,36959,19072,17887
2019/1/1,彰化縣,埔鹽鄉,9135,32414,17040,15374
2019/1/1,彰化縣,埔心鄉,10735,34734,17873,16861
2019/1/1,彰化縣,永靖鄉,10937,36947,19112,17835
2019/1/1,彰化縣,社頭鄉,12971,42850,22020,20830
2019/1/1,彰化縣,二水鄉,5306,15129,7946,7183
2019/1/1,彰化縣,田尾鄉,8003,27276,14047,13229
2019/1/1,彰化縣,埤頭鄉,9098,30489,15753,14736
2019/1/1,彰化縣,芳苑鄉,10132,33444,17633,15811
2019/1/1,彰化縣,大城鄉,5231,16670,8994,7676
2019/1/1,彰化縣,竹塘鄉,4610,15068,7894,7174
2019/1/1,彰化縣,溪州鄉,8990,29693,15488,14205
2019/1/1,南投縣,南投市,34915,99476,49779,49697
2019/1/1,南投縣,埔里鎮,28970,80276,39925,40351
2019/1/1,南投縣,草屯鎮,33384,97146,49150,47996
2019/1/1,南投縣,竹山鎮,20138,54460,27905,26555
2019/1/1,南投縣,集集鎮,4291,10776,5618,5158
2019/1/1,南投縣,名間鄉,12610,38226,20173,18053
2019/1/1,南投縣,鹿谷鄉,8042,17661,9418,8243
2019/1/1,南投縣,中寮鄉,5620,14651,7954,6697
2019/1/1,南投縣,魚池鄉,5750,15767,8310,7457
2019/1/1,南投縣,國姓鄉,7287,18583,10039,8544
2019/1/1,南投縣,水里鄉,7097,17457,9155,8302
2019/1/1,南投縣,信義鄉,5271,16193,8670,7523
2019/1/1,南投縣,仁愛鄉,4891,15934,8220,7714
2019/1/1,雲林縣,斗六市,38580,108597,53961,54636
2019/1/1,雲林縣,斗南鎮,15895,44526,22612,21914
2019/1/1,雲林縣,虎尾鎮,25228,70860,35874,34986
2019/1/1,雲林縣,西螺鎮,14793,45995,23238,22757
2019/1/1,雲林縣,土庫鎮,9466,28758,14994,13764
2019/1/1,雲林縣,北港鎮,16061,39858,20578,19280
2019/1/1,雲林縣,古坑鄉,11027,31310,16502,14808
2019/1/1,雲林縣,大埤鄉,6634,19010,10185,8825
2019/1/1,雲林縣,莿桐鄉,9373,28704,15007,13697
2019/1/1,雲林縣,林內鄉,6026,17940,9366,8574
2019/1/1,雲林縣,二崙鄉,8932,26814,14342,12472
2019/1/1,雲林縣,崙背鄉,8490,24281,12820,11461
2019/1/1,雲林縣,麥寮鄉,14567,46219,23136,23083
2019/1/1,雲林縣,東勢鄉,5714,14720,8137,6583
2019/1/1,雲林縣,褒忠鄉,4434,12868,6940,5928
2019/1/1,雲林縣,臺西鄉,8626,23663,12689,10974
2019/1/1,雲林縣,元長鄉,9216,25592,14007,11585
2019/1/1,雲林縣,四湖鄉,8695,23155,12560,10595
2019/1/1,雲林縣,口湖鄉,9417,27230,14505,12725
2019/1/1,雲林縣,水林鄉,9819,25254,13767,11487
2019/1/1,嘉義縣,太保市,13224,38116,19507,18609
2019/1/1,嘉義縣,朴子市,15774,42101,21248,20853
2019/1/1,嘉義縣,布袋鎮,9910,26705,13644,13061
2019/1/1,嘉義縣,大林鎮,11398,30889,15785,15104
2019/1/1,嘉義縣,民雄鄉,25154,71342,36502,34840
2019/1/1,嘉義縣,溪口鄉,5308,14555,7786,6769
2019/1/1,嘉義縣,新港鄉,10699,31678,16695,14983
2019/1/1,嘉義縣,六腳鄉,8799,22902,12136,10766
2019/1/1,嘉義縣,東石鄉,9186,24529,12989,11540
2019/1/1,嘉義縣,義竹鄉,7322,18203,9458,8745
2019/1/1,嘉義縣,鹿草鄉,5740,15327,8224,7103
2019/1/1,嘉義縣,水上鄉,18164,49290,25470,23820
2019/1/1,嘉義縣,中埔鄉,16056,44544,23188,21356
2019/1/1,嘉義縣,竹崎鄉,11663,35521,18888,16633
2019/1/1,嘉義縣,梅山鄉,6772,19249,10223,9026
2019/1/1,嘉義縣,番路鄉,4229,11415,6166,5249
2019/1/1,嘉義縣,大埔鄉,1924,4609,2377,2232
2019/1/1,嘉義縣,阿里山鄉,1900,5584,2928,2656
2019/1/1,屏東縣,屏東市,74619,199476,98368,101108
2019/1/1,屏東縣,潮州鎮,19566,53907,26929,26978
2019/1/1,屏東縣,東港鎮,16860,47569,23988,23581
2019/1/1,屏東縣,恆春鎮,11680,30789,15791,14998
2019/1/1,屏東縣,萬丹鄉,15102,50485,26206,24279
2019/1/1,屏東縣,長治鄉,10165,29630,15461,14169
2019/1/1,屏東縣,麟洛鄉,3857,11035,5712,5323
2019/1/1,屏東縣,九如鄉,7069,22062,11383,10679
2019/1/1,屏東縣,里港鄉,8201,26018,13232,12786
2019/1/1,屏東縣,鹽埔鄉,7889,25674,13331,12343
2019/1/1,屏東縣,高樹鄉,9251,24335,12977,11358
2019/1/1,屏東縣,萬巒鄉,6523,20565,10712,9853
2019/1/1,屏東縣,內埔鄉,18732,54090,27932,26158
2019/1/1,屏東縣,竹田鄉,5659,17099,9076,8023
2019/1/1,屏東縣,新埤鄉,3449,9940,5278,4662
2019/1/1,屏東縣,枋寮鄉,8557,24278,12685,11593
2019/1/1,屏東縣,新園鄉,11823,34843,18053,16790
2019/1/1,屏東縣,崁頂鄉,4512,15518,7810,7708
2019/1/1,屏東縣,林邊鄉,6698,17780,9088,8692
2019/1/1,屏東縣,南州鄉,3714,10618,5451,5167
2019/1/1,屏東縣,佳冬鄉,6966,19072,9898,9174
2019/1/1,屏東縣,琉球鄉,4541,12351,6767,5584
2019/1/1,屏東縣,車城鄉,3483,8546,4574,3972
2019/1/1,屏東縣,滿州鄉,3041,7919,4283,3636
2019/1/1,屏東縣,枋山鄉,2088,5479,2908,2571
2019/1/1,屏東縣,三地門鄉,2330,7700,3864,3836
2019/1/1,屏東縣,霧臺鄉,1060,3348,1706,1642
2019/1/1,屏東縣,瑪家鄉,2056,6815,3438,3377
2019/1/1,屏東縣,泰武鄉,1363,5393,2820,2573
2019/1/1,屏東縣,來義鄉,2232,7440,3752,3688
2019/1/1,屏東縣,春日鄉,1413,4902,2505,2397
2019/1/1,屏東縣,獅子鄉,1577,4941,2542,2399
2019/1/1,屏東縣,牡丹鄉,1943,4970,2515,2455
2019/1/1,臺東縣,臺東市,39907,105505,52748,52757
2019/1/1,臺東縣,成功鎮,5358,14033,7387,6646
2019/1/1,臺東縣,關山鎮,3160,8684,4511,4173
2019/1/1,臺東縣,卑南鄉,6724,17285,9109,8176
2019/1/1,臺東縣,大武鄉,2464,6020,3134,2886
2019/1/1,臺東縣,太麻里鄉,4730,11139,5927,5212
2019/1/1,臺東縣,東河鄉,3752,8449,4677,3772
2019/1/1,臺東縣,長濱鄉,2909,7166,4068,3098
2019/1/1,臺東縣,鹿野鄉,3045,7864,4166,3698
2019/1/1,臺東縣,池上鄉,3190,8205,4253,3952
2019/1/1,臺東縣,綠島鄉,1160,4080,2169,1911
2019/1/1,臺東縣,延平鄉,1068,3613,1923,1690
2019/1/1,臺東縣,海端鄉,1088,4197,2228,1969
2019/1/1,臺東縣,達仁鄉,1441,3562,1928,1634
2019/1/1,臺東縣,金峰鄉,1150,3726,1882,1844
2019/1/1,臺東縣,蘭嶼鄉,1879,5163,2609,2554
2019/1/1,花蓮縣,花蓮市,41516,103834,50011,53823
2019/1/1,花蓮縣,鳳林鎮,4388,10838,5637,5201
2019/1/1,花蓮縣,玉里鎮,8875,23988,12678,11310
2019/1/1,花蓮縣,新城鄉,7766,20130,10302,9828
2019/1/1,花蓮縣,吉安鄉,32214,83231,41865,41366
2019/1/1,花蓮縣,壽豐鄉,7262,17964,9496,8468
2019/1/1,花蓮縣,光復鄉,5019,12751,6783,5968
2019/1/1,花蓮縣,豐濱鄉,1712,4708,2611,2097
2019/1/1,花蓮縣,瑞穗鄉,4778,11643,6286,5357
2019/1/1,花蓮縣,富里鄉,4039,10267,5581,4686
2019/1/1,花蓮縣,秀林鄉,4850,15943,8179,7764
2019/1/1,花蓮縣,萬榮鄉,2116,6402,3369,3033
2019/1/1,花蓮縣,卓溪鄉,1696,6089,3334,2755
2019/1/1,澎湖縣,馬公市,24983,62590,31830,30760
2019/1/1,澎湖縣,湖西鄉,5730,14640,7744,6896
2019/1/1,澎湖縣,白沙鄉,3468,9824,5124,4700
2019/1/1,澎湖縣,西嶼鄉,3040,8358,4320,4038
2019/1/1,澎湖縣,望安鄉,2046,5266,2843,2423
2019/1/1,澎湖縣,七美鄉,1381,3833,1983,1850
2019/1/1,基隆市,中正區,22637,51655,26309,25346
2019/1/1,基隆市,七堵區,21579,53784,26988,26796
2019/1/1,基隆市,暖暖區,15730,38601,19335,19266
2019/1/1,基隆市,仁愛區,19078,43727,21661,22066
2019/1/1,基隆市,中山區,19254,47315,23993,23322
2019/1/1,基隆市,安樂區,33645,82292,40707,41585
2019/1/1,基隆市,信義區,21707,52613,25912,26701
2019/1/1,新竹市,東區,80821,215897,106058,109839
2019/1/1,新竹市,北區,57456,151714,74117,77597
2019/1/1,新竹市,香山區,27598,78379,39783,38596
2019/1/1,嘉義市,東區,45514,121126,58249,62877
2019/1/1,嘉義市,西區,54456,147453,72130,75323
2019/1/1,金門縣,金城鎮,13019,43366,21577,21789
2019/1/1,金門縣,金湖鎮,9107,29930,14988,14942
2019/1/1,金門縣,金沙鎮,6381,20814,10298,10516
2019/1/1,金門縣,金寧鄉,8880,31859,16057,15802
2019/1/1,金門縣,烈嶼鄉,3184,12832,6321,6511
2019/1/1,金門縣,烏坵鄉,135,683,347,336
2019/1/1,連江縣,南竿鄉,1787,7662,4299,3363
2019/1/1,連江縣,北竿鄉,652,2444,1369,1075
2019/1/1,連江縣,莒光鄉,303,1615,988,627
2019/1/1,連江縣,東引鄉,342,1358,809,549
2019/2/1,總計,新北市,1564546,3998358,1955711,2042647
2019/2/1,總計,臺北市,1056439,2664983,1271327,1393656
2019/2/1,總計,桃園市,810219,2225621,1106147,1119474
2019/2/1,總計,臺中市,975133,2807325,1381561,1425764
2019/2/1,總計,臺南市,690046,1883448,939642,943806
2019/2/1,總計,高雄市,1101122,2773596,1371586,1402010
2019/2/1,總計,臺灣省,2505361,7084174,3607952,3476222
2019/2/1,總計,宜蘭縣,169609,454922,229834,225088
2019/2/1,總計,新竹縣,195924,557641,284703,272938
2019/2/1,總計,苗栗縣,189512,548124,282809,265315
2019/2/1,總計,彰化縣,389981,1276766,650065,626701
2019/2/1,總計,南投縣,178296,496435,254196,242239
2019/2/1,總計,雲林縣,241036,684759,354914,329845
2019/2/1,總計,嘉義縣,183234,506206,263014,243192
2019/2/1,總計,屏東縣,288037,823952,420700,403252
2019/2/1,總計,臺東縣,83032,218513,112594,105919
2019/2/1,總計,花蓮縣,126231,327654,166019,161635
2019/2/1,總計,澎湖縣,40757,104533,53866,50667
2019/2/1,總計,基隆市,153645,369916,184845,185071
2019/2/1,總計,新竹市,166034,446210,220055,226155
2019/2/1,總計,嘉義市,100033,268543,130338,138205
2019/2/1,總計,福建省,43814,152499,77026,75473
2019/2/1,總計,金門縣,40717,139426,69559,69867
2019/2/1,總計,連江縣,3097,13073,7467,5606
2019/2/1,新北市,板橋區,212941,554992,270333,284659
2019/2/1,新北市,三重區,151910,385704,189499,196205
2019/2/1,新北市,中和區,166198,412285,199884,212401
2019/2/1,新北市,永和區,91176,221231,104910,116321
2019/2/1,新北市,新莊區,155826,418085,203836,214249
2019/2/1,新北市,新店區,127887,302180,145078,157102
2019/2/1,新北市,樹林區,66704,183894,91701,92193
2019/2/1,新北市,鶯歌區,30485,86434,43316,43118
2019/2/1,新北市,三峽區,43333,115947,58007,57940
2019/2/1,新北市,淡水區,77641,174288,83427,90861
2019/2/1,新北市,汐止區,88117,200920,97856,103064
2019/2/1,新北市,瑞芳區,16145,39914,20124,19790
2019/2/1,新北市,土城區,87291,236917,116680,120237
2019/2/1,新北市,蘆洲區,71796,201427,98888,102539
2019/2/1,新北市,五股區,32683,86567,43614,42953
2019/2/1,新北市,泰山區,28675,78729,38931,39798
2019/2/1,新北市,林口區,44446,111141,53994,57147
2019/2/1,新北市,深坑區,9649,23691,11853,11838
2019/2/1,新北市,石碇區,3405,7722,4211,3511
2019/2/1,新北市,坪林區,2530,6629,3645,2984
2019/2/1,新北市,三芝區,9502,22889,11790,11099
2019/2/1,新北市,石門區,4311,12066,6238,5828
2019/2/1,新北市,八里區,14927,38859,19388,19471
2019/2/1,新北市,平溪區,2288,4654,2585,2069
2019/2/1,新北市,雙溪區,3793,8831,4770,4061
2019/2/1,新北市,貢寮區,4354,12231,6238,5993
2019/2/1,新北市,金山區,7139,21708,10697,11011
2019/2/1,新北市,萬里區,7497,21994,11056,10938
2019/2/1,新北市,烏來區,1897,6429,3162,3267
2019/2/1,臺北市,松山區,81217,205626,96362,109264
2019/2/1,臺北市,信義區,89483,222814,106189,116625
2019/2/1,臺北市,大安區,121344,308727,143896,164831
2019/2/1,臺北市,中山區,100450,229088,106426,122662
2019/2/1,臺北市,中正區,65475,158814,75791,83023
2019/2/1,臺北市,大同區,51881,127559,62056,65503
2019/2/1,臺北市,萬華區,78764,189052,92662,96390
2019/2/1,臺北市,文山區,106781,273605,131073,142532
2019/2/1,臺北市,南港區,47371,121379,59289,62090
2019/2/1,臺北市,內湖區,108783,287331,137101,150230
2019/2/1,臺北市,士林區,107486,285931,137743,148188
2019/2/1,臺北市,北投區,97404,255057,122739,132318
2019/2/1,桃園市,桃園區,170060,448281,217429,230852
2019/2/1,桃園市,中壢區,153700,412985,203018,209967
2019/2/1,桃園市,大溪區,32939,94988,48332,46656
2019/2/1,桃園市,楊梅區,59601,170810,85988,84822
2019/2/1,桃園市,蘆竹區,59520,164544,81630,82914
2019/2/1,桃園市,大園區,33866,91235,46509,44726
2019/2/1,桃園市,龜山區,62870,160962,80059,80903
2019/2/1,桃園市,八德區,72554,202930,101311,101619
2019/2/1,桃園市,龍潭區,42670,123353,61663,61690
2019/2/1,桃園市,平鎮區,78579,226786,112500,114286
2019/2/1,桃園市,新屋區,16645,49228,26214,23014
2019/2/1,桃園市,觀音區,23385,67442,34975,32467
2019/2/1,桃園市,復興區,3830,12077,6519,5558
2019/2/1,臺中市,中區,7973,18473,9134,9339
2019/2/1,臺中市,東區,28369,76244,37865,38379
2019/2/1,臺中市,南區,49121,126047,60467,65580
2019/2/1,臺中市,西區,45898,115748,54908,60840
2019/2/1,臺中市,北區,59732,147426,70450,76976
2019/2/1,臺中市,西屯區,87298,229083,109809,119274
2019/2/1,臺中市,南屯區,63607,171111,81758,89353
2019/2/1,臺中市,北屯區,102858,280266,134117,146149
2019/2/1,臺中市,豐原區,54349,167114,82483,84631
2019/2/1,臺中市,東勢區,17393,50184,25746,24438
2019/2/1,臺中市,大甲區,23366,77582,38939,38643
2019/2/1,臺中市,清水區,27901,86981,44597,42384
2019/2/1,臺中市,沙鹿區,30275,94256,47499,46757
2019/2/1,臺中市,梧棲區,18200,58430,29290,29140
2019/2/1,臺中市,后里區,16531,54789,27778,27011
2019/2/1,臺中市,神岡區,19718,65706,33469,32237
2019/2/1,臺中市,潭子區,36765,109129,53879,55250
2019/2/1,臺中市,大雅區,30094,95894,47718,48176
2019/2/1,臺中市,新社區,7625,24537,12725,11812
2019/2/1,臺中市,石岡區,4916,14923,7712,7211
2019/2/1,臺中市,外埔區,9847,32256,16462,15794
2019/2/1,臺中市,大安區,5541,19233,10141,9092
2019/2/1,臺中市,烏日區,25225,75548,37822,37726
2019/2/1,臺中市,大肚區,17893,57304,29261,28043
2019/2/1,臺中市,龍井區,23440,77902,39177,38725
2019/2/1,臺中市,霧峰區,20506,65602,33219,32383
2019/2/1,臺中市,太平區,65652,192260,95214,97046
2019/2/1,臺中市,大里區,70437,212320,104047,108273
2019/2/1,臺中市,和平區,4603,10977,5875,5102
2019/2/1,臺南市,新營區,29073,77563,38378,39185
2019/2/1,臺南市,鹽水區,10054,25375,13225,12150
2019/2/1,臺南市,白河區,10785,28033,14648,13385
2019/2/1,臺南市,柳營區,7937,21127,11023,10104
2019/2/1,臺南市,後壁區,8798,23269,12073,11196
2019/2/1,臺南市,東山區,8323,20708,10983,9725
2019/2/1,臺南市,麻豆區,15842,44221,22472,21749
2019/2/1,臺南市,下營區,9058,23838,12305,11533
2019/2/1,臺南市,六甲區,7806,22115,11448,10667
2019/2/1,臺南市,官田區,7973,21279,10841,10438
2019/2/1,臺南市,大內區,3813,9558,5167,4391
2019/2/1,臺南市,佳里區,20858,59073,29252,29821
2019/2/1,臺南市,學甲區,9636,25675,13141,12534
2019/2/1,臺南市,西港區,8277,24657,12458,12199
2019/2/1,臺南市,七股區,8042,22717,11783,10934
2019/2/1,臺南市,將軍區,7278,19626,9991,9635
2019/2/1,臺南市,北門區,4218,11013,5552,5461
2019/2/1,臺南市,新化區,14502,43418,22093,21325
2019/2/1,臺南市,善化區,18128,49143,24699,24444
2019/2/1,臺南市,新市區,12638,37017,18523,18494
2019/2/1,臺南市,安定區,10209,30447,15666,14781
2019/2/1,臺南市,山上區,2729,7300,3809,3491
2019/2/1,臺南市,玉井區,5159,13959,7206,6753
2019/2/1,臺南市,楠西區,3523,9490,5020,4470
2019/2/1,臺南市,南化區,2854,8686,4679,4007
2019/2/1,臺南市,左鎮區,1949,4767,2684,2083
2019/2/1,臺南市,仁德區,27939,75911,38358,37553
2019/2/1,臺南市,歸仁區,22929,68398,34702,33696
2019/2/1,臺南市,關廟區,11247,34285,17668,16617
2019/2/1,臺南市,龍崎區,1534,3986,2142,1844
2019/2/1,臺南市,永康區,85386,234814,115547,119267
2019/2/1,臺南市,東區,72262,186403,89230,97173
2019/2/1,臺南市,南區,46222,124906,61742,63164
2019/2/1,臺南市,北區,51253,131980,64060,67920
2019/2/1,臺南市,安南區,64034,193704,97605,96099
2019/2/1,臺南市,安平區,26073,66835,31760,35075
2019/2/1,臺南市,中西區,31705,78152,37709,40443
2019/2/1,高雄市,鹽埕區,10816,24041,11924,12117
2019/2/1,高雄市,鼓山區,58836,140251,67549,72702
2019/2/1,高雄市,左營區,79465,197039,94560,102479
2019/2/1,高雄市,楠梓區,72210,186184,91244,94940
2019/2/1,高雄市,三民區,137146,340601,164546,176055
2019/2/1,高雄市,新興區,23006,51097,24515,26582
2019/2/1,高雄市,前金區,12727,26832,12724,14108
2019/2/1,高雄市,苓雅區,72344,169504,81347,88157
2019/2/1,高雄市,前鎮區,78762,188100,92394,95706
2019/2/1,高雄市,旗津區,11116,28435,14630,13805
2019/2/1,高雄市,小港區,68583,157771,78259,79512
2019/2/1,高雄市,鳳山區,142167,359665,175934,183731
2019/2/1,高雄市,林園區,26193,69846,35262,34584
2019/2/1,高雄市,大寮區,42571,112462,57431,55031
2019/2/1,高雄市,大樹區,13676,42349,21681,20668
2019/2/1,高雄市,大社區,13168,34617,17515,17102
2019/2/1,高雄市,仁武區,34454,88020,44629,43391
2019/2/1,高雄市,鳥松區,18706,44639,22573,22066
2019/2/1,高雄市,岡山區,35094,97129,48162,48967
2019/2/1,高雄市,橋頭區,13798,37603,19061,18542
2019/2/1,高雄市,燕巢區,10655,29788,15674,14114
2019/2/1,高雄市,田寮區,3228,7146,3961,3185
2019/2/1,高雄市,阿蓮區,9413,28626,14445,14181
2019/2/1,高雄市,路竹區,17167,52544,26775,25769
2019/2/1,高雄市,湖內區,10942,29748,15233,14515
2019/2/1,高雄市,茄萣區,10537,30015,15421,14594
2019/2/1,高雄市,永安區,5753,13896,7007,6889
2019/2/1,高雄市,彌陀區,6796,19231,9859,9372
2019/2/1,高雄市,梓官區,12677,35883,18465,17418
2019/2/1,高雄市,旗山區,13722,36570,18871,17699
2019/2/1,高雄市,美濃區,14816,39530,20733,18797
2019/2/1,高雄市,六龜區,5567,12881,6942,5939
2019/2/1,高雄市,甲仙區,2286,6003,3190,2813
2019/2/1,高雄市,杉林區,4802,11724,6413,5311
2019/2/1,高雄市,內門區,5118,14387,7772,6615
2019/2/1,高雄市,茂林區,601,1977,996,981
2019/2/1,高雄市,桃源區,1360,4312,2272,2040
2019/2/1,高雄市,那瑪夏區,844,3150,1617,1533
2019/2/1,宜蘭縣,宜蘭市,36578,95709,46592,49117
2019/2/1,宜蘭縣,羅東鎮,26542,72445,34260,38185
2019/2/1,宜蘭縣,蘇澳鎮,14207,39530,20147,19383
2019/2/1,宜蘭縣,頭城鎮,10276,29087,14997,14090
2019/2/1,宜蘭縣,礁溪鄉,14204,35579,18485,17094
2019/2/1,宜蘭縣,壯圍鄉,8930,24332,12847,11485
2019/2/1,宜蘭縣,員山鄉,11739,32245,17086,15159
2019/2/1,宜蘭縣,冬山鄉,19448,52886,27132,25754
2019/2/1,宜蘭縣,五結鄉,15125,39531,20385,19146
2019/2/1,宜蘭縣,三星鄉,8650,21354,11478,9876
2019/2/1,宜蘭縣,大同鄉,1933,6221,3327,2894
2019/2/1,宜蘭縣,南澳鄉,1977,6003,3098,2905
2019/2/1,新竹縣,竹北市,68944,188288,93693,94595
2019/2/1,新竹縣,關西鎮,9393,28381,15236,13145
2019/2/1,新竹縣,新埔鎮,10786,33037,17598,15439
2019/2/1,新竹縣,竹東鎮,34169,96404,48387,48017
2019/2/1,新竹縣,湖口鄉,27100,77671,39316,38355
2019/2/1,新竹縣,橫山鄉,4427,12904,6991,5913
2019/2/1,新竹縣,新豐鄉,18871,57087,29257,27830
2019/2/1,新竹縣,芎林鄉,6633,19992,10583,9409
2019/2/1,新竹縣,寶山鄉,5701,14621,7924,6697
2019/2/1,新竹縣,北埔鄉,3133,9299,5046,4253
2019/2/1,新竹縣,峨眉鄉,2088,5567,3062,2505
2019/2/1,新竹縣,尖石鄉,2903,9663,5075,4588
2019/2/1,新竹縣,五峰鄉,1776,4727,2535,2192
2019/2/1,苗栗縣,苗栗市,31563,88143,43982,44161
2019/2/1,苗栗縣,頭份市,35527,103103,52018,51085
2019/2/1,苗栗縣,苑裡鎮,14714,45110,23502,21608
2019/2/1,苗栗縣,通霄鎮,11543,33888,17919,15969
2019/2/1,苗栗縣,竹南鎮,29990,86239,43503,42736
2019/2/1,苗栗縣,後龍鎮,11976,36162,19171,16991
2019/2/1,苗栗縣,卓蘭鎮,5998,16659,8725,7934
2019/2/1,苗栗縣,大湖鄉,5362,14420,7654,6766
2019/2/1,苗栗縣,公館鄉,10720,33208,17336,15872
2019/2/1,苗栗縣,銅鑼鄉,6130,17824,9488,8336
2019/2/1,苗栗縣,南庄鄉,3933,9992,5485,4507
2019/2/1,苗栗縣,頭屋鄉,3643,10621,5627,4994
2019/2/1,苗栗縣,三義鄉,5545,16148,8539,7609
2019/2/1,苗栗縣,西湖鄉,2638,7010,3918,3092
2019/2/1,苗栗縣,造橋鄉,4150,12679,6703,5976
2019/2/1,苗栗縣,三灣鄉,2377,6595,3614,2981
2019/2/1,苗栗縣,獅潭鄉,1715,4311,2418,1893
2019/2/1,苗栗縣,泰安鄉,1988,6012,3207,2805
2019/2/1,彰化縣,彰化市,76842,232613,114756,117857
2019/2/1,彰化縣,員林市,39912,124960,62048,62912
2019/2/1,彰化縣,鹿港鎮,24776,86842,44123,42719
2019/2/1,彰化縣,和美鎮,27026,90728,46110,44618
2019/2/1,彰化縣,北斗鎮,10785,33308,16783,16525
2019/2/1,彰化縣,溪湖鎮,16403,55357,28005,27352
2019/2/1,彰化縣,田中鎮,13218,41523,21367,20156
2019/2/1,彰化縣,二林鎮,15119,50467,25969,24498
2019/2/1,彰化縣,線西鄉,4443,16819,8636,8183
2019/2/1,彰化縣,伸港鄉,10158,37146,18939,18207
2019/2/1,彰化縣,福興鄉,13000,47008,24457,22551
2019/2/1,彰化縣,秀水鄉,10869,39256,20240,19016
2019/2/1,彰化縣,花壇鄉,14217,45828,23508,22320
2019/2/1,彰化縣,芬園鄉,6832,23537,12377,11160
2019/2/1,彰化縣,大村鄉,11218,36950,19089,17861
2019/2/1,彰化縣,埔鹽鄉,9141,32387,17045,15342
2019/2/1,彰化縣,埔心鄉,10752,34723,17860,16863
2019/2/1,彰化縣,永靖鄉,10939,36914,19106,17808
2019/2/1,彰化縣,社頭鄉,12967,42799,21983,20816
2019/2/1,彰化縣,二水鄉,5300,15104,7937,7167
2019/2/1,彰化縣,田尾鄉,7998,27247,14041,13206
2019/2/1,彰化縣,埤頭鄉,9098,30460,15737,14723
2019/2/1,彰化縣,芳苑鄉,10133,33401,17604,15797
2019/2/1,彰化縣,大城鄉,5231,16668,8995,7673
2019/2/1,彰化縣,竹塘鄉,4609,15059,7884,7175
2019/2/1,彰化縣,溪州鄉,8995,29662,15466,14196
2019/2/1,南投縣,南投市,34929,99483,49793,49690
2019/2/1,南投縣,埔里鎮,28990,80274,39922,40352
2019/2/1,南投縣,草屯鎮,33405,97193,49148,48045
2019/2/1,南投縣,竹山鎮,20123,54406,27866,26540
2019/2/1,南投縣,集集鎮,4287,10746,5603,5143
2019/2/1,南投縣,名間鄉,12606,38175,20153,18022
2019/2/1,南投縣,鹿谷鄉,8054,17667,9419,8248
2019/2/1,南投縣,中寮鄉,5615,14640,7948,6692
2019/2/1,南投縣,魚池鄉,5749,15754,8309,7445
2019/2/1,南投縣,國姓鄉,7284,18531,10011,8520
2019/2/1,南投縣,水里鄉,7091,17433,9135,8298
2019/2/1,南投縣,信義鄉,5270,16169,8657,7512
2019/2/1,南投縣,仁愛鄉,4893,15964,8232,7732
2019/2/1,雲林縣,斗六市,38595,108633,53979,54654
2019/2/1,雲林縣,斗南鎮,15900,44495,22604,21891
2019/2/1,雲林縣,虎尾鎮,25246,70861,35871,34990
2019/2/1,雲林縣,西螺鎮,14813,45941,23220,22721
2019/2/1,雲林縣,土庫鎮,9469,28739,14983,13756
2019/2/1,雲林縣,北港鎮,16050,39797,20545,19252
2019/2/1,雲林縣,古坑鄉,11037,31286,16483,14803
2019/2/1,雲林縣,大埤鄉,6625,18985,10174,8811
2019/2/1,雲林縣,莿桐鄉,9369,28710,15009,13701
2019/2/1,雲林縣,林內鄉,6021,17908,9348,8560
2019/2/1,雲林縣,二崙鄉,8928,26755,14303,12452
2019/2/1,雲林縣,崙背鄉,8488,24242,12799,11443
2019/2/1,雲林縣,麥寮鄉,14603,46183,23121,23062
2019/2/1,雲林縣,東勢鄉,5712,14703,8139,6564
2019/2/1,雲林縣,褒忠鄉,4434,12849,6929,5920
2019/2/1,雲林縣,臺西鄉,8616,23605,12658,10947
2019/2/1,雲林縣,元長鄉,9209,25565,13999,11566
2019/2/1,雲林縣,四湖鄉,8695,23115,12538,10577
2019/2/1,雲林縣,口湖鄉,9411,27186,14475,12711
2019/2/1,雲林縣,水林鄉,9815,25201,13737,11464
2019/2/1,嘉義縣,太保市,13247,38124,19513,18611
2019/2/1,嘉義縣,朴子市,15786,42100,21250,20850
2019/2/1,嘉義縣,布袋鎮,9907,26666,13623,13043
2019/2/1,嘉義縣,大林鎮,11399,30896,15796,15100
2019/2/1,嘉義縣,民雄鄉,25161,71337,36479,34858
2019/2/1,嘉義縣,溪口鄉,5304,14517,7767,6750
2019/2/1,嘉義縣,新港鄉,10698,31659,16681,14978
2019/2/1,嘉義縣,六腳鄉,8795,22867,12116,10751
2019/2/1,嘉義縣,東石鄉,9175,24468,12958,11510
2019/2/1,嘉義縣,義竹鄉,7320,18182,9444,8738
2019/2/1,嘉義縣,鹿草鄉,5742,15285,8199,7086
2019/2/1,嘉義縣,水上鄉,18169,49300,25462,23838
2019/2/1,嘉義縣,中埔鄉,16054,44513,23166,21347
2019/2/1,嘉義縣,竹崎鄉,11659,35476,18872,16604
2019/2/1,嘉義縣,梅山鄉,6771,19230,10220,9010
2019/2/1,嘉義縣,番路鄉,4229,11408,6162,5246
2019/2/1,嘉義縣,大埔鄉,1920,4603,2375,2228
2019/2/1,嘉義縣,阿里山鄉,1898,5575,2931,2644
2019/2/1,屏東縣,屏東市,74610,199362,98303,101059
2019/2/1,屏東縣,潮州鎮,19588,53877,26909,26968
2019/2/1,屏東縣,東港鎮,16854,47504,23955,23549
2019/2/1,屏東縣,恆春鎮,11681,30769,15770,14999
2019/2/1,屏東縣,萬丹鄉,15125,50478,26201,24277
2019/2/1,屏東縣,長治鄉,10167,29606,15452,14154
2019/2/1,屏東縣,麟洛鄉,3853,11021,5708,5313
2019/2/1,屏東縣,九如鄉,7069,22036,11361,10675
2019/2/1,屏東縣,里港鄉,8197,25984,13213,12771
2019/2/1,屏東縣,鹽埔鄉,7886,25633,13311,12322
2019/2/1,屏東縣,高樹鄉,9246,24308,12966,11342
2019/2/1,屏東縣,萬巒鄉,6528,20554,10705,9849
2019/2/1,屏東縣,內埔鄉,18736,54050,27908,26142
2019/2/1,屏東縣,竹田鄉,5664,17095,9072,8023
2019/2/1,屏東縣,新埤鄉,3446,9928,5272,4656
2019/2/1,屏東縣,枋寮鄉,8554,24245,12684,11561
2019/2/1,屏東縣,新園鄉,11824,34799,18033,16766
2019/2/1,屏東縣,崁頂鄉,4515,15514,7810,7704
2019/2/1,屏東縣,林邊鄉,6695,17772,9078,8694
2019/2/1,屏東縣,南州鄉,3715,10615,5452,5163
2019/2/1,屏東縣,佳冬鄉,6966,19049,9891,9158
2019/2/1,屏東縣,琉球鄉,4542,12334,6755,5579
2019/2/1,屏東縣,車城鄉,3475,8509,4555,3954
2019/2/1,屏東縣,滿州鄉,3039,7902,4268,3634
2019/2/1,屏東縣,枋山鄉,2085,5456,2900,2556
2019/2/1,屏東縣,三地門鄉,2327,7713,3867,3846
2019/2/1,屏東縣,霧臺鄉,1057,3336,1705,1631
2019/2/1,屏東縣,瑪家鄉,2055,6814,3447,3367
2019/2/1,屏東縣,泰武鄉,1364,5391,2818,2573
2019/2/1,屏東縣,來義鄉,2235,7449,3754,3695
2019/2/1,屏東縣,春日鄉,1412,4915,2511,2404
2019/2/1,屏東縣,獅子鄉,1580,4960,2551,2409
2019/2/1,屏東縣,牡丹鄉,1947,4974,2515,2459
2019/2/1,臺東縣,臺東市,39926,105496,52716,52780
2019/2/1,臺東縣,成功鎮,5355,14005,7373,6632
2019/2/1,臺東縣,關山鎮,3165,8683,4508,4175
2019/2/1,臺東縣,卑南鄉,6725,17270,9097,8173
2019/2/1,臺東縣,大武鄉,2459,5981,3117,2864
2019/2/1,臺東縣,太麻里鄉,4731,11132,5925,5207
2019/2/1,臺東縣,東河鄉,3750,8437,4665,3772
2019/2/1,臺東縣,長濱鄉,2907,7152,4065,3087
2019/2/1,臺東縣,鹿野鄉,3040,7857,4164,3693
2019/2/1,臺東縣,池上鄉,3191,8196,4244,3952
2019/2/1,臺東縣,綠島鄉,1155,4067,2159,1908
2019/2/1,臺東縣,延平鄉,1069,3596,1918,1678
2019/2/1,臺東縣,海端鄉,1087,4196,2228,1968
2019/2/1,臺東縣,達仁鄉,1439,3561,1929,1632
2019/2/1,臺東縣,金峰鄉,1153,3719,1878,1841
2019/2/1,臺東縣,蘭嶼鄉,1880,5165,2608,2557
2019/2/1,花蓮縣,花蓮市,41490,103768,49967,53801
2019/2/1,花蓮縣,鳳林鎮,4386,10826,5625,5201
2019/2/1,花蓮縣,玉里鎮,8874,23958,12664,11294
2019/2/1,花蓮縣,新城鄉,7770,20142,10313,9829
2019/2/1,花蓮縣,吉安鄉,32244,83269,41871,41398
2019/2/1,花蓮縣,壽豐鄉,7257,17963,9494,8469
2019/2/1,花蓮縣,光復鄉,5021,12749,6779,5970
2019/2/1,花蓮縣,豐濱鄉,1715,4693,2599,2094
2019/2/1,花蓮縣,瑞穗鄉,4774,11605,6259,5346
2019/2/1,花蓮縣,富里鄉,4037,10248,5568,4680
2019/2/1,花蓮縣,秀林鄉,4852,15927,8175,7752
2019/2/1,花蓮縣,萬榮鄉,2111,6405,3372,3033
2019/2/1,花蓮縣,卓溪鄉,1700,6101,3333,2768
2019/2/1,澎湖縣,馬公市,25017,62607,31842,30765
2019/2/1,澎湖縣,湖西鄉,5788,14677,7776,6901
2019/2/1,澎湖縣,白沙鄉,3477,9813,5118,4695
2019/2/1,澎湖縣,西嶼鄉,3044,8344,4311,4033
2019/2/1,澎湖縣,望安鄉,2050,5269,2843,2426
2019/2/1,澎湖縣,七美鄉,1381,3823,1976,1847
2019/2/1,基隆市,中正區,22621,51659,26305,25354
2019/2/1,基隆市,七堵區,21586,53745,26978,26767
2019/2/1,基隆市,暖暖區,15736,38587,19316,19271
2019/2/1,基隆市,仁愛區,19054,43644,21620,22024
2019/2/1,基隆市,中山區,19250,47321,24000,23321
2019/2/1,基隆市,安樂區,33664,82333,40721,41612
2019/2/1,基隆市,信義區,21734,52627,25905,26722
2019/2/1,新竹市,東區,80933,216125,106159,109966
2019/2/1,新竹市,北區,57497,151749,74136,77613
2019/2/1,新竹市,香山區,27604,78336,39760,38576
2019/2/1,嘉義市,東區,45518,121098,58229,62869
2019/2/1,嘉義市,西區,54515,147445,72109,75336
2019/2/1,金門縣,金城鎮,13011,43332,21563,21769
2019/2/1,金門縣,金湖鎮,9114,29903,14969,14934
2019/2/1,金門縣,金沙鎮,6383,20816,10294,10522
2019/2/1,金門縣,金寧鄉,8893,31869,16062,15807
2019/2/1,金門縣,烈嶼鄉,3181,12822,6323,6499
2019/2/1,金門縣,烏坵鄉,135,684,348,336
2019/2/1,連江縣,南竿鄉,1788,7644,4291,3353
2019/2/1,連江縣,北竿鄉,663,2458,1378,1080
2019/2/1,連江縣,莒光鄉,303,1612,984,628
2019/2/1,連江縣,東引鄉,343,1359,814,545
2019/3/1,總計,新北市,1566124,3998883,1955860,2043023
2019/3/1,總計,臺北市,1057137,2663425,1270279,1393146
2019/3/1,總計,桃園市,811710,2228118,1107192,1120926
2019/3/1,總計,臺中市,976188,2808219,1381811,1426408
2019/3/1,總計,臺南市,690633,1883356,939536,943820
2019/3/1,總計,高雄市,1102005,2773271,1371330,1401941
2019/3/1,總計,臺灣省,2506701,7081480,3606323,3475157
2019/3/1,總計,宜蘭縣,169707,454770,229735,225035
2019/3/1,總計,新竹縣,196263,558020,284886,273134
2019/3/1,總計,苗栗縣,189622,547692,282591,265101
2019/3/1,總計,彰化縣,390177,1276289,649791,626498
2019/3/1,總計,南投縣,178367,496167,254046,242121
2019/3/1,總計,雲林縣,241064,684241,354632,329609
2019/3/1,總計,嘉義縣,183245,505785,262711,243074
2019/3/1,總計,屏東縣,288169,823256,420292,402964
2019/3/1,總計,臺東縣,83039,218256,112448,105808
2019/3/1,總計,花蓮縣,126224,327513,165931,161582
2019/3/1,總計,澎湖縣,40864,104574,53918,50656
2019/3/1,總計,基隆市,153709,369848,184826,185022
2019/3/1,總計,新竹市,166210,446567,220219,226348
2019/3/1,總計,嘉義市,100041,268502,130297,138205
2019/3/1,總計,福建省,43886,152440,77013,75427
2019/3/1,總計,金門縣,40777,139387,69545,69842
2019/3/1,總計,連江縣,3109,13053,7468,5585
2019/3/1,新北市,板橋區,213129,555001,270301,284700
2019/3/1,新北市,三重區,151951,385550,189485,196065
2019/3/1,新北市,中和區,166319,412114,199762,212352
2019/3/1,新北市,永和區,91206,221265,104940,116325
2019/3/1,新北市,新莊區,155962,418219,203863,214356
2019/3/1,新北市,新店區,127972,302085,145057,157028
2019/3/1,新北市,樹林區,66740,183811,91689,92122
2019/3/1,新北市,鶯歌區,30513,86454,43325,43129
2019/3/1,新北市,三峽區,43416,116058,58068,57990
2019/3/1,新北市,淡水區,77900,174652,83607,91045
2019/3/1,新北市,汐止區,88282,201151,97939,103212
2019/3/1,新北市,瑞芳區,16143,39812,20073,19739
2019/3/1,新北市,土城區,87356,236946,116638,120308
2019/3/1,新北市,蘆洲區,71835,201388,98852,102536
2019/3/1,新北市,五股區,32746,86579,43617,42962
2019/3/1,新北市,泰山區,28696,78735,38934,39801
2019/3/1,新北市,林口區,44655,111589,54204,57385
2019/3/1,新北市,深坑區,9646,23700,11859,11841
2019/3/1,新北市,石碇區,3408,7692,4194,3498
2019/3/1,新北市,坪林區,2529,6632,3645,2987
2019/3/1,新北市,三芝區,9502,22874,11787,11087
2019/3/1,新北市,石門區,4312,12045,6227,5818
2019/3/1,新北市,八里區,14950,38873,19392,19481
2019/3/1,新北市,平溪區,2286,4651,2581,2070
2019/3/1,新北市,雙溪區,3788,8810,4753,4057
2019/3/1,新北市,貢寮區,4352,12204,6228,5976
2019/3/1,新北市,金山區,7141,21657,10666,10991
2019/3/1,新北市,萬里區,7494,21946,11037,10909
2019/3/1,新北市,烏來區,1895,6390,3137,3253
2019/3/1,臺北市,松山區,81266,205588,96335,109253
2019/3/1,臺北市,信義區,89471,222629,106063,116566
2019/3/1,臺北市,大安區,121459,308720,143861,164859
2019/3/1,臺北市,中山區,100456,228831,106270,122561
2019/3/1,臺北市,中正區,65537,158808,75736,83072
2019/3/1,臺北市,大同區,51931,127483,61997,65486
2019/3/1,臺北市,萬華區,78788,188821,92525,96296
2019/3/1,臺北市,文山區,106905,273656,131063,142593
2019/3/1,臺北市,南港區,47344,121134,59167,61967
2019/3/1,臺北市,內湖區,108829,287153,137020,150133
2019/3/1,臺北市,士林區,107668,285756,137638,148118
2019/3/1,臺北市,北投區,97483,254846,122604,132242
2019/3/1,桃園市,桃園區,170410,448940,217705,231235
2019/3/1,桃園市,中壢區,154035,413547,203237,210310
2019/3/1,桃園市,大溪區,32957,94966,48295,46671
2019/3/1,桃園市,楊梅區,59707,171061,86119,84942
2019/3/1,桃園市,蘆竹區,59590,164639,81667,82972
2019/3/1,桃園市,大園區,33962,91415,46588,44827
2019/3/1,桃園市,龜山區,62986,161052,80113,80939
2019/3/1,桃園市,八德區,72727,203236,101445,101791
2019/3/1,桃園市,龍潭區,42698,123408,61668,61740
2019/3/1,桃園市,平鎮區,78716,226994,112618,114376
2019/3/1,桃園市,新屋區,16659,49248,26211,23037
2019/3/1,桃園市,觀音區,23431,67509,35002,32507
2019/3/1,桃園市,復興區,3832,12103,6524,5579
2019/3/1,臺中市,中區,7968,18509,9141,9368
2019/3/1,臺中市,東區,28412,76254,37845,38409
2019/3/1,臺中市,南區,49153,126088,60473,65615
2019/3/1,臺中市,西區,45948,115837,54917,60920
2019/3/1,臺中市,北區,59721,147292,70330,76962
2019/3/1,臺中市,西屯區,87430,229243,109859,119384
2019/3/1,臺中市,南屯區,63685,171257,81815,89442
2019/3/1,臺中市,北屯區,102996,280587,134283,146304
2019/3/1,臺中市,豐原區,54377,167126,82454,84672
2019/3/1,臺中市,東勢區,17406,50156,25731,24425
2019/3/1,臺中市,大甲區,23377,77517,38906,38611
2019/3/1,臺中市,清水區,27954,87045,44613,42432
2019/3/1,臺中市,沙鹿區,30307,94317,47546,46771
2019/3/1,臺中市,梧棲區,18257,58501,29333,29168
2019/3/1,臺中市,后里區,16540,54742,27755,26987
2019/3/1,臺中市,神岡區,19747,65669,33450,32219
2019/3/1,臺中市,潭子區,36812,109109,53855,55254
2019/3/1,臺中市,大雅區,30123,95951,47759,48192
2019/3/1,臺中市,新社區,7626,24511,12709,11802
2019/3/1,臺中市,石岡區,4915,14900,7696,7204
2019/3/1,臺中市,外埔區,9847,32256,16455,15801
2019/3/1,臺中市,大安區,5545,19215,10130,9085
2019/3/1,臺中市,烏日區,25282,75612,37866,37746
2019/3/1,臺中市,大肚區,17912,57308,29255,28053
2019/3/1,臺中市,龍井區,23452,77873,39169,38704
2019/3/1,臺中市,霧峰區,20523,65610,33234,32376
2019/3/1,臺中市,太平區,65757,192401,95279,97122
2019/3/1,臺中市,大里區,70516,212382,104080,108302
2019/3/1,臺中市,和平區,4600,10951,5873,5078
2019/3/1,臺南市,新營區,29084,77524,38362,39162
2019/3/1,臺南市,鹽水區,10056,25369,13222,12147
2019/3/1,臺南市,白河區,10782,28007,14633,13374
2019/3/1,臺南市,柳營區,7928,21092,11011,10081
2019/3/1,臺南市,後壁區,8791,23229,12054,11175
2019/3/1,臺南市,東山區,8328,20692,10972,9720
2019/3/1,臺南市,麻豆區,15860,44203,22462,21741
2019/3/1,臺南市,下營區,9061,23821,12298,11523
2019/3/1,臺南市,六甲區,7804,22108,11439,10669
2019/3/1,臺南市,官田區,7980,21255,10826,10429
2019/3/1,臺南市,大內區,3809,9530,5147,4383
2019/3/1,臺南市,佳里區,20871,59055,29251,29804
2019/3/1,臺南市,學甲區,9639,25676,13146,12530
2019/3/1,臺南市,西港區,8275,24667,12463,12204
2019/3/1,臺南市,七股區,8035,22657,11760,10897
2019/3/1,臺南市,將軍區,7278,19610,9993,9617
2019/3/1,臺南市,北門區,4217,10987,5530,5457
2019/3/1,臺南市,新化區,14489,43416,22098,21318
2019/3/1,臺南市,善化區,18213,49272,24757,24515
2019/3/1,臺南市,新市區,12671,37072,18548,18524
2019/3/1,臺南市,安定區,10214,30439,15658,14781
2019/3/1,臺南市,山上區,2731,7296,3810,3486
2019/3/1,臺南市,玉井區,5158,13957,7202,6755
2019/3/1,臺南市,楠西區,3516,9470,5009,4461
2019/3/1,臺南市,南化區,2858,8672,4666,4006
2019/3/1,臺南市,左鎮區,1949,4769,2682,2087
2019/3/1,臺南市,仁德區,27954,75896,38373,37523
2019/3/1,臺南市,歸仁區,22957,68387,34681,33706
2019/3/1,臺南市,關廟區,11263,34277,17656,16621
2019/3/1,臺南市,龍崎區,1536,3989,2144,1845
2019/3/1,臺南市,永康區,85503,234893,115576,119317
2019/3/1,臺南市,東區,72256,186348,89211,97137
2019/3/1,臺南市,南區,46292,124952,61740,63212
2019/3/1,臺南市,北區,51275,131922,64013,67909
2019/3/1,臺南市,安南區,64149,193782,97650,96132
2019/3/1,臺南市,安平區,26101,66852,31769,35083
2019/3/1,臺南市,中西區,31750,78213,37724,40489
2019/3/1,高雄市,鹽埕區,10824,24038,11938,12100
2019/3/1,高雄市,鼓山區,58888,140297,67553,72744
2019/3/1,高雄市,左營區,79522,196972,94505,102467
2019/3/1,高雄市,楠梓區,72293,186336,91311,95025
2019/3/1,高雄市,三民區,137202,340465,164466,175999
2019/3/1,高雄市,新興區,23019,51102,24504,26598
2019/3/1,高雄市,前金區,12740,26825,12722,14103
2019/3/1,高雄市,苓雅區,72378,169468,81343,88125
2019/3/1,高雄市,前鎮區,78785,187916,92317,95599
2019/3/1,高雄市,旗津區,11120,28368,14593,13775
2019/3/1,高雄市,小港區,68640,157766,78250,79516
2019/3/1,高雄市,鳳山區,142330,359775,175966,183809
2019/3/1,高雄市,林園區,26209,69842,35266,34576
2019/3/1,高雄市,大寮區,42600,112441,57438,55003
2019/3/1,高雄市,大樹區,13672,42283,21638,20645
2019/3/1,高雄市,大社區,13178,34632,17519,17113
2019/3/1,高雄市,仁武區,34581,88222,44719,43503
2019/3/1,高雄市,鳥松區,18767,44713,22586,22127
2019/3/1,高雄市,岡山區,35156,97187,48199,48988
2019/3/1,高雄市,橋頭區,13822,37629,19081,18548
2019/3/1,高雄市,燕巢區,10655,29753,15643,14110
2019/3/1,高雄市,田寮區,3223,7137,3960,3177
2019/3/1,高雄市,阿蓮區,9410,28606,14442,14164
2019/3/1,高雄市,路竹區,17185,52507,26744,25763
2019/3/1,高雄市,湖內區,10938,29739,15230,14509
2019/3/1,高雄市,茄萣區,10542,29983,15404,14579
2019/3/1,高雄市,永安區,5741,13862,6988,6874
2019/3/1,高雄市,彌陀區,6790,19189,9840,9349
2019/3/1,高雄市,梓官區,12683,35843,18438,17405
2019/3/1,高雄市,旗山區,13717,36552,18859,17693
2019/3/1,高雄市,美濃區,14816,39476,20703,18773
2019/3/1,高雄市,六龜區,5564,12853,6939,5914
2019/3/1,高雄市,甲仙區,2285,5986,3185,2801
2019/3/1,高雄市,杉林區,4806,11724,6409,5315
2019/3/1,高雄市,內門區,5117,14352,7753,6599
2019/3/1,高雄市,茂林區,601,1974,994,980
2019/3/1,高雄市,桃源區,1363,4305,2268,2037
2019/3/1,高雄市,那瑪夏區,843,3153,1617,1536
2019/3/1,宜蘭縣,宜蘭市,36601,95721,46616,49105
2019/3/1,宜蘭縣,羅東鎮,26551,72447,34258,38189
2019/3/1,宜蘭縣,蘇澳鎮,14213,39482,20105,19377
2019/3/1,宜蘭縣,頭城鎮,10280,29076,14990,14086
2019/3/1,宜蘭縣,礁溪鄉,14202,35537,18451,17086
2019/3/1,宜蘭縣,壯圍鄉,8940,24276,12823,11453
2019/3/1,宜蘭縣,員山鄉,11750,32228,17077,15151
2019/3/1,宜蘭縣,冬山鄉,19456,52887,27124,25763
2019/3/1,宜蘭縣,五結鄉,15143,39553,20387,19166
2019/3/1,宜蘭縣,三星鄉,8656,21358,11482,9876
2019/3/1,宜蘭縣,大同鄉,1934,6204,3319,2885
2019/3/1,宜蘭縣,南澳鄉,1981,6001,3103,2898
2019/3/1,新竹縣,竹北市,69193,188818,93958,94860
2019/3/1,新竹縣,關西鎮,9386,28332,15210,13122
2019/3/1,新竹縣,新埔鎮,10792,33030,17592,15438
2019/3/1,新竹縣,竹東鎮,34183,96374,48367,48007
2019/3/1,新竹縣,湖口鄉,27139,77626,39295,38331
2019/3/1,新竹縣,橫山鄉,4432,12922,7007,5915
2019/3/1,新竹縣,新豐鄉,18903,57135,29278,27857
2019/3/1,新竹縣,芎林鄉,6639,19976,10574,9402
2019/3/1,新竹縣,寶山鄉,5701,14576,7900,6676
2019/3/1,新竹縣,北埔鄉,3132,9285,5040,4245
2019/3/1,新竹縣,峨眉鄉,2080,5552,3054,2498
2019/3/1,新竹縣,尖石鄉,2908,9677,5083,4594
2019/3/1,新竹縣,五峰鄉,1775,4717,2528,2189
2019/3/1,苗栗縣,苗栗市,31586,88115,43962,44153
2019/3/1,苗栗縣,頭份市,35599,103109,52015,51094
2019/3/1,苗栗縣,苑裡鎮,14709,45047,23476,21571
2019/3/1,苗栗縣,通霄鎮,11539,33832,17895,15937
2019/3/1,苗栗縣,竹南鎮,30028,86261,43531,42730
2019/3/1,苗栗縣,後龍鎮,11991,36126,19153,16973
2019/3/1,苗栗縣,卓蘭鎮,5999,16622,8703,7919
2019/3/1,苗栗縣,大湖鄉,5348,14387,7636,6751
2019/3/1,苗栗縣,公館鄉,10719,33167,17313,15854
2019/3/1,苗栗縣,銅鑼鄉,6127,17808,9474,8334
2019/3/1,苗栗縣,南庄鄉,3931,9952,5458,4494
2019/3/1,苗栗縣,頭屋鄉,3640,10602,5622,4980
2019/3/1,苗栗縣,三義鄉,5543,16121,8527,7594
2019/3/1,苗栗縣,西湖鄉,2637,7000,3913,3087
2019/3/1,苗栗縣,造橋鄉,4149,12662,6693,5969
2019/3/1,苗栗縣,三灣鄉,2377,6593,3612,2981
2019/3/1,苗栗縣,獅潭鄉,1715,4296,2412,1884
2019/3/1,苗栗縣,泰安鄉,1985,5992,3196,2796
2019/3/1,彰化縣,彰化市,76867,232565,114728,117837
2019/3/1,彰化縣,員林市,39949,124906,62021,62885
2019/3/1,彰化縣,鹿港鎮,24790,86879,44129,42750
2019/3/1,彰化縣,和美鎮,27054,90713,46111,44602
2019/3/1,彰化縣,北斗鎮,10797,33334,16795,16539
2019/3/1,彰化縣,溪湖鎮,16422,55367,28027,27340
2019/3/1,彰化縣,田中鎮,13220,41483,21335,20148
2019/3/1,彰化縣,二林鎮,15132,50488,25964,24524
2019/3/1,彰化縣,線西鄉,4447,16819,8634,8185
2019/3/1,彰化縣,伸港鄉,10172,37169,18947,18222
2019/3/1,彰化縣,福興鄉,13009,46933,24404,22529
2019/3/1,彰化縣,秀水鄉,10882,39243,20243,19000
2019/3/1,彰化縣,花壇鄉,14217,45790,23503,22287
2019/3/1,彰化縣,芬園鄉,6825,23501,12350,11151
2019/3/1,彰化縣,大村鄉,11231,36963,19084,17879
2019/3/1,彰化縣,埔鹽鄉,9141,32366,17029,15337
2019/3/1,彰化縣,埔心鄉,10770,34752,17872,16880
2019/3/1,彰化縣,永靖鄉,10933,36891,19099,17792
2019/3/1,彰化縣,社頭鄉,12959,42768,21956,20812
2019/3/1,彰化縣,二水鄉,5301,15069,7923,7146
2019/3/1,彰化縣,田尾鄉,8001,27203,14021,13182
2019/3/1,彰化縣,埤頭鄉,9093,30431,15719,14712
2019/3/1,彰化縣,芳苑鄉,10132,33385,17606,15779
2019/3/1,彰化縣,大城鄉,5238,16628,8974,7654
2019/3/1,彰化縣,竹塘鄉,4602,15025,7870,7155
2019/3/1,彰化縣,溪州鄉,8993,29618,15447,14171
2019/3/1,南投縣,南投市,34959,99507,49806,49701
2019/3/1,南投縣,埔里鎮,28990,80266,39904,40362
2019/3/1,南投縣,草屯鎮,33444,97205,49154,48051
2019/3/1,南投縣,竹山鎮,20139,54371,27849,26522
2019/3/1,南投縣,集集鎮,4277,10713,5590,5123
2019/3/1,南投縣,名間鄉,12607,38152,20126,18026
2019/3/1,南投縣,鹿谷鄉,8062,17616,9392,8224
2019/3/1,南投縣,中寮鄉,5614,14626,7949,6677
2019/3/1,南投縣,魚池鄉,5748,15715,8303,7412
2019/3/1,南投縣,國姓鄉,7283,18506,9995,8511
2019/3/1,南投縣,水里鄉,7088,17426,9126,8300
2019/3/1,南投縣,信義鄉,5271,16137,8644,7493
2019/3/1,南投縣,仁愛鄉,4885,15927,8208,7719
2019/3/1,雲林縣,斗六市,38612,108669,54017,54652
2019/3/1,雲林縣,斗南鎮,15902,44476,22597,21879
2019/3/1,雲林縣,虎尾鎮,25249,70840,35871,34969
2019/3/1,雲林縣,西螺鎮,14815,45926,23206,22720
2019/3/1,雲林縣,土庫鎮,9471,28686,14949,13737
2019/3/1,雲林縣,北港鎮,16041,39743,20512,19231
2019/3/1,雲林縣,古坑鄉,11067,31291,16481,14810
2019/3/1,雲林縣,大埤鄉,6626,18976,10164,8812
2019/3/1,雲林縣,莿桐鄉,9361,28668,14989,13679
2019/3/1,雲林縣,林內鄉,6015,17883,9340,8543
2019/3/1,雲林縣,二崙鄉,8922,26695,14269,12426
2019/3/1,雲林縣,崙背鄉,8489,24239,12804,11435
2019/3/1,雲林縣,麥寮鄉,14624,46153,23097,23056
2019/3/1,雲林縣,東勢鄉,5709,14665,8114,6551
2019/3/1,雲林縣,褒忠鄉,4438,12862,6927,5935
2019/3/1,雲林縣,臺西鄉,8610,23562,12635,10927
2019/3/1,雲林縣,元長鄉,9207,25535,13986,11549
2019/3/1,雲林縣,四湖鄉,8686,23059,12511,10548
2019/3/1,雲林縣,口湖鄉,9410,27164,14459,12705
2019/3/1,雲林縣,水林鄉,9810,25149,13704,11445
2019/3/1,嘉義縣,太保市,13264,38132,19509,18623
2019/3/1,嘉義縣,朴子市,15789,42093,21258,20835
2019/3/1,嘉義縣,布袋鎮,9890,26635,13592,13043
2019/3/1,嘉義縣,大林鎮,11407,30899,15791,15108
2019/3/1,嘉義縣,民雄鄉,25178,71355,36470,34885
2019/3/1,嘉義縣,溪口鄉,5300,14450,7731,6719
2019/3/1,嘉義縣,新港鄉,10695,31649,16669,14980
2019/3/1,嘉義縣,六腳鄉,8788,22812,12077,10735
2019/3/1,嘉義縣,東石鄉,9169,24419,12928,11491
2019/3/1,嘉義縣,義竹鄉,7316,18151,9423,8728
2019/3/1,嘉義縣,鹿草鄉,5738,15250,8183,7067
2019/3/1,嘉義縣,水上鄉,18182,49301,25470,23831
2019/3/1,嘉義縣,中埔鄉,16052,44461,23128,21333
2019/3/1,嘉義縣,竹崎鄉,11667,35453,18852,16601
2019/3/1,嘉義縣,梅山鄉,6769,19180,10190,8990
2019/3/1,嘉義縣,番路鄉,4224,11373,6139,5234
2019/3/1,嘉義縣,大埔鄉,1920,4600,2372,2228
2019/3/1,嘉義縣,阿里山鄉,1897,5572,2929,2643
2019/3/1,屏東縣,屏東市,74650,199414,98306,101108
2019/3/1,屏東縣,潮州鎮,19654,53947,26936,27011
2019/3/1,屏東縣,東港鎮,16857,47483,23951,23532
2019/3/1,屏東縣,恆春鎮,11699,30780,15761,15019
2019/3/1,屏東縣,萬丹鄉,15155,50468,26187,24281
2019/3/1,屏東縣,長治鄉,10161,29546,15424,14122
2019/3/1,屏東縣,麟洛鄉,3849,11009,5718,5291
2019/3/1,屏東縣,九如鄉,7066,21999,11342,10657
2019/3/1,屏東縣,里港鄉,8194,25950,13189,12761
2019/3/1,屏東縣,鹽埔鄉,7878,25572,13283,12289
2019/3/1,屏東縣,高樹鄉,9246,24239,12937,11302
2019/3/1,屏東縣,萬巒鄉,6528,20557,10703,9854
2019/3/1,屏東縣,內埔鄉,18742,53966,27858,26108
2019/3/1,屏東縣,竹田鄉,5660,17058,9060,7998
2019/3/1,屏東縣,新埤鄉,3442,9863,5245,4618
2019/3/1,屏東縣,枋寮鄉,8548,24204,12660,11544
2019/3/1,屏東縣,新園鄉,11834,34743,17997,16746
2019/3/1,屏東縣,崁頂鄉,4515,15459,7781,7678
2019/3/1,屏東縣,林邊鄉,6692,17741,9055,8686
2019/3/1,屏東縣,南州鄉,3712,10596,5442,5154
2019/3/1,屏東縣,佳冬鄉,6965,19037,9884,9153
2019/3/1,屏東縣,琉球鄉,4552,12315,6750,5565
2019/3/1,屏東縣,車城鄉,3466,8485,4538,3947
2019/3/1,屏東縣,滿州鄉,3043,7878,4259,3619
2019/3/1,屏東縣,枋山鄉,2088,5449,2892,2557
2019/3/1,屏東縣,三地門鄉,2328,7705,3867,3838
2019/3/1,屏東縣,霧臺鄉,1055,3334,1702,1632
2019/3/1,屏東縣,瑪家鄉,2057,6803,3441,3362
2019/3/1,屏東縣,泰武鄉,1365,5378,2806,2572
2019/3/1,屏東縣,來義鄉,2233,7443,3752,3691
2019/3/1,屏東縣,春日鄉,1412,4917,2514,2403
2019/3/1,屏東縣,獅子鄉,1581,4955,2547,2408
2019/3/1,屏東縣,牡丹鄉,1942,4963,2505,2458
2019/3/1,臺東縣,臺東市,39941,105425,52673,52752
2019/3/1,臺東縣,成功鎮,5359,13981,7359,6622
2019/3/1,臺東縣,關山鎮,3169,8679,4497,4182
2019/3/1,臺東縣,卑南鄉,6722,17231,9084,8147
2019/3/1,臺東縣,大武鄉,2459,5962,3110,2852
2019/3/1,臺東縣,太麻里鄉,4731,11116,5913,5203
2019/3/1,臺東縣,東河鄉,3755,8413,4651,3762
2019/3/1,臺東縣,長濱鄉,2905,7142,4058,3084
2019/3/1,臺東縣,鹿野鄉,3039,7849,4157,3692
2019/3/1,臺東縣,池上鄉,3185,8182,4239,3943
2019/3/1,臺東縣,綠島鄉,1152,4070,2160,1910
2019/3/1,臺東縣,延平鄉,1068,3571,1907,1664
2019/3/1,臺東縣,海端鄉,1085,4175,2217,1958
2019/3/1,臺東縣,達仁鄉,1434,3563,1927,1636
2019/3/1,臺東縣,金峰鄉,1156,3722,1882,1840
2019/3/1,臺東縣,蘭嶼鄉,1879,5175,2614,2561
2019/3/1,花蓮縣,花蓮市,41456,103717,49921,53796
2019/3/1,花蓮縣,鳳林鎮,4385,10825,5631,5194
2019/3/1,花蓮縣,玉里鎮,8874,23937,12654,11283
2019/3/1,花蓮縣,新城鄉,7772,20145,10315,9830
2019/3/1,花蓮縣,吉安鄉,32288,83365,41909,41456
2019/3/1,花蓮縣,壽豐鄉,7253,17914,9478,8436
2019/3/1,花蓮縣,光復鄉,5020,12719,6763,5956
2019/3/1,花蓮縣,豐濱鄉,1711,4666,2592,2074
2019/3/1,花蓮縣,瑞穗鄉,4767,11579,6241,5338
2019/3/1,花蓮縣,富里鄉,4034,10250,5570,4680
2019/3/1,花蓮縣,秀林鄉,4855,15921,8170,7751
2019/3/1,花蓮縣,萬榮鄉,2110,6384,3360,3024
2019/3/1,花蓮縣,卓溪鄉,1699,6091,3327,2764
2019/3/1,澎湖縣,馬公市,25087,62653,31892,30761
2019/3/1,澎湖縣,湖西鄉,5813,14673,7781,6892
2019/3/1,澎湖縣,白沙鄉,3476,9803,5108,4695
2019/3/1,澎湖縣,西嶼鄉,3043,8339,4311,4028
2019/3/1,澎湖縣,望安鄉,2063,5280,2845,2435
2019/3/1,澎湖縣,七美鄉,1382,3826,1981,1845
2019/3/1,基隆市,中正區,22634,51640,26294,25346
2019/3/1,基隆市,七堵區,21589,53738,26980,26758
2019/3/1,基隆市,暖暖區,15753,38611,19328,19283
2019/3/1,基隆市,仁愛區,19060,43658,21623,22035
2019/3/1,基隆市,中山區,19253,47312,24004,23308
2019/3/1,基隆市,安樂區,33664,82300,40718,41582
2019/3/1,基隆市,信義區,21756,52589,25879,26710
2019/3/1,新竹市,東區,81045,216430,106300,110130
2019/3/1,新竹市,北區,57566,151828,74159,77669
2019/3/1,新竹市,香山區,27599,78309,39760,38549
2019/3/1,嘉義市,東區,45512,121098,58242,62856
2019/3/1,嘉義市,西區,54529,147404,72055,75349
2019/3/1,金門縣,金城鎮,13010,43270,21539,21731
2019/3/1,金門縣,金湖鎮,9141,29950,14998,14952
2019/3/1,金門縣,金沙鎮,6389,20773,10276,10497
2019/3/1,金門縣,金寧鄉,8920,31910,16073,15837
2019/3/1,金門縣,烈嶼鄉,3182,12801,6312,6489
2019/3/1,金門縣,烏坵鄉,135,683,347,336
2019/3/1,連江縣,南竿鄉,1793,7622,4280,3342
2019/3/1,連江縣,北竿鄉,670,2472,1393,1079
2019/3/1,連江縣,莒光鄉,303,1603,980,623
2019/3/1,連江縣,東引鄉,343,1356,815,541
2019/4/1,總計,新北市,1567878,4000164,1956298,2043866
2019/4/1,總計,臺北市,1057682,2661317,1269117,1392200
2019/4/1,總計,桃園市,813329,2230653,1108291,1122362
2019/4/1,總計,臺中市,977147,2809004,1382061,1426943
2019/4/1,總計,臺南市,691153,1883078,939305,943773
2019/4/1,總計,高雄市,1102756,2773229,1371160,1402069
2019/4/1,總計,臺灣省,2508206,7079347,3604853,3474494
2019/4/1,總計,宜蘭縣,169781,454732,229662,225070
2019/4/1,總計,新竹縣,196668,558507,285109,273398
2019/4/1,總計,苗栗縣,189806,547387,282419,264968
2019/4/1,總計,彰化縣,390320,1275669,649376,626293
2019/4/1,總計,南投縣,178452,495891,253853,242038
2019/4/1,總計,雲林縣,241090,683898,354423,329475
2019/4/1,總計,嘉義縣,183274,505408,262470,242938
2019/4/1,總計,屏東縣,288369,822709,419994,402715
2019/4/1,總計,臺東縣,83070,218119,112366,105753
2019/4/1,總計,花蓮縣,126234,327349,165802,161547
2019/4/1,總計,澎湖縣,40971,104683,53997,50686
2019/4/1,總計,基隆市,153757,369820,184813,185007
2019/4/1,總計,新竹市,166371,446701,220281,226420
2019/4/1,總計,嘉義市,100043,268474,130288,138186
2019/4/1,總計,福建省,43953,152520,77044,75476
2019/4/1,總計,金門縣,40830,139464,69579,69885
2019/4/1,總計,連江縣,3123,13056,7465,5591
2019/4/1,新北市,板橋區,213330,555176,270383,284793
2019/4/1,新北市,三重區,152079,385399,189401,195998
2019/4/1,新北市,中和區,166387,412098,199743,212355
2019/4/1,新北市,永和區,91240,221145,104903,116242
2019/4/1,新北市,新莊區,156208,418408,203939,214469
2019/4/1,新北市,新店區,128057,302212,145090,157122
2019/4/1,新北市,樹林區,66793,183795,91654,92141
2019/4/1,新北市,鶯歌區,30553,86468,43345,43123
2019/4/1,新北市,三峽區,43460,116104,58080,58024
2019/4/1,新北市,淡水區,78154,175108,83797,91311
2019/4/1,新北市,汐止區,88404,201316,98016,103300
2019/4/1,新北市,瑞芳區,16128,39739,20038,19701
2019/4/1,新北市,土城區,87432,236959,116629,120330
2019/4/1,新北市,蘆洲區,71895,201446,98868,102578
2019/4/1,新北市,五股區,32849,86732,43684,43048
2019/4/1,新北市,泰山區,28709,78727,38932,39795
2019/4/1,新北市,林口區,44851,112053,54405,57648
2019/4/1,新北市,深坑區,9648,23666,11837,11829
2019/4/1,新北市,石碇區,3406,7666,4186,3480
2019/4/1,新北市,坪林區,2529,6644,3646,2998
2019/4/1,新北市,三芝區,9507,22864,11785,11079
2019/4/1,新北市,石門區,4310,12018,6214,5804
2019/4/1,新北市,八里區,14977,38873,19401,19472
2019/4/1,新北市,平溪區,2284,4636,2571,2065
2019/4/1,新北市,雙溪區,3786,8787,4742,4045
2019/4/1,新北市,貢寮區,4350,12186,6222,5964
2019/4/1,新北市,金山區,7148,21624,10647,10977
2019/4/1,新北市,萬里區,7506,21938,11012,10926
2019/4/1,新北市,烏來區,1898,6377,3128,3249
2019/4/1,臺北市,松山區,81296,205472,96278,109194
2019/4/1,臺北市,信義區,89412,222261,105868,116393
2019/4/1,臺北市,大安區,121525,308743,143822,164921
2019/4/1,臺北市,中山區,100499,228709,106253,122456
2019/4/1,臺北市,中正區,65561,158709,75672,83037
2019/4/1,臺北市,大同區,51976,127361,61909,65452
2019/4/1,臺北市,萬華區,78954,188609,92401,96208
2019/4/1,臺北市,文山區,106938,273396,130919,142477
2019/4/1,臺北市,南港區,47358,121028,59111,61917
2019/4/1,臺北市,內湖區,108875,286928,136908,150020
2019/4/1,臺北市,士林區,107779,285498,137507,147991
2019/4/1,臺北市,北投區,97509,254603,122469,132134
2019/4/1,桃園市,桃園區,170812,449630,217971,231659
2019/4/1,桃園市,中壢區,154327,413926,203400,210526
2019/4/1,桃園市,大溪區,33019,95039,48316,46723
2019/4/1,桃園市,楊梅區,59863,171360,86258,85102
2019/4/1,桃園市,蘆竹區,59647,164794,81714,83080
2019/4/1,桃園市,大園區,34078,91634,46701,44933
2019/4/1,桃園市,龜山區,63118,161262,80211,81051
2019/4/1,桃園市,八德區,72893,203569,101616,101953
2019/4/1,桃園市,龍潭區,42754,123458,61661,61797
2019/4/1,桃園市,平鎮區,78832,227204,112762,114442
2019/4/1,桃園市,新屋區,16676,49224,26199,23025
2019/4/1,桃園市,觀音區,23467,67469,34957,32512
2019/4/1,桃園市,復興區,3843,12084,6525,5559
2019/4/1,臺中市,中區,7984,18556,9173,9383
2019/4/1,臺中市,東區,28416,76210,37812,38398
2019/4/1,臺中市,南區,49199,126089,60460,65629
2019/4/1,臺中市,西區,45951,115798,54873,60925
2019/4/1,臺中市,北區,59717,147227,70276,76951
2019/4/1,臺中市,西屯區,87544,229381,109902,119479
2019/4/1,臺中市,南屯區,63794,171520,81927,89593
2019/4/1,臺中市,北屯區,103170,280870,134406,146464
2019/4/1,臺中市,豐原區,54390,167118,82464,84654
2019/4/1,臺中市,東勢區,17410,50111,25694,24417
2019/4/1,臺中市,大甲區,23378,77434,38851,38583
2019/4/1,臺中市,清水區,27997,87087,44619,42468
2019/4/1,臺中市,沙鹿區,30337,94379,47566,46813
2019/4/1,臺中市,梧棲區,18294,58576,29371,29205
2019/4/1,臺中市,后里區,16540,54723,27740,26983
2019/4/1,臺中市,神岡區,19781,65696,33474,32222
2019/4/1,臺中市,潭子區,36846,109094,53834,55260
2019/4/1,臺中市,大雅區,30145,95914,47764,48150
2019/4/1,臺中市,新社區,7625,24491,12690,11801
2019/4/1,臺中市,石岡區,4910,14894,7696,7198
2019/4/1,臺中市,外埔區,9863,32259,16466,15793
2019/4/1,臺中市,大安區,5543,19202,10118,9084
2019/4/1,臺中市,烏日區,25292,75523,37815,37708
2019/4/1,臺中市,大肚區,17918,57325,29263,28062
2019/4/1,臺中市,龍井區,23478,77869,39180,38689
2019/4/1,臺中市,霧峰區,20533,65556,33231,32325
2019/4/1,臺中市,太平區,65893,192650,95386,97264
2019/4/1,臺中市,大里區,70607,212530,104152,108378
2019/4/1,臺中市,和平區,4592,10922,5858,5064
2019/4/1,臺南市,新營區,29071,77434,38323,39111
2019/4/1,臺南市,鹽水區,10059,25348,13203,12145
2019/4/1,臺南市,白河區,10771,27965,14611,13354
2019/4/1,臺南市,柳營區,7949,21094,11003,10091
2019/4/1,臺南市,後壁區,8788,23213,12047,11166
2019/4/1,臺南市,東山區,8315,20658,10966,9692
2019/4/1,臺南市,麻豆區,15861,44170,22438,21732
2019/4/1,臺南市,下營區,9069,23778,12282,11496
2019/4/1,臺南市,六甲區,7815,22094,11433,10661
2019/4/1,臺南市,官田區,7997,21268,10829,10439
2019/4/1,臺南市,大內區,3801,9509,5132,4377
2019/4/1,臺南市,佳里區,20898,59079,29258,29821
2019/4/1,臺南市,學甲區,9637,25646,13130,12516
2019/4/1,臺南市,西港區,8277,24628,12451,12177
2019/4/1,臺南市,七股區,8038,22611,11732,10879
2019/4/1,臺南市,將軍區,7282,19588,9980,9608
2019/4/1,臺南市,北門區,4215,10973,5525,5448
2019/4/1,臺南市,新化區,14492,43429,22099,21330
2019/4/1,臺南市,善化區,18282,49361,24817,24544
2019/4/1,臺南市,新市區,12696,37093,18565,18528
2019/4/1,臺南市,安定區,10216,30434,15652,14782
2019/4/1,臺南市,山上區,2731,7278,3809,3469
2019/4/1,臺南市,玉井區,5162,13934,7187,6747
2019/4/1,臺南市,楠西區,3514,9450,4999,4451
2019/4/1,臺南市,南化區,2857,8670,4668,4002
2019/4/1,臺南市,左鎮區,1950,4756,2675,2081
2019/4/1,臺南市,仁德區,27991,75920,38371,37549
2019/4/1,臺南市,歸仁區,22963,68371,34660,33711
2019/4/1,臺南市,關廟區,11271,34259,17635,16624
2019/4/1,臺南市,龍崎區,1538,3980,2137,1843
2019/4/1,臺南市,永康區,85598,235013,115601,119412
2019/4/1,臺南市,東區,72258,186263,89135,97128
2019/4/1,臺南市,南區,46388,125008,61727,63281
2019/4/1,臺南市,北區,51283,131913,64016,67897
2019/4/1,臺南市,安南區,64202,193788,97680,96108
2019/4/1,臺南市,安平區,26155,66902,31779,35123
2019/4/1,臺南市,中西區,31763,78200,37750,40450
2019/4/1,高雄市,鹽埕區,10826,23988,11912,12076
2019/4/1,高雄市,鼓山區,58918,140348,67582,72766
2019/4/1,高雄市,左營區,79571,197116,94550,102566
2019/4/1,高雄市,楠梓區,72432,186526,91384,95142
2019/4/1,高雄市,三民區,137252,340366,164413,175953
2019/4/1,高雄市,新興區,23022,51083,24479,26604
2019/4/1,高雄市,前金區,12761,26836,12716,14120
2019/4/1,高雄市,苓雅區,72368,169345,81310,88035
2019/4/1,高雄市,前鎮區,78793,187832,92265,95567
2019/4/1,高雄市,旗津區,11122,28346,14587,13759
2019/4/1,高雄市,小港區,68676,157751,78195,79556
2019/4/1,高雄市,鳳山區,142468,359866,176052,183814
2019/4/1,高雄市,林園區,26214,69833,35255,34578
2019/4/1,高雄市,大寮區,42641,112440,57417,55023
2019/4/1,高雄市,大樹區,13682,42257,21612,20645
2019/4/1,高雄市,大社區,13179,34533,17480,17053
2019/4/1,高雄市,仁武區,34672,88410,44795,43615
2019/4/1,高雄市,鳥松區,18790,44712,22561,22151
2019/4/1,高雄市,岡山區,35185,97138,48172,48966
2019/4/1,高雄市,橋頭區,13879,37714,19111,18603
2019/4/1,高雄市,燕巢區,10654,29763,15663,14100
2019/4/1,高雄市,田寮區,3221,7133,3963,3170
2019/4/1,高雄市,阿蓮區,9413,28599,14437,14162
2019/4/1,高雄市,路竹區,17189,52482,26726,25756
2019/4/1,高雄市,湖內區,10937,29740,15218,14522
2019/4/1,高雄市,茄萣區,10551,29977,15399,14578
2019/4/1,高雄市,永安區,5739,13852,6974,6878
2019/4/1,高雄市,彌陀區,6806,19185,9835,9350
2019/4/1,高雄市,梓官區,12689,35818,18428,17390
2019/4/1,高雄市,旗山區,13725,36539,18855,17684
2019/4/1,高雄市,美濃區,14807,39449,20689,18760
2019/4/1,高雄市,六龜區,5558,12808,6924,5884
2019/4/1,高雄市,甲仙區,2285,5971,3178,2793
2019/4/1,高雄市,杉林區,4804,11724,6405,5319
2019/4/1,高雄市,內門區,5117,14325,7743,6582
2019/4/1,高雄市,茂林區,603,1975,996,979
2019/4/1,高雄市,桃源區,1365,4300,2261,2039
2019/4/1,高雄市,那瑪夏區,842,3149,1618,1531
2019/4/1,宜蘭縣,宜蘭市,36607,95722,46612,49110
2019/4/1,宜蘭縣,羅東鎮,26557,72404,34226,38178
2019/4/1,宜蘭縣,蘇澳鎮,14200,39458,20103,19355
2019/4/1,宜蘭縣,頭城鎮,10297,29068,14989,14079
2019/4/1,宜蘭縣,礁溪鄉,14207,35533,18427,17106
2019/4/1,宜蘭縣,壯圍鄉,8945,24305,12830,11475
2019/4/1,宜蘭縣,員山鄉,11762,32262,17086,15176
2019/4/1,宜蘭縣,冬山鄉,19471,52898,27122,25776
2019/4/1,宜蘭縣,五結鄉,15148,39561,20372,19189
2019/4/1,宜蘭縣,三星鄉,8670,21360,11486,9874
2019/4/1,宜蘭縣,大同鄉,1937,6178,3311,2867
2019/4/1,宜蘭縣,南澳鄉,1980,5983,3098,2885
2019/4/1,新竹縣,竹北市,69488,189466,94291,95175
2019/4/1,新竹縣,關西鎮,9379,28272,15163,13109
2019/4/1,新竹縣,新埔鎮,10799,32993,17571,15422
2019/4/1,新竹縣,竹東鎮,34219,96395,48364,48031
2019/4/1,新竹縣,湖口鄉,27189,77647,39289,38358
2019/4/1,新竹縣,橫山鄉,4419,12875,6979,5896
2019/4/1,新竹縣,新豐鄉,18929,57148,29299,27849
2019/4/1,新竹縣,芎林鄉,6646,19975,10575,9400
2019/4/1,新竹縣,寶山鄉,5717,14570,7904,6666
2019/4/1,新竹縣,北埔鄉,3130,9266,5034,4232
2019/4/1,新竹縣,峨眉鄉,2079,5547,3051,2496
2019/4/1,新竹縣,尖石鄉,2907,9643,5065,4578
2019/4/1,新竹縣,五峰鄉,1767,4710,2524,2186
2019/4/1,苗栗縣,苗栗市,31616,88131,43969,44162
2019/4/1,苗栗縣,頭份市,35676,103180,52061,51119
2019/4/1,苗栗縣,苑裡鎮,14746,45046,23484,21562
2019/4/1,苗栗縣,通霄鎮,11541,33793,17876,15917
2019/4/1,苗栗縣,竹南鎮,30082,86268,43524,42744
2019/4/1,苗栗縣,後龍鎮,11986,36058,19113,16945
2019/4/1,苗栗縣,卓蘭鎮,5995,16581,8683,7898
2019/4/1,苗栗縣,大湖鄉,5343,14372,7620,6752
2019/4/1,苗栗縣,公館鄉,10710,33098,17275,15823
2019/4/1,苗栗縣,銅鑼鄉,6133,17778,9460,8318
2019/4/1,苗栗縣,南庄鄉,3935,9938,5454,4484
2019/4/1,苗栗縣,頭屋鄉,3641,10599,5619,4980
2019/4/1,苗栗縣,三義鄉,5549,16124,8523,7601
2019/4/1,苗栗縣,西湖鄉,2635,6969,3897,3072
2019/4/1,苗栗縣,造橋鄉,4142,12629,6676,5953
2019/4/1,苗栗縣,三灣鄉,2376,6581,3600,2981
2019/4/1,苗栗縣,獅潭鄉,1715,4271,2402,1869
2019/4/1,苗栗縣,泰安鄉,1985,5971,3183,2788
2019/4/1,彰化縣,彰化市,76896,232505,114701,117804
2019/4/1,彰化縣,員林市,39976,124918,62016,62902
2019/4/1,彰化縣,鹿港鎮,24800,86866,44104,42762
2019/4/1,彰化縣,和美鎮,27046,90662,46092,44570
2019/4/1,彰化縣,北斗鎮,10803,33326,16785,16541
2019/4/1,彰化縣,溪湖鎮,16442,55388,28025,27363
2019/4/1,彰化縣,田中鎮,13225,41467,21320,20147
2019/4/1,彰化縣,二林鎮,15152,50409,25918,24491
2019/4/1,彰化縣,線西鄉,4453,16849,8650,8199
2019/4/1,彰化縣,伸港鄉,10180,37181,18947,18234
2019/4/1,彰化縣,福興鄉,13013,46918,24404,22514
2019/4/1,彰化縣,秀水鄉,10881,39222,20221,19001
2019/4/1,彰化縣,花壇鄉,14226,45765,23476,22289
2019/4/1,彰化縣,芬園鄉,6821,23463,12319,11144
2019/4/1,彰化縣,大村鄉,11234,36982,19093,17889
2019/4/1,彰化縣,埔鹽鄉,9135,32332,17013,15319
2019/4/1,彰化縣,埔心鄉,10784,34739,17872,16867
2019/4/1,彰化縣,永靖鄉,10943,36868,19076,17792
2019/4/1,彰化縣,社頭鄉,12957,42715,21929,20786
2019/4/1,彰化縣,二水鄉,5301,15032,7895,7137
2019/4/1,彰化縣,田尾鄉,7993,27168,14010,13158
2019/4/1,彰化縣,埤頭鄉,9102,30398,15697,14701
2019/4/1,彰化縣,芳苑鄉,10136,33336,17580,15756
2019/4/1,彰化縣,大城鄉,5232,16573,8945,7628
2019/4/1,彰化縣,竹塘鄉,4600,15013,7862,7151
2019/4/1,彰化縣,溪州鄉,8989,29574,15426,14148
2019/4/1,南投縣,南投市,34991,99447,49783,49664
2019/4/1,南投縣,埔里鎮,28997,80244,39906,40338
2019/4/1,南投縣,草屯鎮,33486,97245,49158,48087
2019/4/1,南投縣,竹山鎮,20144,54330,27823,26507
2019/4/1,南投縣,集集鎮,4276,10716,5590,5126
2019/4/1,南投縣,名間鄉,12611,38137,20109,18028
2019/4/1,南投縣,鹿谷鄉,8065,17583,9372,8211
2019/4/1,南投縣,中寮鄉,5619,14616,7934,6682
2019/4/1,南投縣,魚池鄉,5751,15707,8287,7420
2019/4/1,南投縣,國姓鄉,7275,18459,9972,8487
2019/4/1,南投縣,水里鄉,7085,17386,9097,8289
2019/4/1,南投縣,信義鄉,5268,16110,8626,7484
2019/4/1,南投縣,仁愛鄉,4884,15911,8196,7715
2019/4/1,雲林縣,斗六市,38643,108654,53996,54658
2019/4/1,雲林縣,斗南鎮,15913,44480,22592,21888
2019/4/1,雲林縣,虎尾鎮,25260,70831,35876,34955
2019/4/1,雲林縣,西螺鎮,14816,45908,23173,22735
2019/4/1,雲林縣,土庫鎮,9482,28702,14951,13751
2019/4/1,雲林縣,北港鎮,16033,39724,20501,19223
2019/4/1,雲林縣,古坑鄉,11075,31307,16504,14803
2019/4/1,雲林縣,大埤鄉,6622,18950,10149,8801
2019/4/1,雲林縣,莿桐鄉,9353,28618,14955,13663
2019/4/1,雲林縣,林內鄉,6013,17971,9400,8571
2019/4/1,雲林縣,二崙鄉,8916,26660,14241,12419
2019/4/1,雲林縣,崙背鄉,8492,24230,12798,11432
2019/4/1,雲林縣,麥寮鄉,14647,46215,23120,23095
2019/4/1,雲林縣,東勢鄉,5708,14615,8085,6530
2019/4/1,雲林縣,褒忠鄉,4431,12822,6898,5924
2019/4/1,雲林縣,臺西鄉,8608,23516,12619,10897
2019/4/1,雲林縣,元長鄉,9212,25477,13952,11525
2019/4/1,雲林縣,四湖鄉,8674,23023,12490,10533
2019/4/1,雲林縣,口湖鄉,9401,27121,14454,12667
2019/4/1,雲林縣,水林鄉,9791,25074,13669,11405
2019/4/1,嘉義縣,太保市,13283,38137,19513,18624
2019/4/1,嘉義縣,朴子市,15799,42121,21264,20857
2019/4/1,嘉義縣,布袋鎮,9884,26581,13563,13018
2019/4/1,嘉義縣,大林鎮,11414,30870,15765,15105
2019/4/1,嘉義縣,民雄鄉,25179,71351,36468,34883
2019/4/1,嘉義縣,溪口鄉,5302,14435,7717,6718
2019/4/1,嘉義縣,新港鄉,10703,31631,16663,14968
2019/4/1,嘉義縣,六腳鄉,8772,22758,12044,10714
2019/4/1,嘉義縣,東石鄉,9169,24366,12905,11461
2019/4/1,嘉義縣,義竹鄉,7305,18112,9409,8703
2019/4/1,嘉義縣,鹿草鄉,5735,15234,8183,7051
2019/4/1,嘉義縣,水上鄉,18201,49286,25448,23838
2019/4/1,嘉義縣,中埔鄉,16063,44457,23116,21341
2019/4/1,嘉義縣,竹崎鄉,11664,35417,18825,16592
2019/4/1,嘉義縣,梅山鄉,6763,19131,10164,8967
2019/4/1,嘉義縣,番路鄉,4217,11349,6119,5230
2019/4/1,嘉義縣,大埔鄉,1924,4600,2372,2228
2019/4/1,嘉義縣,阿里山鄉,1897,5572,2932,2640
2019/4/1,屏東縣,屏東市,74710,199360,98261,101099
2019/4/1,屏東縣,潮州鎮,19699,53960,26940,27020
2019/4/1,屏東縣,東港鎮,16862,47469,23924,23545
2019/4/1,屏東縣,恆春鎮,11721,30745,15740,15005
2019/4/1,屏東縣,萬丹鄉,15195,50480,26201,24279
2019/4/1,屏東縣,長治鄉,10169,29529,15411,14118
2019/4/1,屏東縣,麟洛鄉,3855,11011,5709,5302
2019/4/1,屏東縣,九如鄉,7065,21977,11330,10647
2019/4/1,屏東縣,里港鄉,8212,25961,13187,12774
2019/4/1,屏東縣,鹽埔鄉,7874,25534,13262,12272
2019/4/1,屏東縣,高樹鄉,9237,24181,12903,11278
2019/4/1,屏東縣,萬巒鄉,6521,20547,10693,9854
2019/4/1,屏東縣,內埔鄉,18754,53960,27878,26082
2019/4/1,屏東縣,竹田鄉,5661,17028,9044,7984
2019/4/1,屏東縣,新埤鄉,3442,9833,5237,4596
2019/4/1,屏東縣,枋寮鄉,8555,24197,12649,11548
2019/4/1,屏東縣,新園鄉,11836,34718,17999,16719
2019/4/1,屏東縣,崁頂鄉,4512,15437,7776,7661
2019/4/1,屏東縣,林邊鄉,6696,17727,9041,8686
2019/4/1,屏東縣,南州鄉,3710,10589,5440,5149
2019/4/1,屏東縣,佳冬鄉,6964,19017,9869,9148
2019/4/1,屏東縣,琉球鄉,4560,12302,6737,5565
2019/4/1,屏東縣,車城鄉,3468,8454,4523,3931
2019/4/1,屏東縣,滿州鄉,3036,7839,4249,3590
2019/4/1,屏東縣,枋山鄉,2084,5430,2882,2548
2019/4/1,屏東縣,三地門鄉,2326,7700,3863,3837
2019/4/1,屏東縣,霧臺鄉,1054,3324,1698,1626
2019/4/1,屏東縣,瑪家鄉,2054,6784,3431,3353
2019/4/1,屏東縣,泰武鄉,1367,5382,2812,2570
2019/4/1,屏東縣,來義鄉,2233,7424,3747,3677
2019/4/1,屏東縣,春日鄉,1412,4910,2509,2401
2019/4/1,屏東縣,獅子鄉,1580,4956,2554,2402
2019/4/1,屏東縣,牡丹鄉,1945,4944,2495,2449
2019/4/1,臺東縣,臺東市,39939,105369,52630,52739
2019/4/1,臺東縣,成功鎮,5365,13949,7338,6611
2019/4/1,臺東縣,關山鎮,3171,8683,4503,4180
2019/4/1,臺東縣,卑南鄉,6730,17213,9071,8142
2019/4/1,臺東縣,大武鄉,2457,5946,3105,2841
2019/4/1,臺東縣,太麻里鄉,4736,11103,5915,5188
2019/4/1,臺東縣,東河鄉,3765,8427,4662,3765
2019/4/1,臺東縣,長濱鄉,2899,7124,4041,3083
2019/4/1,臺東縣,鹿野鄉,3037,7817,4139,3678
2019/4/1,臺東縣,池上鄉,3187,8188,4237,3951
2019/4/1,臺東縣,綠島鄉,1158,4080,2167,1913
2019/4/1,臺東縣,延平鄉,1066,3572,1909,1663
2019/4/1,臺東縣,海端鄉,1084,4162,2215,1947
2019/4/1,臺東縣,達仁鄉,1435,3559,1926,1633
2019/4/1,臺東縣,金峰鄉,1158,3725,1880,1845
2019/4/1,臺東縣,蘭嶼鄉,1883,5202,2628,2574
2019/4/1,花蓮縣,花蓮市,41450,103705,49890,53815
2019/4/1,花蓮縣,鳳林鎮,4378,10795,5618,5177
2019/4/1,花蓮縣,玉里鎮,8877,23897,12636,11261
2019/4/1,花蓮縣,新城鄉,7778,20134,10312,9822
2019/4/1,花蓮縣,吉安鄉,32297,83414,41929,41485
2019/4/1,花蓮縣,壽豐鄉,7249,17906,9467,8439
2019/4/1,花蓮縣,光復鄉,5028,12689,6735,5954
2019/4/1,花蓮縣,豐濱鄉,1713,4656,2589,2067
2019/4/1,花蓮縣,瑞穗鄉,4762,11542,6222,5320
2019/4/1,花蓮縣,富里鄉,4037,10236,5560,4676
2019/4/1,花蓮縣,秀林鄉,4848,15916,8165,7751
2019/4/1,花蓮縣,萬榮鄉,2113,6383,3354,3029
2019/4/1,花蓮縣,卓溪鄉,1704,6076,3325,2751
2019/4/1,澎湖縣,馬公市,25156,62740,31947,30793
2019/4/1,澎湖縣,湖西鄉,5847,14699,7798,6901
2019/4/1,澎湖縣,白沙鄉,3479,9789,5109,4680
2019/4/1,澎湖縣,西嶼鄉,3045,8342,4312,4030
2019/4/1,澎湖縣,望安鄉,2060,5286,2854,2432
2019/4/1,澎湖縣,七美鄉,1384,3827,1977,1850
2019/4/1,基隆市,中正區,22627,51553,26245,25308
2019/4/1,基隆市,七堵區,21579,53773,26987,26786
2019/4/1,基隆市,暖暖區,15774,38620,19340,19280
2019/4/1,基隆市,仁愛區,19073,43612,21587,22025
2019/4/1,基隆市,中山區,19243,47289,23993,23296
2019/4/1,基隆市,安樂區,33680,82357,40748,41609
2019/4/1,基隆市,信義區,21781,52616,25913,26703
2019/4/1,新竹市,東區,81104,216512,106335,110177
2019/4/1,新竹市,北區,57622,151845,74169,77676
2019/4/1,新竹市,香山區,27645,78344,39777,38567
2019/4/1,嘉義市,東區,45526,121140,58286,62854
2019/4/1,嘉義市,西區,54517,147334,72002,75332
2019/4/1,金門縣,金城鎮,13019,43285,21540,21745
2019/4/1,金門縣,金湖鎮,9156,29965,15025,14940
2019/4/1,金門縣,金沙鎮,6398,20798,10285,10513
2019/4/1,金門縣,金寧鄉,8939,31954,16081,15873
2019/4/1,金門縣,烈嶼鄉,3183,12781,6300,6481
2019/4/1,金門縣,烏坵鄉,135,681,348,333
2019/4/1,連江縣,南竿鄉,1796,7624,4276,3348
2019/4/1,連江縣,北竿鄉,679,2481,1404,1077
2019/4/1,連江縣,莒光鄉,304,1601,977,624
2019/4/1,連江縣,東引鄉,344,1350,808,542
2019/5/1,總計,新北市,1570234,4003297,1957654,2045643
2019/5/1,總計,臺北市,1058272,2658615,1267542,1391073
2019/5/1,總計,桃園市,814796,2232623,1109050,1123573
2019/5/1,總計,臺中市,978511,2809545,1382201,1427344
2019/5/1,總計,臺南市,691787,1882624,938972,943652
2019/5/1,總計,高雄市,1103788,2773026,1370878,1402148
2019/5/1,總計,臺灣省,2510428,7077605,3603707,3473898
2019/5/1,總計,宜蘭縣,169818,454725,229656,225069
2019/5/1,總計,新竹縣,197267,559317,285493,273824
2019/5/1,總計,苗栗縣,189994,547037,282228,264809
2019/5/1,總計,彰化縣,390579,1275111,649050,626061
2019/5/1,總計,南投縣,178557,495546,253671,241875
2019/5/1,總計,雲林縣,241234,683589,354242,329347
2019/5/1,總計,嘉義縣,183308,505035,262315,242720
2019/5/1,總計,屏東縣,288556,822270,419737,402533
2019/5/1,總計,臺東縣,83129,217936,112260,105676
2019/5/1,總計,花蓮縣,126263,327080,165627,161453
2019/5/1,總計,澎湖縣,41063,104751,54037,50714
2019/5/1,總計,基隆市,153861,369613,184664,184949
2019/5/1,總計,新竹市,166658,447081,220447,226634
2019/5/1,總計,嘉義市,100141,268514,130280,138234
2019/5/1,總計,福建省,44026,152535,77070,75465
2019/5/1,總計,金門縣,40892,139440,69577,69863
2019/5/1,總計,連江縣,3134,13095,7493,5602
2019/5/1,新北市,板橋區,213658,555550,270569,284981
2019/5/1,新北市,三重區,152237,385488,189424,196064
2019/5/1,新北市,中和區,166499,412132,199699,212433
2019/5/1,新北市,永和區,91264,221155,104906,116249
2019/5/1,新北市,新莊區,156491,418931,204146,214785
2019/5/1,新北市,新店區,128192,302429,145168,157261
2019/5/1,新北市,樹林區,66853,183835,91693,92142
2019/5/1,新北市,鶯歌區,30615,86539,43380,43159
2019/5/1,新北市,三峽區,43531,116161,58089,58072
2019/5/1,新北市,淡水區,78490,175709,84125,91584
2019/5/1,新北市,汐止區,88582,201548,98133,103415
2019/5/1,新北市,瑞芳區,16131,39731,20030,19701
2019/5/1,新北市,土城區,87519,237054,116662,120392
2019/5/1,新北市,蘆洲區,72002,201530,98894,102636
2019/5/1,新北市,五股區,32987,86914,43763,43151
2019/5/1,新北市,泰山區,28704,78751,38947,39804
2019/5/1,新北市,林口區,45077,112587,54678,57909
2019/5/1,新北市,深坑區,9647,23654,11832,11822
2019/5/1,新北市,石碇區,3412,7671,4184,3487
2019/5/1,新北市,坪林區,2534,6660,3645,3015
2019/5/1,新北市,三芝區,9503,22830,11763,11067
2019/5/1,新北市,石門區,4310,12015,6215,5800
2019/5/1,新北市,八里區,15029,38963,19438,19525
2019/5/1,新北市,平溪區,2281,4620,2562,2058
2019/5/1,新北市,雙溪區,3790,8778,4735,4043
2019/5/1,新北市,貢寮區,4348,12165,6214,5951
2019/5/1,新北市,金山區,7139,21583,10625,10958
2019/5/1,新北市,萬里區,7507,21937,11011,10926
2019/5/1,新北市,烏來區,1902,6377,3124,3253
2019/5/1,臺北市,松山區,81347,205288,96160,109128
2019/5/1,臺北市,信義區,89472,221935,105700,116235
2019/5/1,臺北市,大安區,121534,308711,143763,164948
2019/5/1,臺北市,中山區,100519,228418,106094,122324
2019/5/1,臺北市,中正區,65597,158638,75633,83005
2019/5/1,臺北市,大同區,51985,127129,61797,65332
2019/5/1,臺北市,萬華區,78989,188305,92211,96094
2019/5/1,臺北市,文山區,106980,273083,130735,142348
2019/5/1,臺北市,南港區,47417,120902,59040,61862
2019/5/1,臺北市,內湖區,108996,286776,136791,149985
2019/5/1,臺北市,士林區,107853,285149,137342,147807
2019/5/1,臺北市,北投區,97583,254281,122276,132005
2019/5/1,桃園市,桃園區,170977,449724,217991,231733
2019/5/1,桃園市,中壢區,154636,414243,203515,210728
2019/5/1,桃園市,大溪區,33080,95095,48320,46775
2019/5/1,桃園市,楊梅區,60024,171579,86381,85198
2019/5/1,桃園市,蘆竹區,59741,165098,81850,83248
2019/5/1,桃園市,大園區,34238,91844,46786,45058
2019/5/1,桃園市,龜山區,63237,161484,80290,81194
2019/5/1,桃園市,八德區,73046,203811,101708,102103
2019/5/1,桃園市,龍潭區,42785,123450,61661,61789
2019/5/1,桃園市,平鎮區,78943,227489,112878,114611
2019/5/1,桃園市,新屋區,16709,49192,26176,23016
2019/5/1,桃園市,觀音區,23535,67509,34957,32552
2019/5/1,桃園市,復興區,3845,12105,6537,5568
2019/5/1,臺中市,中區,7982,18525,9150,9375
2019/5/1,臺中市,東區,28434,76144,37775,38369
2019/5/1,臺中市,南區,49238,126186,60472,65714
2019/5/1,臺中市,西區,45987,115788,54863,60925
2019/5/1,臺中市,北區,59751,147252,70289,76963
2019/5/1,臺中市,西屯區,87661,229429,109943,119486
2019/5/1,臺中市,南屯區,63970,171777,82081,89696
2019/5/1,臺中市,北屯區,103317,281138,134469,146669
2019/5/1,臺中市,豐原區,54436,167072,82424,84648
2019/5/1,臺中市,東勢區,17411,50026,25652,24374
2019/5/1,臺中市,大甲區,23400,77400,38816,38584
2019/5/1,臺中市,清水區,28076,87105,44626,42479
2019/5/1,臺中市,沙鹿區,30392,94458,47596,46862
2019/5/1,臺中市,梧棲區,18357,58643,29385,29258
2019/5/1,臺中市,后里區,16554,54687,27709,26978
2019/5/1,臺中市,神岡區,19785,65672,33453,32219
2019/5/1,臺中市,潭子區,36909,109124,53850,55274
2019/5/1,臺中市,大雅區,30162,95856,47730,48126
2019/5/1,臺中市,新社區,7633,24449,12671,11778
2019/5/1,臺中市,石岡區,4909,14865,7685,7180
2019/5/1,臺中市,外埔區,9878,32253,16455,15798
2019/5/1,臺中市,大安區,5551,19191,10119,9072
2019/5/1,臺中市,烏日區,25354,75502,37807,37695
2019/5/1,臺中市,大肚區,17944,57274,29234,28040
2019/5/1,臺中市,龍井區,23526,77875,39186,38689
2019/5/1,臺中市,霧峰區,20535,65532,33222,32310
2019/5/1,臺中市,太平區,66015,192819,95474,97345
2019/5/1,臺中市,大里區,70750,212563,104194,108369
2019/5/1,臺中市,和平區,4594,10940,5871,5069
2019/5/1,臺南市,新營區,29102,77363,38290,39073
2019/5/1,臺南市,鹽水區,10061,25320,13188,12132
2019/5/1,臺南市,白河區,10769,27940,14596,13344
2019/5/1,臺南市,柳營區,7963,21102,11009,10093
2019/5/1,臺南市,後壁區,8787,23206,12039,11167
2019/5/1,臺南市,東山區,8314,20639,10941,9698
2019/5/1,臺南市,麻豆區,15866,44116,22428,21688
2019/5/1,臺南市,下營區,9081,23756,12263,11493
2019/5/1,臺南市,六甲區,7817,22082,11425,10657
2019/5/1,臺南市,官田區,7999,21259,10823,10436
2019/5/1,臺南市,大內區,3796,9488,5117,4371
2019/5/1,臺南市,佳里區,20933,59078,29249,29829
2019/5/1,臺南市,學甲區,9642,25633,13110,12523
2019/5/1,臺南市,西港區,8277,24578,12426,12152
2019/5/1,臺南市,七股區,8032,22583,11714,10869
2019/5/1,臺南市,將軍區,7285,19564,9968,9596
2019/5/1,臺南市,北門區,4218,10956,5519,5437
2019/5/1,臺南市,新化區,14517,43423,22101,21322
2019/5/1,臺南市,善化區,18370,49491,24881,24610
2019/5/1,臺南市,新市區,12734,37138,18593,18545
2019/5/1,臺南市,安定區,10224,30417,15652,14765
2019/5/1,臺南市,山上區,2720,7261,3799,3462
2019/5/1,臺南市,玉井區,5160,13902,7168,6734
2019/5/1,臺南市,楠西區,3510,9432,4989,4443
2019/5/1,臺南市,南化區,2855,8664,4663,4001
2019/5/1,臺南市,左鎮區,1950,4749,2670,2079
2019/5/1,臺南市,仁德區,28026,75963,38363,37600
2019/5/1,臺南市,歸仁區,22941,68309,34610,33699
2019/5/1,臺南市,關廟區,11286,34249,17634,16615
2019/5/1,臺南市,龍崎區,1536,3970,2129,1841
2019/5/1,臺南市,永康區,85753,235105,115606,119499
2019/5/1,臺南市,東區,72284,186157,89119,97038
2019/5/1,臺南市,南區,46423,124977,61690,63287
2019/5/1,臺南市,北區,51315,131831,63989,67842
2019/5/1,臺南市,安南區,64251,193756,97648,96108
2019/5/1,臺南市,安平區,26187,66953,31796,35157
2019/5/1,臺南市,中西區,31803,78214,37767,40447
2019/5/1,高雄市,鹽埕區,10845,23966,11903,12063
2019/5/1,高雄市,鼓山區,58960,140383,67578,72805
2019/5/1,高雄市,左營區,79661,197187,94544,102643
2019/5/1,高雄市,楠梓區,72580,186646,91423,95223
2019/5/1,高雄市,三民區,137304,340179,164300,175879
2019/5/1,高雄市,新興區,23052,51072,24476,26596
2019/5/1,高雄市,前金區,12775,26816,12708,14108
2019/5/1,高雄市,苓雅區,72379,169227,81248,87979
2019/5/1,高雄市,前鎮區,78870,187827,92252,95575
2019/5/1,高雄市,旗津區,11115,28341,14588,13753
2019/5/1,高雄市,小港區,68745,157734,78166,79568
2019/5/1,高雄市,鳳山區,142576,359906,176023,183883
2019/5/1,高雄市,林園區,26243,69814,35225,34589
2019/5/1,高雄市,大寮區,42686,112415,57426,54989
2019/5/1,高雄市,大樹區,13693,42225,21600,20625
2019/5/1,高雄市,大社區,13172,34532,17489,17043
2019/5/1,高雄市,仁武區,34780,88545,44848,43697
2019/5/1,高雄市,鳥松區,18800,44686,22568,22118
2019/5/1,高雄市,岡山區,35213,97133,48173,48960
2019/5/1,高雄市,橋頭區,13960,37820,19153,18667
2019/5/1,高雄市,燕巢區,10675,29780,15676,14104
2019/5/1,高雄市,田寮區,3220,7127,3959,3168
2019/5/1,高雄市,阿蓮區,9410,28599,14437,14162
2019/5/1,高雄市,路竹區,17203,52445,26708,25737
2019/5/1,高雄市,湖內區,10944,29730,15204,14526
2019/5/1,高雄市,茄萣區,10561,29950,15385,14565
2019/5/1,高雄市,永安區,5749,13860,6974,6886
2019/5/1,高雄市,彌陀區,6806,19159,9821,9338
2019/5/1,高雄市,梓官區,12692,35812,18428,17384
2019/5/1,高雄市,旗山區,13726,36508,18850,17658
2019/5/1,高雄市,美濃區,14816,39397,20661,18736
2019/5/1,高雄市,六龜區,5559,12791,6907,5884
2019/5/1,高雄市,甲仙區,2287,5969,3173,2796
2019/5/1,高雄市,杉林區,4801,11725,6403,5322
2019/5/1,高雄市,內門區,5119,14310,7734,6576
2019/5/1,高雄市,茂林區,604,1972,991,981
2019/5/1,高雄市,桃源區,1366,4292,2256,2036
2019/5/1,高雄市,那瑪夏區,841,3146,1620,1526
2019/5/1,宜蘭縣,宜蘭市,36605,95745,46619,49126
2019/5/1,宜蘭縣,羅東鎮,26561,72391,34239,38152
2019/5/1,宜蘭縣,蘇澳鎮,14192,39391,20071,19320
2019/5/1,宜蘭縣,頭城鎮,10293,29025,14968,14057
2019/5/1,宜蘭縣,礁溪鄉,14192,35491,18414,17077
2019/5/1,宜蘭縣,壯圍鄉,8951,24326,12826,11500
2019/5/1,宜蘭縣,員山鄉,11781,32288,17097,15191
2019/5/1,宜蘭縣,冬山鄉,19484,52901,27115,25786
2019/5/1,宜蘭縣,五結鄉,15158,39647,20401,19246
2019/5/1,宜蘭縣,三星鄉,8680,21378,11503,9875
2019/5/1,宜蘭縣,大同鄉,1942,6164,3303,2861
2019/5/1,宜蘭縣,南澳鄉,1979,5978,3100,2878
2019/5/1,新竹縣,竹北市,69926,190366,94720,95646
2019/5/1,新竹縣,關西鎮,9377,28232,15144,13088
2019/5/1,新竹縣,新埔鎮,10811,33005,17569,15436
2019/5/1,新竹縣,竹東鎮,34272,96446,48400,48046
2019/5/1,新竹縣,湖口鄉,27232,77642,39295,38347
2019/5/1,新竹縣,橫山鄉,4414,12854,6965,5889
2019/5/1,新竹縣,新豐鄉,18963,57159,29310,27849
2019/5/1,新竹縣,芎林鄉,6663,19988,10575,9413
2019/5/1,新竹縣,寶山鄉,5735,14576,7910,6666
2019/5/1,新竹縣,北埔鄉,3130,9234,5021,4213
2019/5/1,新竹縣,峨眉鄉,2073,5534,3043,2491
2019/5/1,新竹縣,尖石鄉,2907,9611,5034,4577
2019/5/1,新竹縣,五峰鄉,1764,4670,2507,2163
2019/5/1,苗栗縣,苗栗市,31633,88111,43970,44141
2019/5/1,苗栗縣,頭份市,35798,103288,52088,51200
2019/5/1,苗栗縣,苑裡鎮,14760,44981,23447,21534
2019/5/1,苗栗縣,通霄鎮,11533,33735,17853,15882
2019/5/1,苗栗縣,竹南鎮,30146,86288,43548,42740
2019/5/1,苗栗縣,後龍鎮,11991,35972,19075,16897
2019/5/1,苗栗縣,卓蘭鎮,5987,16557,8668,7889
2019/5/1,苗栗縣,大湖鄉,5346,14353,7605,6748
2019/5/1,苗栗縣,公館鄉,10708,33048,17253,15795
2019/5/1,苗栗縣,銅鑼鄉,6119,17760,9447,8313
2019/5/1,苗栗縣,南庄鄉,3940,9909,5436,4473
2019/5/1,苗栗縣,頭屋鄉,3644,10585,5611,4974
2019/5/1,苗栗縣,三義鄉,5546,16101,8511,7590
2019/5/1,苗栗縣,西湖鄉,2636,6962,3891,3071
2019/5/1,苗栗縣,造橋鄉,4127,12579,6648,5931
2019/5/1,苗栗縣,三灣鄉,2375,6583,3598,2985
2019/5/1,苗栗縣,獅潭鄉,1719,4273,2399,1874
2019/5/1,苗栗縣,泰安鄉,1986,5952,3180,2772
2019/5/1,彰化縣,彰化市,76955,232441,114628,117813
2019/5/1,彰化縣,員林市,40023,124914,62020,62894
2019/5/1,彰化縣,鹿港鎮,24822,86860,44133,42727
2019/5/1,彰化縣,和美鎮,27063,90631,46081,44550
2019/5/1,彰化縣,北斗鎮,10818,33320,16786,16534
2019/5/1,彰化縣,溪湖鎮,16454,55364,27997,27367
2019/5/1,彰化縣,田中鎮,13236,41468,21315,20153
2019/5/1,彰化縣,二林鎮,15142,50339,25876,24463
2019/5/1,彰化縣,線西鄉,4459,16853,8645,8208
2019/5/1,彰化縣,伸港鄉,10191,37212,18949,18263
2019/5/1,彰化縣,福興鄉,13037,46881,24382,22499
2019/5/1,彰化縣,秀水鄉,10888,39174,20201,18973
2019/5/1,彰化縣,花壇鄉,14227,45698,23459,22239
2019/5/1,彰化縣,芬園鄉,6816,23427,12307,11120
2019/5/1,彰化縣,大村鄉,11238,36953,19068,17885
2019/5/1,彰化縣,埔鹽鄉,9147,32332,17006,15326
2019/5/1,彰化縣,埔心鄉,10801,34730,17876,16854
2019/5/1,彰化縣,永靖鄉,10943,36842,19054,17788
2019/5/1,彰化縣,社頭鄉,12963,42710,21922,20788
2019/5/1,彰化縣,二水鄉,5295,14995,7882,7113
2019/5/1,彰化縣,田尾鄉,7996,27117,13981,13136
2019/5/1,彰化縣,埤頭鄉,9113,30403,15703,14700
2019/5/1,彰化縣,芳苑鄉,10130,33331,17576,15755
2019/5/1,彰化縣,大城鄉,5233,16557,8927,7630
2019/5/1,彰化縣,竹塘鄉,4600,15014,7858,7156
2019/5/1,彰化縣,溪州鄉,8989,29545,15418,14127
2019/5/1,南投縣,南投市,35035,99387,49745,49642
2019/5/1,南投縣,埔里鎮,29018,80250,39914,40336
2019/5/1,南投縣,草屯鎮,33528,97269,49161,48108
2019/5/1,南投縣,竹山鎮,20153,54276,27794,26482
2019/5/1,南投縣,集集鎮,4276,10698,5578,5120
2019/5/1,南投縣,名間鄉,12621,38106,20098,18008
2019/5/1,南投縣,鹿谷鄉,8064,17562,9355,8207
2019/5/1,南投縣,中寮鄉,5616,14609,7932,6677
2019/5/1,南投縣,魚池鄉,5751,15687,8278,7409
2019/5/1,南投縣,國姓鄉,7269,18427,9949,8478
2019/5/1,南投縣,水里鄉,7082,17355,9084,8271
2019/5/1,南投縣,信義鄉,5270,16076,8616,7460
2019/5/1,南投縣,仁愛鄉,4874,15844,8167,7677
2019/5/1,雲林縣,斗六市,38663,108601,53950,54651
2019/5/1,雲林縣,斗南鎮,15915,44426,22555,21871
2019/5/1,雲林縣,虎尾鎮,25323,70883,35906,34977
2019/5/1,雲林縣,西螺鎮,14834,45948,23165,22783
2019/5/1,雲林縣,土庫鎮,9487,28708,14956,13752
2019/5/1,雲林縣,北港鎮,16029,39698,20496,19202
2019/5/1,雲林縣,古坑鄉,11078,31306,16506,14800
2019/5/1,雲林縣,大埤鄉,6625,18919,10134,8785
2019/5/1,雲林縣,莿桐鄉,9355,28597,14944,13653
2019/5/1,雲林縣,林內鄉,6025,18022,9433,8589
2019/5/1,雲林縣,二崙鄉,8921,26645,14227,12418
2019/5/1,雲林縣,崙背鄉,8501,24180,12766,11414
2019/5/1,雲林縣,麥寮鄉,14680,46358,23185,23173
2019/5/1,雲林縣,東勢鄉,5702,14582,8077,6505
2019/5/1,雲林縣,褒忠鄉,4426,12805,6889,5916
2019/5/1,雲林縣,臺西鄉,8610,23471,12597,10874
2019/5/1,雲林縣,元長鄉,9211,25414,13933,11481
2019/5/1,雲林縣,四湖鄉,8666,22967,12455,10512
2019/5/1,雲林縣,口湖鄉,9390,27041,14427,12614
2019/5/1,雲林縣,水林鄉,9793,25018,13641,11377
2019/5/1,嘉義縣,太保市,13294,38120,19514,18606
2019/5/1,嘉義縣,朴子市,15813,42111,21271,20840
2019/5/1,嘉義縣,布袋鎮,9873,26544,13534,13010
2019/5/1,嘉義縣,大林鎮,11412,30868,15756,15112
2019/5/1,嘉義縣,民雄鄉,25206,71338,36474,34864
2019/5/1,嘉義縣,溪口鄉,5304,14410,7707,6703
2019/5/1,嘉義縣,新港鄉,10701,31630,16663,14967
2019/5/1,嘉義縣,六腳鄉,8777,22726,12021,10705
2019/5/1,嘉義縣,東石鄉,9172,24323,12882,11441
2019/5/1,嘉義縣,義竹鄉,7299,18090,9405,8685
2019/5/1,嘉義縣,鹿草鄉,5737,15214,8176,7038
2019/5/1,嘉義縣,水上鄉,18198,49241,25429,23812
2019/5/1,嘉義縣,中埔鄉,16062,44418,23090,21328
2019/5/1,嘉義縣,竹崎鄉,11664,35371,18813,16558
2019/5/1,嘉義縣,梅山鄉,6764,19124,10169,8955
2019/5/1,嘉義縣,番路鄉,4214,11345,6114,5231
2019/5/1,嘉義縣,大埔鄉,1920,4589,2367,2222
2019/5/1,嘉義縣,阿里山鄉,1898,5573,2930,2643
2019/5/1,屏東縣,屏東市,74754,199399,98285,101114
2019/5/1,屏東縣,潮州鎮,19721,53902,26893,27009
2019/5/1,屏東縣,東港鎮,16879,47446,23923,23523
2019/5/1,屏東縣,恆春鎮,11737,30739,15727,15012
2019/5/1,屏東縣,萬丹鄉,15225,50503,26210,24293
2019/5/1,屏東縣,長治鄉,10175,29529,15407,14122
2019/5/1,屏東縣,麟洛鄉,3860,10999,5702,5297
2019/5/1,屏東縣,九如鄉,7072,21974,11328,10646
2019/5/1,屏東縣,里港鄉,8223,25953,13187,12766
2019/5/1,屏東縣,鹽埔鄉,7874,25494,13225,12269
2019/5/1,屏東縣,高樹鄉,9229,24140,12884,11256
2019/5/1,屏東縣,萬巒鄉,6519,20518,10676,9842
2019/5/1,屏東縣,內埔鄉,18772,53941,27868,26073
2019/5/1,屏東縣,竹田鄉,5664,17000,9026,7974
2019/5/1,屏東縣,新埤鄉,3435,9807,5235,4572
2019/5/1,屏東縣,枋寮鄉,8560,24183,12643,11540
2019/5/1,屏東縣,新園鄉,11830,34677,17982,16695
2019/5/1,屏東縣,崁頂鄉,4513,15456,7784,7672
2019/5/1,屏東縣,林邊鄉,6698,17718,9034,8684
2019/5/1,屏東縣,南州鄉,3716,10582,5438,5144
2019/5/1,屏東縣,佳冬鄉,6965,18975,9846,9129
2019/5/1,屏東縣,琉球鄉,4563,12287,6737,5550
2019/5/1,屏東縣,車城鄉,3471,8463,4524,3939
2019/5/1,屏東縣,滿州鄉,3042,7821,4237,3584
2019/5/1,屏東縣,枋山鄉,2083,5418,2875,2543
2019/5/1,屏東縣,三地門鄉,2331,7684,3851,3833
2019/5/1,屏東縣,霧臺鄉,1053,3311,1689,1622
2019/5/1,屏東縣,瑪家鄉,2054,6763,3423,3340
2019/5/1,屏東縣,泰武鄉,1369,5385,2814,2571
2019/5/1,屏東縣,來義鄉,2235,7421,3744,3677
2019/5/1,屏東縣,春日鄉,1414,4911,2511,2400
2019/5/1,屏東縣,獅子鄉,1576,4944,2546,2398
2019/5/1,屏東縣,牡丹鄉,1944,4927,2483,2444
2019/5/1,臺東縣,臺東市,39965,105338,52617,52721
2019/5/1,臺東縣,成功鎮,5369,13930,7324,6606
2019/5/1,臺東縣,關山鎮,3183,8678,4502,4176
2019/5/1,臺東縣,卑南鄉,6740,17215,9072,8143
2019/5/1,臺東縣,大武鄉,2455,5928,3095,2833
2019/5/1,臺東縣,太麻里鄉,4735,11091,5901,5190
2019/5/1,臺東縣,東河鄉,3766,8424,4660,3764
2019/5/1,臺東縣,長濱鄉,2900,7116,4038,3078
2019/5/1,臺東縣,鹿野鄉,3028,7789,4128,3661
2019/5/1,臺東縣,池上鄉,3193,8180,4229,3951
2019/5/1,臺東縣,綠島鄉,1163,4066,2157,1909
2019/5/1,臺東縣,延平鄉,1067,3573,1908,1665
2019/5/1,臺東縣,海端鄉,1084,4147,2207,1940
2019/5/1,臺東縣,達仁鄉,1438,3552,1925,1627
2019/5/1,臺東縣,金峰鄉,1159,3724,1876,1848
2019/5/1,臺東縣,蘭嶼鄉,1884,5185,2621,2564
2019/5/1,花蓮縣,花蓮市,41466,103626,49836,53790
2019/5/1,花蓮縣,鳳林鎮,4383,10805,5624,5181
2019/5/1,花蓮縣,玉里鎮,8866,23850,12604,11246
2019/5/1,花蓮縣,新城鄉,7785,20131,10311,9820
2019/5/1,花蓮縣,吉安鄉,32301,83379,41899,41480
2019/5/1,花蓮縣,壽豐鄉,7266,17883,9463,8420
2019/5/1,花蓮縣,光復鄉,5017,12653,6716,5937
2019/5/1,花蓮縣,豐濱鄉,1717,4635,2583,2052
2019/5/1,花蓮縣,瑞穗鄉,4765,11530,6212,5318
2019/5/1,花蓮縣,富里鄉,4034,10223,5555,4668
2019/5/1,花蓮縣,秀林鄉,4852,15925,8164,7761
2019/5/1,花蓮縣,萬榮鄉,2107,6368,3344,3024
2019/5/1,花蓮縣,卓溪鄉,1704,6072,3316,2756
2019/5/1,澎湖縣,馬公市,25215,62778,31969,30809
2019/5/1,澎湖縣,湖西鄉,5880,14745,7825,6920
2019/5/1,澎湖縣,白沙鄉,3478,9797,5116,4681
2019/5/1,澎湖縣,西嶼鄉,3046,8313,4298,4015
2019/5/1,澎湖縣,望安鄉,2061,5296,2859,2437
2019/5/1,澎湖縣,七美鄉,1383,3822,1970,1852
2019/5/1,基隆市,中正區,22644,51514,26235,25279
2019/5/1,基隆市,七堵區,21593,53748,26964,26784
2019/5/1,基隆市,暖暖區,15792,38608,19328,19280
2019/5/1,基隆市,仁愛區,19091,43593,21552,22041
2019/5/1,基隆市,中山區,19228,47218,23944,23274
2019/5/1,基隆市,安樂區,33719,82339,40734,41605
2019/5/1,基隆市,信義區,21794,52593,25907,26686
2019/5/1,新竹市,東區,81242,216755,106463,110292
2019/5/1,新竹市,北區,57725,152015,74244,77771
2019/5/1,新竹市,香山區,27691,78311,39740,38571
2019/5/1,嘉義市,東區,45569,121139,58262,62877
2019/5/1,嘉義市,西區,54572,147375,72018,75357
2019/5/1,金門縣,金城鎮,13027,43251,21528,21723
2019/5/1,金門縣,金湖鎮,9172,29954,15021,14933
2019/5/1,金門縣,金沙鎮,6402,20786,10284,10502
2019/5/1,金門縣,金寧鄉,8969,31998,16099,15899
2019/5/1,金門縣,烈嶼鄉,3187,12770,6296,6474
2019/5/1,金門縣,烏坵鄉,135,681,349,332
2019/5/1,連江縣,南竿鄉,1798,7637,4278,3359
2019/5/1,連江縣,北竿鄉,685,2509,1427,1082
2019/5/1,連江縣,莒光鄉,306,1599,978,621
2019/5/1,連江縣,東引鄉,345,1350,810,540
2019/6/1,總計,新北市,1571557,4004598,1957935,2046663
2019/6/1,總計,臺北市,1058621,2657652,1266944,1390708
2019/6/1,總計,桃園市,816222,2235005,1110132,1124873
2019/6/1,總計,臺中市,979469,2810219,1382399,1427820
2019/6/1,總計,臺南市,692289,1882313,938707,943606
2019/6/1,總計,高雄市,1104650,2773177,1370833,1402344
2019/6/1,總計,臺灣省,2511768,7075691,3602439,3473252
2019/6/1,總計,宜蘭縣,169900,454706,229638,225068
2019/6/1,總計,新竹縣,197610,559734,285742,273992
2019/6/1,總計,苗栗縣,190098,546690,282025,264665
2019/6/1,總計,彰化縣,390815,1274724,648798,625926
2019/6/1,總計,南投縣,178590,495283,253499,241784
2019/6/1,總計,雲林縣,241342,683318,354050,329268
2019/6/1,總計,嘉義縣,183302,504750,262133,242617
2019/6/1,總計,屏東縣,288710,821834,419526,402308
2019/6/1,總計,臺東縣,83150,217721,112169,105552
2019/6/1,總計,花蓮縣,126329,326986,165538,161448
2019/6/1,總計,澎湖縣,40947,104676,53992,50684
2019/6/1,總計,基隆市,153933,369475,184555,184920
2019/6/1,總計,新竹市,166833,447359,220553,226806
2019/6/1,總計,嘉義市,100209,268435,130221,138214
2019/6/1,總計,福建省,44085,152376,77022,75354
2019/6/1,總計,金門縣,40950,139281,69523,69758
2019/6/1,總計,連江縣,3135,13095,7499,5596
2019/6/1,新北市,板橋區,213864,555688,270601,285087
2019/6/1,新北市,三重區,152305,385403,189359,196044
2019/6/1,新北市,中和區,166561,412101,199612,212489
2019/6/1,新北市,永和區,91259,221081,104816,116265
2019/6/1,新北市,新莊區,156660,419116,204203,214913
2019/6/1,新北市,新店區,128262,302446,145174,157272
2019/6/1,新北市,樹林區,66894,183832,91671,92161
2019/6/1,新北市,鶯歌區,30668,86589,43408,43181
2019/6/1,新北市,三峽區,43592,116176,58087,58089
2019/6/1,新北市,淡水區,78668,176068,84280,91788
2019/6/1,新北市,汐止區,88653,201658,98150,103508
2019/6/1,新北市,瑞芳區,16125,39712,20030,19682
2019/6/1,新北市,土城區,87552,237048,116667,120381
2019/6/1,新北市,蘆洲區,72049,201647,98927,102720
2019/6/1,新北市,五股區,33059,87046,43839,43207
2019/6/1,新北市,泰山區,28711,78801,38953,39848
2019/6/1,新北市,林口區,45232,112955,54847,58108
2019/6/1,新北市,深坑區,9649,23618,11807,11811
2019/6/1,新北市,石碇區,3414,7664,4180,3484
2019/6/1,新北市,坪林區,2538,6678,3651,3027
2019/6/1,新北市,三芝區,9514,22837,11761,11076
2019/6/1,新北市,石門區,4308,11999,6212,5787
2019/6/1,新北市,八里區,15056,39008,19457,19551
2019/6/1,新北市,平溪區,2278,4604,2555,2049
2019/6/1,新北市,雙溪區,3793,8767,4731,4036
2019/6/1,新北市,貢寮區,4349,12150,6213,5937
2019/6/1,新北市,金山區,7137,21554,10609,10945
2019/6/1,新北市,萬里區,7504,21948,11009,10939
2019/6/1,新北市,烏來區,1903,6404,3126,3278
2019/6/1,桃園市,桃園區,171228,450028,218109,231919
2019/6/1,桃園市,中壢區,154894,414676,203741,210935
2019/6/1,桃園市,大溪區,33127,95146,48340,46806
2019/6/1,桃園市,楊梅區,60173,171776,86452,85324
2019/6/1,桃園市,蘆竹區,59829,165345,81956,83389
2019/6/1,桃園市,大園區,34344,92046,46883,45163
2019/6/1,桃園市,龜山區,63335,161770,80405,81365
2019/6/1,桃園市,八德區,73229,204143,101857,102286
2019/6/1,桃園市,龍潭區,42828,123566,61720,61846
2019/6/1,桃園市,平鎮區,79060,227601,112932,114669
2019/6/1,桃園市,新屋區,16728,49196,26190,23006
2019/6/1,桃園市,觀音區,23599,67593,34998,32595
2019/6/1,桃園市,復興區,3848,12119,6549,5570
2019/6/1,臺北市,松山區,81372,205219,96101,109118
2019/6/1,臺北市,信義區,89427,221606,105505,116101
2019/6/1,臺北市,大安區,121526,308722,143740,164982
2019/6/1,臺北市,中山區,100537,228285,106021,122264
2019/6/1,臺北市,中正區,65635,158583,75577,83006
2019/6/1,臺北市,大同區,51965,127086,61731,65355
2019/6/1,臺北市,萬華區,79029,188225,92205,96020
2019/6/1,臺北市,文山區,107025,273040,130712,142328
2019/6/1,臺北市,南港區,47449,120897,59047,61850
2019/6/1,臺北市,內湖區,109087,286834,136788,150046
2019/6/1,臺北市,士林區,107933,285017,137303,147714
2019/6/1,臺北市,北投區,97636,254138,122214,131924
2019/6/1,臺中市,中區,7981,18505,9144,9361
2019/6/1,臺中市,東區,28440,76113,37769,38344
2019/6/1,臺中市,南區,49287,126271,60494,65777
2019/6/1,臺中市,西區,45986,115691,54830,60861
2019/6/1,臺中市,北區,59796,147234,70243,76991
2019/6/1,臺中市,西屯區,87735,229499,109932,119567
2019/6/1,臺中市,南屯區,64062,171952,82182,89770
2019/6/1,臺中市,北屯區,103436,281376,134571,146805
2019/6/1,臺中市,豐原區,54464,166969,82351,84618
2019/6/1,臺中市,東勢區,17398,49984,25626,24358
2019/6/1,臺中市,大甲區,23404,77375,38796,38579
2019/6/1,臺中市,清水區,28121,87158,44652,42506
2019/6/1,臺中市,沙鹿區,30420,94506,47624,46882
2019/6/1,臺中市,梧棲區,18385,58676,29380,29296
2019/6/1,臺中市,后里區,16565,54705,27717,26988
2019/6/1,臺中市,神岡區,19817,65709,33484,32225
2019/6/1,臺中市,潭子區,37019,109290,53925,55365
2019/6/1,臺中市,大雅區,30172,95828,47718,48110
2019/6/1,臺中市,新社區,7631,24424,12653,11771
2019/6/1,臺中市,石岡區,4910,14854,7686,7168
2019/6/1,臺中市,外埔區,9879,32209,16439,15770
2019/6/1,臺中市,大安區,5558,19174,10110,9064
2019/6/1,臺中市,烏日區,25390,75470,37793,37677
2019/6/1,臺中市,大肚區,17952,57261,29224,28037
2019/6/1,臺中市,龍井區,23567,77886,39206,38680
2019/6/1,臺中市,霧峰區,20543,65519,33203,32316
2019/6/1,臺中市,太平區,66109,192993,95536,97457
2019/6/1,臺中市,大里區,70842,212641,104236,108405
2019/6/1,臺中市,和平區,4600,10947,5875,5072
2019/6/1,高雄市,鹽埕區,10859,23948,11904,12044
2019/6/1,高雄市,鼓山區,59038,140523,67640,72883
2019/6/1,高雄市,左營區,79739,197248,94566,102682
2019/6/1,高雄市,楠梓區,72665,186780,91481,95299
2019/6/1,高雄市,三民區,137355,340126,164281,175845
2019/6/1,高雄市,新興區,23057,51015,24450,26565
2019/6/1,高雄市,前金區,12795,26829,12704,14125
2019/6/1,高雄市,苓雅區,72425,169187,81219,87968
2019/6/1,高雄市,前鎮區,78970,187837,92230,95607
2019/6/1,高雄市,旗津區,11118,28318,14586,13732
2019/6/1,高雄市,小港區,68805,157685,78115,79570
2019/6/1,高雄市,鳳山區,142655,359850,175941,183909
2019/6/1,高雄市,林園區,26257,69801,35210,34591
2019/6/1,高雄市,大寮區,42741,112502,57484,55018
2019/6/1,高雄市,大樹區,13695,42208,21583,20625
2019/6/1,高雄市,大社區,13184,34532,17504,17028
2019/6/1,高雄市,仁武區,34857,88703,44911,43792
2019/6/1,高雄市,鳥松區,18840,44736,22587,22149
2019/6/1,高雄市,岡山區,35229,97148,48179,48969
2019/6/1,高雄市,橋頭區,14008,37875,19171,18704
2019/6/1,高雄市,燕巢區,10691,29807,15691,14116
2019/6/1,高雄市,田寮區,3215,7116,3954,3162
2019/6/1,高雄市,阿蓮區,9408,28581,14427,14154
2019/6/1,高雄市,路竹區,17204,52395,26684,25711
2019/6/1,高雄市,湖內區,10952,29725,15197,14528
2019/6/1,高雄市,茄萣區,10561,29947,15392,14555
2019/6/1,高雄市,永安區,5744,13854,6973,6881
2019/6/1,高雄市,彌陀區,6799,19141,9814,9327
2019/6/1,高雄市,梓官區,12689,35775,18409,17366
2019/6/1,高雄市,旗山區,13718,36455,18830,17625
2019/6/1,高雄市,美濃區,14807,39352,20636,18716
2019/6/1,高雄市,六龜區,5558,12789,6912,5877
2019/6/1,高雄市,甲仙區,2283,5970,3171,2799
2019/6/1,高雄市,杉林區,4801,11712,6400,5312
2019/6/1,高雄市,內門區,5119,14302,7730,6572
2019/6/1,高雄市,茂林區,604,1976,994,982
2019/6/1,高雄市,桃源區,1365,4281,2251,2030
2019/6/1,高雄市,那瑪夏區,840,3148,1622,1526
2019/6/1,臺南市,新營區,29126,77336,38270,39066
2019/6/1,臺南市,鹽水區,10073,25322,13183,12139
2019/6/1,臺南市,白河區,10775,27909,14578,13331
2019/6/1,臺南市,柳營區,7968,21092,10996,10096
2019/6/1,臺南市,後壁區,8782,23173,12023,11150
2019/6/1,臺南市,東山區,8313,20616,10929,9687
2019/6/1,臺南市,麻豆區,15865,44102,22420,21682
2019/6/1,臺南市,下營區,9102,23741,12263,11478
2019/6/1,臺南市,六甲區,7812,22044,11402,10642
2019/6/1,臺南市,官田區,8008,21265,10820,10445
2019/6/1,臺南市,大內區,3794,9471,5111,4360
2019/6/1,臺南市,佳里區,20959,59080,29246,29834
2019/6/1,臺南市,學甲區,9646,25614,13106,12508
2019/6/1,臺南市,西港區,8277,24576,12427,12149
2019/6/1,臺南市,七股區,8032,22538,11683,10855
2019/6/1,臺南市,將軍區,7280,19524,9955,9569
2019/6/1,臺南市,北門區,4221,10941,5510,5431
2019/6/1,臺南市,新化區,14529,43409,22096,21313
2019/6/1,臺南市,善化區,18433,49570,24929,24641
2019/6/1,臺南市,新市區,12761,37159,18593,18566
2019/6/1,臺南市,安定區,10243,30406,15636,14770
2019/6/1,臺南市,山上區,2721,7245,3794,3451
2019/6/1,臺南市,玉井區,5155,13898,7168,6730
2019/6/1,臺南市,楠西區,3504,9412,4977,4435
2019/6/1,臺南市,南化區,2856,8652,4659,3993
2019/6/1,臺南市,左鎮區,1947,4736,2660,2076
2019/6/1,臺南市,仁德區,28058,75985,38392,37593
2019/6/1,臺南市,歸仁區,22917,68233,34565,33668
2019/6/1,臺南市,關廟區,11295,34259,17639,16620
2019/6/1,臺南市,龍崎區,1533,3962,2126,1836
2019/6/1,臺南市,永康區,85848,235157,115604,119553
2019/6/1,臺南市,東區,72301,186057,89050,97007
2019/6/1,臺南市,南區,46459,125011,61712,63299
2019/6/1,臺南市,北區,51326,131776,63955,67821
2019/6/1,臺南市,安南區,64309,193786,97655,96131
2019/6/1,臺南市,安平區,26203,66980,31804,35176
2019/6/1,臺南市,中西區,31858,78276,37771,40505
2019/6/1,宜蘭縣,宜蘭市,36613,95727,46607,49120
2019/6/1,宜蘭縣,羅東鎮,26553,72340,34219,38121
2019/6/1,宜蘭縣,蘇澳鎮,14210,39353,20063,19290
2019/6/1,宜蘭縣,頭城鎮,10304,29050,14976,14074
2019/6/1,宜蘭縣,礁溪鄉,14185,35460,18408,17052
2019/6/1,宜蘭縣,壯圍鄉,8955,24335,12828,11507
2019/6/1,宜蘭縣,員山鄉,11796,32264,17067,15197
2019/6/1,宜蘭縣,冬山鄉,19491,52979,27164,25815
2019/6/1,宜蘭縣,五結鄉,15180,39697,20395,19302
2019/6/1,宜蘭縣,三星鄉,8690,21381,11510,9871
2019/6/1,宜蘭縣,大同鄉,1942,6149,3301,2848
2019/6/1,宜蘭縣,南澳鄉,1981,5971,3100,2871
2019/6/1,新竹縣,竹北市,70192,190945,95019,95926
2019/6/1,新竹縣,關西鎮,9367,28227,15142,13085
2019/6/1,新竹縣,新埔鎮,10817,32986,17552,15434
2019/6/1,新竹縣,竹東鎮,34290,96369,48387,47982
2019/6/1,新竹縣,湖口鄉,27264,77677,39320,38357
2019/6/1,新竹縣,橫山鄉,4413,12855,6970,5885
2019/6/1,新竹縣,新豐鄉,18980,57150,29293,27857
2019/6/1,新竹縣,芎林鄉,6666,19947,10558,9389
2019/6/1,新竹縣,寶山鄉,5743,14560,7905,6655
2019/6/1,新竹縣,北埔鄉,3135,9243,5020,4223
2019/6/1,新竹縣,峨眉鄉,2072,5529,3044,2485
2019/6/1,新竹縣,尖石鄉,2905,9597,5036,4561
2019/6/1,新竹縣,五峰鄉,1766,4649,2496,2153
2019/6/1,苗栗縣,苗栗市,31654,88089,43961,44128
2019/6/1,苗栗縣,頭份市,35837,103275,52089,51186
2019/6/1,苗栗縣,苑裡鎮,14771,44970,23450,21520
2019/6/1,苗栗縣,通霄鎮,11535,33684,17826,15858
2019/6/1,苗栗縣,竹南鎮,30191,86297,43547,42750
2019/6/1,苗栗縣,後龍鎮,12003,35922,19043,16879
2019/6/1,苗栗縣,卓蘭鎮,5979,16529,8652,7877
2019/6/1,苗栗縣,大湖鄉,5345,14348,7604,6744
2019/6/1,苗栗縣,公館鄉,10696,32970,17204,15766
2019/6/1,苗栗縣,銅鑼鄉,6117,17760,9435,8325
2019/6/1,苗栗縣,南庄鄉,3934,9892,5427,4465
2019/6/1,苗栗縣,頭屋鄉,3646,10572,5604,4968
2019/6/1,苗栗縣,三義鄉,5544,16085,8504,7581
2019/6/1,苗栗縣,西湖鄉,2634,6957,3888,3069
2019/6/1,苗栗縣,造橋鄉,4131,12564,6640,5924
2019/6/1,苗栗縣,三灣鄉,2373,6582,3593,2989
2019/6/1,苗栗縣,獅潭鄉,1720,4265,2389,1876
2019/6/1,苗栗縣,泰安鄉,1988,5929,3169,2760
2019/6/1,彰化縣,彰化市,77010,232402,114562,117840
2019/6/1,彰化縣,員林市,40039,124863,61980,62883
2019/6/1,彰化縣,鹿港鎮,24848,86892,44125,42767
2019/6/1,彰化縣,和美鎮,27094,90682,46095,44587
2019/6/1,彰化縣,北斗鎮,10818,33296,16770,16526
2019/6/1,彰化縣,溪湖鎮,16458,55319,27977,27342
2019/6/1,彰化縣,田中鎮,13254,41441,21290,20151
2019/6/1,彰化縣,二林鎮,15140,50295,25862,24433
2019/6/1,彰化縣,線西鄉,4459,16832,8641,8191
2019/6/1,彰化縣,伸港鄉,10212,37237,18951,18286
2019/6/1,彰化縣,福興鄉,13044,46869,24378,22491
2019/6/1,彰化縣,秀水鄉,10893,39171,20204,18967
2019/6/1,彰化縣,花壇鄉,14246,45681,23465,22216
2019/6/1,彰化縣,芬園鄉,6813,23400,12303,11097
2019/6/1,彰化縣,大村鄉,11255,36994,19092,17902
2019/6/1,彰化縣,埔鹽鄉,9147,32319,16995,15324
2019/6/1,彰化縣,埔心鄉,10806,34722,17863,16859
2019/6/1,彰化縣,永靖鄉,10945,36799,19047,17752
2019/6/1,彰化縣,社頭鄉,12976,42725,21927,20798
2019/6/1,彰化縣,二水鄉,5296,14983,7872,7111
2019/6/1,彰化縣,田尾鄉,7997,27088,13973,13115
2019/6/1,彰化縣,埤頭鄉,9110,30397,15698,14699
2019/6/1,彰化縣,芳苑鄉,10136,33274,17558,15716
2019/6/1,彰化縣,大城鄉,5226,16532,8919,7613
2019/6/1,彰化縣,竹塘鄉,4596,14999,7850,7149
2019/6/1,彰化縣,溪州鄉,8997,29512,15401,14111
2019/6/1,南投縣,南投市,35043,99364,49711,49653
2019/6/1,南投縣,埔里鎮,29020,80218,39899,40319
2019/6/1,南投縣,草屯鎮,33561,97291,49162,48129
2019/6/1,南投縣,竹山鎮,20133,54157,27727,26430
2019/6/1,南投縣,集集鎮,4273,10687,5573,5114
2019/6/1,南投縣,名間鄉,12630,38092,20092,18000
2019/6/1,南投縣,鹿谷鄉,8075,17555,9348,8207
2019/6/1,南投縣,中寮鄉,5611,14604,7922,6682
2019/6/1,南投縣,魚池鄉,5752,15680,8268,7412
2019/6/1,南投縣,國姓鄉,7270,18400,9941,8459
2019/6/1,南投縣,水里鄉,7080,17361,9089,8272
2019/6/1,南投縣,信義鄉,5267,16047,8613,7434
2019/6/1,南投縣,仁愛鄉,4875,15827,8154,7673
2019/6/1,雲林縣,斗六市,38714,108573,53926,54647
2019/6/1,雲林縣,斗南鎮,15923,44370,22526,21844
2019/6/1,雲林縣,虎尾鎮,25348,70902,35906,34996
2019/6/1,雲林縣,西螺鎮,14848,45940,23141,22799
2019/6/1,雲林縣,土庫鎮,9485,28691,14953,13738
2019/6/1,雲林縣,北港鎮,16031,39681,20501,19180
2019/6/1,雲林縣,古坑鄉,11086,31307,16498,14809
2019/6/1,雲林縣,大埤鄉,6624,18904,10128,8776
2019/6/1,雲林縣,莿桐鄉,9351,28599,14942,13657
2019/6/1,雲林縣,林內鄉,6024,18011,9428,8583
2019/6/1,雲林縣,二崙鄉,8928,26624,14221,12403
2019/6/1,雲林縣,崙背鄉,8501,24165,12772,11393
2019/6/1,雲林縣,麥寮鄉,14705,46481,23235,23246
2019/6/1,雲林縣,東勢鄉,5694,14565,8067,6498
2019/6/1,雲林縣,褒忠鄉,4425,12779,6876,5903
2019/6/1,雲林縣,臺西鄉,8605,23437,12572,10865
2019/6/1,雲林縣,元長鄉,9211,25360,13899,11461
2019/6/1,雲林縣,四湖鄉,8665,22947,12436,10511
2019/6/1,雲林縣,口湖鄉,9386,27017,14412,12605
2019/6/1,雲林縣,水林鄉,9788,24965,13611,11354
2019/6/1,嘉義縣,太保市,13317,38166,19520,18646
2019/6/1,嘉義縣,朴子市,15800,42081,21254,20827
2019/6/1,嘉義縣,布袋鎮,9867,26503,13514,12989
2019/6/1,嘉義縣,大林鎮,11408,30864,15750,15114
2019/6/1,嘉義縣,民雄鄉,25219,71355,36485,34870
2019/6/1,嘉義縣,溪口鄉,5302,14395,7688,6707
2019/6/1,嘉義縣,新港鄉,10710,31606,16655,14951
2019/6/1,嘉義縣,六腳鄉,8776,22697,12006,10691
2019/6/1,嘉義縣,東石鄉,9166,24314,12883,11431
2019/6/1,嘉義縣,義竹鄉,7290,18054,9381,8673
2019/6/1,嘉義縣,鹿草鄉,5733,15215,8179,7036
2019/6/1,嘉義縣,水上鄉,18215,49225,25410,23815
2019/6/1,嘉義縣,中埔鄉,16053,44364,23061,21303
2019/6/1,嘉義縣,竹崎鄉,11665,35345,18807,16538
2019/6/1,嘉義縣,梅山鄉,6757,19088,10154,8934
2019/6/1,嘉義縣,番路鄉,4211,11324,6105,5219
2019/6/1,嘉義縣,大埔鄉,1918,4595,2363,2232
2019/6/1,嘉義縣,阿里山鄉,1895,5559,2918,2641
2019/6/1,屏東縣,屏東市,74755,199358,98264,101094
2019/6/1,屏東縣,潮州鎮,19760,53937,26910,27027
2019/6/1,屏東縣,東港鎮,16885,47424,23916,23508
2019/6/1,屏東縣,恆春鎮,11736,30697,15718,14979
2019/6/1,屏東縣,萬丹鄉,15257,50497,26222,24275
2019/6/1,屏東縣,長治鄉,10185,29532,15415,14117
2019/6/1,屏東縣,麟洛鄉,3862,10979,5697,5282
2019/6/1,屏東縣,九如鄉,7110,21998,11341,10657
2019/6/1,屏東縣,里港鄉,8223,25925,13166,12759
2019/6/1,屏東縣,鹽埔鄉,7876,25479,13211,12268
2019/6/1,屏東縣,高樹鄉,9238,24132,12889,11243
2019/6/1,屏東縣,萬巒鄉,6521,20524,10684,9840
2019/6/1,屏東縣,內埔鄉,18774,53898,27845,26053
2019/6/1,屏東縣,竹田鄉,5665,16990,9019,7971
2019/6/1,屏東縣,新埤鄉,3434,9791,5219,4572
2019/6/1,屏東縣,枋寮鄉,8568,24159,12627,11532
2019/6/1,屏東縣,新園鄉,11832,34649,17957,16692
2019/6/1,屏東縣,崁頂鄉,4513,15421,7766,7655
2019/6/1,屏東縣,林邊鄉,6692,17706,9027,8679
2019/6/1,屏東縣,南州鄉,3711,10554,5421,5133
2019/6/1,屏東縣,佳冬鄉,6968,18941,9825,9116
2019/6/1,屏東縣,琉球鄉,4560,12241,6714,5527
2019/6/1,屏東縣,車城鄉,3473,8480,4525,3955
2019/6/1,屏東縣,滿州鄉,3040,7801,4227,3574
2019/6/1,屏東縣,枋山鄉,2079,5402,2865,2537
2019/6/1,屏東縣,三地門鄉,2333,7677,3852,3825
2019/6/1,屏東縣,霧臺鄉,1052,3298,1681,1617
2019/6/1,屏東縣,瑪家鄉,2057,6763,3422,3341
2019/6/1,屏東縣,泰武鄉,1376,5372,2814,2558
2019/6/1,屏東縣,來義鄉,2235,7428,3748,3680
2019/6/1,屏東縣,春日鄉,1417,4935,2523,2412
2019/6/1,屏東縣,獅子鄉,1577,4928,2540,2388
2019/6/1,屏東縣,牡丹鄉,1946,4918,2476,2442
2019/6/1,臺東縣,臺東市,39983,105317,52611,52706
2019/6/1,臺東縣,成功鎮,5371,13901,7311,6590
2019/6/1,臺東縣,關山鎮,3182,8660,4494,4166
2019/6/1,臺東縣,卑南鄉,6757,17192,9071,8121
2019/6/1,臺東縣,大武鄉,2449,5909,3090,2819
2019/6/1,臺東縣,太麻里鄉,4736,11073,5888,5185
2019/6/1,臺東縣,東河鄉,3772,8414,4659,3755
2019/6/1,臺東縣,長濱鄉,2899,7103,4029,3074
2019/6/1,臺東縣,鹿野鄉,3026,7774,4118,3656
2019/6/1,臺東縣,池上鄉,3187,8168,4218,3950
2019/6/1,臺東縣,綠島鄉,1165,4079,2163,1916
2019/6/1,臺東縣,延平鄉,1067,3556,1903,1653
2019/6/1,臺東縣,海端鄉,1083,4141,2207,1934
2019/6/1,臺東縣,達仁鄉,1435,3540,1915,1625
2019/6/1,臺東縣,金峰鄉,1156,3726,1880,1846
2019/6/1,臺東縣,蘭嶼鄉,1882,5168,2612,2556
2019/6/1,花蓮縣,花蓮市,41491,103647,49823,53824
2019/6/1,花蓮縣,鳳林鎮,4386,10811,5624,5187
2019/6/1,花蓮縣,玉里鎮,8863,23815,12595,11220
2019/6/1,花蓮縣,新城鄉,7788,20120,10315,9805
2019/6/1,花蓮縣,吉安鄉,32331,83431,41905,41526
2019/6/1,花蓮縣,壽豐鄉,7281,17882,9463,8419
2019/6/1,花蓮縣,光復鄉,5018,12632,6704,5928
2019/6/1,花蓮縣,豐濱鄉,1718,4603,2568,2035
2019/6/1,花蓮縣,瑞穗鄉,4765,11498,6184,5314
2019/6/1,花蓮縣,富里鄉,4031,10211,5550,4661
2019/6/1,花蓮縣,秀林鄉,4847,15913,8147,7766
2019/6/1,花蓮縣,萬榮鄉,2109,6356,3343,3013
2019/6/1,花蓮縣,卓溪鄉,1701,6067,3317,2750
2019/6/1,澎湖縣,馬公市,25058,62633,31894,30739
2019/6/1,澎湖縣,湖西鄉,5916,14804,7852,6952
2019/6/1,澎湖縣,白沙鄉,3479,9816,5128,4688
2019/6/1,澎湖縣,西嶼鄉,3048,8306,4291,4015
2019/6/1,澎湖縣,望安鄉,2062,5295,2862,2433
2019/6/1,澎湖縣,七美鄉,1384,3822,1965,1857
2019/6/1,基隆市,中正區,22657,51532,26247,25285
2019/6/1,基隆市,七堵區,21630,53783,26966,26817
2019/6/1,基隆市,暖暖區,15805,38611,19326,19285
2019/6/1,基隆市,仁愛區,19056,43447,21462,21985
2019/6/1,基隆市,中山區,19227,47156,23911,23245
2019/6/1,基隆市,安樂區,33753,82332,40724,41608
2019/6/1,基隆市,信義區,21805,52614,25919,26695
2019/6/1,新竹市,東區,81331,216986,106554,110432
2019/6/1,新竹市,北區,57744,152018,74249,77769
2019/6/1,新竹市,香山區,27758,78355,39750,38605
2019/6/1,嘉義市,東區,45619,121167,58260,62907
2019/6/1,嘉義市,西區,54590,147268,71961,75307
2019/6/1,金門縣,金城鎮,13051,43300,21577,21723
2019/6/1,金門縣,金湖鎮,9173,29950,15019,14931
2019/6/1,金門縣,金沙鎮,6400,20790,10284,10506
2019/6/1,金門縣,金寧鄉,9004,31790,15992,15798
2019/6/1,金門縣,烈嶼鄉,3187,12767,6302,6465
2019/6/1,金門縣,烏坵鄉,135,684,349,335
2019/6/1,連江縣,南竿鄉,1797,7612,4272,3340
2019/6/1,連江縣,北竿鄉,688,2534,1442,1092
2019/6/1,連江縣,莒光鄉,307,1597,976,621
2019/6/1,連江縣,東引鄉,343,1352,809,543
2019/7/1,總計,新北市,1574033,4007814,1959173,2048641
2019/7/1,總計,臺北市,1058501,2654008,1265088,1388920
2019/7/1,總計,桃園市,818144,2237943,1111403,1126540
2019/7/1,總計,臺中市,980922,2811148,1382696,1428452
2019/7/1,總計,臺南市,693158,1881796,938297,943499
2019/7/1,總計,高雄市,1105884,2773591,1370832,1402759
2019/7/1,總計,臺灣省,2514155,7073871,3601266,3472605
2019/7/1,總計,宜蘭縣,170042,454636,229596,225040
2019/7/1,總計,新竹縣,198307,560719,286222,274497
2019/7/1,總計,苗栗縣,190328,546461,281886,264575
2019/7/1,總計,彰化縣,391126,1274274,648533,625741
2019/7/1,總計,南投縣,178697,495084,253340,241744
2019/7/1,總計,雲林縣,241464,682912,353819,329093
2019/7/1,總計,嘉義縣,183347,504453,261974,242479
2019/7/1,總計,屏東縣,288981,821196,419100,402096
2019/7/1,總計,臺東縣,83167,217540,112052,105488
2019/7/1,總計,花蓮縣,126371,326813,165472,161341
2019/7/1,總計,澎湖縣,40948,104708,54009,50699
2019/7/1,總計,基隆市,154009,369360,184486,184874
2019/7/1,總計,新竹市,167100,447484,220631,226853
2019/7/1,總計,嘉義市,100268,268231,130146,138085
2019/7/1,總計,福建省,44157,152427,77056,75371
2019/7/1,總計,金門縣,41008,139365,69577,69788
2019/7/1,總計,連江縣,3149,13062,7479,5583
2019/7/1,新北市,板橋區,214148,556027,270729,285298
2019/7/1,新北市,三重區,152500,385722,189456,196266
2019/7/1,新北市,中和區,166722,412221,199630,212591
2019/7/1,新北市,永和區,91287,220971,104737,116234
2019/7/1,新北市,新莊區,156932,419454,204347,215107
2019/7/1,新北市,新店區,128484,302686,145251,157435
2019/7/1,新北市,樹林區,66970,183898,91657,92241
2019/7/1,新北市,鶯歌區,30710,86643,43446,43197
2019/7/1,新北市,三峽區,43667,116201,58098,58103
2019/7/1,新北市,淡水區,78954,176657,84528,92129
2019/7/1,新北市,汐止區,88897,202207,98428,103779
2019/7/1,新北市,瑞芳區,16128,39688,20020,19668
2019/7/1,新北市,土城區,87681,237142,116706,120436
2019/7/1,新北市,蘆洲區,72131,201753,98947,102806
2019/7/1,新北市,五股區,33170,87259,43944,43315
2019/7/1,新北市,泰山區,28727,78722,38912,39810
2019/7/1,新北市,林口區,45430,113350,55036,58314
2019/7/1,新北市,深坑區,9665,23662,11825,11837
2019/7/1,新北市,石碇區,3412,7656,4174,3482
2019/7/1,新北市,坪林區,2539,6663,3638,3025
2019/7/1,新北市,三芝區,9514,22824,11760,11064
2019/7/1,新北市,石門區,4308,11966,6204,5762
2019/7/1,新北市,八里區,15091,39099,19495,19604
2019/7/1,新北市,平溪區,2284,4600,2553,2047
2019/7/1,新北市,雙溪區,3789,8731,4719,4012
2019/7/1,新北市,貢寮區,4346,12112,6185,5927
2019/7/1,新北市,金山區,7133,21516,10595,10921
2019/7/1,新北市,萬里區,7509,21971,11021,10950
2019/7/1,新北市,烏來區,1905,6413,3132,3281
2019/7/1,桃園市,桃園區,171650,450510,218316,232194
2019/7/1,桃園市,中壢區,155225,415217,203984,211233
2019/7/1,桃園市,大溪區,33199,95270,48396,46874
2019/7/1,桃園市,楊梅區,60375,172073,86568,85505
2019/7/1,桃園市,蘆竹區,59971,165693,82127,83566
2019/7/1,桃園市,大園區,34444,92196,46959,45237
2019/7/1,桃園市,龜山區,63493,162042,80490,81552
2019/7/1,桃園市,八德區,73431,204515,102018,102497
2019/7/1,桃園市,龍潭區,42880,123652,61752,61900
2019/7/1,桃園市,平鎮區,79206,227785,113022,114763
2019/7/1,桃園市,新屋區,16738,49198,26177,23021
2019/7/1,桃園市,觀音區,23681,67653,35032,32621
2019/7/1,桃園市,復興區,3851,12139,6562,5577
2019/7/1,臺北市,松山區,81310,204903,95935,108968
2019/7/1,臺北市,信義區,89405,221234,105313,115921
2019/7/1,臺北市,大安區,121514,308383,143580,164803
2019/7/1,臺北市,中山區,100506,228075,105898,122177
2019/7/1,臺北市,中正區,65533,158228,75417,82811
2019/7/1,臺北市,大同區,51857,126687,61554,65133
2019/7/1,臺北市,萬華區,79035,187920,92051,95869
2019/7/1,臺北市,文山區,107100,272790,130610,142180
2019/7/1,臺北市,南港區,47437,120710,58947,61763
2019/7/1,臺北市,內湖區,109173,286527,136618,149909
2019/7/1,臺北市,士林區,107931,284577,137101,147476
2019/7/1,臺北市,北投區,97700,253974,122064,131910
2019/7/1,臺中市,中區,7984,18500,9147,9353
2019/7/1,臺中市,東區,28443,76063,37729,38334
2019/7/1,臺中市,南區,49365,126423,60536,65887
2019/7/1,臺中市,西區,46021,115585,54769,60816
2019/7/1,臺中市,北區,59926,147349,70300,77049
2019/7/1,臺中市,西屯區,87886,229680,110015,119665
2019/7/1,臺中市,南屯區,64194,172155,82266,89889
2019/7/1,臺中市,北屯區,103639,281742,134722,147020
2019/7/1,臺中市,豐原區,54530,166994,82348,84646
2019/7/1,臺中市,東勢區,17406,49962,25616,24346
2019/7/1,臺中市,大甲區,23418,77245,38725,38520
2019/7/1,臺中市,清水區,28243,87278,44712,42566
2019/7/1,臺中市,沙鹿區,30467,94536,47637,46899
2019/7/1,臺中市,梧棲區,18452,58733,29410,29323
2019/7/1,臺中市,后里區,16581,54701,27715,26986
2019/7/1,臺中市,神岡區,19855,65717,33477,32240
2019/7/1,臺中市,潭子區,37037,109246,53911,55335
2019/7/1,臺中市,大雅區,30213,95822,47704,48118
2019/7/1,臺中市,新社區,7628,24397,12641,11756
2019/7/1,臺中市,石岡區,4908,14844,7685,7159
2019/7/1,臺中市,外埔區,9889,32211,16445,15766
2019/7/1,臺中市,大安區,5558,19141,10102,9039
2019/7/1,臺中市,烏日區,25424,75420,37740,37680
2019/7/1,臺中市,大肚區,17957,57259,29228,28031
2019/7/1,臺中市,龍井區,23631,77951,39239,38712
2019/7/1,臺中市,霧峰區,20540,65497,33197,32300
2019/7/1,臺中市,太平區,66191,193113,95595,97518
2019/7/1,臺中市,大里區,70939,212653,104212,108441
2019/7/1,臺中市,和平區,4597,10931,5873,5058
2019/7/1,高雄市,鹽埕區,10879,23990,11917,12073
2019/7/1,高雄市,鼓山區,59106,140671,67722,72949
2019/7/1,高雄市,左營區,79824,197313,94607,102706
2019/7/1,高雄市,楠梓區,72890,187014,91591,95423
2019/7/1,高雄市,三民區,137444,339948,164184,175764
2019/7/1,高雄市,新興區,23107,51082,24476,26606
2019/7/1,高雄市,前金區,12808,26822,12702,14120
2019/7/1,高雄市,苓雅區,72488,169084,81139,87945
2019/7/1,高雄市,前鎮區,79034,187855,92193,95662
2019/7/1,高雄市,旗津區,11112,28275,14567,13708
2019/7/1,高雄市,小港區,68874,157749,78146,79603
2019/7/1,高雄市,鳳山區,142745,359919,175937,183982
2019/7/1,高雄市,林園區,26262,69743,35174,34569
2019/7/1,高雄市,大寮區,42785,112466,57453,55013
2019/7/1,高雄市,大樹區,13707,42216,21584,20632
2019/7/1,高雄市,大社區,13193,34504,17495,17009
2019/7/1,高雄市,仁武區,34991,88918,45015,43903
2019/7/1,高雄市,鳥松區,18884,44802,22611,22191
2019/7/1,高雄市,岡山區,35280,97167,48169,48998
2019/7/1,高雄市,橋頭區,14104,38011,19231,18780
2019/7/1,高雄市,燕巢區,10694,29780,15681,14099
2019/7/1,高雄市,田寮區,3213,7114,3951,3163
2019/7/1,高雄市,阿蓮區,9396,28549,14400,14149
2019/7/1,高雄市,路竹區,17210,52374,26671,25703
2019/7/1,高雄市,湖內區,10962,29750,15198,14552
2019/7/1,高雄市,茄萣區,10572,29956,15390,14566
2019/7/1,高雄市,永安區,5739,13827,6954,6873
2019/7/1,高雄市,彌陀區,6798,19129,9808,9321
2019/7/1,高雄市,梓官區,12700,35743,18403,17340
2019/7/1,高雄市,旗山區,13709,36414,18804,17610
2019/7/1,高雄市,美濃區,14806,39283,20596,18687
2019/7/1,高雄市,六龜區,5557,12780,6913,5867
2019/7/1,高雄市,甲仙區,2282,5967,3168,2799
2019/7/1,高雄市,杉林區,4799,11711,6404,5307
2019/7/1,高雄市,內門區,5120,14280,7716,6564
2019/7/1,高雄市,茂林區,604,1965,991,974
2019/7/1,高雄市,桃源區,1366,4268,2246,2022
2019/7/1,高雄市,那瑪夏區,840,3152,1625,1527
2019/7/1,臺南市,新營區,29136,77208,38206,39002
2019/7/1,臺南市,鹽水區,10069,25311,13186,12125
2019/7/1,臺南市,白河區,10772,27859,14558,13301
2019/7/1,臺南市,柳營區,7971,21101,10995,10106
2019/7/1,臺南市,後壁區,8780,23150,12018,11132
2019/7/1,臺南市,東山區,8306,20581,10913,9668
2019/7/1,臺南市,麻豆區,15880,44045,22398,21647
2019/7/1,臺南市,下營區,9127,23722,12252,11470
2019/7/1,臺南市,六甲區,7815,22010,11382,10628
2019/7/1,臺南市,官田區,8014,21280,10834,10446
2019/7/1,臺南市,大內區,3790,9460,5101,4359
2019/7/1,臺南市,佳里區,20985,59042,29231,29811
2019/7/1,臺南市,學甲區,9648,25593,13088,12505
2019/7/1,臺南市,西港區,8273,24559,12419,12140
2019/7/1,臺南市,七股區,8025,22476,11638,10838
2019/7/1,臺南市,將軍區,7286,19509,9951,9558
2019/7/1,臺南市,北門區,4221,10919,5498,5421
2019/7/1,臺南市,新化區,14549,43362,22075,21287
2019/7/1,臺南市,善化區,18498,49655,24968,24687
2019/7/1,臺南市,新市區,12786,37198,18591,18607
2019/7/1,臺南市,安定區,10292,30445,15653,14792
2019/7/1,臺南市,山上區,2718,7237,3787,3450
2019/7/1,臺南市,玉井區,5156,13883,7159,6724
2019/7/1,臺南市,楠西區,3505,9389,4963,4426
2019/7/1,臺南市,南化區,2852,8642,4649,3993
2019/7/1,臺南市,左鎮區,1943,4730,2658,2072
2019/7/1,臺南市,仁德區,28107,76013,38402,37611
2019/7/1,臺南市,歸仁區,22908,68177,34509,33668
2019/7/1,臺南市,關廟區,11305,34234,17624,16610
2019/7/1,臺南市,龍崎區,1531,3947,2118,1829
2019/7/1,臺南市,永康區,86045,235287,115671,119616
2019/7/1,臺南市,東區,72396,186013,88994,97019
2019/7/1,臺南市,南區,46517,124886,61646,63240
2019/7/1,臺南市,北區,51356,131762,63919,67843
2019/7/1,臺南市,安南區,64437,193869,97706,96163
2019/7/1,臺南市,安平區,26258,66965,31769,35196
2019/7/1,臺南市,中西區,31901,78277,37768,40509
2019/7/1,宜蘭縣,宜蘭市,36695,95707,46567,49140
2019/7/1,宜蘭縣,羅東鎮,26575,72203,34193,38010
2019/7/1,宜蘭縣,蘇澳鎮,14228,39336,20062,19274
2019/7/1,宜蘭縣,頭城鎮,10314,29028,14964,14064
2019/7/1,宜蘭縣,礁溪鄉,14174,35431,18394,17037
2019/7/1,宜蘭縣,壯圍鄉,8954,24346,12821,11525
2019/7/1,宜蘭縣,員山鄉,11812,32301,17096,15205
2019/7/1,宜蘭縣,冬山鄉,19493,53042,27180,25862
2019/7/1,宜蘭縣,五結鄉,15185,39741,20409,19332
2019/7/1,宜蘭縣,三星鄉,8682,21363,11498,9865
2019/7/1,宜蘭縣,大同鄉,1945,6149,3300,2849
2019/7/1,宜蘭縣,南澳鄉,1985,5989,3112,2877
2019/7/1,新竹縣,竹北市,70522,191594,95354,96240
2019/7/1,新竹縣,關西鎮,9357,28161,15111,13050
2019/7/1,新竹縣,新埔鎮,10813,32923,17509,15414
2019/7/1,新竹縣,竹東鎮,34592,96794,48615,48179
2019/7/1,新竹縣,湖口鄉,27311,77722,39346,38376
2019/7/1,新竹縣,橫山鄉,4419,12831,6952,5879
2019/7/1,新竹縣,新豐鄉,18998,57208,29321,27887
2019/7/1,新竹縣,芎林鄉,6677,19948,10546,9402
2019/7/1,新竹縣,寶山鄉,5751,14585,7912,6673
2019/7/1,新竹縣,北埔鄉,3133,9227,5009,4218
2019/7/1,新竹縣,峨眉鄉,2073,5514,3035,2479
2019/7/1,新竹縣,尖石鄉,2895,9583,5014,4569
2019/7/1,新竹縣,五峰鄉,1766,4629,2498,2131
2019/7/1,苗栗縣,苗栗市,31696,88118,43965,44153
2019/7/1,苗栗縣,頭份市,35911,103313,52120,51193
2019/7/1,苗栗縣,苑裡鎮,14804,44983,23444,21539
2019/7/1,苗栗縣,通霄鎮,11535,33643,17810,15833
2019/7/1,苗栗縣,竹南鎮,30272,86360,43556,42804
2019/7/1,苗栗縣,後龍鎮,12012,35876,19030,16846
2019/7/1,苗栗縣,卓蘭鎮,5969,16511,8640,7871
2019/7/1,苗栗縣,大湖鄉,5334,14311,7585,6726
2019/7/1,苗栗縣,公館鄉,10706,32905,17168,15737
2019/7/1,苗栗縣,銅鑼鄉,6126,17725,9414,8311
2019/7/1,苗栗縣,南庄鄉,3936,9885,5425,4460
2019/7/1,苗栗縣,頭屋鄉,3641,10554,5593,4961
2019/7/1,苗栗縣,三義鄉,5542,16071,8498,7573
2019/7/1,苗栗縣,西湖鄉,2633,6945,3886,3059
2019/7/1,苗栗縣,造橋鄉,4133,12543,6634,5909
2019/7/1,苗栗縣,三灣鄉,2373,6549,3575,2974
2019/7/1,苗栗縣,獅潭鄉,1716,4249,2377,1872
2019/7/1,苗栗縣,泰安鄉,1989,5920,3166,2754
2019/7/1,彰化縣,彰化市,77040,232325,114512,117813
2019/7/1,彰化縣,員林市,40108,124887,61986,62901
2019/7/1,彰化縣,鹿港鎮,24867,86908,44112,42796
2019/7/1,彰化縣,和美鎮,27111,90617,46061,44556
2019/7/1,彰化縣,北斗鎮,10831,33316,16774,16542
2019/7/1,彰化縣,溪湖鎮,16479,55283,27963,27320
2019/7/1,彰化縣,田中鎮,13259,41348,21235,20113
2019/7/1,彰化縣,二林鎮,15148,50264,25852,24412
2019/7/1,彰化縣,線西鄉,4456,16812,8632,8180
2019/7/1,彰化縣,伸港鄉,10242,37292,18973,18319
2019/7/1,彰化縣,福興鄉,13061,46815,24375,22440
2019/7/1,彰化縣,秀水鄉,10907,39176,20207,18969
2019/7/1,彰化縣,花壇鄉,14248,45704,23464,22240
2019/7/1,彰化縣,芬園鄉,6818,23409,12311,11098
2019/7/1,彰化縣,大村鄉,11269,37026,19101,17925
2019/7/1,彰化縣,埔鹽鄉,9150,32308,16989,15319
2019/7/1,彰化縣,埔心鄉,10825,34744,17870,16874
2019/7/1,彰化縣,永靖鄉,10946,36788,19033,17755
2019/7/1,彰化縣,社頭鄉,12985,42698,21906,20792
2019/7/1,彰化縣,二水鄉,5298,14958,7868,7090
2019/7/1,彰化縣,田尾鄉,7998,27060,13958,13102
2019/7/1,彰化縣,埤頭鄉,9111,30368,15684,14684
2019/7/1,彰化縣,芳苑鄉,10142,33246,17548,15698
2019/7/1,彰化縣,大城鄉,5227,16486,8898,7588
2019/7/1,彰化縣,竹塘鄉,4597,14960,7832,7128
2019/7/1,彰化縣,溪州鄉,9003,29476,15389,14087
2019/7/1,南投縣,南投市,35069,99306,49687,49619
2019/7/1,南投縣,埔里鎮,29023,80159,39880,40279
2019/7/1,南投縣,草屯鎮,33645,97379,49189,48190
2019/7/1,南投縣,竹山鎮,20143,54122,27681,26441
2019/7/1,南投縣,集集鎮,4262,10667,5563,5104
2019/7/1,南投縣,名間鄉,12625,38084,20077,18007
2019/7/1,南投縣,鹿谷鄉,8078,17571,9363,8208
2019/7/1,南投縣,中寮鄉,5602,14584,7906,6678
2019/7/1,南投縣,魚池鄉,5764,15669,8268,7401
2019/7/1,南投縣,國姓鄉,7262,18384,9927,8457
2019/7/1,南投縣,水里鄉,7073,17318,9065,8253
2019/7/1,南投縣,信義鄉,5273,16041,8601,7440
2019/7/1,南投縣,仁愛鄉,4878,15800,8133,7667
2019/7/1,雲林縣,斗六市,38756,108567,53940,54627
2019/7/1,雲林縣,斗南鎮,15927,44341,22510,21831
2019/7/1,雲林縣,虎尾鎮,25393,70936,35906,35030
2019/7/1,雲林縣,西螺鎮,14865,45863,23111,22752
2019/7/1,雲林縣,土庫鎮,9489,28660,14920,13740
2019/7/1,雲林縣,北港鎮,16021,39612,20483,19129
2019/7/1,雲林縣,古坑鄉,11108,31285,16488,14797
2019/7/1,雲林縣,大埤鄉,6629,18880,10102,8778
2019/7/1,雲林縣,莿桐鄉,9351,28555,14921,13634
2019/7/1,雲林縣,林內鄉,6023,17991,9417,8574
2019/7/1,雲林縣,二崙鄉,8933,26609,14209,12400
2019/7/1,雲林縣,崙背鄉,8500,24134,12750,11384
2019/7/1,雲林縣,麥寮鄉,14742,46614,23295,23319
2019/7/1,雲林縣,東勢鄉,5696,14526,8056,6470
2019/7/1,雲林縣,褒忠鄉,4425,12791,6881,5910
2019/7/1,雲林縣,臺西鄉,8592,23422,12560,10862
2019/7/1,雲林縣,元長鄉,9191,25296,13868,11428
2019/7/1,雲林縣,四湖鄉,8665,22912,12429,10483
2019/7/1,雲林縣,口湖鄉,9384,26960,14384,12576
2019/7/1,雲林縣,水林鄉,9774,24958,13589,11369
2019/7/1,嘉義縣,太保市,13353,38225,19563,18662
2019/7/1,嘉義縣,朴子市,15793,42026,21232,20794
2019/7/1,嘉義縣,布袋鎮,9860,26470,13500,12970
2019/7/1,嘉義縣,大林鎮,11402,30834,15743,15091
2019/7/1,嘉義縣,民雄鄉,25247,71364,36473,34891
2019/7/1,嘉義縣,溪口鄉,5294,14374,7670,6704
2019/7/1,嘉義縣,新港鄉,10717,31568,16643,14925
2019/7/1,嘉義縣,六腳鄉,8778,22671,11986,10685
2019/7/1,嘉義縣,東石鄉,9163,24280,12855,11425
2019/7/1,嘉義縣,義竹鄉,7284,18012,9366,8646
2019/7/1,嘉義縣,鹿草鄉,5741,15199,8171,7028
2019/7/1,嘉義縣,水上鄉,18228,49238,25424,23814
2019/7/1,嘉義縣,中埔鄉,16057,44347,23060,21287
2019/7/1,嘉義縣,竹崎鄉,11675,35331,18797,16534
2019/7/1,嘉義縣,梅山鄉,6746,19057,10119,8938
2019/7/1,嘉義縣,番路鄉,4211,11308,6095,5213
2019/7/1,嘉義縣,大埔鄉,1918,4597,2361,2236
2019/7/1,嘉義縣,阿里山鄉,1880,5552,2916,2636
2019/7/1,屏東縣,屏東市,74816,199282,98185,101097
2019/7/1,屏東縣,潮州鎮,19835,53931,26904,27027
2019/7/1,屏東縣,東港鎮,16901,47357,23870,23487
2019/7/1,屏東縣,恆春鎮,11737,30675,15712,14963
2019/7/1,屏東縣,萬丹鄉,15299,50490,26217,24273
2019/7/1,屏東縣,長治鄉,10211,29553,15423,14130
2019/7/1,屏東縣,麟洛鄉,3866,10966,5695,5271
2019/7/1,屏東縣,九如鄉,7114,21984,11331,10653
2019/7/1,屏東縣,里港鄉,8229,25886,13146,12740
2019/7/1,屏東縣,鹽埔鄉,7885,25453,13187,12266
2019/7/1,屏東縣,高樹鄉,9240,24111,12874,11237
2019/7/1,屏東縣,萬巒鄉,6515,20505,10673,9832
2019/7/1,屏東縣,內埔鄉,18786,53819,27783,26036
2019/7/1,屏東縣,竹田鄉,5661,16951,9003,7948
2019/7/1,屏東縣,新埤鄉,3436,9778,5211,4567
2019/7/1,屏東縣,枋寮鄉,8580,24134,12612,11522
2019/7/1,屏東縣,新園鄉,11851,34657,17964,16693
2019/7/1,屏東縣,崁頂鄉,4514,15380,7751,7629
2019/7/1,屏東縣,林邊鄉,6691,17675,9013,8662
2019/7/1,屏東縣,南州鄉,3718,10547,5411,5136
2019/7/1,屏東縣,佳冬鄉,6962,18921,9802,9119
2019/7/1,屏東縣,琉球鄉,4561,12225,6706,5519
2019/7/1,屏東縣,車城鄉,3471,8450,4514,3936
2019/7/1,屏東縣,滿州鄉,3030,7754,4207,3547
2019/7/1,屏東縣,枋山鄉,2081,5395,2856,2539
2019/7/1,屏東縣,三地門鄉,2331,7674,3854,3820
2019/7/1,屏東縣,霧臺鄉,1050,3302,1685,1617
2019/7/1,屏東縣,瑪家鄉,2057,6765,3422,3343
2019/7/1,屏東縣,泰武鄉,1380,5381,2814,2567
2019/7/1,屏東縣,來義鄉,2232,7425,3743,3682
2019/7/1,屏東縣,春日鄉,1419,4946,2533,2413
2019/7/1,屏東縣,獅子鄉,1579,4914,2528,2386
2019/7/1,屏東縣,牡丹鄉,1943,4910,2471,2439
2019/7/1,臺東縣,臺東市,39976,105261,52575,52686
2019/7/1,臺東縣,成功鎮,5375,13871,7294,6577
2019/7/1,臺東縣,關山鎮,3186,8652,4480,4172
2019/7/1,臺東縣,卑南鄉,6772,17229,9080,8149
2019/7/1,臺東縣,大武鄉,2453,5889,3084,2805
2019/7/1,臺東縣,太麻里鄉,4739,11057,5879,5178
2019/7/1,臺東縣,東河鄉,3764,8394,4647,3747
2019/7/1,臺東縣,長濱鄉,2897,7100,4026,3074
2019/7/1,臺東縣,鹿野鄉,3029,7760,4103,3657
2019/7/1,臺東縣,池上鄉,3183,8162,4219,3943
2019/7/1,臺東縣,綠島鄉,1172,4088,2166,1922
2019/7/1,臺東縣,延平鄉,1067,3547,1900,1647
2019/7/1,臺東縣,海端鄉,1084,4119,2202,1917
2019/7/1,臺東縣,達仁鄉,1435,3538,1910,1628
2019/7/1,臺東縣,金峰鄉,1156,3718,1879,1839
2019/7/1,臺東縣,蘭嶼鄉,1879,5155,2608,2547
2019/7/1,花蓮縣,花蓮市,41505,103550,49777,53773
2019/7/1,花蓮縣,鳳林鎮,4381,10795,5623,5172
2019/7/1,花蓮縣,玉里鎮,8865,23791,12598,11193
2019/7/1,花蓮縣,新城鄉,7793,20124,10317,9807
2019/7/1,花蓮縣,吉安鄉,32357,83458,41911,41547
2019/7/1,花蓮縣,壽豐鄉,7286,17878,9472,8406
2019/7/1,花蓮縣,光復鄉,5012,12612,6692,5920
2019/7/1,花蓮縣,豐濱鄉,1714,4581,2559,2022
2019/7/1,花蓮縣,瑞穗鄉,4755,11477,6166,5311
2019/7/1,花蓮縣,富里鄉,4037,10199,5547,4652
2019/7/1,花蓮縣,秀林鄉,4854,15936,8154,7782
2019/7/1,花蓮縣,萬榮鄉,2109,6351,3341,3010
2019/7/1,花蓮縣,卓溪鄉,1703,6061,3315,2746
2019/7/1,澎湖縣,馬公市,25037,62587,31857,30730
2019/7/1,澎湖縣,湖西鄉,5941,14856,7887,6969
2019/7/1,澎湖縣,白沙鄉,3481,9820,5134,4686
2019/7/1,澎湖縣,西嶼鄉,3046,8326,4299,4027
2019/7/1,澎湖縣,望安鄉,2059,5298,2869,2429
2019/7/1,澎湖縣,七美鄉,1384,3821,1963,1858
2019/7/1,基隆市,中正區,22645,51528,26250,25278
2019/7/1,基隆市,七堵區,21638,53789,26976,26813
2019/7/1,基隆市,暖暖區,15815,38568,19288,19280
2019/7/1,基隆市,仁愛區,19059,43403,21444,21959
2019/7/1,基隆市,中山區,19223,47101,23887,23214
2019/7/1,基隆市,安樂區,33797,82343,40723,41620
2019/7/1,基隆市,信義區,21832,52628,25918,26710
2019/7/1,新竹市,東區,81435,216966,106566,110400
2019/7/1,新竹市,北區,57843,152025,74238,77787
2019/7/1,新竹市,香山區,27822,78493,39827,38666
2019/7/1,嘉義市,東區,45668,121098,58248,62850
2019/7/1,嘉義市,西區,54600,147133,71898,75235
2019/7/1,金門縣,金城鎮,13052,43321,21596,21725
2019/7/1,金門縣,金湖鎮,9189,30035,15063,14972
2019/7/1,金門縣,金沙鎮,6396,20805,10293,10512
2019/7/1,金門縣,金寧鄉,9049,31730,15958,15772
2019/7/1,金門縣,烈嶼鄉,3187,12789,6319,6470
2019/7/1,金門縣,烏坵鄉,135,685,348,337
2019/7/1,連江縣,南竿鄉,1801,7598,4268,3330
2019/7/1,連江縣,北竿鄉,697,2537,1445,1092
2019/7/1,連江縣,莒光鄉,306,1576,959,617
2019/7/1,連江縣,東引鄉,345,1351,807,544
2019/8/1,總計,新北市,1577188,4010657,1960366,2050291
2019/8/1,總計,臺北市,1059212,2650154,1263106,1387048
2019/8/1,總計,桃園市,820261,2240328,1112439,1127889
2019/8/1,總計,臺中市,982560,2811729,1382933,1428796
2019/8/1,總計,臺南市,694260,1881730,938165,943565
2019/8/1,總計,高雄市,1107397,2773786,1370774,1403012
2019/8/1,總計,臺灣省,2517304,7073018,3600420,3472598
2019/8/1,總計,宜蘭縣,170290,454579,229535,225044
2019/8/1,總計,新竹縣,199016,561806,286757,275049
2019/8/1,總計,苗栗縣,190518,546424,281805,264619
2019/8/1,總計,彰化縣,391619,1273613,648149,625464
2019/8/1,總計,南投縣,178813,495062,253281,241781
2019/8/1,總計,雲林縣,241701,682577,353624,328953
2019/8/1,總計,嘉義縣,183441,504106,261787,242319
2019/8/1,總計,屏東縣,289243,820798,418833,401965
2019/8/1,總計,臺東縣,83187,217408,111980,105428
2019/8/1,總計,花蓮縣,126445,326780,165437,161343
2019/8/1,總計,澎湖縣,40978,104711,54009,50702
2019/8/1,總計,基隆市,154216,369305,184382,184923
2019/8/1,總計,新竹市,167457,447781,220780,227001
2019/8/1,總計,嘉義市,100380,268068,130061,138007
2019/8/1,總計,福建省,44219,152392,77031,75361
2019/8/1,總計,金門縣,41066,139319,69552,69767
2019/8/1,總計,連江縣,3153,13073,7479,5594
2019/8/1,新北市,板橋區,214525,556242,270781,285461
2019/8/1,新北市,三重區,152788,385993,189554,196439
2019/8/1,新北市,中和區,167010,412440,199726,212714
2019/8/1,新北市,永和區,91288,220821,104691,116130
2019/8/1,新北市,新莊區,157184,419741,204465,215276
2019/8/1,新北市,新店區,128707,302857,145300,157557
2019/8/1,新北市,樹林區,67103,184041,91702,92339
2019/8/1,新北市,鶯歌區,30788,86666,43458,43208
2019/8/1,新北市,三峽區,43792,116263,58115,58148
2019/8/1,新北市,淡水區,79342,177210,84831,92379
2019/8/1,新北市,汐止區,89128,202533,98567,103966
2019/8/1,新北市,瑞芳區,16146,39648,20013,19635
2019/8/1,新北市,土城區,87805,237226,116728,120498
2019/8/1,新北市,蘆洲區,72252,201728,98941,102787
2019/8/1,新北市,五股區,33300,87457,44033,43424
2019/8/1,新北市,泰山區,28770,78781,38929,39852
2019/8/1,新北市,林口區,45667,113829,55273,58556
2019/8/1,新北市,深坑區,9699,23698,11843,11855
2019/8/1,新北市,石碇區,3410,7635,4161,3474
2019/8/1,新北市,坪林區,2537,6663,3631,3032
2019/8/1,新北市,三芝區,9530,22805,11731,11074
2019/8/1,新北市,石門區,4308,11938,6194,5744
2019/8/1,新北市,八里區,15123,39192,19545,19647
2019/8/1,新北市,平溪區,2287,4592,2554,2038
2019/8/1,新北市,雙溪區,3790,8709,4708,4001
2019/8/1,新北市,貢寮區,4350,12089,6174,5915
2019/8/1,新北市,金山區,7133,21470,10571,10899
2019/8/1,新北市,萬里區,7520,21966,11016,10950
2019/8/1,新北市,烏來區,1906,6424,3131,3293
2019/8/1,桃園市,桃園區,172083,450928,218522,232406
2019/8/1,桃園市,中壢區,155643,415698,204194,211504
2019/8/1,桃園市,大溪區,33263,95318,48413,46905
2019/8/1,桃園市,楊梅區,60552,172239,86609,85630
2019/8/1,桃園市,蘆竹區,60119,165945,82252,83693
2019/8/1,桃園市,大園區,34555,92359,47033,45326
2019/8/1,桃園市,龜山區,63613,162221,80565,81656
2019/8/1,桃園市,八德區,73661,204827,102173,102654
2019/8/1,桃園市,龍潭區,43034,123813,61829,61984
2019/8/1,桃園市,平鎮區,79359,227902,113046,114856
2019/8/1,桃園市,新屋區,16776,49208,26173,23035
2019/8/1,桃園市,觀音區,23752,67725,35064,32661
2019/8/1,桃園市,復興區,3851,12145,6566,5579
2019/8/1,臺北市,松山區,81289,204460,95706,108754
2019/8/1,臺北市,信義區,89376,220817,105078,115739
2019/8/1,臺北市,大安區,121616,308079,143439,164640
2019/8/1,臺北市,中山區,100598,227807,105744,122063
2019/8/1,臺北市,中正區,65550,157990,75288,82702
2019/8/1,臺北市,大同區,51836,126316,61355,64961
2019/8/1,臺北市,萬華區,79176,187695,91933,95762
2019/8/1,臺北市,文山區,107209,272456,130449,142007
2019/8/1,臺北市,南港區,47476,120537,58867,61670
2019/8/1,臺北市,內湖區,109296,286227,136460,149767
2019/8/1,臺北市,士林區,108011,284119,136889,147230
2019/8/1,臺北市,北投區,97779,253651,121898,131753
2019/8/1,臺中市,中區,7951,18405,9101,9304
2019/8/1,臺中市,東區,28478,76068,37731,38337
2019/8/1,臺中市,南區,49435,126472,60559,65913
2019/8/1,臺中市,西區,46026,115381,54666,60715
2019/8/1,臺中市,北區,60062,147324,70275,77049
2019/8/1,臺中市,西屯區,88030,229840,110124,119716
2019/8/1,臺中市,南屯區,64383,172440,82390,90050
2019/8/1,臺中市,北屯區,103955,282290,135000,147290
2019/8/1,臺中市,豐原區,54593,166929,82318,84611
2019/8/1,臺中市,東勢區,17416,49914,25594,24320
2019/8/1,臺中市,大甲區,23440,77081,38643,38438
2019/8/1,臺中市,清水區,28354,87402,44743,42659
2019/8/1,臺中市,沙鹿區,30546,94575,47659,46916
2019/8/1,臺中市,梧棲區,18497,58792,29449,29343
2019/8/1,臺中市,后里區,16586,54670,27707,26963
2019/8/1,臺中市,神岡區,19894,65681,33448,32233
2019/8/1,臺中市,潭子區,37077,109315,53957,55358
2019/8/1,臺中市,大雅區,30229,95746,47651,48095
2019/8/1,臺中市,新社區,7625,24353,12623,11730
2019/8/1,臺中市,石岡區,4908,14812,7671,7141
2019/8/1,臺中市,外埔區,9893,32220,16445,15775
2019/8/1,臺中市,大安區,5566,19128,10105,9023
2019/8/1,臺中市,烏日區,25451,75405,37746,37659
2019/8/1,臺中市,大肚區,17967,57240,29219,28021
2019/8/1,臺中市,龍井區,23658,77909,39227,38682
2019/8/1,臺中市,霧峰區,20581,65449,33174,32275
2019/8/1,臺中市,太平區,66304,193311,95638,97673
2019/8/1,臺中市,大里區,71064,212662,104201,108461
2019/8/1,臺中市,和平區,4591,10915,5869,5046
2019/8/1,高雄市,鹽埕區,10906,23969,11900,12069
2019/8/1,高雄市,鼓山區,59223,140836,67806,73030
2019/8/1,高雄市,左營區,79956,197436,94636,102800
2019/8/1,高雄市,楠梓區,73094,187263,91727,95536
2019/8/1,高雄市,三民區,137558,339796,164090,175706
2019/8/1,高雄市,新興區,23149,51041,24468,26573
2019/8/1,高雄市,前金區,12829,26833,12707,14126
2019/8/1,高雄市,苓雅區,72604,169074,81128,87946
2019/8/1,高雄市,前鎮區,79163,187843,92154,95689
2019/8/1,高雄市,旗津區,11111,28248,14553,13695
2019/8/1,高雄市,小港區,68946,157775,78138,79637
2019/8/1,高雄市,鳳山區,142933,359973,175981,183992
2019/8/1,高雄市,林園區,26278,69707,35141,34566
2019/8/1,高雄市,大寮區,42784,112428,57427,55001
2019/8/1,高雄市,大樹區,13710,42180,21561,20619
2019/8/1,高雄市,大社區,13198,34499,17504,16995
2019/8/1,高雄市,仁武區,35074,89051,45048,44003
2019/8/1,高雄市,鳥松區,18930,44831,22626,22205
2019/8/1,高雄市,岡山區,35317,97140,48149,48991
2019/8/1,高雄市,橋頭區,14183,38094,19250,18844
2019/8/1,高雄市,燕巢區,10701,29760,15675,14085
2019/8/1,高雄市,田寮區,3207,7105,3949,3156
2019/8/1,高雄市,阿蓮區,9404,28546,14398,14148
2019/8/1,高雄市,路竹區,17233,52296,26631,25665
2019/8/1,高雄市,湖內區,10975,29759,15189,14570
2019/8/1,高雄市,茄萣區,10571,29989,15410,14579
2019/8/1,高雄市,永安區,5743,13808,6938,6870
2019/8/1,高雄市,彌陀區,6787,19102,9802,9300
2019/8/1,高雄市,梓官區,12729,35748,18404,17344
2019/8/1,高雄市,旗山區,13727,36391,18784,17607
2019/8/1,高雄市,美濃區,14810,39216,20567,18649
2019/8/1,高雄市,六龜區,5552,12740,6893,5847
2019/8/1,高雄市,甲仙區,2278,5959,3167,2792
2019/8/1,高雄市,杉林區,4804,11724,6419,5305
2019/8/1,高雄市,內門區,5125,14259,7705,6554
2019/8/1,高雄市,茂林區,605,1959,987,972
2019/8/1,高雄市,桃源區,1363,4258,2239,2019
2019/8/1,高雄市,那瑪夏區,837,3150,1623,1527
2019/8/1,臺南市,新營區,29175,77137,38155,38982
2019/8/1,臺南市,鹽水區,10068,25279,13162,12117
2019/8/1,臺南市,白河區,10771,27818,14526,13292
2019/8/1,臺南市,柳營區,7982,21132,11008,10124
2019/8/1,臺南市,後壁區,8778,23089,11988,11101
2019/8/1,臺南市,東山區,8299,20563,10898,9665
2019/8/1,臺南市,麻豆區,15913,44043,22399,21644
2019/8/1,臺南市,下營區,9141,23714,12249,11465
2019/8/1,臺南市,六甲區,7825,21987,11365,10622
2019/8/1,臺南市,官田區,8022,21287,10832,10455
2019/8/1,臺南市,大內區,3790,9436,5091,4345
2019/8/1,臺南市,佳里區,21032,59086,29258,29828
2019/8/1,臺南市,學甲區,9659,25568,13083,12485
2019/8/1,臺南市,西港區,8281,24573,12427,12146
2019/8/1,臺南市,七股區,8015,22413,11603,10810
2019/8/1,臺南市,將軍區,7278,19479,9923,9556
2019/8/1,臺南市,北門區,4223,10898,5486,5412
2019/8/1,臺南市,新化區,14544,43335,22047,21288
2019/8/1,臺南市,善化區,18584,49731,25004,24727
2019/8/1,臺南市,新市區,12820,37214,18581,18633
2019/8/1,臺南市,安定區,10304,30439,15648,14791
2019/8/1,臺南市,山上區,2715,7218,3781,3437
2019/8/1,臺南市,玉井區,5159,13868,7161,6707
2019/8/1,臺南市,楠西區,3503,9375,4948,4427
2019/8/1,臺南市,南化區,2852,8623,4638,3985
2019/8/1,臺南市,左鎮區,1943,4711,2655,2056
2019/8/1,臺南市,仁德區,28156,76058,38429,37629
2019/8/1,臺南市,歸仁區,22930,68162,34506,33656
2019/8/1,臺南市,關廟區,11324,34232,17619,16613
2019/8/1,臺南市,龍崎區,1533,3944,2117,1827
2019/8/1,臺南市,永康區,86254,235469,115754,119715
2019/8/1,臺南市,東區,72534,186048,88999,97049
2019/8/1,臺南市,南區,46609,124858,61634,63224
2019/8/1,臺南市,北區,51419,131728,63903,67825
2019/8/1,臺南市,安南區,64596,193975,97738,96237
2019/8/1,臺南市,安平區,26293,66989,31773,35216
2019/8/1,臺南市,中西區,31936,78251,37777,40474
2019/8/1,宜蘭縣,宜蘭市,36760,95729,46571,49158
2019/8/1,宜蘭縣,羅東鎮,26610,72162,34180,37982
2019/8/1,宜蘭縣,蘇澳鎮,14245,39326,20069,19257
2019/8/1,宜蘭縣,頭城鎮,10335,29024,14956,14068
2019/8/1,宜蘭縣,礁溪鄉,14185,35419,18398,17021
2019/8/1,宜蘭縣,壯圍鄉,8980,24360,12822,11538
2019/8/1,宜蘭縣,員山鄉,11808,32274,17077,15197
2019/8/1,宜蘭縣,冬山鄉,19516,53046,27156,25890
2019/8/1,宜蘭縣,五結鄉,15231,39784,20433,19351
2019/8/1,宜蘭縣,三星鄉,8688,21340,11484,9856
2019/8/1,宜蘭縣,大同鄉,1948,6140,3293,2847
2019/8/1,宜蘭縣,南澳鄉,1984,5975,3096,2879
2019/8/1,苗栗縣,苗栗市,31731,88099,43944,44155
2019/8/1,苗栗縣,頭份市,36012,103495,52192,51303
2019/8/1,苗栗縣,苑裡鎮,14832,44988,23442,21546
2019/8/1,苗栗縣,通霄鎮,11531,33619,17793,15826
2019/8/1,苗栗縣,竹南鎮,30303,86417,43596,42821
2019/8/1,苗栗縣,後龍鎮,12023,35832,18992,16840
2019/8/1,苗栗縣,卓蘭鎮,5965,16489,8619,7870
2019/8/1,苗栗縣,大湖鄉,5327,14273,7574,6699
2019/8/1,苗栗縣,公館鄉,10717,32907,17164,15743
2019/8/1,苗栗縣,銅鑼鄉,6119,17685,9396,8289
2019/8/1,苗栗縣,南庄鄉,3940,9879,5425,4454
2019/8/1,苗栗縣,頭屋鄉,3645,10534,5579,4955
2019/8/1,苗栗縣,三義鄉,5538,16040,8477,7563
2019/8/1,苗栗縣,西湖鄉,2627,6918,3872,3046
2019/8/1,苗栗縣,造橋鄉,4136,12537,6632,5905
2019/8/1,苗栗縣,三灣鄉,2368,6549,3575,2974
2019/8/1,苗栗縣,獅潭鄉,1715,4251,2374,1877
2019/8/1,苗栗縣,泰安鄉,1989,5912,3159,2753
2019/8/1,新竹縣,竹北市,70875,192375,95738,96637
2019/8/1,新竹縣,關西鎮,9350,28136,15088,13048
2019/8/1,新竹縣,新埔鎮,10828,32926,17515,15411
2019/8/1,新竹縣,竹東鎮,34788,97036,48745,48291
2019/8/1,新竹縣,湖口鄉,27378,77771,39357,38414
2019/8/1,新竹縣,橫山鄉,4420,12819,6942,5877
2019/8/1,新竹縣,新豐鄉,19044,57302,29364,27938
2019/8/1,新竹縣,芎林鄉,6694,19947,10552,9395
2019/8/1,新竹縣,寶山鄉,5755,14579,7912,6667
2019/8/1,新竹縣,北埔鄉,3138,9221,5007,4214
2019/8/1,新竹縣,峨眉鄉,2077,5510,3031,2479
2019/8/1,新竹縣,尖石鄉,2902,9572,5014,4558
2019/8/1,新竹縣,五峰鄉,1767,4612,2492,2120
2019/8/1,彰化縣,彰化市,77158,232204,114413,117791
2019/8/1,彰化縣,員林市,40195,124919,61990,62929
2019/8/1,彰化縣,鹿港鎮,24903,86891,44096,42795
2019/8/1,彰化縣,和美鎮,27165,90603,46051,44552
2019/8/1,彰化縣,北斗鎮,10843,33320,16792,16528
2019/8/1,彰化縣,溪湖鎮,16501,55212,27925,27287
2019/8/1,彰化縣,田中鎮,13270,41286,21199,20087
2019/8/1,彰化縣,二林鎮,15149,50196,25830,24366
2019/8/1,彰化縣,線西鄉,4465,16787,8620,8167
2019/8/1,彰化縣,伸港鄉,10261,37296,18977,18319
2019/8/1,彰化縣,福興鄉,13080,46790,24365,22425
2019/8/1,彰化縣,秀水鄉,10915,39127,20191,18936
2019/8/1,彰化縣,花壇鄉,14263,45685,23466,22219
2019/8/1,彰化縣,芬園鄉,6819,23399,12298,11101
2019/8/1,彰化縣,大村鄉,11300,37043,19113,17930
2019/8/1,彰化縣,埔鹽鄉,9154,32269,16969,15300
2019/8/1,彰化縣,埔心鄉,10844,34778,17874,16904
2019/8/1,彰化縣,永靖鄉,10953,36734,18992,17742
2019/8/1,彰化縣,社頭鄉,12996,42655,21887,20768
2019/8/1,彰化縣,二水鄉,5301,14928,7856,7072
2019/8/1,彰化縣,田尾鄉,7996,27039,13947,13092
2019/8/1,彰化縣,埤頭鄉,9120,30373,15690,14683
2019/8/1,彰化縣,芳苑鄉,10148,33207,17517,15690
2019/8/1,彰化縣,大城鄉,5220,16451,8881,7570
2019/8/1,彰化縣,竹塘鄉,4590,14966,7833,7133
2019/8/1,彰化縣,溪州鄉,9010,29455,15377,14078
2019/8/1,南投縣,南投市,35112,99384,49706,49678
2019/8/1,南投縣,埔里鎮,29042,80164,39887,40277
2019/8/1,南投縣,草屯鎮,33690,97474,49210,48264
2019/8/1,南投縣,竹山鎮,20148,54069,27643,26426
2019/8/1,南投縣,集集鎮,4258,10652,5560,5092
2019/8/1,南投縣,名間鄉,12634,38063,20064,17999
2019/8/1,南投縣,鹿谷鄉,8080,17569,9371,8198
2019/8/1,南投縣,中寮鄉,5594,14547,7890,6657
2019/8/1,南投縣,魚池鄉,5764,15652,8250,7402
2019/8/1,南投縣,國姓鄉,7258,18357,9908,8449
2019/8/1,南投縣,水里鄉,7080,17313,9069,8244
2019/8/1,南投縣,信義鄉,5275,16012,8591,7421
2019/8/1,南投縣,仁愛鄉,4878,15806,8132,7674
2019/8/1,雲林縣,斗六市,38830,108630,53969,54661
2019/8/1,雲林縣,斗南鎮,15950,44329,22497,21832
2019/8/1,雲林縣,虎尾鎮,25447,70949,35904,35045
2019/8/1,雲林縣,西螺鎮,14883,45832,23094,22738
2019/8/1,雲林縣,土庫鎮,9495,28645,14924,13721
2019/8/1,雲林縣,北港鎮,16031,39599,20462,19137
2019/8/1,雲林縣,古坑鄉,11121,31275,16484,14791
2019/8/1,雲林縣,大埤鄉,6626,18845,10081,8764
2019/8/1,雲林縣,莿桐鄉,9361,28537,14916,13621
2019/8/1,雲林縣,林內鄉,6019,17937,9388,8549
2019/8/1,雲林縣,二崙鄉,8927,26551,14177,12374
2019/8/1,雲林縣,崙背鄉,8511,24115,12742,11373
2019/8/1,雲林縣,麥寮鄉,14781,46713,23338,23375
2019/8/1,雲林縣,東勢鄉,5698,14504,8043,6461
2019/8/1,雲林縣,褒忠鄉,4427,12744,6864,5880
2019/8/1,雲林縣,臺西鄉,8599,23409,12550,10859
2019/8/1,雲林縣,元長鄉,9190,25273,13858,11415
2019/8/1,雲林縣,四湖鄉,8669,22880,12411,10469
2019/8/1,雲林縣,口湖鄉,9373,26922,14367,12555
2019/8/1,雲林縣,水林鄉,9763,24888,13555,11333
2019/8/1,嘉義縣,太保市,13376,38222,19554,18668
2019/8/1,嘉義縣,朴子市,15802,41977,21212,20765
2019/8/1,嘉義縣,布袋鎮,9861,26441,13493,12948
2019/8/1,嘉義縣,大林鎮,11396,30790,15724,15066
2019/8/1,嘉義縣,民雄鄉,25279,71352,36465,34887
2019/8/1,嘉義縣,溪口鄉,5291,14356,7661,6695
2019/8/1,嘉義縣,新港鄉,10730,31556,16649,14907
2019/8/1,嘉義縣,六腳鄉,8771,22636,11959,10677
2019/8/1,嘉義縣,東石鄉,9157,24229,12838,11391
2019/8/1,嘉義縣,義竹鄉,7280,17991,9361,8630
2019/8/1,嘉義縣,鹿草鄉,5741,15186,8166,7020
2019/8/1,嘉義縣,水上鄉,18266,49235,25402,23833
2019/8/1,嘉義縣,中埔鄉,16076,44357,23059,21298
2019/8/1,嘉義縣,竹崎鄉,11662,35291,18778,16513
2019/8/1,嘉義縣,梅山鄉,6747,19041,10108,8933
2019/8/1,嘉義縣,番路鄉,4209,11313,6094,5219
2019/8/1,嘉義縣,大埔鄉,1922,4592,2355,2237
2019/8/1,嘉義縣,阿里山鄉,1875,5541,2909,2632
2019/8/1,屏東縣,屏東市,74887,199266,98157,101109
2019/8/1,屏東縣,潮州鎮,19885,53964,26910,27054
2019/8/1,屏東縣,東港鎮,16911,47299,23827,23472
2019/8/1,屏東縣,恆春鎮,11755,30677,15721,14956
2019/8/1,屏東縣,萬丹鄉,15328,50512,26220,24292
2019/8/1,屏東縣,長治鄉,10221,29528,15402,14126
2019/8/1,屏東縣,麟洛鄉,3871,10973,5700,5273
2019/8/1,屏東縣,九如鄉,7124,21980,11322,10658
2019/8/1,屏東縣,里港鄉,8231,25851,13135,12716
2019/8/1,屏東縣,鹽埔鄉,7880,25402,13160,12242
2019/8/1,屏東縣,高樹鄉,9238,24079,12854,11225
2019/8/1,屏東縣,萬巒鄉,6517,20491,10661,9830
2019/8/1,屏東縣,內埔鄉,18802,53762,27739,26023
2019/8/1,屏東縣,竹田鄉,5665,16941,9004,7937
2019/8/1,屏東縣,新埤鄉,3444,9762,5203,4559
2019/8/1,屏東縣,枋寮鄉,8586,24121,12605,11516
2019/8/1,屏東縣,新園鄉,11850,34623,17950,16673
2019/8/1,屏東縣,崁頂鄉,4518,15357,7748,7609
2019/8/1,屏東縣,林邊鄉,6698,17647,8998,8649
2019/8/1,屏東縣,南州鄉,3729,10549,5420,5129
2019/8/1,屏東縣,佳冬鄉,6962,18905,9791,9114
2019/8/1,屏東縣,琉球鄉,4572,12229,6700,5529
2019/8/1,屏東縣,車城鄉,3471,8459,4518,3941
2019/8/1,屏東縣,滿州鄉,3025,7730,4197,3533
2019/8/1,屏東縣,枋山鄉,2078,5377,2846,2531
2019/8/1,屏東縣,三地門鄉,2329,7658,3849,3809
2019/8/1,屏東縣,霧臺鄉,1048,3300,1682,1618
2019/8/1,屏東縣,瑪家鄉,2058,6774,3423,3351
2019/8/1,屏東縣,泰武鄉,1379,5399,2823,2576
2019/8/1,屏東縣,來義鄉,2238,7437,3746,3691
2019/8/1,屏東縣,春日鄉,1420,4952,2538,2414
2019/8/1,屏東縣,獅子鄉,1580,4899,2521,2378
2019/8/1,屏東縣,牡丹鄉,1943,4895,2463,2432
2019/8/1,臺東縣,臺東市,40003,105276,52574,52702
2019/8/1,臺東縣,成功鎮,5374,13845,7282,6563
2019/8/1,臺東縣,關山鎮,3193,8642,4471,4171
2019/8/1,臺東縣,卑南鄉,6777,17235,9084,8151
2019/8/1,臺東縣,大武鄉,2450,5884,3082,2802
2019/8/1,臺東縣,太麻里鄉,4734,11042,5870,5172
2019/8/1,臺東縣,東河鄉,3763,8380,4639,3741
2019/8/1,臺東縣,長濱鄉,2894,7075,4009,3066
2019/8/1,臺東縣,鹿野鄉,3028,7742,4094,3648
2019/8/1,臺東縣,池上鄉,3174,8153,4212,3941
2019/8/1,臺東縣,綠島鄉,1171,4079,2160,1919
2019/8/1,臺東縣,延平鄉,1068,3551,1907,1644
2019/8/1,臺東縣,海端鄉,1086,4118,2201,1917
2019/8/1,臺東縣,達仁鄉,1433,3521,1903,1618
2019/8/1,臺東縣,金峰鄉,1157,3714,1877,1837
2019/8/1,臺東縣,蘭嶼鄉,1882,5151,2615,2536
2019/8/1,花蓮縣,花蓮市,41507,103453,49744,53709
2019/8/1,花蓮縣,鳳林鎮,4378,10797,5625,5172
2019/8/1,花蓮縣,玉里鎮,8858,23758,12582,11176
2019/8/1,花蓮縣,新城鄉,7799,20137,10313,9824
2019/8/1,花蓮縣,吉安鄉,32407,83572,41920,41652
2019/8/1,花蓮縣,壽豐鄉,7299,17871,9466,8405
2019/8/1,花蓮縣,光復鄉,5008,12580,6674,5906
2019/8/1,花蓮縣,豐濱鄉,1713,4567,2549,2018
2019/8/1,花蓮縣,瑞穗鄉,4762,11478,6173,5305
2019/8/1,花蓮縣,富里鄉,4044,10205,5551,4654
2019/8/1,花蓮縣,秀林鄉,4853,15948,8172,7776
2019/8/1,花蓮縣,萬榮鄉,2112,6342,3344,2998
2019/8/1,花蓮縣,卓溪鄉,1705,6072,3324,2748
2019/8/1,澎湖縣,馬公市,25042,62593,31866,30727
2019/8/1,澎湖縣,湖西鄉,5950,14876,7898,6978
2019/8/1,澎湖縣,白沙鄉,3484,9808,5122,4686
2019/8/1,澎湖縣,西嶼鄉,3043,8318,4294,4024
2019/8/1,澎湖縣,望安鄉,2068,5299,2866,2433
2019/8/1,澎湖縣,七美鄉,1391,3817,1963,1854
2019/8/1,基隆市,中正區,22687,51525,26249,25276
2019/8/1,基隆市,七堵區,21685,53795,26952,26843
2019/8/1,基隆市,暖暖區,15844,38562,19276,19286
2019/8/1,基隆市,仁愛區,19054,43339,21412,21927
2019/8/1,基隆市,中山區,19211,47046,23850,23196
2019/8/1,基隆市,安樂區,33862,82339,40704,41635
2019/8/1,基隆市,信義區,21873,52699,25939,26760
2019/8/1,新竹市,東區,81596,217098,106647,110451
2019/8/1,新竹市,北區,57963,152123,74264,77859
2019/8/1,新竹市,香山區,27898,78560,39869,38691
2019/8/1,嘉義市,東區,45748,121062,58197,62865
2019/8/1,嘉義市,西區,54632,147006,71864,75142
2019/8/1,金門縣,金城鎮,13062,43347,21609,21738
2019/8/1,金門縣,金湖鎮,9205,30043,15058,14985
2019/8/1,金門縣,金沙鎮,6394,20758,10270,10488
2019/8/1,金門縣,金寧鄉,9079,31703,15950,15753
2019/8/1,金門縣,烈嶼鄉,3191,12784,6316,6468
2019/8/1,金門縣,烏坵鄉,135,684,349,335
2019/8/1,連江縣,南竿鄉,1798,7586,4258,3328
2019/8/1,連江縣,北竿鄉,704,2574,1460,1114
2019/8/1,連江縣,莒光鄉,306,1565,956,609
2019/8/1,連江縣,東引鄉,345,1348,805,543
